GAME_DATE_EST,HOME_TEAM_ID,VISITOR_TEAM_ID,SEASON,PTS_home,PTS_away,point_total,point_average_last10,point_againts_average_last10,away_point_average_last10,away_point_againts_average_last10,cgp,wins,losses,winpercent,cgp_away,wins_away,losses_away,winpercen_away,hometeam-homewins,hometeam-awaywins,awayteam-homewins,awayteam-awaywins,avgpointtotal_home,avgpointtotal_away,meanpointtotal
2020-03-01,1610612766,1610612749,2019,85.0,93.0,178.0,97.4,102.8,120.9,105.4,59,21,38,0.35600000000000004,59,51,8,0.8640000000000001,9,12,27,24,205.2,224.0,214.6
2020-03-01,1610612750,1610612742,2019,91.0,111.0,202.0,123.5,128.3,119.0,112.4,58,17,41,0.293,60,36,24,0.6,7,10,16,20,246.6,239.2,242.89999999999998
2020-03-01,1610612746,1610612755,2019,136.0,130.0,266.0,118.1,110.5,107.8,112.8,59,40,19,0.6779999999999999,60,37,23,0.617,24,16,28,9,224.6,224.0,224.3
2020-03-01,1610612743,1610612761,2019,133.0,118.0,251.0,115.5,112.9,111.1,102.9,59,40,19,0.6779999999999999,59,42,17,0.7120000000000001,23,17,23,19,233.2,218.0,225.6
2020-03-01,1610612758,1610612765,2019,106.0,100.0,206.0,112.9,110.2,104.6,109.6,59,25,34,0.424,61,20,41,0.328,12,13,11,9,228.8,211.4,220.10000000000002
2020-03-01,1610612740,1610612747,2019,114.0,122.0,236.0,122.0,114.5,116.3,108.7,59,26,33,0.441,58,45,13,0.7759999999999999,12,14,21,24,238.8,226.4,232.60000000000002
2020-03-01,1610612744,1610612764,2019,110.0,124.0,234.0,105.2,116.0,119.1,123.0,60,13,47,0.217,58,21,37,0.362,7,6,14,7,215.6,230.6,223.1
2020-02-29,1610612752,1610612741,2019,125.0,115.0,240.0,106.4,112.4,111.5,120.2,59,17,42,0.28800000000000003,59,20,39,0.339,8,9,12,8,212.4,229.0,220.7
2020-02-29,1610612737,1610612757,2019,129.0,117.0,246.0,121.8,123.7,110.2,117.5,61,18,43,0.295,60,26,34,0.433,12,6,16,10,251.0,228.8,239.9
2020-02-29,1610612748,1610612751,2019,116.0,113.0,229.0,118.0,115.3,114.4,106.3,59,37,22,0.627,58,26,32,0.448,24,13,16,10,236.2,220.8,228.5
2020-02-29,1610612739,1610612754,2019,104.0,113.0,217.0,112.6,114.7,112.8,112.2,59,17,42,0.28800000000000003,59,35,24,0.593,9,8,21,14,235.2,217.2,226.2
2020-02-29,1610612763,1610612747,2019,105.0,88.0,193.0,107.1,110.4,116.6,109.0,59,28,31,0.475,57,45,12,0.789,16,12,21,24,204.2,226.4,215.3
2020-02-29,1610612738,1610612745,2019,110.0,111.0,221.0,118.0,109.5,119.6,113.1,58,41,17,0.7070000000000001,58,38,20,0.655,23,18,21,17,228.6,234.0,231.3
2020-02-29,1610612759,1610612753,2019,114.0,113.0,227.0,110.1,112.2,114.8,115.0,57,24,33,0.421,59,27,32,0.458,14,10,16,11,216.2,236.8,226.5
2020-02-29,1610612756,1610612744,2019,99.0,115.0,214.0,110.2,110.3,104.1,118.0,60,24,36,0.4,59,12,47,0.203,11,13,7,5,215.8,215.6,215.7
2020-02-28,1610612753,1610612750,2019,136.0,125.0,261.0,110.1,112.7,121.9,126.0,58,26,32,0.448,57,17,40,0.298,15,11,7,10,222.8,246.6,234.7
2020-02-28,1610612737,1610612751,2019,141.0,118.0,259.0,119.2,124.2,114.4,104.1,60,17,43,0.28300000000000003,57,26,31,0.456,11,6,16,10,246.8,220.8,233.8
2020-02-28,1610612761,1610612766,2019,96.0,99.0,195.0,113.4,104.8,98.5,105.7,58,42,16,0.7240000000000001,58,20,38,0.345,23,19,9,11,226.4,205.2,215.8
2020-02-28,1610612748,1610612742,2019,126.0,118.0,244.0,116.7,112.7,119.0,111.7,58,36,22,0.621,59,36,23,0.61,23,13,16,20,228.4,239.2,233.8
2020-02-28,1610612763,1610612758,2019,101.0,104.0,205.0,108.6,112.6,113.6,112.4,58,28,30,0.483,58,24,34,0.414,16,12,12,12,211.6,228.8,220.2
2020-02-28,1610612749,1610612760,2019,133.0,86.0,219.0,119.1,109.5,116.4,108.9,58,50,8,0.862,59,37,22,0.627,26,24,20,17,228.6,222.2,225.39999999999998
2020-02-28,1610612740,1610612739,2019,116.0,104.0,220.0,122.7,114.9,113.8,114.9,58,25,33,0.431,58,17,41,0.293,11,14,9,8,241.0,235.2,238.1
2020-02-28,1610612756,1610612765,2019,111.0,113.0,224.0,109.8,110.1,101.5,108.1,59,24,35,0.407,60,19,41,0.317,11,13,11,8,214.6,211.4,213.0
2020-02-28,1610612762,1610612764,2019,129.0,119.0,248.0,110.8,116.8,119.6,121.3,58,36,22,0.621,57,21,36,0.368,20,16,14,7,224.6,230.6,227.6
2020-02-28,1610612746,1610612743,2019,132.0,103.0,235.0,116.7,110.8,117.9,111.2,58,39,19,0.672,58,40,18,0.69,23,16,23,17,222.4,233.2,227.8
2020-02-27,1610612755,1610612752,2019,115.0,106.0,221.0,108.2,112.9,109.7,114.3,59,36,23,0.61,58,17,41,0.293,27,9,8,9,225.0,212.4,218.7
2020-02-27,1610612754,1610612757,2019,106.0,100.0,206.0,112.8,113.7,112.9,118.8,58,34,24,0.586,59,26,33,0.441,20,14,16,10,220.2,228.8,224.5
2020-02-27,1610612760,1610612758,2019,112.0,108.0,220.0,116.0,108.2,115.2,111.5,58,36,22,0.621,57,24,33,0.421,19,17,12,12,220.0,228.8,224.4
2020-02-27,1610612744,1610612747,2019,86.0,116.0,202.0,107.5,118.9,117.8,111.7,58,12,46,0.207,56,44,12,0.7859999999999999,7,5,21,23,224.2,226.4,225.3
2020-02-26,1610612766,1610612752,2019,107.0,101.0,208.0,98.1,107.2,108.8,112.1,57,19,38,0.333,57,17,40,0.298,8,11,8,9,207.4,212.4,209.9
2020-02-26,1610612739,1610612755,2019,108.0,94.0,202.0,114.2,118.6,110.5,114.8,57,16,41,0.281,58,36,22,0.621,8,8,27,9,243.4,225.0,234.2
2020-02-26,1610612764,1610612751,2019,110.0,106.0,216.0,120.5,122.5,114.5,104.4,56,20,36,0.35700000000000004,56,26,30,0.464,13,7,16,10,234.8,220.8,227.8
2020-02-26,1610612737,1610612753,2019,120.0,130.0,250.0,119.9,122.9,106.3,112.0,59,17,42,0.28800000000000003,57,25,32,0.439,11,6,15,10,245.6,222.8,234.2
2020-02-26,1610612748,1610612750,2019,126.0,129.0,255.0,115.8,112.0,119.6,125.2,57,36,21,0.632,56,16,40,0.28600000000000003,23,13,7,9,225.2,246.6,235.89999999999998
2020-02-26,1610612745,1610612763,2019,140.0,112.0,252.0,117.3,112.8,108.1,110.5,57,37,20,0.649,57,28,29,0.491,20,17,16,12,228.8,211.6,220.2
2020-02-26,1610612759,1610612742,2019,103.0,109.0,212.0,110.5,111.5,119.3,111.7,56,24,32,0.429,58,35,23,0.603,14,10,16,19,215.6,239.2,227.39999999999998
2020-02-26,1610612756,1610612746,2019,92.0,102.0,194.0,109.3,111.1,117.7,111.3,58,24,34,0.414,57,38,19,0.667,11,13,23,15,215.6,222.4,219.0
2020-02-26,1610612762,1610612738,2019,103.0,114.0,217.0,112.2,116.8,117.8,110.3,57,36,21,0.632,57,40,17,0.7020000000000001,20,16,23,17,227.4,228.6,228.0
2020-02-25,1610612754,1610612766,2019,119.0,80.0,199.0,111.2,116.9,99.1,106.7,57,33,24,0.579,56,19,37,0.339,19,14,8,11,223.4,207.4,215.4
2020-02-25,1610612761,1610612749,2019,97.0,108.0,205.0,115.6,105.8,120.3,110.6,57,42,15,0.737,57,49,8,0.86,23,19,26,23,232.8,228.6,230.7
2020-02-25,1610612741,1610612760,2019,122.0,124.0,246.0,110.3,118.7,115.6,107.4,58,20,38,0.345,57,35,22,0.614,12,8,19,16,223.6,220.0,221.8
2020-02-25,1610612743,1610612765,2019,115.0,98.0,213.0,117.0,111.4,103.2,109.1,57,39,18,0.684,59,19,40,0.322,22,17,11,8,231.8,211.4,221.60000000000002
2020-02-25,1610612747,1610612740,2019,118.0,109.0,227.0,118.9,111.0,122.7,114.8,55,43,12,0.782,57,25,32,0.439,20,23,11,14,227.2,241.0,234.1
2020-02-25,1610612757,1610612738,2019,106.0,118.0,224.0,114.7,117.7,118.3,111.2,58,26,32,0.448,56,39,17,0.696,16,10,23,16,230.2,228.6,229.39999999999998
2020-02-25,1610612744,1610612758,2019,94.0,112.0,206.0,109.9,120.6,117.3,115.0,57,12,45,0.211,56,23,33,0.411,7,5,12,11,232.4,228.8,230.60000000000002
2020-02-24,1610612739,1610612748,2019,125.0,119.0,244.0,112.6,118.2,113.6,110.0,56,15,41,0.268,56,36,20,0.643,7,8,23,13,239.4,225.2,232.3
2020-02-24,1610612755,1610612737,2019,129.0,112.0,241.0,109.1,114.0,118.7,122.3,57,35,22,0.614,58,17,41,0.293,26,9,11,6,220.6,245.6,233.1
2020-02-24,1610612764,1610612749,2019,134.0,137.0,271.0,118.8,121.3,118.2,107.5,55,20,35,0.364,56,48,8,0.857,13,7,26,22,229.0,228.6,228.8
2020-02-24,1610612751,1610612753,2019,113.0,115.0,228.0,115.7,104.4,105.4,109.0,55,26,29,0.473,56,24,32,0.429,16,10,15,9,223.2,222.8,223.0
2020-02-24,1610612745,1610612752,2019,123.0,112.0,235.0,117.8,113.7,106.8,109.5,56,36,20,0.643,56,17,39,0.304,19,17,8,9,231.6,212.4,222.0
2020-02-24,1610612742,1610612750,2019,139.0,123.0,262.0,115.8,112.7,118.3,123.0,57,34,23,0.596,55,16,39,0.29100000000000004,15,19,7,9,234.2,246.6,240.39999999999998
2020-02-24,1610612762,1610612756,2019,111.0,131.0,242.0,110.6,113.5,105.9,111.9,56,36,20,0.643,57,23,34,0.404,20,16,11,12,217.6,215.6,216.6
2020-02-24,1610612746,1610612763,2019,124.0,97.0,221.0,115.6,114.0,110.5,108.8,56,37,19,0.6609999999999999,56,28,28,0.5,22,15,16,12,223.6,211.6,217.6
2020-02-23,1610612747,1610612738,2019,114.0,112.0,226.0,119.4,112.5,118.0,109.9,54,42,12,0.778,55,39,16,0.7090000000000001,19,23,23,16,231.2,228.6,229.89999999999998
2020-02-23,1610612761,1610612754,2019,127.0,81.0,208.0,115.8,107.9,114.3,112.9,56,41,15,0.732,56,33,23,0.589,22,19,19,14,237.4,223.4,230.4
2020-02-23,1610612743,1610612750,2019,128.0,116.0,244.0,115.9,110.8,118.1,121.8,56,38,18,0.679,54,16,38,0.29600000000000004,21,17,7,9,228.4,246.6,237.5
2020-02-23,1610612741,1610612764,2019,126.0,117.0,243.0,105.8,116.8,120.0,122.1,57,19,38,0.333,54,20,34,0.37,11,8,13,7,210.8,229.0,219.9
2020-02-23,1610612760,1610612759,2019,131.0,103.0,234.0,113.4,107.4,111.9,110.9,56,34,22,0.607,55,24,31,0.436,18,16,14,10,215.6,215.6,215.6
2020-02-23,1610612744,1610612740,2019,101.0,115.0,216.0,109.4,122.0,123.7,115.8,56,12,44,0.214,56,24,32,0.429,7,5,11,13,234.2,241.0,237.6
2020-02-23,1610612757,1610612765,2019,107.0,104.0,211.0,116.5,118.5,102.8,109.0,57,25,32,0.439,58,19,39,0.328,15,10,11,8,235.4,211.4,223.4
2020-02-22,1610612746,1610612758,2019,103.0,112.0,215.0,117.5,112.3,115.9,112.8,55,37,18,0.6729999999999999,55,22,33,0.4,22,15,12,10,224.0,228.8,226.4
2020-02-22,1610612766,1610612751,2019,86.0,115.0,201.0,98.8,105.8,113.9,106.8,55,19,36,0.345,54,25,29,0.463,8,11,16,9,205.0,223.2,214.1
2020-02-22,1610612737,1610612742,2019,111.0,107.0,218.0,122.8,124.9,117.2,114.4,57,16,41,0.281,56,34,22,0.607,10,6,15,19,259.0,234.2,246.6
2020-02-22,1610612748,1610612739,2019,124.0,105.0,229.0,114.6,112.4,113.0,117.1,55,35,20,0.636,55,15,40,0.273,22,13,7,8,232.0,239.4,235.7
2020-02-22,1610612741,1610612756,2019,104.0,112.0,216.0,107.1,116.6,105.5,114.4,56,19,37,0.339,56,22,34,0.393,11,8,11,11,213.0,215.6,214.3
2020-02-22,1610612749,1610612755,2019,119.0,98.0,217.0,121.4,110.8,108.8,112.8,55,47,8,0.855,56,35,21,0.625,25,22,26,9,241.6,220.6,231.1
2020-02-22,1610612762,1610612745,2019,110.0,120.0,230.0,111.3,114.1,118.4,114.4,55,36,19,0.655,55,35,20,0.636,20,16,19,16,220.2,231.6,225.89999999999998
2020-02-21,1610612753,1610612742,2019,106.0,122.0,228.0,104.5,108.0,115.7,113.5,55,24,31,0.436,55,33,22,0.6,15,9,15,18,219.0,234.2,226.6
2020-02-21,1610612764,1610612739,2019,108.0,113.0,221.0,120.5,121.5,112.0,119.1,53,20,33,0.377,54,14,40,0.259,13,7,7,7,228.8,239.4,234.10000000000002
2020-02-21,1610612752,1610612754,2019,98.0,106.0,204.0,108.2,110.7,112.5,114.9,55,17,38,0.309,55,32,23,0.5820000000000001,8,9,19,13,217.6,223.4,220.5
2020-02-21,1610612761,1610612756,2019,118.0,101.0,219.0,117.0,109.2,108.7,113.0,55,40,15,0.727,55,22,33,0.4,21,19,11,11,242.4,215.6,229.0
2020-02-21,1610612750,1610612738,2019,117.0,127.0,244.0,116.8,120.4,116.1,110.5,53,16,37,0.302,54,38,16,0.7040000000000001,7,9,23,15,241.2,228.6,234.89999999999998
2020-02-21,1610612760,1610612743,2019,113.0,101.0,214.0,111.8,108.0,115.4,109.9,55,33,22,0.6,55,38,17,0.691,17,16,21,17,213.6,228.4,221.0
2020-02-21,1610612762,1610612759,2019,104.0,113.0,217.0,112.1,113.5,110.8,113.4,54,36,18,0.667,54,23,31,0.426,20,16,14,9,220.6,215.6,218.1
2020-02-21,1610612747,1610612763,2019,117.0,105.0,222.0,119.5,113.9,111.1,111.0,53,41,12,0.774,55,28,27,0.509,18,23,16,12,234.2,211.6,222.89999999999998
2020-02-21,1610612757,1610612740,2019,115.0,128.0,243.0,118.9,118.6,123.5,115.9,56,25,31,0.446,55,23,32,0.418,15,10,11,12,240.4,241.0,240.7
2020-02-20,1610612765,1610612749,2019,106.0,126.0,232.0,101.4,106.9,120.5,109.9,57,19,38,0.333,54,46,8,0.852,11,8,25,21,204.4,241.6,223.0
2020-02-20,1610612737,1610612748,2019,129.0,124.0,253.0,120.1,122.0,113.3,112.3,56,15,41,0.268,54,35,19,0.648,9,6,22,13,247.8,232.0,239.9
2020-02-20,1610612755,1610612751,2019,112.0,104.0,216.0,108.4,111.5,115.6,106.7,55,34,21,0.618,53,25,28,0.472,25,9,16,9,217.2,223.2,220.2
2020-02-20,1610612741,1610612766,2019,93.0,103.0,196.0,109.6,117.9,99.2,108.6,55,19,36,0.345,54,18,36,0.333,11,8,8,10,220.6,205.0,212.8
2020-02-20,1610612758,1610612763,2019,129.0,125.0,254.0,113.0,112.3,111.3,108.7,54,21,33,0.389,54,28,26,0.519,11,10,16,12,222.0,211.6,216.8
2020-02-20,1610612744,1610612745,2019,105.0,135.0,240.0,109.8,118.0,115.9,115.6,55,12,43,0.218,54,34,20,0.63,7,5,19,15,227.0,231.6,229.3
2020-02-13,1610612738,1610612746,2019,141.0,133.0,274.0,113.9,106.7,116.4,109.9,53,37,16,0.698,54,37,17,0.685,22,15,22,15,216.6,224.0,220.3
2020-02-13,1610612740,1610612760,2019,118.0,123.0,241.0,122.3,114.9,110.7,106.9,54,23,31,0.426,54,32,22,0.593,11,12,17,15,236.6,213.6,225.1
2020-02-12,1610612739,1610612737,2019,127.0,105.0,232.0,110.4,121.1,121.0,122.3,53,13,40,0.245,55,15,40,0.273,6,7,9,6,240.2,247.8,244.0
2020-02-12,1610612753,1610612765,2019,116.0,112.0,228.0,102.7,107.7,103.8,105.6,54,23,31,0.426,56,19,37,0.339,14,9,11,8,214.8,204.4,209.60000000000002
2020-02-12,1610612751,1610612761,2019,101.0,91.0,192.0,116.8,110.4,119.7,110.3,52,24,28,0.462,54,40,14,0.741,15,9,21,19,233.0,242.4,237.7
2020-02-12,1610612754,1610612749,2019,118.0,111.0,229.0,109.2,113.0,121.6,108.2,54,31,23,0.574,53,46,7,0.868,18,13,25,21,213.0,241.6,227.3
2020-02-12,1610612752,1610612764,2019,96.0,114.0,210.0,107.8,109.3,120.2,125.9,54,17,37,0.315,52,19,33,0.365,8,9,13,6,214.0,228.8,221.4
2020-02-12,1610612763,1610612757,2019,111.0,104.0,215.0,111.5,109.2,119.1,119.4,53,27,26,0.509,55,25,30,0.455,15,12,15,10,213.0,240.4,226.7
2020-02-12,1610612750,1610612766,2019,108.0,115.0,223.0,118.4,122.0,96.3,107.8,52,16,36,0.308,53,17,36,0.321,7,9,8,9,247.6,205.0,226.3
2020-02-12,1610612742,1610612758,2019,130.0,111.0,241.0,113.4,113.4,112.5,112.0,54,32,22,0.593,53,21,32,0.396,14,18,11,10,229.4,222.0,225.7
2020-02-12,1610612756,1610612744,2019,112.0,106.0,218.0,109.3,114.4,109.6,118.3,54,21,33,0.389,54,12,42,0.222,10,11,7,5,219.6,227.0,223.3
2020-02-12,1610612762,1610612748,2019,116.0,101.0,217.0,112.3,112.2,113.4,109.6,53,35,18,0.66,53,35,18,0.66,19,16,22,13,218.4,232.0,225.2
2020-02-12,1610612743,1610612747,2019,116.0,120.0,236.0,114.5,109.4,117.5,111.5,54,38,16,0.7040000000000001,52,40,12,0.769,21,17,18,22,225.6,234.2,229.89999999999998
2020-02-11,1610612755,1610612746,2019,110.0,103.0,213.0,107.4,110.1,115.6,109.1,54,33,21,0.611,53,37,16,0.698,24,9,22,15,212.4,224.0,218.2
2020-02-11,1610612764,1610612741,2019,126.0,114.0,240.0,119.7,125.2,110.0,115.9,51,18,33,0.353,54,19,35,0.35200000000000004,12,6,11,8,226.4,220.6,223.5
2020-02-11,1610612740,1610612757,2019,138.0,117.0,255.0,120.2,115.3,118.6,117.6,53,22,31,0.415,54,25,29,0.463,10,12,15,10,233.2,240.4,236.8
2020-02-11,1610612760,1610612759,2019,106.0,114.0,220.0,114.1,106.6,109.9,113.6,53,32,21,0.604,53,22,31,0.415,17,15,14,8,219.8,215.6,217.7
2020-02-11,1610612745,1610612738,2019,116.0,105.0,221.0,116.4,115.6,114.3,104.9,53,33,20,0.623,52,37,15,0.7120000000000001,18,15,22,15,232.6,216.6,224.6
2020-02-10,1610612765,1610612766,2019,76.0,87.0,163.0,106.2,108.4,98.8,111.7,55,19,36,0.345,52,16,36,0.308,11,8,8,8,214.8,205.0,209.9
2020-02-10,1610612754,1610612751,2019,105.0,106.0,211.0,110.2,113.0,116.8,111.6,53,31,22,0.585,51,23,28,0.451,18,13,15,8,215.0,233.0,224.0
2020-02-10,1610612753,1610612737,2019,135.0,126.0,261.0,100.6,107.1,119.5,122.8,53,22,31,0.415,54,15,39,0.278,13,9,9,6,209.4,247.8,228.60000000000002
2020-02-10,1610612761,1610612750,2019,137.0,126.0,263.0,116.7,107.2,116.7,122.2,53,39,14,0.736,51,16,35,0.314,20,19,7,9,230.2,247.6,238.89999999999998
2020-02-10,1610612749,1610612758,2019,123.0,111.0,234.0,120.4,106.9,112.7,111.5,52,45,7,0.865,52,21,31,0.404,24,21,11,10,236.6,222.0,229.3
2020-02-10,1610612742,1610612762,2019,119.0,123.0,242.0,113.5,112.3,112.9,109.9,53,32,21,0.604,52,34,18,0.654,14,18,19,15,227.4,218.4,222.9
2020-02-10,1610612743,1610612759,2019,127.0,120.0,247.0,111.8,106.0,108.8,111.9,53,37,16,0.698,52,22,30,0.423,20,17,14,8,213.4,215.6,214.5
2020-02-10,1610612744,1610612748,2019,101.0,113.0,214.0,112.6,120.4,112.3,110.2,53,12,41,0.226,52,34,18,0.654,7,5,22,12,237.2,232.0,234.6
2020-02-10,1610612747,1610612756,2019,125.0,100.0,225.0,117.8,111.4,110.2,113.3,51,39,12,0.765,53,21,32,0.396,17,22,10,11,234.6,219.6,227.1
2020-02-09,1610612760,1610612738,2019,111.0,112.0,223.0,114.9,106.0,115.4,106.6,52,32,20,0.615,51,36,15,0.706,17,15,22,14,220.2,216.6,218.39999999999998
2020-02-09,1610612737,1610612752,2019,140.0,135.0,275.0,117.2,121.5,104.9,103.9,53,14,39,0.264,53,17,36,0.321,8,6,8,9,240.6,214.0,227.3
2020-02-09,1610612755,1610612741,2019,118.0,111.0,229.0,107.3,109.6,108.7,115.2,53,32,21,0.604,53,19,34,0.358,23,9,11,8,211.2,220.6,215.89999999999998
2020-02-09,1610612764,1610612763,2019,99.0,106.0,205.0,120.4,124.6,113.4,110.5,50,18,32,0.36,52,26,26,0.5,12,6,15,11,226.6,213.0,219.8
2020-02-09,1610612745,1610612762,2019,113.0,114.0,227.0,115.8,115.4,114.7,112.4,52,33,19,0.635,51,33,18,0.647,18,15,19,14,231.0,218.4,224.7
2020-02-09,1610612739,1610612746,2019,92.0,133.0,225.0,111.8,119.6,113.3,110.6,52,13,39,0.25,52,36,16,0.6920000000000001,6,7,22,14,240.0,224.0,232.0
2020-02-09,1610612757,1610612748,2019,115.0,109.0,224.0,119.6,120.0,112.9,109.5,53,24,29,0.453,51,34,17,0.667,14,10,22,12,247.2,232.0,239.6
2020-02-08,1610612753,1610612749,2019,95.0,111.0,206.0,103.4,104.9,122.0,108.0,52,22,30,0.423,51,44,7,0.863,13,9,24,20,210.6,236.6,223.6
2020-02-08,1610612766,1610612742,2019,100.0,116.0,216.0,99.8,111.3,112.6,113.5,51,16,35,0.314,52,31,21,0.596,8,8,14,17,206.2,227.4,216.8
2020-02-08,1610612765,1610612752,2019,92.0,95.0,187.0,108.1,111.0,105.6,107.5,54,19,35,0.35200000000000004,52,16,36,0.308,11,8,8,8,223.8,214.0,218.9
2020-02-08,1610612754,1610612740,2019,117.0,124.0,241.0,110.1,112.0,119.5,114.6,52,31,21,0.596,52,21,31,0.404,18,13,10,11,212.8,233.2,223.0
2020-02-08,1610612761,1610612751,2019,119.0,118.0,237.0,118.8,106.5,113.9,109.8,52,38,14,0.731,50,23,27,0.46,19,19,15,8,233.0,233.0,233.0
2020-02-08,1610612750,1610612746,2019,142.0,115.0,257.0,112.5,121.4,115.1,109.4,50,15,35,0.3,51,36,15,0.706,6,9,22,14,237.6,224.0,230.8
2020-02-08,1610612744,1610612747,2019,120.0,125.0,245.0,110.3,120.3,116.0,113.3,52,12,40,0.231,50,38,12,0.76,7,5,17,21,232.4,234.6,233.5
2020-02-08,1610612756,1610612743,2019,108.0,117.0,225.0,109.4,110.8,111.4,105.8,52,21,31,0.404,52,36,16,0.6920000000000001,10,11,20,16,213.0,213.4,213.2
2020-02-08,1610612758,1610612759,2019,122.0,102.0,224.0,112.8,114.0,110.7,111.4,51,20,31,0.392,51,22,29,0.431,10,10,14,8,227.2,215.6,221.39999999999998
2020-02-07,1610612755,1610612763,2019,119.0,107.0,226.0,106.3,108.7,112.2,110.5,52,31,21,0.596,51,26,25,0.51,22,9,15,11,207.4,213.0,210.2
2020-02-07,1610612764,1610612742,2019,119.0,118.0,237.0,120.1,125.5,114.1,114.1,49,17,32,0.34700000000000003,51,31,20,0.608,11,6,14,17,227.8,227.4,227.60000000000002
2020-02-07,1610612738,1610612737,2019,112.0,107.0,219.0,118.1,106.6,118.6,122.3,50,35,15,0.7,52,14,38,0.269,21,14,8,6,222.0,240.6,231.3
2020-02-07,1610612754,1610612761,2019,106.0,115.0,221.0,109.6,110.0,119.5,107.6,51,31,20,0.608,51,37,14,0.725,18,13,19,18,207.8,233.0,220.4
2020-02-07,1610612760,1610612765,2019,108.0,101.0,209.0,114.9,107.4,109.6,110.5,51,31,20,0.608,53,19,34,0.358,16,15,11,8,223.0,223.8,223.4
2020-02-07,1610612756,1610612745,2019,127.0,91.0,218.0,106.5,111.1,119.8,115.1,51,20,31,0.392,51,33,18,0.647,9,11,18,15,207.8,231.0,219.4
2020-02-07,1610612758,1610612748,2019,105.0,97.0,202.0,113.5,115.7,115.3,111.4,50,19,31,0.38,50,34,16,0.68,9,10,22,12,232.0,232.0,232.0
2020-02-07,1610612762,1610612757,2019,117.0,114.0,231.0,115.3,111.1,119.9,119.0,50,32,18,0.64,52,24,28,0.462,18,14,14,10,217.0,247.2,232.1
2020-02-06,1610612752,1610612753,2019,105.0,103.0,208.0,103.8,106.2,102.6,105.3,51,15,36,0.294,51,22,29,0.431,7,8,13,9,207.8,210.6,209.2
2020-02-06,1610612741,1610612740,2019,119.0,125.0,244.0,108.3,113.3,117.5,116.7,52,19,33,0.365,51,20,31,0.392,11,8,10,10,216.0,233.2,224.6
2020-02-06,1610612749,1610612755,2019,112.0,101.0,213.0,123.6,110.2,107.9,108.6,50,43,7,0.86,51,31,20,0.608,23,20,22,9,244.2,207.4,225.8
2020-02-06,1610612757,1610612759,2019,125.0,117.0,242.0,120.3,119.7,111.0,110.7,51,23,28,0.451,50,22,28,0.44,13,10,14,8,249.4,215.6,232.5
2020-02-06,1610612747,1610612745,2019,111.0,121.0,232.0,116.6,109.9,118.7,116.1,49,38,11,0.7759999999999999,50,32,18,0.64,17,21,18,14,229.0,231.0,230.0
2020-02-05,1610612765,1610612756,2019,116.0,108.0,224.0,109.2,112.2,106.0,109.4,52,18,34,0.34600000000000003,50,20,30,0.4,10,8,9,11,226.4,207.8,217.10000000000002
2020-02-05,1610612738,1610612753,2019,116.0,100.0,216.0,118.4,108.9,102.1,105.9,49,34,15,0.6940000000000001,50,22,28,0.44,20,14,13,9,227.2,210.6,218.89999999999998
2020-02-05,1610612751,1610612744,2019,129.0,88.0,217.0,112.1,112.7,113.9,120.3,49,22,27,0.449,51,12,39,0.235,14,8,7,5,235.2,232.4,233.8
2020-02-05,1610612761,1610612754,2019,119.0,118.0,237.0,118.0,106.3,109.3,108.8,50,36,14,0.72,50,31,19,0.62,18,18,18,13,227.4,207.8,217.60000000000002
2020-02-05,1610612750,1610612737,2019,120.0,127.0,247.0,111.7,120.9,114.5,121.1,49,15,34,0.306,51,13,38,0.255,6,9,8,5,235.0,240.6,237.8
2020-02-05,1610612760,1610612739,2019,109.0,103.0,212.0,116.1,110.1,111.4,121.5,50,30,20,0.6,51,13,38,0.255,15,15,6,7,230.8,240.0,235.4
2020-02-05,1610612742,1610612763,2019,107.0,121.0,228.0,114.3,111.1,112.2,111.2,50,31,19,0.62,50,25,25,0.5,14,17,15,10,221.8,213.0,217.4
2020-02-05,1610612762,1610612743,2019,95.0,98.0,193.0,116.7,110.5,112.1,108.4,49,32,17,0.653,51,35,16,0.6859999999999999,18,14,20,15,218.6,213.4,216.0
2020-02-05,1610612746,1610612748,2019,128.0,111.0,239.0,115.1,108.6,115.5,110.3,50,35,15,0.7,49,34,15,0.6940000000000001,21,14,22,12,222.4,232.0,227.2
2020-02-04,1610612740,1610612749,2019,108.0,120.0,228.0,119.7,118.0,122.3,109.2,50,20,30,0.4,49,42,7,0.857,10,10,23,19,240.2,244.2,242.2
2020-02-04,1610612745,1610612766,2019,125.0,110.0,235.0,117.7,117.5,98.0,108.8,49,31,18,0.633,50,16,34,0.32,17,14,8,8,231.8,206.2,219.0
2020-02-04,1610612743,1610612757,2019,127.0,99.0,226.0,110.8,108.9,120.6,118.6,50,34,16,0.68,50,23,27,0.46,19,15,13,10,211.8,249.4,230.60000000000002
2020-02-04,1610612747,1610612759,2019,129.0,102.0,231.0,114.3,109.6,110.8,108.4,48,37,11,0.7709999999999999,49,22,27,0.449,16,21,14,8,223.8,215.6,219.7
2020-02-03,1610612766,1610612753,2019,100.0,112.0,212.0,98.4,109.1,102.8,107.7,49,16,33,0.327,49,21,28,0.429,8,8,13,8,207.6,210.6,209.1
2020-02-03,1610612739,1610612752,2019,134.0,139.0,273.0,109.2,120.0,100.3,105.6,50,13,37,0.26,50,14,36,0.28,6,7,7,7,232.6,207.8,220.2
2020-02-03,1610612754,1610612742,2019,103.0,112.0,215.0,109.8,109.8,115.8,113.1,49,31,18,0.633,49,30,19,0.612,18,13,14,16,210.8,221.8,216.3
2020-02-03,1610612764,1610612744,2019,117.0,125.0,242.0,119.5,123.1,111.6,120.8,48,17,31,0.354,50,11,39,0.22,11,6,7,4,221.8,232.4,227.10000000000002
2020-02-03,1610612737,1610612738,2019,115.0,123.0,238.0,113.3,122.4,115.9,108.3,50,13,37,0.26,48,33,15,0.688,8,5,20,13,240.8,227.2,234.0
2020-02-03,1610612751,1610612756,2019,119.0,97.0,216.0,109.9,114.7,108.6,109.4,48,21,27,0.43799999999999994,49,20,29,0.408,13,8,9,11,234.8,207.8,221.3
2020-02-03,1610612748,1610612755,2019,137.0,106.0,243.0,113.6,111.0,106.3,103.6,48,33,15,0.688,50,31,19,0.62,21,12,22,9,229.6,207.4,218.5
2020-02-03,1610612763,1610612765,2019,96.0,82.0,178.0,114.7,114.0,112.5,113.9,49,24,25,0.49,51,18,33,0.353,14,10,10,8,223.6,226.4,225.0
2020-02-03,1610612758,1610612750,2019,113.0,109.0,222.0,112.8,117.5,112.0,121.5,49,18,31,0.3670000000000001,48,15,33,0.313,8,10,6,9,234.2,235.0,234.6
2020-02-03,1610612746,1610612759,2019,108.0,105.0,213.0,115.2,108.1,110.8,108.0,49,34,15,0.6940000000000001,48,22,26,0.45799999999999996,20,14,14,8,221.6,215.6,218.6
2020-02-02,1610612765,1610612743,2019,128.0,123.0,251.0,112.4,112.2,109.2,106.1,50,17,33,0.34,49,34,15,0.6940000000000001,9,8,19,15,222.8,211.8,217.3
2020-02-02,1610612745,1610612740,2019,117.0,109.0,226.0,116.7,118.3,121.1,117.4,48,30,18,0.625,49,20,29,0.408,16,14,10,10,231.4,240.2,235.8
2020-02-02,1610612749,1610612756,2019,129.0,108.0,237.0,122.2,108.6,109.9,106.3,48,41,7,0.8540000000000001,48,20,28,0.41700000000000004,22,19,9,11,242.8,207.8,225.3
2020-02-02,1610612761,1610612741,2019,129.0,102.0,231.0,115.0,106.2,107.0,110.4,49,35,14,0.7140000000000001,51,19,32,0.373,17,18,11,8,221.2,216.0,218.6
2020-02-01,1610612746,1610612750,2019,118.0,106.0,224.0,116.9,110.7,113.2,120.0,48,33,15,0.688,47,15,32,0.319,19,14,6,9,230.2,235.0,232.6
2020-02-01,1610612754,1610612752,2019,85.0,92.0,177.0,112.9,113.0,99.8,108.8,48,31,17,0.6459999999999999,49,13,36,0.265,18,13,7,6,223.4,207.8,215.60000000000002
2020-02-01,1610612753,1610612748,2019,89.0,102.0,191.0,104.0,106.4,115.6,112.9,48,21,27,0.43799999999999994,47,32,15,0.6809999999999999,13,8,21,11,210.4,229.6,220.0
2020-02-01,1610612739,1610612744,2019,112.0,131.0,243.0,106.6,117.5,108.5,120.5,49,13,36,0.265,49,10,39,0.204,6,7,7,3,222.4,232.4,227.4
2020-02-01,1610612764,1610612751,2019,113.0,107.0,220.0,118.1,121.8,110.3,115.7,47,16,31,0.34,47,21,26,0.447,10,6,13,8,216.4,234.8,225.60000000000002
2020-02-01,1610612738,1610612755,2019,116.0,95.0,211.0,114.6,110.4,106.3,102.1,47,32,15,0.6809999999999999,49,31,18,0.633,19,13,22,9,228.8,207.4,218.10000000000002
2020-02-01,1610612742,1610612737,2019,123.0,100.0,223.0,114.9,116.0,113.4,121.2,48,29,19,0.604,49,13,36,0.265,13,16,8,5,225.8,240.8,233.3
2020-02-01,1610612759,1610612766,2019,114.0,90.0,204.0,111.4,111.1,98.6,108.6,47,21,26,0.447,48,16,32,0.33299999999999996,13,8,8,8,223.0,207.6,215.3
2020-02-01,1610612758,1610612747,2019,113.0,129.0,242.0,112.6,114.4,113.8,109.8,48,18,30,0.375,47,36,11,0.7659999999999999,8,10,16,20,227.6,223.8,225.7
2020-02-01,1610612757,1610612762,2019,124.0,107.0,231.0,119.7,119.1,117.8,108.8,49,22,27,0.449,48,32,16,0.667,12,10,18,14,248.6,218.6,233.6
2020-01-31,1610612765,1610612761,2019,92.0,105.0,197.0,114.2,113.4,116.7,108.2,49,17,32,0.34700000000000003,48,34,14,0.708,9,8,17,17,228.8,221.2,225.0
2020-01-31,1610612751,1610612741,2019,133.0,118.0,251.0,107.7,115.7,105.3,108.4,46,20,26,0.435,50,19,31,0.38,12,8,11,8,229.6,216.0,222.8
2020-01-31,1610612745,1610612742,2019,128.0,121.0,249.0,117.8,117.1,115.2,112.9,47,29,18,0.617,47,29,18,0.617,15,14,13,16,231.2,225.8,228.5
2020-01-31,1610612740,1610612763,2019,139.0,111.0,250.0,121.0,119.5,117.6,111.5,48,19,29,0.396,48,24,24,0.5,9,10,14,10,244.2,223.6,233.89999999999998
2020-01-31,1610612749,1610612743,2019,115.0,127.0,242.0,123.4,107.7,109.9,107.7,47,41,6,0.872,48,33,15,0.688,22,19,19,14,243.4,211.8,227.60000000000002
2020-01-31,1610612756,1610612760,2019,107.0,111.0,218.0,109.5,106.6,116.7,109.8,47,20,27,0.426,49,29,20,0.5920000000000001,9,11,15,14,207.6,230.8,219.2
2020-01-31,1610612747,1610612757,2019,119.0,127.0,246.0,114.2,108.4,117.1,117.1,46,36,10,0.7829999999999999,48,21,27,0.43799999999999994,16,20,12,9,221.8,248.6,235.2
2020-01-30,1610612739,1610612761,2019,109.0,115.0,224.0,107.0,117.5,118.2,109.4,48,13,35,0.271,47,33,14,0.7020000000000001,6,7,17,16,223.2,221.2,222.2
2020-01-30,1610612764,1610612766,2019,121.0,107.0,228.0,118.8,122.5,100.2,108.5,46,15,31,0.326,47,16,31,0.34,9,6,8,8,219.2,207.6,213.39999999999998
2020-01-30,1610612737,1610612755,2019,127.0,117.0,244.0,113.0,120.5,103.7,100.3,48,12,36,0.25,48,31,17,0.6459999999999999,7,5,22,9,238.6,207.4,223.0
2020-01-30,1610612738,1610612744,2019,119.0,104.0,223.0,114.0,110.1,107.9,119.7,46,31,15,0.674,48,10,38,0.20800000000000002,18,13,7,3,227.0,232.4,229.7
2020-01-30,1610612743,1610612762,2019,106.0,100.0,206.0,109.6,108.8,120.5,109.8,47,32,15,0.6809999999999999,47,32,15,0.6809999999999999,18,14,18,14,213.4,218.6,216.0
2020-01-30,1610612746,1610612758,2019,103.0,124.0,227.0,118.0,112.3,110.3,116.4,47,33,14,0.7020000000000001,47,17,30,0.36200000000000004,19,14,8,9,235.6,227.6,231.6
2020-01-29,1610612754,1610612741,2019,115.0,106.0,221.0,112.9,112.1,105.5,106.8,47,30,17,0.638,49,19,30,0.388,17,13,11,8,221.6,216.0,218.8
2020-01-29,1610612751,1610612765,2019,125.0,115.0,240.0,106.0,112.8,112.6,111.5,45,19,26,0.422,48,17,31,0.354,11,8,9,8,220.4,228.8,224.60000000000002
2020-01-29,1610612752,1610612763,2019,106.0,127.0,233.0,99.0,108.2,117.2,113.7,48,13,35,0.271,47,23,24,0.489,7,6,14,9,205.0,223.6,214.3
2020-01-29,1610612759,1610612762,2019,127.0,120.0,247.0,111.3,109.5,121.3,109.7,46,20,26,0.435,46,32,14,0.696,12,8,18,14,219.6,218.6,219.1
2020-01-29,1610612757,1610612745,2019,125.0,112.0,237.0,114.7,118.1,115.8,115.9,47,20,27,0.426,46,29,17,0.63,11,9,15,14,245.8,231.2,238.5
2020-01-29,1610612758,1610612760,2019,100.0,120.0,220.0,111.8,116.1,115.8,110.1,46,17,29,0.37,48,28,20,0.583,8,9,15,13,230.0,230.8,230.4
2020-01-28,1610612766,1610612752,2019,97.0,92.0,189.0,99.7,110.2,103.0,112.0,46,15,31,0.326,47,13,34,0.277,7,8,7,6,210.0,205.0,207.5
2020-01-28,1610612755,1610612744,2019,115.0,104.0,219.0,104.2,101.2,105.9,118.1,47,30,17,0.638,47,10,37,0.213,21,9,7,3,210.2,232.4,221.3
2020-01-28,1610612739,1610612740,2019,111.0,125.0,236.0,106.2,116.8,120.2,119.9,47,13,34,0.277,47,18,29,0.383,6,7,9,9,220.2,244.2,232.2
2020-01-28,1610612761,1610612737,2019,130.0,114.0,244.0,116.9,107.7,112.2,118.4,46,32,14,0.696,47,12,35,0.255,16,16,7,5,215.2,238.6,226.89999999999998
2020-01-28,1610612748,1610612738,2019,101.0,109.0,210.0,116.1,112.0,112.5,109.9,46,32,14,0.696,45,30,15,0.667,21,11,18,12,228.8,227.0,227.9
2020-01-28,1610612763,1610612743,2019,104.0,96.0,200.0,119.0,114.3,110.7,109.0,46,22,24,0.478,46,32,14,0.696,13,9,18,14,228.4,213.4,220.9
2020-01-28,1610612749,1610612764,2019,151.0,131.0,282.0,118.9,105.0,116.3,118.9,46,40,6,0.87,45,15,30,0.333,21,19,9,6,229.0,219.2,224.1
2020-01-28,1610612742,1610612756,2019,104.0,133.0,237.0,115.4,110.3,107.2,108.5,46,29,17,0.63,46,19,27,0.413,13,16,9,10,221.0,207.6,214.3
2020-01-27,1610612765,1610612739,2019,100.0,115.0,215.0,112.5,110.8,105.8,117.1,47,17,30,0.362,46,12,34,0.261,9,8,6,6,227.2,220.2,223.7
2020-01-27,1610612748,1610612753,2019,113.0,92.0,205.0,117.0,113.9,106.2,106.3,45,31,14,0.6890000000000001,47,21,26,0.447,20,11,13,8,234.4,210.4,222.4
2020-01-27,1610612741,1610612759,2019,110.0,109.0,219.0,105.0,107.5,112.5,111.9,48,18,30,0.375,45,20,25,0.444,10,8,12,8,216.4,219.6,218.0
2020-01-27,1610612750,1610612758,2019,129.0,133.0,262.0,110.2,117.1,109.9,113.5,46,15,31,0.326,45,16,29,0.35600000000000004,6,9,8,8,223.2,230.0,226.6
2020-01-27,1610612760,1610612742,2019,97.0,107.0,204.0,117.1,111.9,114.8,111.2,47,28,19,0.596,45,28,17,0.622,15,13,13,15,237.0,221.0,229.0
2020-01-27,1610612762,1610612745,2019,117.0,126.0,243.0,122.4,107.5,115.4,115.7,45,32,13,0.711,45,28,17,0.622,18,14,15,13,216.4,231.2,223.8
2020-01-26,1610612743,1610612745,2019,117.0,110.0,227.0,111.0,109.5,115.6,116.7,45,31,14,0.6890000000000001,44,28,16,0.636,17,14,15,13,215.0,231.2,223.1
2020-01-26,1610612759,1610612761,2019,106.0,110.0,216.0,112.2,111.8,117.1,108.1,44,20,24,0.455,45,31,14,0.6890000000000001,12,8,16,15,218.8,215.2,217.0
2020-01-26,1610612737,1610612764,2019,152.0,133.0,285.0,108.5,117.3,111.9,116.0,46,11,35,0.239,44,15,29,0.341,6,5,9,6,229.0,219.2,224.1
2020-01-26,1610612752,1610612751,2019,110.0,97.0,207.0,104.4,114.4,107.8,114.0,46,12,34,0.261,44,19,25,0.4320000000000001,6,6,11,8,212.6,220.4,216.5
2020-01-26,1610612753,1610612746,2019,97.0,112.0,209.0,106.1,106.0,117.2,114.0,46,21,25,0.457,46,32,14,0.696,13,8,19,13,209.6,235.6,222.6
2020-01-26,1610612763,1610612756,2019,114.0,109.0,223.0,121.0,115.5,107.0,108.8,45,21,24,0.467,45,19,26,0.422,12,9,9,10,234.8,207.6,221.2
2020-01-26,1610612740,1610612738,2019,123.0,108.0,231.0,120.2,119.9,112.8,108.0,46,17,29,0.37,44,30,14,0.682,8,9,18,12,244.2,227.0,235.6
2020-01-26,1610612757,1610612754,2019,139.0,129.0,268.0,112.4,117.4,110.4,108.1,46,19,27,0.413,46,30,16,0.652,10,9,17,13,239.8,221.6,230.7
2020-01-25,1610612762,1610612742,2019,112.0,107.0,219.0,121.6,104.9,113.6,110.8,44,31,13,0.705,44,28,16,0.636,17,14,13,15,209.6,221.0,215.3
2020-01-25,1610612765,1610612751,2019,111.0,121.0,232.0,112.6,110.2,105.5,113.7,46,17,29,0.37,43,18,25,0.419,9,8,11,7,226.2,220.4,223.3
2020-01-25,1610612739,1610612741,2019,106.0,118.0,224.0,105.8,117.4,104.0,109.2,45,12,33,0.267,47,17,30,0.362,6,6,10,7,220.8,216.4,218.60000000000002
2020-01-25,1610612750,1610612760,2019,104.0,113.0,217.0,110.2,117.5,117.1,113.5,45,15,30,0.333,46,27,19,0.5870000000000001,6,9,15,12,224.0,237.0,230.5
2020-01-25,1610612755,1610612747,2019,108.0,91.0,199.0,105.5,103.0,117.6,108.6,46,29,17,0.63,45,36,9,0.8,20,9,16,20,216.4,221.8,219.10000000000002
2020-01-24,1610612766,1610612749,2019,103.0,116.0,219.0,99.6,109.0,117.7,107.3,45,15,30,0.333,45,39,6,0.867,7,8,21,18,207.4,229.0,218.2
2020-01-24,1610612765,1610612763,2019,112.0,125.0,237.0,114.6,107.9,119.5,116.2,45,17,28,0.378,44,20,24,0.455,9,8,12,8,225.6,234.8,230.2
2020-01-24,1610612753,1610612738,2019,98.0,109.0,207.0,106.8,103.6,112.8,107.4,45,21,24,0.467,43,29,14,0.674,13,8,18,11,206.2,227.0,216.6
2020-01-24,1610612752,1610612761,2019,112.0,118.0,230.0,104.3,114.9,117.4,107.1,45,12,33,0.267,44,30,14,0.682,6,6,16,14,213.4,215.2,214.3
2020-01-24,1610612748,1610612746,2019,117.0,122.0,239.0,113.7,109.3,115.5,111.0,44,31,13,0.705,45,31,14,0.6890000000000001,20,11,19,12,218.6,235.6,227.1
2020-01-24,1610612741,1610612758,2019,81.0,98.0,179.0,106.3,110.5,111.6,117.4,46,17,29,0.37,44,15,29,0.341,10,7,8,7,223.6,230.0,226.8
2020-01-24,1610612750,1610612745,2019,124.0,131.0,255.0,109.4,114.6,112.9,115.9,44,15,29,0.341,43,27,16,0.628,6,9,15,12,216.6,231.2,223.89999999999998
2020-01-24,1610612740,1610612743,2019,106.0,113.0,219.0,122.2,121.4,112.0,110.4,45,17,28,0.378,44,30,14,0.682,8,9,17,13,251.2,215.0,233.1
2020-01-24,1610612760,1610612737,2019,140.0,111.0,251.0,114.4,111.6,107.5,112.6,45,26,19,0.578,45,11,34,0.244,14,12,6,5,227.8,229.0,228.4
2020-01-24,1610612759,1610612756,2019,99.0,103.0,202.0,114.0,112.8,108.9,110.5,43,20,23,0.465,44,18,26,0.409,12,8,9,9,224.4,207.6,216.0
2020-01-24,1610612744,1610612754,2019,118.0,129.0,247.0,103.9,115.9,109.1,106.8,46,10,36,0.217,45,29,16,0.644,7,3,17,12,224.0,221.6,222.8
2020-01-23,1610612739,1610612764,2019,112.0,124.0,236.0,105.2,115.9,109.7,118.0,44,12,32,0.273,43,14,29,0.326,6,6,9,5,216.6,219.2,217.89999999999998
2020-01-23,1610612751,1610612747,2019,113.0,128.0,241.0,105.9,112.2,117.7,108.7,42,18,24,0.429,44,35,9,0.795,11,7,16,19,218.2,221.8,220.0
2020-01-23,1610612757,1610612742,2019,125.0,133.0,258.0,111.9,116.9,114.4,110.4,45,19,26,0.422,43,27,16,0.628,10,9,13,14,237.8,221.0,229.4
2020-01-22,1610612765,1610612758,2019,127.0,106.0,233.0,112.8,109.8,112.5,116.6,44,16,28,0.364,43,15,28,0.349,8,8,8,7,225.8,230.0,227.9
2020-01-22,1610612753,1610612760,2019,114.0,120.0,234.0,104.7,101.7,114.5,110.8,44,21,23,0.477,44,25,19,0.568,13,8,14,11,198.2,227.8,213.0
2020-01-22,1610612761,1610612755,2019,107.0,95.0,202.0,116.4,107.4,106.8,104.1,43,29,14,0.674,45,29,16,0.644,15,14,20,9,213.8,216.4,215.10000000000002
2020-01-22,1610612737,1610612746,2019,102.0,95.0,197.0,108.8,115.4,117.1,111.4,44,10,34,0.227,44,31,13,0.705,5,5,19,12,237.2,235.6,236.39999999999998
2020-01-22,1610612738,1610612763,2019,119.0,95.0,214.0,114.9,108.4,121.0,114.0,42,28,14,0.667,43,20,23,0.465,17,11,12,8,233.2,234.8,234.0
2020-01-22,1610612748,1610612764,2019,134.0,129.0,263.0,112.0,108.0,108.9,116.1,43,30,13,0.698,42,14,28,0.333,19,11,9,5,212.6,219.2,215.89999999999998
2020-01-22,1610612752,1610612747,2019,92.0,100.0,192.0,106.8,114.2,120.5,111.5,44,12,32,0.273,43,34,9,0.7909999999999999,6,6,16,18,217.0,221.8,219.4
2020-01-22,1610612741,1610612750,2019,117.0,110.0,227.0,104.4,109.7,108.8,113.5,45,16,29,0.35600000000000004,43,15,28,0.349,9,7,6,9,218.2,216.6,217.39999999999998
2020-01-22,1610612745,1610612743,2019,121.0,105.0,226.0,112.6,116.2,112.9,111.1,42,26,16,0.619,43,30,13,0.698,14,12,17,13,231.2,215.0,223.1
2020-01-22,1610612756,1610612754,2019,87.0,112.0,199.0,111.6,111.4,109.4,108.5,43,18,25,0.419,44,28,16,0.636,9,9,17,11,214.8,221.6,218.2
2020-01-22,1610612740,1610612759,2019,117.0,121.0,238.0,123.2,120.5,114.8,112.5,44,17,27,0.386,42,19,23,0.452,8,9,12,7,251.4,224.4,237.9
2020-01-22,1610612744,1610612762,2019,96.0,129.0,225.0,104.7,114.1,119.6,104.9,45,10,35,0.222,43,30,13,0.698,7,3,17,13,222.0,209.6,215.8
2020-01-21,1610612742,1610612746,2019,107.0,110.0,217.0,115.5,110.4,117.3,112.5,42,27,15,0.643,43,30,13,0.698,13,14,19,11,223.2,235.6,229.39999999999998
2020-01-20,1610612764,1610612765,2019,106.0,100.0,206.0,108.6,118.3,113.9,109.6,41,13,28,0.317,43,16,27,0.3720000000000001,8,5,8,8,223.0,225.8,224.4
2020-01-20,1610612737,1610612761,2019,117.0,122.0,239.0,108.7,114.3,111.8,104.1,43,10,33,0.233,42,28,14,0.667,5,5,15,13,234.8,213.8,224.3
2020-01-20,1610612751,1610612755,2019,111.0,117.0,228.0,105.1,111.6,104.8,104.5,41,18,23,0.439,44,28,16,0.636,11,7,20,8,215.4,216.4,215.9
2020-01-20,1610612766,1610612753,2019,83.0,106.0,189.0,102.0,109.8,103.5,103.2,44,15,29,0.341,43,20,23,0.465,7,8,13,7,213.8,198.2,206.0
2020-01-20,1610612739,1610612752,2019,86.0,106.0,192.0,108.7,117.1,107.4,117.6,43,12,31,0.279,43,11,32,0.256,6,6,6,5,226.0,217.0,221.5
2020-01-20,1610612748,1610612758,2019,118.0,113.0,231.0,111.5,107.9,111.7,116.7,42,29,13,0.69,42,15,27,0.35700000000000004,18,11,8,7,211.4,230.0,220.7
2020-01-20,1610612745,1610612760,2019,107.0,112.0,219.0,114.9,115.4,114.2,110.4,41,26,15,0.634,43,24,19,0.5579999999999999,14,12,14,10,234.2,227.8,231.0
2020-01-20,1610612763,1610612740,2019,116.0,126.0,242.0,121.3,112.6,121.9,121.2,42,20,22,0.476,43,16,27,0.3720000000000001,12,8,8,8,232.6,251.4,242.0
2020-01-20,1610612749,1610612741,2019,111.0,98.0,209.0,117.7,107.5,105.6,110.4,44,38,6,0.8640000000000001,44,16,28,0.364,20,18,9,7,229.4,218.2,223.8
2020-01-20,1610612738,1610612747,2019,139.0,107.0,246.0,112.4,110.6,120.2,108.7,41,27,14,0.659,42,34,8,0.81,16,11,16,18,232.6,221.8,227.2
2020-01-20,1610612750,1610612743,2019,100.0,107.0,207.0,108.7,111.2,114.6,112.7,42,15,27,0.35700000000000004,42,29,13,0.69,6,9,17,12,211.8,215.0,213.4
2020-01-20,1610612756,1610612759,2019,118.0,120.0,238.0,111.8,110.6,114.6,113.4,42,18,24,0.429,41,18,23,0.439,9,9,12,6,213.6,224.4,219.0
2020-01-20,1610612762,1610612754,2019,118.0,88.0,206.0,119.9,107.6,111.7,108.3,42,29,13,0.69,43,28,15,0.6509999999999999,16,13,17,11,215.6,221.6,218.6
2020-01-20,1610612757,1610612744,2019,129.0,124.0,253.0,108.4,114.7,103.6,112.9,44,18,26,0.409,44,10,34,0.227,9,9,7,3,226.4,222.0,224.2
2020-01-19,1610612759,1610612748,2019,107.0,102.0,209.0,117.5,114.1,109.8,107.7,40,17,23,0.425,41,29,12,0.7070000000000001,11,6,18,11,231.6,211.4,221.5
2020-01-19,1610612743,1610612754,2019,107.0,115.0,222.0,115.8,112.2,110.0,109.6,41,29,12,0.7070000000000001,42,27,15,0.643,17,12,17,10,216.4,221.6,219.0
2020-01-18,1610612740,1610612746,2019,130.0,133.0,263.0,120.9,117.7,117.4,110.4,42,16,26,0.381,42,29,13,0.69,8,8,19,10,242.4,235.6,239.0
2020-01-18,1610612751,1610612749,2019,97.0,117.0,214.0,105.6,112.0,118.3,108.0,40,18,22,0.45,43,37,6,0.86,11,7,20,17,217.2,229.4,223.3
2020-01-18,1610612738,1610612756,2019,119.0,123.0,242.0,111.4,108.9,110.7,109.7,40,27,13,0.675,41,17,24,0.415,16,11,9,8,227.2,213.6,220.39999999999998
2020-01-18,1610612737,1610612765,2019,103.0,136.0,239.0,107.0,111.9,111.5,111.9,42,10,32,0.238,42,15,27,0.35700000000000004,5,5,8,7,226.6,225.8,226.2
2020-01-18,1610612752,1610612755,2019,87.0,90.0,177.0,110.2,120.7,107.4,107.5,42,11,31,0.262,43,27,16,0.628,6,5,20,7,228.8,216.4,222.60000000000002
2020-01-18,1610612741,1610612739,2019,118.0,116.0,234.0,104.0,111.1,108.6,116.5,43,15,28,0.349,42,12,30,0.28600000000000003,8,7,6,6,216.4,226.0,221.2
2020-01-18,1610612750,1610612761,2019,112.0,122.0,234.0,109.7,110.5,110.9,102.6,41,15,26,0.366,41,27,14,0.659,6,9,15,12,212.4,213.8,213.10000000000002
2020-01-18,1610612745,1610612747,2019,115.0,124.0,239.0,114.2,112.8,118.0,107.7,40,26,14,0.65,41,33,8,0.805,14,12,16,17,227.6,221.8,224.7
2020-01-18,1610612744,1610612753,2019,109.0,95.0,204.0,104.8,117.5,106.2,102.4,43,9,34,0.209,42,20,22,0.476,6,3,13,7,233.6,198.2,215.89999999999998
2020-01-18,1610612760,1610612757,2019,119.0,106.0,225.0,112.9,109.9,108.9,115.0,42,23,19,0.5479999999999999,43,18,25,0.419,13,10,9,9,224.2,226.4,225.3
2020-01-18,1610612762,1610612758,2019,123.0,101.0,224.0,118.5,107.7,111.8,115.4,41,28,13,0.6829999999999999,41,15,26,0.366,15,13,8,7,213.0,230.0,221.5
2020-01-17,1610612754,1610612750,2019,116.0,114.0,230.0,110.4,109.7,108.8,109.3,41,26,15,0.634,40,15,25,0.375,16,10,6,9,222.6,212.4,217.5
2020-01-17,1610612755,1610612741,2019,100.0,89.0,189.0,109.9,109.4,104.6,111.4,42,26,16,0.619,42,15,27,0.35700000000000004,19,7,8,7,225.2,216.4,220.8
2020-01-17,1610612761,1610612764,2019,140.0,111.0,251.0,107.1,103.3,108.3,116.8,40,26,14,0.65,40,13,27,0.325,14,12,8,5,207.6,223.0,215.3
2020-01-17,1610612763,1610612739,2019,113.0,109.0,222.0,121.7,112.1,107.4,116.9,41,19,22,0.463,41,12,29,0.293,11,8,6,6,232.4,226.0,229.2
2020-01-17,1610612760,1610612748,2019,108.0,115.0,223.0,111.8,109.4,108.8,109.2,41,23,18,0.561,40,28,12,0.7,13,10,18,10,221.0,211.4,216.2
2020-01-17,1610612759,1610612737,2019,120.0,121.0,241.0,116.4,115.4,103.0,111.5,39,17,22,0.436,41,9,32,0.22,11,6,5,4,232.0,226.6,229.3
2020-01-17,1610612742,1610612757,2019,120.0,112.0,232.0,115.5,111.5,109.9,113.3,41,26,15,0.634,42,18,24,0.429,12,14,9,9,225.4,226.4,225.9
2020-01-16,1610612752,1610612756,2019,98.0,121.0,219.0,110.6,120.9,108.2,110.4,41,11,30,0.268,40,16,24,0.4,6,5,9,7,230.0,213.6,221.8
2020-01-16,1610612749,1610612738,2019,128.0,123.0,251.0,117.2,104.6,110.9,106.3,42,36,6,0.857,39,27,12,0.6920000000000001,19,17,16,11,220.4,227.2,223.8
2020-01-16,1610612740,1610612762,2019,138.0,132.0,270.0,117.2,115.3,115.5,103.7,41,15,26,0.366,40,28,12,0.7,7,8,15,13,230.2,213.0,221.6
2020-01-16,1610612744,1610612743,2019,131.0,134.0,265.0,102.2,113.7,112.8,112.1,42,9,33,0.214,40,28,12,0.7,6,3,17,11,220.8,216.4,218.60000000000002
2020-01-16,1610612746,1610612753,2019,122.0,95.0,217.0,117.8,112.1,106.7,101.3,41,28,13,0.6829999999999999,41,20,21,0.488,18,10,13,7,239.8,198.2,219.0
2020-01-15,1610612738,1610612765,2019,103.0,116.0,219.0,110.3,106.0,108.0,112.0,38,27,11,0.711,41,14,27,0.341,16,11,8,6,225.4,225.8,225.60000000000002
2020-01-15,1610612755,1610612751,2019,117.0,106.0,223.0,108.0,110.5,105.5,112.1,41,25,16,0.61,39,18,21,0.462,18,7,11,7,223.6,217.2,220.39999999999998
2020-01-15,1610612748,1610612759,2019,106.0,100.0,206.0,108.9,109.6,116.2,115.0,39,27,12,0.6920000000000001,38,17,21,0.447,17,10,11,6,212.4,232.0,222.2
2020-01-15,1610612741,1610612764,2019,115.0,106.0,221.0,104.7,108.9,109.5,117.5,41,14,27,0.341,39,13,26,0.333,7,7,8,5,211.6,223.0,217.3
2020-01-15,1610612750,1610612754,2019,99.0,104.0,203.0,107.7,108.3,111.2,111.1,39,15,24,0.385,40,25,15,0.625,6,9,16,9,208.2,222.6,215.39999999999998
2020-01-15,1610612760,1610612761,2019,121.0,130.0,251.0,111.5,107.6,105.6,103.2,40,23,17,0.575,39,25,14,0.6409999999999999,13,10,14,11,216.8,207.6,212.2
2020-01-15,1610612743,1610612766,2019,100.0,86.0,186.0,112.8,114.7,104.3,110.4,39,27,12,0.6920000000000001,43,15,28,0.349,16,11,7,8,221.6,213.8,217.7
2020-01-15,1610612745,1610612757,2019,107.0,117.0,224.0,114.4,111.8,107.5,114.3,39,26,13,0.667,41,17,24,0.415,14,12,9,8,226.0,226.4,226.2
2020-01-15,1610612758,1610612742,2019,123.0,127.0,250.0,112.3,115.0,113.5,110.2,40,15,25,0.375,40,25,15,0.625,8,7,12,13,230.2,225.4,227.8
2020-01-15,1610612747,1610612753,2019,118.0,119.0,237.0,117.9,106.5,105.1,101.3,40,33,7,0.825,40,19,21,0.475,16,17,13,6,219.2,198.2,208.7
2020-01-14,1610612737,1610612756,2019,123.0,110.0,233.0,101.3,111.6,108.0,110.7,40,8,32,0.2,39,16,23,0.41,4,4,9,7,223.4,213.6,218.5
2020-01-14,1610612751,1610612762,2019,107.0,118.0,225.0,103.0,109.7,115.7,103.7,38,18,20,0.474,39,27,12,0.6920000000000001,11,7,15,12,207.4,213.0,210.2
2020-01-14,1610612763,1610612745,2019,121.0,110.0,231.0,121.1,115.6,114.7,110.1,40,18,22,0.45,38,26,12,0.684,10,8,14,12,238.2,226.0,232.1
2020-01-14,1610612749,1610612752,2019,128.0,102.0,230.0,115.5,104.8,111.1,118.1,41,35,6,0.8540000000000001,40,11,29,0.275,18,17,6,5,217.4,230.0,223.7
2020-01-14,1610612744,1610612742,2019,97.0,124.0,221.0,104.1,111.7,112.8,110.3,41,9,32,0.22,39,24,15,0.615,6,3,12,12,220.6,225.4,223.0
2020-01-14,1610612746,1610612739,2019,128.0,103.0,231.0,115.7,113.8,106.5,112.9,40,27,13,0.675,40,12,28,0.3,17,10,6,6,239.0,226.0,232.5
2020-01-13,1610612765,1610612740,2019,110.0,117.0,227.0,107.7,112.2,116.7,114.3,40,14,26,0.35,40,14,26,0.35,8,6,7,7,225.6,230.2,227.89999999999998
2020-01-13,1610612754,1610612755,2019,101.0,95.0,196.0,113.0,112.1,108.2,110.2,39,24,15,0.615,40,25,15,0.625,15,9,18,7,228.2,223.6,225.89999999999998
2020-01-13,1610612738,1610612741,2019,113.0,101.0,214.0,111.9,107.6,106.5,108.3,37,26,11,0.703,40,14,26,0.35,15,11,7,7,231.8,211.6,221.7
2020-01-13,1610612750,1610612760,2019,104.0,117.0,221.0,107.2,107.3,109.6,106.9,38,15,23,0.395,39,22,17,0.564,6,9,13,9,205.2,216.8,211.0
2020-01-13,1610612757,1610612766,2019,115.0,112.0,227.0,107.3,113.7,103.5,110.6,40,16,24,0.4,42,15,27,0.35700000000000004,8,8,7,8,224.8,213.8,219.3
2020-01-13,1610612758,1610612753,2019,112.0,114.0,226.0,109.8,114.1,104.1,101.4,39,15,24,0.385,39,18,21,0.462,8,7,13,5,223.4,198.2,210.8
2020-01-13,1610612747,1610612739,2019,128.0,99.0,227.0,115.9,106.1,108.3,113.0,39,32,7,0.821,39,12,27,0.308,15,17,6,6,214.4,226.0,220.2
2020-01-12,1610612752,1610612748,2019,124.0,121.0,245.0,113.0,118.0,107.6,107.6,39,10,29,0.256,38,27,11,0.711,5,5,17,10,233.6,212.4,223.0
2020-01-12,1610612764,1610612762,2019,116.0,127.0,243.0,108.0,117.0,113.4,102.8,38,13,25,0.342,38,26,12,0.684,8,5,15,11,219.0,213.0,216.0
2020-01-12,1610612751,1610612737,2019,108.0,86.0,194.0,104.4,112.3,104.5,112.9,37,17,20,0.459,39,8,31,0.205,10,7,4,4,215.4,223.4,219.4
2020-01-12,1610612761,1610612759,2019,104.0,105.0,209.0,106.2,103.4,120.2,116.1,38,25,13,0.6579999999999999,37,16,21,0.4320000000000001,14,11,11,5,209.2,232.0,220.6
2020-01-12,1610612763,1610612744,2019,122.0,102.0,224.0,120.8,116.9,105.1,111.7,39,17,22,0.436,40,9,31,0.225,9,8,6,3,240.2,220.6,230.39999999999998
2020-01-12,1610612743,1610612746,2019,114.0,104.0,218.0,112.3,114.3,115.9,113.3,38,26,12,0.684,39,27,12,0.6920000000000001,15,11,17,10,219.8,239.0,229.4
2020-01-12,1610612756,1610612766,2019,100.0,92.0,192.0,109.1,112.8,103.6,112.5,38,15,23,0.395,41,15,26,0.366,8,7,7,8,220.0,213.8,216.9
2020-01-11,1610612745,1610612750,2019,139.0,109.0,248.0,111.5,110.7,106.7,104.7,37,25,12,0.6759999999999999,37,15,22,0.405,13,12,6,9,220.8,205.2,213.0
2020-01-11,1610612738,1610612740,2019,140.0,105.0,245.0,109.8,106.4,116.4,109.7,36,25,11,0.6940000000000001,39,14,25,0.359,14,11,7,7,225.2,230.2,227.7
2020-01-11,1610612765,1610612741,2019,99.0,108.0,207.0,107.7,112.6,106.7,109.3,39,14,25,0.359,39,13,26,0.333,8,6,7,6,226.4,211.6,219.0
2020-01-11,1610612760,1610612747,2019,110.0,125.0,235.0,111.2,105.2,113.5,104.7,38,22,16,0.579,38,31,7,0.816,13,9,15,16,216.6,214.4,215.5
2020-01-11,1610612742,1610612755,2019,109.0,91.0,200.0,114.2,112.3,111.6,110.2,38,23,15,0.605,39,25,14,0.6409999999999999,11,12,18,7,232.2,223.6,227.89999999999998
2020-01-11,1610612743,1610612739,2019,103.0,111.0,214.0,113.3,113.6,108.5,116.0,37,26,11,0.703,38,11,27,0.289,15,11,6,5,220.4,226.0,223.2
2020-01-11,1610612757,1610612749,2019,101.0,122.0,223.0,109.0,111.8,114.5,103.3,39,16,23,0.41,40,34,6,0.85,8,8,18,16,224.4,217.4,220.9
2020-01-10,1610612764,1610612737,2019,111.0,101.0,212.0,109.2,117.4,105.6,114.0,37,12,25,0.324,38,8,30,0.211,7,5,4,4,222.2,223.4,222.8
2020-01-10,1610612752,1610612740,2019,111.0,123.0,234.0,112.2,116.1,114.3,109.2,38,10,28,0.263,38,13,25,0.342,5,5,7,6,228.2,230.2,229.2
2020-01-10,1610612751,1610612748,2019,117.0,113.0,230.0,103.6,109.9,107.4,107.7,36,16,20,0.444,37,27,10,0.73,9,7,17,10,209.0,212.4,210.7
2020-01-10,1610612741,1610612754,2019,105.0,116.0,221.0,107.1,108.3,110.3,113.3,38,13,25,0.342,38,23,15,0.605,7,6,15,8,210.4,228.2,219.3
2020-01-10,1610612763,1610612759,2019,134.0,121.0,255.0,119.2,115.9,118.8,113.6,38,16,22,0.421,36,16,20,0.444,8,8,11,5,235.0,232.0,233.5
2020-01-10,1610612756,1610612753,2019,98.0,94.0,192.0,111.8,117.3,104.9,102.5,37,14,23,0.378,38,18,20,0.474,7,7,13,5,234.4,198.2,216.3
2020-01-10,1610612762,1610612766,2019,109.0,92.0,201.0,113.9,104.2,104.2,111.6,37,25,12,0.6759999999999999,40,15,25,0.375,14,11,7,8,216.8,213.8,215.3
2020-01-10,1610612742,1610612747,2019,114.0,129.0,243.0,113.0,109.2,111.9,104.3,37,23,14,0.622,37,30,7,0.8109999999999999,11,12,15,15,223.6,214.4,219.0
2020-01-10,1610612758,1610612749,2019,106.0,127.0,233.0,110.2,112.6,112.7,104.8,38,15,23,0.395,39,33,6,0.846,8,7,18,15,221.2,217.4,219.3
2020-01-10,1610612746,1610612744,2019,109.0,100.0,209.0,116.7,115.5,105.7,112.2,38,26,12,0.684,39,9,30,0.231,16,10,6,3,245.0,220.6,232.8
2020-01-09,1610612765,1610612739,2019,112.0,115.0,227.0,108.4,114.4,107.8,117.3,38,14,24,0.368,37,10,27,0.27,8,6,6,4,231.4,226.0,228.7
2020-01-09,1610612755,1610612738,2019,109.0,98.0,207.0,111.1,111.2,110.9,105.8,38,24,14,0.632,35,25,10,0.7140000000000001,17,7,14,11,224.6,225.2,224.89999999999998
2020-01-09,1610612750,1610612757,2019,116.0,102.0,218.0,106.8,106.9,110.3,112.3,36,14,22,0.389,38,16,22,0.421,5,9,8,8,209.8,224.4,217.10000000000002
2020-01-09,1610612760,1610612745,2019,113.0,92.0,205.0,112.5,108.2,116.2,111.9,37,21,16,0.568,36,25,11,0.6940000000000001,12,9,13,12,225.2,220.8,223.0
2020-01-08,1610612738,1610612759,2019,114.0,129.0,243.0,110.9,102.2,118.0,114.1,34,25,9,0.735,35,15,20,0.429,14,11,11,4,218.0,232.0,225.0
2020-01-08,1610612766,1610612761,2019,110.0,112.0,222.0,104.2,110.6,106.2,102.3,39,15,24,0.385,37,24,13,0.649,7,8,14,10,211.8,209.2,210.5
2020-01-08,1610612754,1610612748,2019,108.0,122.0,230.0,110.0,111.3,107.4,108.7,37,23,14,0.622,36,26,10,0.722,15,8,17,9,223.6,212.4,218.0
2020-01-08,1610612753,1610612764,2019,123.0,89.0,212.0,102.4,103.3,113.6,117.0,37,17,20,0.459,36,12,24,0.333,12,5,7,5,194.8,222.2,208.5
2020-01-08,1610612737,1610612745,2019,115.0,122.0,237.0,103.7,111.9,116.2,112.1,37,8,29,0.21600000000000005,35,24,11,0.6859999999999999,4,4,13,11,215.4,220.8,218.10000000000002
2020-01-08,1610612742,1610612743,2019,106.0,107.0,213.0,112.7,109.4,113.9,114.1,36,23,13,0.639,36,25,11,0.6940000000000001,11,12,15,10,223.4,220.4,221.9
2020-01-08,1610612740,1610612741,2019,123.0,108.0,231.0,113.9,111.4,106.9,106.9,37,12,25,0.324,37,13,24,0.35100000000000003,6,6,7,6,233.8,210.4,222.10000000000002
2020-01-08,1610612762,1610612752,2019,128.0,104.0,232.0,110.1,104.2,111.2,111.5,36,24,12,0.667,37,10,27,0.27,13,11,5,5,209.2,228.2,218.7
2020-01-08,1610612744,1610612749,2019,98.0,107.0,205.0,107.2,111.9,114.3,105.2,38,9,29,0.237,38,32,6,0.8420000000000001,6,3,18,14,223.0,217.4,220.2
2020-01-07,1610612739,1610612765,2019,113.0,115.0,228.0,107.9,116.5,107.8,116.7,36,10,26,0.278,37,13,24,0.35100000000000003,6,4,8,5,224.6,231.4,228.0
2020-01-07,1610612761,1610612757,2019,99.0,101.0,200.0,108.5,104.0,111.3,113.4,36,24,12,0.667,37,15,22,0.405,14,10,8,7,217.2,224.4,220.8
2020-01-07,1610612751,1610612760,2019,103.0,111.0,214.0,104.1,110.1,111.8,108.1,35,16,19,0.457,36,20,16,0.556,9,7,12,8,210.4,225.2,217.8
2020-01-07,1610612763,1610612750,2019,119.0,112.0,231.0,120.1,115.8,106.2,106.3,37,15,22,0.405,35,14,21,0.4,7,8,5,9,236.6,209.8,223.2
2020-01-07,1610612756,1610612758,2019,103.0,114.0,217.0,112.5,117.0,108.8,110.2,36,14,22,0.389,37,14,23,0.378,7,7,8,6,235.2,221.2,228.2
2020-01-07,1610612747,1610612752,2019,117.0,87.0,204.0,110.8,106.7,113.9,112.7,36,29,7,0.8059999999999999,36,10,26,0.278,14,15,5,5,217.0,228.2,222.6
2020-01-06,1610612766,1610612754,2019,104.0,115.0,219.0,105.2,109.8,109.5,110.9,38,15,23,0.395,36,22,14,0.611,7,8,15,7,212.2,223.6,217.89999999999998
2020-01-06,1610612753,1610612751,2019,101.0,89.0,190.0,102.6,103.9,106.0,110.1,36,16,20,0.444,34,16,18,0.471,11,5,9,7,196.4,210.4,203.4
2020-01-06,1610612755,1610612760,2019,120.0,113.0,233.0,110.7,110.8,110.7,107.1,37,23,14,0.622,35,20,15,0.5710000000000001,16,7,12,8,223.0,225.2,224.1
2020-01-06,1610612764,1610612738,2019,99.0,94.0,193.0,113.7,118.3,113.2,104.5,35,11,24,0.314,33,25,8,0.758,6,5,14,11,225.0,218.0,221.5
2020-01-06,1610612737,1610612743,2019,115.0,123.0,238.0,102.2,110.6,114.4,113.0,36,8,28,0.222,35,24,11,0.6859999999999999,4,4,15,9,209.8,220.4,215.10000000000002
2020-01-06,1610612740,1610612762,2019,126.0,128.0,254.0,111.6,109.1,108.7,102.3,36,12,24,0.333,35,23,12,0.657,6,6,13,10,224.6,209.2,216.89999999999998
2020-01-06,1610612742,1610612741,2019,118.0,110.0,228.0,112.7,110.6,106.4,106.1,35,22,13,0.629,36,13,23,0.361,10,12,7,6,225.8,210.4,218.10000000000002
2020-01-06,1610612759,1610612749,2019,126.0,104.0,230.0,117.2,114.2,116.6,104.0,34,14,20,0.412,37,32,5,0.865,10,4,18,14,230.6,217.4,224.0
2020-01-06,1610612758,1610612744,2019,111.0,98.0,209.0,108.1,110.9,107.4,110.6,36,13,23,0.361,37,9,28,0.243,7,6,6,3,221.2,223.0,222.1
2020-01-05,1610612746,1610612752,2019,135.0,132.0,267.0,115.2,112.2,111.2,110.3,37,25,12,0.6759999999999999,35,10,25,0.28600000000000003,15,10,5,5,235.4,228.2,231.8
2020-01-05,1610612748,1610612757,2019,122.0,111.0,233.0,108.1,109.0,110.1,112.6,35,25,10,0.7140000000000001,36,15,21,0.417,16,9,8,7,214.4,224.4,219.4
2020-01-05,1610612739,1610612750,2019,103.0,118.0,221.0,107.6,114.5,104.4,106.9,35,10,25,0.28600000000000003,34,13,21,0.382,6,4,5,8,220.0,209.8,214.9
2020-01-05,1610612756,1610612763,2019,114.0,121.0,235.0,113.0,117.0,118.7,115.8,35,14,21,0.4,36,14,22,0.389,7,7,7,7,236.2,236.6,236.39999999999998
2020-01-05,1610612747,1610612765,2019,106.0,99.0,205.0,110.6,109.6,107.2,117.5,35,28,7,0.8,36,13,23,0.361,13,15,8,5,222.4,231.4,226.9
2020-01-04,1610612746,1610612763,2019,114.0,140.0,254.0,115.5,107.9,116.9,117.0,36,25,11,0.6940000000000001,35,13,22,0.371,15,10,7,6,227.4,236.6,232.0
2020-01-04,1610612751,1610612761,2019,102.0,121.0,223.0,106.3,108.2,105.7,103.0,33,16,17,0.485,35,23,12,0.657,9,7,14,9,207.2,217.2,212.2
2020-01-04,1610612753,1610612762,2019,96.0,109.0,205.0,103.7,106.0,108.9,103.3,35,16,19,0.457,34,22,12,0.647,11,5,13,9,202.8,209.2,206.0
2020-01-04,1610612737,1610612754,2019,116.0,111.0,227.0,102.4,112.5,108.8,109.6,35,7,28,0.2,35,22,13,0.629,3,4,15,7,214.0,223.6,218.8
2020-01-04,1610612739,1610612760,2019,106.0,121.0,227.0,108.0,114.0,107.9,105.9,34,10,24,0.294,34,19,15,0.5589999999999999,6,4,12,7,219.8,225.2,222.5
2020-01-04,1610612764,1610612743,2019,128.0,114.0,242.0,111.8,117.9,112.2,109.9,34,10,24,0.294,34,24,10,0.706,5,5,15,9,220.4,220.4,220.4
2020-01-04,1610612741,1610612738,2019,104.0,111.0,215.0,103.3,103.3,113.4,104.5,35,13,22,0.371,32,24,8,0.75,7,6,14,10,198.6,218.0,208.3
2020-01-04,1610612742,1610612766,2019,120.0,123.0,243.0,111.3,109.3,101.4,108.5,34,22,12,0.647,37,14,23,0.378,10,12,7,7,220.4,212.2,216.3
2020-01-04,1610612749,1610612759,2019,127.0,118.0,245.0,115.5,104.2,115.2,114.7,36,31,5,0.861,33,14,19,0.424,17,14,10,4,215.6,230.6,223.1
2020-01-04,1610612744,1610612765,2019,104.0,111.0,215.0,107.6,109.7,107.6,117.8,36,9,27,0.25,35,12,23,0.343,6,3,8,4,221.6,231.4,226.5
2020-01-04,1610612758,1610612740,2019,115.0,117.0,232.0,107.0,110.5,110.6,107.5,35,13,22,0.371,35,11,24,0.314,7,6,6,5,218.2,224.6,221.39999999999998
2020-01-03,1610612738,1610612737,2019,109.0,106.0,215.0,113.4,105.4,103.8,115.9,31,23,8,0.742,34,7,27,0.206,13,10,3,4,219.8,214.0,216.9
2020-01-03,1610612753,1610612748,2019,105.0,85.0,190.0,101.9,107.1,108.9,109.7,34,15,19,0.441,34,25,9,0.735,10,5,16,9,201.4,214.4,207.9
2020-01-03,1610612764,1610612757,2019,103.0,122.0,225.0,113.4,119.2,107.6,114.0,33,10,23,0.303,35,14,21,0.4,5,5,8,6,226.2,224.4,225.3
2020-01-03,1610612745,1610612755,2019,118.0,108.0,226.0,116.2,113.2,108.8,109.9,34,23,11,0.6759999999999999,36,23,13,0.639,12,11,16,7,223.0,223.0,223.0
2020-01-03,1610612756,1610612752,2019,120.0,112.0,232.0,111.8,117.3,110.3,108.4,34,13,21,0.382,34,10,24,0.294,6,7,5,5,234.4,228.2,231.3
2020-01-03,1610612747,1610612740,2019,123.0,113.0,236.0,112.5,110.8,110.2,106.8,34,27,7,0.794,34,11,23,0.324,12,15,6,5,228.6,224.6,226.6
2020-01-02,1610612739,1610612766,2019,106.0,109.0,215.0,106.1,112.4,98.8,105.2,33,10,23,0.303,36,13,23,0.361,6,4,7,6,212.8,212.2,212.5
2020-01-02,1610612754,1610612743,2019,116.0,124.0,240.0,107.9,105.7,110.0,108.8,34,22,12,0.647,33,23,10,0.6970000000000001,15,7,15,8,214.0,220.4,217.2
2020-01-02,1610612748,1610612761,2019,84.0,76.0,160.0,111.5,113.4,108.5,105.6,33,24,9,0.727,34,23,11,0.6759999999999999,15,9,14,9,227.0,217.2,222.1
2020-01-02,1610612741,1610612762,2019,98.0,102.0,200.0,107.1,103.3,111.4,105.1,34,13,21,0.382,33,21,12,0.636,7,6,13,8,206.2,209.2,207.7
2020-01-02,1610612750,1610612744,2019,99.0,84.0,183.0,106.1,111.2,108.3,110.4,33,12,21,0.364,35,9,26,0.257,4,8,6,3,221.8,221.6,221.7
2020-01-02,1610612742,1610612751,2019,123.0,111.0,234.0,112.0,106.6,105.4,106.9,33,21,12,0.636,32,16,16,0.5,9,12,9,7,216.4,207.2,211.8
2020-01-02,1610612759,1610612760,2019,103.0,109.0,212.0,115.8,115.5,107.4,104.6,32,14,18,0.43799999999999994,33,18,15,0.545,10,4,12,6,233.4,225.2,229.3
2020-01-02,1610612758,1610612763,2019,128.0,123.0,251.0,104.3,108.5,116.1,115.0,34,12,22,0.353,34,13,21,0.382,6,6,7,6,208.8,236.6,222.7
2020-01-02,1610612746,1610612765,2019,126.0,112.0,238.0,117.9,109.2,106.9,115.5,35,24,11,0.6859999999999999,34,12,22,0.353,14,10,8,4,234.8,231.4,233.10000000000002
2020-01-01,1610612764,1610612753,2019,101.0,122.0,223.0,115.2,118.3,102.7,108.9,32,10,22,0.313,33,14,19,0.424,5,5,10,4,228.0,201.4,214.7
2020-01-01,1610612752,1610612757,2019,117.0,93.0,210.0,107.8,112.0,110.0,111.7,33,9,24,0.273,34,14,20,0.41200000000000003,4,5,8,6,230.4,224.4,227.4
2020-01-01,1610612749,1610612750,2019,106.0,104.0,210.0,117.4,104.6,106.6,113.1,35,30,5,0.857,32,12,20,0.375,16,14,4,8,220.2,221.8,221.0
2020-01-01,1610612747,1610612756,2019,117.0,107.0,224.0,110.8,111.5,111.0,117.6,33,26,7,0.7879999999999999,33,13,20,0.39399999999999996,11,15,6,7,226.6,234.4,230.5
2019-12-31,1610612766,1610612738,2019,92.0,109.0,201.0,100.3,106.5,113.2,107.4,35,13,22,0.371,30,22,8,0.733,7,6,13,9,217.8,219.8,218.8
2019-12-31,1610612754,1610612755,2019,115.0,97.0,212.0,108.6,107.7,110.6,109.3,33,21,12,0.636,35,23,12,0.657,14,7,16,7,219.4,223.0,221.2
2019-12-31,1610612758,1610612746,2019,87.0,105.0,192.0,105.0,107.3,119.8,112.2,33,12,21,0.364,34,23,11,0.6759999999999999,6,6,14,9,207.8,234.8,221.3
2019-12-31,1610612761,1610612739,2019,117.0,97.0,214.0,110.1,107.2,108.1,111.6,33,22,11,0.667,32,10,22,0.313,13,9,6,4,223.6,212.8,218.2
2019-12-31,1610612745,1610612743,2019,130.0,104.0,234.0,114.7,113.7,109.1,106.6,33,22,11,0.667,32,23,9,0.7190000000000001,11,11,15,8,221.0,220.4,220.7
2019-12-31,1610612759,1610612744,2019,117.0,113.0,230.0,114.6,114.6,104.9,109.1,31,13,18,0.419,34,9,25,0.265,9,4,6,3,229.2,221.6,225.39999999999998
2019-12-31,1610612760,1610612742,2019,106.0,101.0,207.0,107.7,105.1,113.9,107.6,32,17,15,0.531,32,21,11,0.6559999999999999,11,6,9,12,226.8,216.4,221.60000000000002
2019-12-30,1610612753,1610612737,2019,93.0,101.0,194.0,106.2,110.2,103.9,120.2,32,14,18,0.438,33,6,27,0.182,10,4,3,3,211.0,214.0,212.5
2019-12-30,1610612764,1610612748,2019,123.0,105.0,228.0,114.9,120.5,113.1,112.1,31,9,22,0.29,32,24,8,0.75,4,5,15,9,231.8,227.0,229.4
2019-12-30,1610612741,1610612749,2019,102.0,123.0,225.0,106.1,100.3,117.8,104.7,33,13,20,0.394,34,29,5,0.853,7,6,16,13,198.2,220.2,209.2
2019-12-30,1610612750,1610612751,2019,122.0,115.0,237.0,105.1,113.1,105.0,105.1,31,11,20,0.355,31,16,15,0.516,3,8,9,7,218.8,207.2,213.0
2019-12-30,1610612762,1610612765,2019,104.0,81.0,185.0,113.6,108.2,111.5,114.5,32,20,12,0.625,33,12,21,0.364,12,8,8,4,219.8,231.4,225.60000000000002
2019-12-30,1610612757,1610612756,2019,116.0,122.0,238.0,110.6,110.7,109.7,117.5,33,14,19,0.424,32,12,20,0.375,8,6,6,6,223.6,234.4,229.0
2019-12-29,1610612761,1610612760,2019,97.0,98.0,195.0,111.4,107.6,108.7,105.0,32,22,10,0.688,31,16,15,0.516,13,9,11,5,227.0,226.8,226.9
2019-12-29,1610612763,1610612766,2019,117.0,104.0,221.0,115.8,117.3,101.2,105.6,33,12,21,0.364,34,13,21,0.382,6,6,7,6,240.6,217.8,229.2
2019-12-29,1610612740,1610612745,2019,127.0,112.0,239.0,110.7,109.5,116.5,111.7,33,10,23,0.303,32,22,10,0.688,5,5,11,11,231.0,221.0,226.0
2019-12-29,1610612743,1610612758,2019,120.0,115.0,235.0,108.2,105.6,105.4,107.1,31,22,9,0.71,32,12,20,0.375,14,8,6,6,216.6,207.8,212.2
2019-12-29,1610612747,1610612742,2019,108.0,95.0,203.0,112.5,112.3,116.6,107.9,32,25,7,0.7809999999999999,31,21,10,0.677,10,15,9,12,231.6,216.4,224.0
2019-12-28,1610612743,1610612763,2019,119.0,110.0,229.0,107.3,104.8,115.8,115.6,30,21,9,0.7,32,12,20,0.375,13,8,6,6,213.2,240.6,226.89999999999998
2019-12-28,1610612738,1610612761,2019,97.0,113.0,210.0,114.5,104.9,109.1,106.2,29,22,7,0.759,31,21,10,0.677,13,9,13,8,217.4,227.0,222.2
2019-12-28,1610612740,1610612754,2019,120.0,98.0,218.0,108.4,111.5,108.9,106.5,32,9,23,0.281,32,21,11,0.6559999999999999,4,5,14,7,230.4,219.4,224.9
2019-12-28,1610612748,1610612755,2019,117.0,116.0,233.0,114.9,112.6,110.3,109.5,31,23,8,0.742,34,23,11,0.6759999999999999,14,9,16,7,231.6,223.0,227.3
2019-12-28,1610612764,1610612752,2019,100.0,107.0,207.0,115.5,121.1,109.5,114.2,30,9,21,0.3,32,8,24,0.25,4,5,4,4,234.2,230.4,232.3
2019-12-28,1610612741,1610612737,2019,116.0,81.0,197.0,104.3,102.2,107.9,122.1,32,12,20,0.375,32,6,26,0.188,6,6,3,3,198.4,214.0,206.2
2019-12-28,1610612745,1610612751,2019,108.0,98.0,206.0,121.5,113.0,108.2,106.1,31,21,10,0.677,30,16,14,0.5329999999999999,10,11,9,7,233.6,207.2,220.39999999999998
2019-12-28,1610612750,1610612739,2019,88.0,94.0,182.0,106.1,113.7,107.5,113.8,30,11,19,0.3670000000000001,31,9,22,0.29,3,8,6,3,222.0,212.8,217.4
2019-12-28,1610612749,1610612753,2019,111.0,100.0,211.0,119.4,105.9,106.3,110.1,33,28,5,0.848,31,14,17,0.452,15,13,10,4,225.8,211.0,218.4
2019-12-28,1610612759,1610612765,2019,136.0,109.0,245.0,114.5,117.0,110.7,111.1,30,12,18,0.4,32,12,20,0.375,8,4,8,4,233.8,231.4,232.60000000000002
2019-12-28,1610612744,1610612742,2019,121.0,141.0,262.0,100.7,105.0,114.3,105.5,33,9,24,0.273,30,20,10,0.667,6,3,9,11,205.0,216.4,210.7
2019-12-28,1610612758,1610612756,2019,110.0,112.0,222.0,105.0,107.2,112.4,119.7,31,12,19,0.387,31,11,20,0.355,6,6,6,5,207.2,234.4,220.8
2019-12-28,1610612757,1610612747,2019,120.0,128.0,248.0,110.1,106.6,109.3,109.0,32,14,18,0.438,31,24,7,0.774,8,6,10,14,214.4,231.6,223.0
2019-12-28,1610612746,1610612762,2019,107.0,120.0,227.0,122.5,111.1,111.0,107.8,33,23,10,0.6970000000000001,31,19,12,0.613,14,9,12,7,238.0,219.8,228.9
2019-12-27,1610612738,1610612739,2019,129.0,117.0,246.0,112.4,102.7,105.2,115.0,28,21,7,0.75,30,9,21,0.3,12,9,6,3,208.8,212.8,210.8
2019-12-27,1610612766,1610612760,2019,102.0,104.0,206.0,101.4,106.3,109.0,105.2,33,13,20,0.394,30,15,15,0.5,7,6,11,4,219.6,226.8,223.2
2019-12-27,1610612753,1610612755,2019,98.0,97.0,195.0,106.5,110.0,110.7,109.2,30,13,17,0.433,33,23,10,0.6970000000000001,9,4,16,7,211.2,223.0,217.1
2019-12-27,1610612737,1610612749,2019,86.0,112.0,198.0,109.7,118.8,120.1,108.3,31,6,25,0.194,32,27,5,0.8440000000000001,3,3,15,12,211.0,225.8,218.4
2019-12-27,1610612748,1610612754,2019,113.0,112.0,225.0,114.6,111.9,108.4,105.2,30,22,8,0.733,31,21,10,0.677,13,9,14,7,229.6,219.4,224.5
2019-12-27,1610612744,1610612756,2019,105.0,96.0,201.0,102.4,107.8,114.2,122.0,32,8,24,0.25,30,11,19,0.3670000000000001,5,3,6,5,214.0,234.4,224.2
2019-12-26,1610612765,1610612764,2019,132.0,102.0,234.0,108.6,113.1,116.4,120.7,31,11,20,0.355,29,9,20,0.31,7,4,4,5,231.2,234.2,232.7
2019-12-26,1610612751,1610612752,2019,82.0,94.0,176.0,110.6,107.6,108.8,117.5,29,16,13,0.552,31,7,24,0.226,9,7,4,3,215.0,230.4,222.7
2019-12-26,1610612760,1610612763,2019,97.0,110.0,207.0,113.2,106.9,116.0,118.5,29,15,14,0.517,31,11,20,0.355,11,4,6,5,238.6,240.6,239.6
2019-12-26,1610612742,1610612759,2019,102.0,98.0,200.0,116.2,107.1,115.8,117.2,29,19,10,0.655,29,12,17,0.414,8,11,8,4,223.4,233.8,228.60000000000002
2019-12-26,1610612758,1610612750,2019,104.0,105.0,209.0,104.6,106.4,108.1,117.5,30,12,18,0.4,29,10,19,0.345,6,6,3,7,204.8,222.0,213.4
2019-12-26,1610612762,1610612757,2019,121.0,115.0,236.0,108.5,108.4,109.0,105.5,30,18,12,0.6,31,14,17,0.452,11,7,8,6,216.0,214.4,215.2
2019-12-25,1610612761,1610612738,2019,102.0,118.0,220.0,108.1,105.6,109.8,102.1,30,21,9,0.7,27,20,7,0.741,13,8,12,8,223.8,208.8,216.3
2019-12-25,1610612755,1610612749,2019,121.0,109.0,230.0,108.3,107.5,122.7,108.9,32,22,10,0.688,31,27,4,0.871,15,7,15,12,214.8,225.8,220.3
2019-12-25,1610612744,1610612745,2019,116.0,104.0,220.0,101.0,108.4,122.7,112.4,31,7,24,0.226,30,21,9,0.7,4,3,10,11,212.4,233.6,223.0
2019-12-25,1610612747,1610612746,2019,106.0,111.0,217.0,109.9,108.6,122.6,109.7,30,24,6,0.8,32,22,10,0.688,10,14,14,8,232.0,238.0,235.0
2019-12-25,1610612743,1610612740,2019,100.0,112.0,212.0,108.7,103.5,108.4,114.2,29,21,8,0.7240000000000001,31,8,23,0.258,13,8,4,4,213.4,230.4,221.9
2019-12-23,1610612739,1610612737,2019,121.0,118.0,239.0,102.5,115.9,110.1,117.4,29,8,21,0.276,30,6,24,0.2,5,3,3,3,209.2,211.0,210.1
2019-12-23,1610612765,1610612755,2019,109.0,125.0,234.0,108.5,110.7,105.4,106.7,30,11,19,0.3670000000000001,31,21,10,0.677,7,4,15,6,226.2,214.8,220.5
2019-12-23,1610612754,1610612761,2019,120.0,115.0,235.0,106.3,104.7,108.5,105.2,30,20,10,0.667,29,21,8,0.7240000000000001,13,7,13,8,214.2,223.8,219.0
2019-12-23,1610612752,1610612764,2019,115.0,121.0,236.0,107.7,116.7,115.0,120.6,30,7,23,0.233,28,8,20,0.28600000000000003,4,3,4,4,226.6,234.2,230.39999999999998
2019-12-23,1610612753,1610612741,2019,103.0,95.0,198.0,104.5,109.5,106.1,102.5,29,12,17,0.414,31,12,19,0.387,8,4,6,6,206.2,198.4,202.3
2019-12-23,1610612748,1610612762,2019,107.0,104.0,211.0,115.1,111.8,109.1,110.7,29,21,8,0.7240000000000001,29,18,11,0.621,12,9,11,7,230.4,216.0,223.2
2019-12-23,1610612763,1610612759,2019,115.0,145.0,260.0,114.9,115.7,111.7,117.2,30,11,19,0.3670000000000001,28,11,17,0.393,6,5,8,3,232.8,233.8,233.3
2019-12-23,1610612756,1610612743,2019,111.0,113.0,224.0,115.6,121.6,110.3,101.6,29,11,18,0.379,28,20,8,0.7140000000000001,6,5,13,7,236.4,213.4,224.9
2019-12-23,1610612757,1610612740,2019,94.0,102.0,196.0,109.2,106.1,106.6,117.8,30,14,16,0.467,30,7,23,0.233,8,6,4,3,216.0,230.4,223.2
2019-12-23,1610612758,1610612745,2019,104.0,113.0,217.0,106.2,106.7,123.3,112.9,29,12,17,0.414,29,20,9,0.69,6,6,10,10,208.6,233.6,221.1
2019-12-23,1610612744,1610612750,2019,113.0,104.0,217.0,100.1,107.0,110.4,120.1,30,6,24,0.2,28,10,18,0.35700000000000004,3,3,3,7,207.8,222.0,214.9
2019-12-22,1610612761,1610612742,2019,110.0,107.0,217.0,108.4,106.4,116.9,106.1,28,20,8,0.7140000000000001,28,19,9,0.679,12,8,8,11,226.0,223.4,224.7
2019-12-22,1610612738,1610612766,2019,119.0,93.0,212.0,109.1,102.1,101.7,108.1,26,19,7,0.731,32,13,19,0.406,11,8,7,6,207.4,219.6,213.5
2019-12-22,1610612749,1610612754,2019,117.0,89.0,206.0,122.0,110.1,109.1,103.4,30,26,4,0.867,29,20,9,0.69,14,12,13,7,226.8,214.2,220.5
2019-12-22,1610612760,1610612746,2019,118.0,112.0,230.0,111.4,106.4,122.4,107.8,28,14,14,0.5,31,22,9,0.71,10,4,14,8,234.0,238.0,236.0
2019-12-22,1610612747,1610612743,2019,104.0,128.0,232.0,111.7,105.9,107.2,101.2,29,24,5,0.828,27,19,8,0.7040000000000001,10,14,13,6,230.2,213.4,221.8
2019-12-21,1610612766,1610612762,2019,107.0,114.0,221.0,101.6,105.8,108.0,109.4,31,13,18,0.419,28,17,11,0.607,7,6,11,6,214.8,216.0,215.4
2019-12-21,1610612751,1610612737,2019,122.0,112.0,234.0,109.6,107.1,110.0,121.0,28,15,13,0.536,29,6,23,0.207,8,7,3,3,212.0,211.0,211.5
2019-12-21,1610612765,1610612741,2019,107.0,119.0,226.0,108.1,111.5,104.5,102.5,29,11,18,0.379,30,11,19,0.3670000000000001,7,4,6,5,227.0,198.4,212.7
2019-12-21,1610612755,1610612764,2019,125.0,108.0,233.0,103.9,106.3,114.5,119.3,30,20,10,0.667,27,8,19,0.29600000000000004,14,6,4,4,211.0,234.2,222.6
2019-12-21,1610612752,1610612749,2019,102.0,123.0,225.0,107.0,114.5,121.2,110.0,29,7,22,0.241,29,25,4,0.862,4,3,14,11,220.8,226.8,223.8
2019-12-21,1610612763,1610612758,2019,119.0,115.0,234.0,112.4,114.5,105.7,105.4,29,10,19,0.345,28,12,16,0.429,5,5,6,6,225.4,208.6,217.0
2019-12-21,1610612759,1610612746,2019,109.0,134.0,243.0,111.5,113.5,122.5,108.8,27,11,16,0.407,30,21,9,0.7,8,3,14,7,226.0,238.0,232.0
2019-12-21,1610612756,1610612745,2019,125.0,139.0,264.0,114.4,119.7,122.7,113.9,28,11,17,0.393,28,19,9,0.679,6,5,10,9,230.2,233.6,231.89999999999998
2019-12-21,1610612757,1610612750,2019,113.0,106.0,219.0,109.2,109.1,111.2,120.9,29,13,16,0.448,27,10,17,0.37,7,6,3,7,222.0,222.0,222.0
2019-12-20,1610612739,1610612763,2019,114.0,107.0,221.0,102.1,117.1,111.6,113.7,28,7,21,0.25,28,10,18,0.35700000000000004,4,3,5,5,210.8,225.4,218.10000000000002
2019-12-20,1610612754,1610612758,2019,119.0,105.0,224.0,107.7,103.3,105.6,104.0,28,19,9,0.679,27,12,15,0.444,12,7,6,6,211.2,208.6,209.89999999999998
2019-12-20,1610612738,1610612765,2019,114.0,93.0,207.0,109.8,103.8,107.8,110.5,25,18,7,0.72,28,11,17,0.393,10,8,7,4,212.2,227.0,219.6
2019-12-20,1610612761,1610612764,2019,122.0,118.0,240.0,107.2,106.7,115.2,122.1,27,19,8,0.7040000000000001,26,8,18,0.308,11,8,4,4,224.2,234.2,229.2
2019-12-20,1610612748,1610612752,2019,129.0,114.0,243.0,114.4,110.9,104.4,114.8,28,20,8,0.7140000000000001,28,7,21,0.25,11,9,4,3,227.2,220.8,224.0
2019-12-20,1610612755,1610612742,2019,98.0,117.0,215.0,108.2,104.0,117.2,107.6,29,20,9,0.69,27,18,9,0.667,14,6,8,10,215.0,223.4,219.2
2019-12-20,1610612760,1610612756,2019,126.0,108.0,234.0,109.7,106.0,114.5,117.5,27,13,14,0.481,27,11,16,0.407,9,4,6,5,229.8,230.2,230.0
2019-12-20,1610612743,1610612750,2019,109.0,100.0,209.0,105.9,101.7,112.5,120.1,26,18,8,0.6920000000000001,26,10,16,0.385,12,6,3,7,211.8,222.0,216.9
2019-12-20,1610612757,1610612753,2019,118.0,103.0,221.0,110.1,110.4,103.5,106.4,28,12,16,0.429,28,12,16,0.429,6,6,8,4,226.4,206.2,216.3
2019-12-20,1610612744,1610612740,2019,106.0,102.0,208.0,99.2,106.8,106.8,118.1,29,5,24,0.172,29,7,22,0.241,2,3,4,3,205.6,230.4,218.0
2019-12-19,1610612737,1610612762,2019,106.0,111.0,217.0,110.7,122.4,107.1,110.9,28,6,22,0.214,27,16,11,0.593,3,3,11,5,215.2,216.0,215.6
2019-12-19,1610612749,1610612747,2019,111.0,104.0,215.0,122.0,108.7,114.9,106.1,28,24,4,0.857,28,24,4,0.857,13,11,10,14,225.8,230.2,228.0
2019-12-19,1610612759,1610612751,2019,118.0,105.0,223.0,109.8,114.3,110.1,107.4,26,10,16,0.385,27,15,12,0.556,7,3,8,7,224.2,212.0,218.1
2019-12-19,1610612746,1610612745,2019,117.0,122.0,239.0,123.0,108.5,122.4,114.4,29,21,8,0.7240000000000001,27,18,9,0.667,14,7,10,8,238.4,233.6,236.0
2019-12-18,1610612739,1610612766,2019,100.0,98.0,198.0,102.5,118.9,102.8,106.5,27,6,21,0.222,30,13,17,0.433,3,3,7,6,215.2,214.8,215.0
2019-12-18,1610612765,1610612761,2019,99.0,112.0,211.0,111.1,109.1,106.2,107.8,27,11,16,0.407,26,18,8,0.6920000000000001,7,4,11,7,230.8,224.2,227.5
2019-12-18,1610612764,1610612741,2019,109.0,110.0,219.0,116.8,122.9,102.5,102.0,25,8,17,0.32,29,10,19,0.345,4,4,6,4,239.0,198.4,218.7
2019-12-18,1610612755,1610612748,2019,104.0,108.0,212.0,108.1,102.6,114.5,111.1,28,20,8,0.7140000000000001,27,19,8,0.7040000000000001,14,6,11,8,212.0,227.2,219.6
2019-12-18,1610612750,1610612740,2019,99.0,107.0,206.0,112.1,119.7,107.0,121.6,25,10,15,0.4,28,6,22,0.214,3,7,4,2,220.4,230.4,225.4
2019-12-18,1610612760,1610612763,2019,126.0,122.0,248.0,109.8,106.8,110.9,111.8,26,12,14,0.462,27,10,17,0.37,8,4,5,5,231.6,225.4,228.5
2019-12-18,1610612743,1610612753,2019,113.0,104.0,217.0,106.3,101.7,105.8,107.1,25,17,8,0.68,27,12,15,0.444,11,6,8,4,212.6,206.2,209.39999999999998
2019-12-18,1610612742,1610612738,2019,103.0,109.0,212.0,116.8,108.1,109.3,104.2,26,18,8,0.6920000000000001,24,17,7,0.708,8,10,10,7,223.6,212.2,217.89999999999998
2019-12-18,1610612757,1610612744,2019,122.0,112.0,234.0,108.6,109.5,97.6,104.6,27,11,16,0.407,28,5,23,0.179,5,6,2,3,221.6,205.6,213.6
2019-12-17,1610612766,1610612758,2019,110.0,102.0,212.0,102.2,107.2,107.0,105.7,29,12,17,0.414,26,12,14,0.462,6,6,6,6,215.0,208.6,211.8
2019-12-17,1610612754,1610612747,2019,105.0,102.0,207.0,109.3,103.3,116.8,105.2,27,18,9,0.667,27,24,3,0.889,11,7,10,14,214.4,230.2,222.3
2019-12-17,1610612752,1610612737,2019,143.0,120.0,263.0,100.2,113.1,109.1,118.6,27,6,21,0.222,27,6,21,0.222,3,3,3,3,209.0,215.2,212.1
2019-12-17,1610612740,1610612751,2019,101.0,108.0,209.0,107.3,121.5,110.1,107.9,27,6,21,0.222,26,14,12,0.5379999999999999,4,2,8,6,230.8,212.0,221.4
2019-12-17,1610612762,1610612753,2019,109.0,102.0,211.0,109.0,112.7,107.2,106.6,26,15,11,0.5770000000000001,26,12,14,0.462,10,5,8,4,223.4,206.2,214.8
2019-12-17,1610612746,1610612756,2019,120.0,99.0,219.0,121.7,109.0,115.0,117.1,28,20,8,0.7140000000000001,26,11,15,0.423,13,7,6,5,236.8,230.2,233.5
2019-12-16,1610612765,1610612764,2019,119.0,133.0,252.0,109.9,106.8,113.8,123.5,26,11,15,0.423,24,7,17,0.292,7,4,4,3,223.8,239.0,231.4
2019-12-16,1610612761,1610612739,2019,133.0,113.0,246.0,105.9,107.5,101.3,119.9,25,17,8,0.68,26,6,20,0.231,10,7,3,3,223.0,215.2,219.1
2019-12-16,1610612745,1610612759,2019,109.0,107.0,216.0,123.2,114.5,112.3,117.2,26,17,9,0.654,25,10,15,0.4,9,8,7,3,235.4,224.2,229.8
2019-12-16,1610612763,1610612748,2019,118.0,111.0,229.0,111.0,112.8,114.2,111.0,26,9,17,0.34600000000000003,26,19,7,0.731,4,5,11,8,227.6,227.2,227.39999999999998
2019-12-16,1610612749,1610612742,2019,116.0,120.0,236.0,123.6,105.5,118.5,108.8,27,24,3,0.889,25,17,8,0.68,13,11,8,9,222.6,223.6,223.1
2019-12-16,1610612760,1610612741,2019,109.0,106.0,215.0,111.6,108.1,103.5,102.6,25,11,14,0.44,28,10,18,0.35700000000000004,7,4,6,4,237.8,198.4,218.10000000000002
2019-12-16,1610612756,1610612757,2019,110.0,111.0,221.0,117.2,120.0,110.4,112.2,25,11,14,0.44,26,10,16,0.385,6,5,5,5,240.4,221.6,231.0
2019-12-15,1610612740,1610612753,2019,119.0,130.0,249.0,106.4,119.9,103.0,105.0,26,6,20,0.231,25,11,14,0.44,4,2,8,3,225.8,206.2,216.0
2019-12-15,1610612754,1610612766,2019,107.0,85.0,192.0,111.2,106.2,103.7,108.2,26,17,9,0.654,28,12,16,0.429,10,7,6,6,224.0,215.0,219.5
2019-12-15,1610612737,1610612747,2019,96.0,101.0,197.0,111.1,120.4,117.2,105.2,26,6,20,0.231,26,23,3,0.885,3,3,10,13,222.8,230.2,226.5
2019-12-15,1610612751,1610612755,2019,109.0,89.0,198.0,110.8,108.7,110.6,101.2,25,13,12,0.52,27,20,7,0.741,7,6,14,6,215.0,212.0,213.5
2019-12-15,1610612743,1610612752,2019,111.0,105.0,216.0,106.8,101.6,99.5,114.6,24,16,8,0.667,26,6,20,0.231,10,6,3,3,213.4,209.0,211.2
2019-12-15,1610612744,1610612758,2019,79.0,100.0,179.0,99.7,105.1,106.1,107.5,27,5,22,0.185,25,11,14,0.44,2,3,6,5,210.8,208.6,209.7
2019-12-14,1610612756,1610612759,2019,119.0,121.0,240.0,117.4,120.3,111.2,117.0,24,11,13,0.458,24,9,15,0.375,6,5,7,2,241.4,224.2,232.8
2019-12-14,1610612761,1610612751,2019,110.0,102.0,212.0,107.5,107.1,110.9,107.8,24,16,8,0.667,24,13,11,0.542,9,7,7,6,225.4,215.0,220.2
2019-12-14,1610612741,1610612746,2019,109.0,106.0,215.0,103.2,101.9,120.2,110.0,27,9,18,0.333,27,20,7,0.741,5,4,13,7,196.4,236.8,216.60000000000002
2019-12-14,1610612763,1610612764,2019,128.0,111.0,239.0,109.0,112.6,116.7,123.9,25,8,17,0.32,23,7,16,0.304,3,5,4,3,223.2,239.0,231.1
2019-12-14,1610612742,1610612748,2019,118.0,122.0,240.0,121.0,106.7,110.6,110.5,24,17,7,0.708,25,18,7,0.72,8,9,11,7,224.4,227.2,225.8
2019-12-14,1610612749,1610612739,2019,125.0,108.0,233.0,124.8,104.3,100.5,119.8,26,23,3,0.885,25,6,19,0.24,12,11,3,3,222.6,215.2,218.89999999999998
2019-12-14,1610612745,1610612765,2019,107.0,115.0,222.0,124.8,116.7,107.3,107.0,25,17,8,0.68,25,10,15,0.4,9,8,7,3,243.0,223.8,233.4
2019-12-14,1610612743,1610612760,2019,110.0,102.0,212.0,105.4,100.6,113.3,110.7,23,15,8,0.652,24,11,13,0.458,9,6,7,4,208.6,237.8,223.2
2019-12-13,1610612753,1610612745,2019,107.0,130.0,237.0,104.8,104.1,121.3,116.5,24,11,13,0.458,24,16,8,0.667,8,3,9,7,208.0,243.0,225.5
2019-12-13,1610612755,1610612740,2019,116.0,109.0,225.0,110.9,101.9,107.5,121.1,26,19,7,0.731,25,6,19,0.24,13,6,4,2,214.0,225.8,219.9
2019-12-13,1610612748,1610612747,2019,110.0,113.0,223.0,111.3,109.2,117.3,105.2,24,18,6,0.75,25,22,3,0.88,11,7,10,12,226.0,230.2,228.1
2019-12-13,1610612737,1610612754,2019,100.0,110.0,210.0,113.8,122.9,111.8,108.1,25,6,19,0.24,25,16,9,0.64,3,3,10,6,233.2,224.0,228.6
2019-12-13,1610612741,1610612766,2019,73.0,83.0,156.0,105.3,105.3,107.2,113.4,26,9,17,0.34600000000000003,27,11,16,0.407,5,4,6,5,207.4,215.0,211.2
2019-12-13,1610612763,1610612749,2019,114.0,127.0,241.0,107.1,111.3,122.3,101.2,24,8,16,0.333,25,22,3,0.88,3,5,12,10,216.8,222.6,219.7
2019-12-13,1610612762,1610612744,2019,114.0,106.0,220.0,108.9,113.0,99.6,105.9,25,14,11,0.56,26,5,21,0.192,9,5,2,3,223.8,210.8,217.3
2019-12-13,1610612750,1610612746,2019,117.0,124.0,241.0,110.9,119.8,117.5,109.0,24,10,14,0.417,26,19,7,0.731,3,7,13,6,218.2,236.8,227.5
2019-12-13,1610612758,1610612752,2019,101.0,103.0,204.0,106.0,107.1,99.6,115.4,24,11,13,0.458,25,5,20,0.2,6,5,3,2,207.6,209.0,208.3
2019-12-12,1610612738,1610612755,2019,109.0,115.0,224.0,108.7,102.9,111.3,103.7,23,17,6,0.7390000000000001,25,18,7,0.72,10,7,13,5,208.4,214.0,211.2
2019-12-12,1610612759,1610612739,2019,109.0,117.0,226.0,110.7,116.7,99.3,121.2,23,9,14,0.391,24,5,19,0.208,7,2,3,2,222.6,215.2,218.89999999999998
2019-12-12,1610612765,1610612742,2019,111.0,122.0,233.0,106.5,103.6,119.1,106.2,24,10,14,0.417,23,16,7,0.696,7,3,8,8,215.4,224.4,219.9
2019-12-12,1610612743,1610612757,2019,114.0,99.0,213.0,104.5,100.2,110.9,112.3,22,14,8,0.636,25,10,15,0.4,8,6,5,5,206.0,221.6,213.8
2019-12-11,1610612739,1610612745,2019,110.0,116.0,226.0,98.9,120.4,122.2,116.0,23,5,18,0.217,23,15,8,0.652,3,2,9,6,212.8,243.0,227.9
2019-12-11,1610612754,1610612738,2019,122.0,117.0,239.0,110.7,107.0,106.9,99.2,24,15,9,0.625,22,17,5,0.773,9,6,10,7,219.6,208.4,214.0
2019-12-11,1610612753,1610612747,2019,87.0,96.0,183.0,107.2,105.4,119.1,106.9,23,11,12,0.478,24,21,3,0.875,8,3,10,11,215.4,230.2,222.8
2019-12-11,1610612761,1610612746,2019,92.0,112.0,204.0,108.4,105.5,118.4,111.7,23,16,7,0.696,25,18,7,0.72,9,7,13,5,224.0,236.8,230.4
2019-12-11,1610612751,1610612766,2019,108.0,113.0,221.0,110.2,105.6,105.0,112.7,23,13,10,0.565,26,10,16,0.385,7,6,6,4,209.2,215.0,212.1
2019-12-11,1610612741,1610612737,2019,136.0,102.0,238.0,102.5,106.7,113.8,120.4,25,8,17,0.32,24,6,18,0.25,4,4,3,3,204.6,233.2,218.89999999999998
2019-12-11,1610612750,1610612762,2019,116.0,127.0,243.0,110.9,120.8,108.0,113.6,23,10,13,0.435,24,13,11,0.542,3,7,9,4,220.2,223.8,222.0
2019-12-11,1610612756,1610612763,2019,108.0,115.0,223.0,115.1,118.7,107.0,113.1,23,11,12,0.478,23,7,16,0.304,6,5,3,4,233.6,216.8,225.2
2019-12-11,1610612749,1610612740,2019,127.0,112.0,239.0,120.7,100.2,108.7,120.5,24,21,3,0.875,24,6,18,0.25,11,10,4,2,217.4,225.8,221.60000000000002
2019-12-11,1610612758,1610612760,2019,94.0,93.0,187.0,107.3,107.7,114.0,111.0,23,10,13,0.435,23,11,12,0.478,5,5,7,4,211.4,237.8,224.60000000000002
2019-12-11,1610612744,1610612752,2019,122.0,124.0,246.0,98.2,105.7,97.4,115.2,25,5,20,0.2,24,4,20,0.16699999999999998,2,3,3,1,207.6,209.0,208.3
2019-12-10,1610612766,1610612764,2019,114.0,107.0,221.0,103.8,112.1,116.4,124.2,25,9,16,0.36,22,7,15,0.318,5,4,4,3,211.4,239.0,225.2
2019-12-10,1610612755,1610612743,2019,97.0,92.0,189.0,111.3,103.6,108.4,101.9,24,17,7,0.708,21,14,7,0.667,12,5,8,6,213.8,206.0,209.9
2019-12-10,1610612748,1610612737,2019,135.0,121.0,256.0,110.2,107.1,112.0,119.7,23,17,6,0.7390000000000001,23,6,17,0.261,10,7,3,3,219.6,233.2,226.39999999999998
2019-12-10,1610612757,1610612752,2019,115.0,87.0,202.0,113.0,115.5,99.3,113.9,24,9,15,0.375,23,4,19,0.174,4,5,3,1,232.2,209.0,220.6
2019-12-09,1610612754,1610612746,2019,99.0,110.0,209.0,109.1,106.2,118.8,111.7,23,15,8,0.652,24,17,7,0.708,9,6,13,4,214.8,236.8,225.8
2019-12-09,1610612738,1610612739,2019,110.0,88.0,198.0,109.9,103.7,99.8,119.2,21,16,5,0.762,22,5,17,0.227,9,7,3,2,223.4,212.8,218.10000000000002
2019-12-09,1610612741,1610612761,2019,92.0,93.0,185.0,104.2,106.3,110.5,106.9,24,8,16,0.333,22,15,7,0.682,4,4,9,6,207.2,224.0,215.6
2019-12-09,1610612745,1610612758,2019,118.0,119.0,237.0,123.6,114.9,105.6,106.2,22,15,7,0.682,22,9,13,0.409,9,6,5,4,243.6,211.4,227.5
2019-12-09,1610612749,1610612753,2019,110.0,101.0,211.0,121.9,101.9,107.7,105.5,23,20,3,0.87,22,11,11,0.5,10,10,8,3,223.2,215.4,219.3
2019-12-09,1610612740,1610612765,2019,103.0,105.0,208.0,109.9,120.4,106.6,104.2,23,6,17,0.261,23,9,14,0.391,4,2,7,2,228.0,215.4,221.7
2019-12-09,1610612756,1610612750,2019,125.0,109.0,234.0,115.4,119.0,112.5,119.6,22,10,12,0.455,22,10,12,0.455,5,5,3,7,234.8,220.2,227.5
2019-12-09,1610612762,1610612760,2019,90.0,104.0,194.0,109.2,114.4,114.3,113.2,23,13,10,0.565,22,10,12,0.455,9,4,7,3,227.8,237.8,232.8
2019-12-09,1610612744,1610612763,2019,102.0,110.0,212.0,100.7,106.5,107.9,114.6,24,5,19,0.208,22,6,16,0.273,2,3,3,3,214.2,216.8,215.5
2019-12-08,1610612751,1610612743,2019,105.0,102.0,207.0,108.3,106.9,108.2,101.2,22,12,10,0.545,20,14,6,0.7,6,6,8,6,208.0,206.0,207.0
2019-12-08,1610612766,1610612737,2019,107.0,122.0,229.0,104.6,111.5,109.9,121.2,24,9,15,0.375,22,5,17,0.227,5,4,3,2,211.8,233.2,222.5
2019-12-08,1610612748,1610612741,2019,110.0,105.0,215.0,110.1,106.0,105.2,107.7,22,16,6,0.727,23,8,15,0.348,9,7,4,4,217.2,207.2,212.2
2019-12-08,1610612755,1610612761,2019,110.0,104.0,214.0,111.6,101.8,108.9,105.7,23,16,7,0.696,21,15,6,0.7140000000000001,11,5,9,6,210.8,224.0,217.4
2019-12-08,1610612764,1610612746,2019,119.0,135.0,254.0,118.3,123.9,118.0,113.0,21,7,14,0.333,23,16,7,0.696,4,3,13,3,242.2,236.8,239.5
2019-12-08,1610612742,1610612758,2019,106.0,110.0,216.0,122.7,104.6,105.9,106.2,22,16,6,0.727,21,8,13,0.381,8,8,5,3,228.4,211.4,219.9
2019-12-08,1610612757,1610612760,2019,96.0,108.0,204.0,114.0,116.1,112.3,112.6,23,9,14,0.391,21,9,12,0.429,4,5,7,2,235.4,237.8,236.60000000000002
2019-12-08,1610612747,1610612750,2019,142.0,125.0,267.0,114.8,104.1,111.2,115.6,23,20,3,0.87,21,10,11,0.476,9,11,3,7,216.0,220.2,218.1
2019-12-07,1610612742,1610612740,2019,130.0,84.0,214.0,121.4,107.2,110.9,118.3,21,15,6,0.7140000000000001,22,6,16,0.273,7,8,4,2,231.0,228.0,229.5
2019-12-07,1610612752,1610612754,2019,103.0,104.0,207.0,99.4,114.6,110.2,104.5,22,4,18,0.182,22,14,8,0.636,3,1,9,5,210.6,214.8,212.7
2019-12-07,1610612755,1610612739,2019,141.0,94.0,235.0,109.0,102.8,101.2,113.8,22,15,7,0.682,21,5,16,0.238,10,5,3,2,207.6,212.8,210.2
2019-12-07,1610612745,1610612756,2019,115.0,109.0,224.0,123.2,114.2,114.5,117.3,21,14,7,0.667,21,10,11,0.476,8,6,5,5,241.4,234.8,238.10000000000002
2019-12-07,1610612762,1610612763,2019,126.0,112.0,238.0,108.5,114.6,108.0,112.9,22,12,10,0.545,21,6,15,0.28600000000000003,8,4,3,3,226.8,216.8,221.8
2019-12-06,1610612766,1610612751,2019,104.0,111.0,215.0,105.1,111.0,108.9,107.6,23,9,14,0.391,21,11,10,0.524,5,4,6,5,211.8,208.0,209.9
2019-12-06,1610612739,1610612753,2019,87.0,93.0,180.0,103.5,114.9,108.1,108.1,20,5,15,0.25,21,10,11,0.476,3,2,8,2,219.6,215.4,217.5
2019-12-06,1610612765,1610612754,2019,108.0,101.0,209.0,108.6,104.4,110.3,104.8,22,8,14,0.364,21,14,7,0.667,6,2,9,5,219.8,214.8,217.3
2019-12-06,1610612738,1610612743,2019,108.0,95.0,203.0,110.7,104.8,107.8,99.1,20,15,5,0.75,19,14,5,0.737,8,7,8,6,227.2,206.0,216.6
2019-12-06,1610612748,1610612764,2019,112.0,103.0,215.0,110.6,106.5,120.1,125.2,21,15,6,0.7140000000000001,20,7,13,0.35,8,7,4,3,219.2,242.2,230.7
2019-12-06,1610612741,1610612744,2019,98.0,100.0,198.0,105.5,109.2,101.6,108.0,22,8,14,0.364,23,4,19,0.174,4,4,2,2,210.8,214.2,212.5
2019-12-06,1610612760,1610612750,2019,139.0,127.0,266.0,110.3,112.0,110.5,113.1,20,8,12,0.4,20,10,10,0.5,6,2,3,7,232.6,220.2,226.39999999999998
2019-12-06,1610612749,1610612746,2019,119.0,91.0,210.0,120.4,101.8,118.2,111.3,22,19,3,0.8640000000000001,22,16,6,0.727,9,10,13,3,220.0,236.8,228.4
2019-12-06,1610612759,1610612758,2019,105.0,104.0,209.0,111.8,118.4,105.2,107.3,22,8,14,0.364,20,8,12,0.4,6,2,5,3,228.2,211.4,219.8
2019-12-06,1610612757,1610612747,2019,113.0,136.0,249.0,115.1,113.8,112.1,103.6,22,9,13,0.409,22,19,3,0.8640000000000001,4,5,9,10,233.0,216.0,224.5
2019-12-05,1610612764,1610612755,2019,119.0,113.0,232.0,118.2,125.2,107.4,102.1,19,6,13,0.316,21,15,6,0.7140000000000001,3,3,10,5,238.4,207.6,223.0
2019-12-05,1610612752,1610612743,2019,92.0,129.0,221.0,102.5,112.2,105.6,102.1,21,4,17,0.19,18,13,5,0.722,3,1,8,5,212.0,206.0,209.0
2019-12-05,1610612761,1610612745,2019,109.0,119.0,228.0,109.3,103.5,123.5,114.9,20,15,5,0.75,20,13,7,0.65,9,6,8,5,220.4,241.4,230.9
2019-12-05,1610612740,1610612756,2019,132.0,139.0,271.0,108.5,114.4,112.2,116.1,21,6,15,0.28600000000000003,20,9,11,0.45,4,2,5,4,215.4,234.8,225.10000000000002
2019-12-04,1610612766,1610612744,2019,106.0,91.0,197.0,106.2,113.8,101.9,111.6,22,8,14,0.364,22,4,18,0.182,4,4,2,2,219.6,214.2,216.89999999999998
2019-12-04,1610612765,1610612749,2019,103.0,127.0,230.0,109.7,103.7,119.8,103.4,21,8,13,0.381,21,18,3,0.857,6,2,9,9,220.6,220.0,220.3
2019-12-04,1610612753,1610612756,2019,128.0,114.0,242.0,106.5,106.4,112.2,113.8,20,9,11,0.45,19,9,10,0.474,7,2,5,4,208.8,234.8,221.8
2019-12-04,1610612737,1610612751,2019,118.0,130.0,248.0,109.0,120.3,105.2,105.9,21,5,16,0.238,20,10,10,0.5,3,2,6,4,229.6,208.0,218.8
2019-12-04,1610612738,1610612748,2019,112.0,93.0,205.0,109.9,105.7,112.9,106.1,19,14,5,0.737,20,15,5,0.75,7,7,8,7,227.4,219.2,223.3
2019-12-04,1610612741,1610612763,2019,106.0,99.0,205.0,106.0,111.0,106.7,114.1,21,7,14,0.333,20,6,14,0.3,3,4,3,3,215.4,216.8,216.10000000000002
2019-12-04,1610612760,1610612754,2019,100.0,107.0,207.0,111.7,112.1,110.5,105.0,19,8,11,0.421,20,13,7,0.65,6,2,9,4,235.6,214.8,225.2
2019-12-04,1610612742,1610612750,2019,121.0,114.0,235.0,120.3,106.0,111.2,114.7,20,14,6,0.7,19,10,9,0.526,6,8,3,7,226.4,220.2,223.3
2019-12-04,1610612762,1610612747,2019,96.0,121.0,217.0,109.2,112.5,113.0,106.7,21,12,9,0.5710000000000001,21,18,3,0.857,8,4,9,9,224.0,216.0,220.0
2019-12-04,1610612757,1610612758,2019,127.0,116.0,243.0,113.9,114.1,103.3,104.5,21,8,13,0.381,19,8,11,0.421,3,5,5,3,231.2,211.4,221.3
2019-12-03,1610612739,1610612765,2019,94.0,127.0,221.0,103.6,113.6,107.8,106.0,19,5,14,0.263,20,7,13,0.35,3,2,6,1,217.2,220.6,218.89999999999998
2019-12-03,1610612764,1610612753,2019,120.0,127.0,247.0,117.7,122.4,104.4,105.1,18,6,12,0.333,19,8,11,0.421,3,3,7,1,231.8,208.8,220.3
2019-12-03,1610612761,1610612748,2019,110.0,121.0,231.0,111.5,101.0,111.6,104.8,19,15,4,0.789,19,14,5,0.737,9,6,8,6,219.8,219.2,219.5
2019-12-03,1610612740,1610612742,2019,97.0,118.0,215.0,112.0,115.3,119.1,107.9,20,6,14,0.3,19,13,6,0.684,4,2,6,7,224.2,226.4,225.3
2019-12-03,1610612759,1610612745,2019,135.0,133.0,268.0,109.2,116.4,121.9,110.8,21,7,14,0.333,19,13,6,0.684,5,2,8,5,219.0,241.4,230.2
2019-12-03,1610612743,1610612747,2019,96.0,105.0,201.0,106.1,100.9,114.8,108.6,17,13,4,0.765,20,17,3,0.85,8,5,9,8,204.6,216.0,210.3
2019-12-03,1610612746,1610612757,2019,117.0,97.0,214.0,115.5,110.4,115.0,115.6,21,15,6,0.7140000000000001,20,8,12,0.4,12,3,3,5,229.6,231.2,230.39999999999998
2019-12-02,1610612766,1610612756,2019,104.0,109.0,213.0,106.8,114.4,113.4,114.4,21,8,13,0.381,18,8,10,0.444,4,4,5,3,222.0,234.8,228.4
2019-12-02,1610612755,1610612762,2019,103.0,94.0,197.0,108.0,103.1,110.1,111.7,20,14,6,0.7,20,12,8,0.6,9,5,8,4,210.8,224.0,217.4
2019-12-02,1610612737,1610612744,2019,104.0,79.0,183.0,107.9,123.7,105.4,110.7,20,4,16,0.2,21,4,17,0.19,2,2,2,2,234.2,214.2,224.2
2019-12-02,1610612763,1610612754,2019,104.0,117.0,221.0,107.7,115.5,110.8,106.8,19,6,13,0.316,19,12,7,0.632,3,3,9,3,221.6,214.8,218.2
2019-12-02,1610612749,1610612752,2019,132.0,88.0,220.0,120.3,107.5,103.9,111.2,20,17,3,0.85,20,4,16,0.2,8,9,3,1,229.2,212.0,220.6
2019-12-02,1610612758,1610612741,2019,106.0,113.0,219.0,102.9,103.3,106.0,109.7,18,8,10,0.444,20,6,14,0.3,5,3,3,3,208.2,215.4,211.8
2019-12-01,1610612751,1610612748,2019,106.0,109.0,215.0,108.1,107.5,108.7,103.7,19,10,9,0.526,18,13,5,0.722,6,4,8,5,217.0,219.2,218.1
2019-12-01,1610612752,1610612738,2019,104.0,113.0,217.0,103.7,110.2,108.5,105.3,19,4,15,0.211,18,13,5,0.722,3,1,7,6,209.6,227.4,218.5
2019-12-01,1610612750,1610612763,2019,107.0,115.0,222.0,113.4,114.6,105.3,116.8,18,10,8,0.556,18,5,13,0.278,3,7,3,2,224.4,221.6,223.0
2019-12-01,1610612747,1610612742,2019,100.0,114.0,214.0,116.8,106.6,121.5,110.1,19,17,2,0.895,18,12,6,0.667,9,8,6,6,216.0,226.4,221.2
2019-12-01,1610612765,1610612759,2019,132.0,98.0,230.0,106.8,106.4,110.3,114.3,19,6,13,0.316,20,7,13,0.35,5,1,5,2,219.4,219.0,219.2
2019-12-01,1610612740,1610612760,2019,104.0,107.0,211.0,113.2,116.8,109.5,112.8,19,6,13,0.316,18,7,11,0.389,4,2,6,1,229.6,235.6,232.6
2019-12-01,1610612753,1610612744,2019,100.0,96.0,196.0,104.6,106.4,105.8,111.5,18,7,11,0.389,20,4,16,0.2,6,1,2,2,211.8,214.2,213.0
2019-12-01,1610612761,1610612762,2019,130.0,110.0,240.0,110.9,102.0,109.7,109.4,18,14,4,0.778,19,12,7,0.632,8,6,8,4,220.6,224.0,222.3
2019-12-01,1610612746,1610612764,2019,150.0,125.0,275.0,115.5,108.0,118.9,119.0,20,14,6,0.7,17,6,11,0.353,11,3,3,3,224.8,231.8,228.3
2019-11-30,1610612758,1610612743,2019,100.0,97.0,197.0,104.0,105.4,106.5,100.3,17,7,10,0.412,16,13,3,0.813,4,3,8,5,214.6,204.6,209.6
2019-11-30,1610612755,1610612754,2019,119.0,116.0,235.0,105.9,101.2,111.0,105.7,19,13,6,0.684,18,12,6,0.667,8,5,9,3,202.8,214.8,208.8
2019-11-30,1610612745,1610612737,2019,158.0,111.0,269.0,116.3,109.0,106.9,122.9,18,12,6,0.667,19,4,15,0.211,7,5,2,2,226.6,234.2,230.39999999999998
2019-11-30,1610612749,1610612766,2019,137.0,96.0,233.0,119.0,109.4,106.8,113.9,19,16,3,0.8420000000000001,20,8,12,0.4,7,9,4,4,230.4,222.0,226.2
2019-11-29,1610612751,1610612738,2019,112.0,107.0,219.0,109.2,108.4,108.3,104.1,18,9,9,0.5,17,13,4,0.765,5,4,7,6,221.0,227.4,224.2
2019-11-29,1610612765,1610612766,2019,107.0,110.0,217.0,107.4,106.3,106.1,113.4,18,6,12,0.333,19,7,12,0.368,5,1,4,3,220.4,222.0,221.2
2019-11-29,1610612753,1610612761,2019,83.0,90.0,173.0,108.1,106.0,113.2,104.1,17,7,10,0.412,17,13,4,0.765,6,1,8,5,218.0,220.6,219.3
2019-11-29,1610612739,1610612749,2019,110.0,119.0,229.0,102.3,112.5,117.1,108.7,18,5,13,0.278,18,15,3,0.833,3,2,7,8,212.4,230.4,221.4
2019-11-29,1610612752,1610612755,2019,95.0,101.0,196.0,104.8,110.4,105.5,101.7,18,4,14,0.222,18,12,6,0.667,3,1,8,4,212.2,202.8,207.5
2019-11-29,1610612754,1610612737,2019,105.0,104.0,209.0,111.6,103.8,107.7,125.2,17,11,6,0.647,18,4,14,0.222,8,3,2,2,212.2,234.2,223.2
2019-11-29,1610612748,1610612744,2019,122.0,105.0,227.0,109.4,103.2,104.7,111.3,17,12,5,0.706,19,4,15,0.211,7,5,2,2,219.6,214.2,216.89999999999998
2019-11-29,1610612763,1610612762,2019,94.0,103.0,197.0,106.6,117.1,111.6,110.8,17,5,12,0.294,18,11,7,0.611,3,2,8,3,224.8,224.0,224.4
2019-11-29,1610612760,1610612740,2019,109.0,104.0,213.0,108.8,111.8,114.3,116.9,17,6,11,0.353,18,6,12,0.333,5,1,4,2,232.2,229.6,230.89999999999998
2019-11-29,1610612759,1610612746,2019,107.0,97.0,204.0,111.1,118.1,115.4,108.3,19,6,13,0.316,19,14,5,0.737,4,2,11,3,228.2,224.8,226.5
2019-11-29,1610612756,1610612742,2019,113.0,120.0,233.0,113.6,114.7,122.6,109.9,17,8,9,0.471,17,11,6,0.647,5,3,6,5,235.8,226.4,231.10000000000002
2019-11-29,1610612757,1610612741,2019,107.0,103.0,210.0,117.1,118.2,105.2,109.8,19,7,12,0.368,19,6,13,0.316,2,5,3,3,240.6,215.4,228.0
2019-11-29,1610612747,1610612764,2019,125.0,103.0,228.0,114.7,107.6,121.9,120.5,18,16,2,0.889,16,6,10,0.375,8,8,3,3,213.8,231.8,222.8
2019-11-27,1610612738,1610612751,2019,121.0,110.0,231.0,107.8,103.6,109.6,108.2,16,12,4,0.75,17,9,8,0.529,6,6,5,4,225.4,221.0,223.2
2019-11-27,1610612766,1610612765,2019,102.0,101.0,203.0,104.6,114.1,107.9,107.3,18,6,12,0.333,17,6,11,0.353,3,3,5,1,220.4,220.4,220.4
2019-11-27,1610612739,1610612753,2019,104.0,116.0,220.0,103.2,112.8,105.9,105.8,17,5,12,0.294,16,6,10,0.375,3,2,6,0,214.8,218.0,216.4
2019-11-27,1610612754,1610612762,2019,121.0,102.0,223.0,110.7,104.2,110.8,109.2,16,10,6,0.625,17,11,6,0.647,7,3,8,3,211.2,224.0,217.6
2019-11-27,1610612755,1610612758,2019,97.0,91.0,188.0,107.2,103.2,107.0,106.6,17,11,6,0.647,16,7,9,0.438,7,4,4,3,209.2,214.6,211.89999999999998
2019-11-27,1610612761,1610612752,2019,126.0,98.0,224.0,113.1,105.6,105.2,108.2,16,12,4,0.75,17,4,13,0.235,7,5,3,1,223.4,212.2,217.8
2019-11-27,1610612745,1610612748,2019,117.0,108.0,225.0,117.5,109.4,111.0,102.3,17,11,6,0.647,16,12,4,0.75,6,5,7,5,229.8,219.6,224.7
2019-11-27,1610612763,1610612746,2019,119.0,121.0,240.0,106.9,118.8,115.5,109.4,16,5,11,0.313,18,13,5,0.722,3,2,11,2,228.8,224.8,226.8
2019-11-27,1610612749,1610612737,2019,111.0,102.0,213.0,117.5,109.0,110.0,126.2,17,14,3,0.8240000000000001,17,4,13,0.235,6,8,2,2,231.8,234.2,233.0
2019-11-27,1610612759,1610612750,2019,101.0,113.0,214.0,113.1,118.0,115.2,115.4,18,6,12,0.333,17,9,8,0.529,4,2,3,6,232.0,224.4,228.2
2019-11-27,1610612756,1610612764,2019,132.0,140.0,272.0,114.2,111.9,118.5,119.4,16,8,8,0.5,15,5,10,0.333,5,3,3,2,231.4,231.8,231.60000000000002
2019-11-27,1610612740,1610612747,2019,110.0,114.0,224.0,113.7,117.7,115.1,107.8,17,6,11,0.353,17,15,2,0.882,4,2,8,7,230.0,213.8,221.9
2019-11-27,1610612757,1610612760,2019,136.0,119.0,255.0,113.5,117.1,108.1,110.3,18,6,12,0.333,16,6,10,0.375,1,5,5,1,231.2,232.2,231.7
2019-11-27,1610612744,1610612741,2019,104.0,90.0,194.0,103.0,111.6,107.3,111.1,18,3,15,0.16699999999999998,18,6,12,0.333,1,2,3,3,211.4,215.4,213.4
2019-11-26,1610612742,1610612746,2019,99.0,114.0,213.0,122.9,109.1,118.2,111.7,16,11,5,0.688,17,12,5,0.706,6,5,11,1,225.4,224.8,225.10000000000002
2019-11-26,1610612743,1610612764,2019,117.0,104.0,221.0,106.9,102.4,120.3,120.1,15,12,3,0.8,14,5,9,0.35700000000000004,7,5,3,2,209.6,231.8,220.7
2019-11-25,1610612739,1610612751,2019,106.0,108.0,214.0,103.7,115.1,110.0,111.4,16,5,11,0.313,16,8,8,0.5,3,2,5,3,220.4,221.0,220.7
2019-11-25,1610612765,1610612753,2019,103.0,88.0,191.0,107.2,107.9,106.6,105.9,16,5,11,0.313,15,6,9,0.4,4,1,6,0,220.2,218.0,219.1
2019-11-25,1610612754,1610612763,2019,126.0,114.0,240.0,110.2,103.4,105.6,118.2,15,9,6,0.6,15,5,10,0.333,6,3,3,2,208.6,228.8,218.7
2019-11-25,1610612737,1610612750,2019,113.0,125.0,238.0,109.5,123.7,112.2,115.8,16,4,12,0.25,16,8,8,0.5,2,2,3,5,228.2,224.4,226.3
2019-11-25,1610612738,1610612758,2019,103.0,102.0,205.0,108.7,104.0,108.8,108.7,15,11,4,0.733,15,7,8,0.467,5,6,4,3,228.0,214.6,221.3
2019-11-25,1610612748,1610612766,2019,117.0,100.0,217.0,110.5,102.0,105.2,113.8,15,11,4,0.733,17,6,11,0.353,6,5,3,3,218.0,220.4,219.2
2019-11-25,1610612761,1610612755,2019,101.0,96.0,197.0,113.4,105.5,108.0,103.7,15,11,4,0.733,16,11,5,0.688,6,5,7,4,223.8,209.2,216.5
2019-11-25,1610612741,1610612757,2019,94.0,117.0,211.0,109.9,109.6,113.9,119.3,17,6,11,0.353,17,5,12,0.294,3,3,1,4,217.6,231.2,224.39999999999998
2019-11-25,1610612749,1610612762,2019,122.0,118.0,240.0,118.2,108.4,109.1,107.2,16,13,3,0.813,16,11,5,0.688,5,8,8,3,232.0,224.0,228.0
2019-11-25,1610612759,1610612747,2019,104.0,114.0,218.0,112.3,116.9,114.0,107.0,17,6,11,0.353,16,14,2,0.875,4,2,8,6,228.2,213.8,221.0
2019-11-25,1610612744,1610612760,2019,97.0,100.0,197.0,104.3,114.3,109.3,112.2,17,3,14,0.17600000000000002,15,5,10,0.333,1,2,5,0,219.4,232.2,225.8
2019-11-24,1610612745,1610612742,2019,123.0,137.0,260.0,116.8,106.9,120.1,107.4,16,11,5,0.688,15,10,5,0.667,6,5,6,4,223.4,225.4,224.4
2019-11-24,1610612752,1610612751,2019,101.0,103.0,204.0,103.8,108.7,111.6,112.8,16,4,12,0.25,15,7,8,0.467,3,1,5,2,210.4,221.0,215.7
2019-11-24,1610612764,1610612758,2019,106.0,113.0,219.0,120.6,121.9,108.8,107.3,13,5,8,0.385,14,6,8,0.429,3,2,4,2,236.0,214.6,225.3
2019-11-24,1610612743,1610612756,2019,116.0,104.0,220.0,105.3,101.7,114.5,111.1,14,11,3,0.7859999999999999,15,8,7,0.5329999999999999,6,5,5,3,205.0,231.4,218.2
2019-11-24,1610612746,1610612740,2019,134.0,109.0,243.0,114.6,109.6,115.3,117.8,16,11,5,0.688,16,6,10,0.375,10,1,4,2,213.4,230.0,221.7
2019-11-23,1610612750,1610612756,2019,98.0,100.0,198.0,112.2,115.8,117.9,113.1,15,8,7,0.5329999999999999,14,7,7,0.5,3,5,5,2,224.4,231.4,227.9
2019-11-23,1610612766,1610612741,2019,115.0,116.0,231.0,105.9,114.2,108.1,108.6,16,6,10,0.375,16,5,11,0.313,3,3,3,2,222.6,217.6,220.1
2019-11-23,1610612754,1610612753,2019,111.0,106.0,217.0,109.9,102.3,105.9,105.1,14,8,6,0.5710000000000001,14,6,8,0.429,5,3,6,0,205.8,218.0,211.9
2019-11-23,1610612737,1610612761,2019,116.0,119.0,235.0,107.6,122.4,113.7,104.3,15,4,11,0.267,14,10,4,0.7140000000000001,2,2,6,4,221.8,223.8,222.8
2019-11-23,1610612752,1610612759,2019,104.0,111.0,215.0,102.6,108.9,112.6,119.4,15,4,11,0.267,16,5,11,0.313,3,1,4,1,208.4,228.2,218.3
2019-11-23,1610612755,1610612748,2019,113.0,86.0,199.0,108.4,104.6,110.8,101.6,15,10,5,0.667,14,11,3,0.7859999999999999,6,4,6,5,211.8,218.0,214.9
2019-11-23,1610612739,1610612757,2019,110.0,104.0,214.0,104.4,115.8,113.4,119.0,15,4,11,0.267,16,5,11,0.313,2,2,1,4,223.2,231.2,227.2
2019-11-23,1610612763,1610612747,2019,108.0,109.0,217.0,108.5,119.4,115.0,107.2,14,5,9,0.35700000000000004,15,13,2,0.867,3,2,8,5,237.0,213.8,225.4
2019-11-23,1610612749,1610612765,2019,104.0,90.0,194.0,120.4,112.5,108.1,109.0,15,12,3,0.8,15,5,10,0.333,4,8,4,1,244.6,220.2,232.39999999999998
2019-11-23,1610612762,1610612740,2019,128.0,120.0,248.0,106.9,105.6,113.7,116.5,15,10,5,0.667,15,6,9,0.4,7,3,4,2,216.4,230.0,223.2
2019-11-22,1610612765,1610612737,2019,128.0,103.0,231.0,106.4,110.4,108.6,122.0,14,4,10,0.28600000000000003,14,4,10,0.28600000000000003,3,1,2,2,219.6,221.8,220.7
2019-11-22,1610612764,1610612766,2019,125.0,118.0,243.0,123.9,126.0,103.4,110.4,12,4,8,0.333,15,6,9,0.4,2,2,3,3,250.8,222.6,236.7
2019-11-22,1610612751,1610612758,2019,116.0,97.0,213.0,110.8,114.9,107.2,107.0,14,6,8,0.429,13,6,7,0.462,4,2,4,2,223.6,214.6,219.1
2019-11-22,1610612755,1610612759,2019,115.0,104.0,219.0,107.6,103.5,112.2,118.7,14,9,5,0.643,15,5,10,0.333,5,4,4,1,208.0,228.2,218.1
2019-11-22,1610612741,1610612748,2019,108.0,116.0,224.0,106.7,108.7,109.8,100.5,15,5,10,0.333,13,10,3,0.769,3,2,6,4,215.0,218.0,216.5
2019-11-22,1610612760,1610612747,2019,127.0,130.0,257.0,108.1,109.6,112.2,105.7,14,5,9,0.35700000000000004,14,12,2,0.857,5,0,8,4,224.6,213.8,219.2
2019-11-22,1610612742,1610612739,2019,143.0,101.0,244.0,116.5,107.9,105.6,111.5,14,9,5,0.643,14,4,10,0.28600000000000003,5,4,2,2,219.2,223.2,221.2
2019-11-22,1610612743,1610612738,2019,96.0,92.0,188.0,106.6,101.4,113.0,105.9,13,10,3,0.769,14,11,3,0.7859999999999999,5,5,5,6,207.0,228.0,217.5
2019-11-22,1610612762,1610612744,2019,113.0,109.0,222.0,106.6,104.3,104.2,114.4,14,9,5,0.643,16,3,13,0.188,6,3,1,2,213.2,219.4,216.3
2019-11-22,1610612746,1610612745,2019,122.0,119.0,241.0,113.1,107.8,115.6,104.7,15,10,5,0.667,15,11,4,0.733,9,1,6,5,206.8,223.4,215.10000000000002
2019-11-21,1610612749,1610612757,2019,137.0,129.0,266.0,118.5,109.2,110.6,116.0,14,11,3,0.7859999999999999,15,5,10,0.333,3,8,1,4,234.2,231.2,232.7
2019-11-21,1610612756,1610612740,2019,121.0,124.0,245.0,116.6,113.1,113.6,117.0,13,7,6,0.5379999999999999,14,5,9,0.35700000000000004,5,2,4,1,228.8,230.0,229.4
2019-11-20,1610612755,1610612752,2019,109.0,104.0,213.0,106.0,104.3,100.5,107.5,13,8,5,0.615,14,4,10,0.28600000000000003,4,4,3,1,206.4,208.4,207.4
2019-11-20,1610612764,1610612759,2019,138.0,132.0,270.0,120.9,124.3,111.7,115.9,11,3,8,0.273,14,5,9,0.35700000000000004,1,2,4,1,241.4,228.2,234.8
2019-11-20,1610612737,1610612749,2019,127.0,135.0,262.0,106.2,119.0,117.9,108.9,13,4,9,0.308,13,10,3,0.769,2,2,3,7,211.0,234.2,222.6
2019-11-20,1610612751,1610612766,2019,101.0,91.0,192.0,112.0,116.7,106.1,111.4,13,5,8,0.385,14,6,8,0.429,3,2,3,3,229.6,222.6,226.1
2019-11-20,1610612748,1610612739,2019,124.0,100.0,224.0,109.4,100.6,105.1,109.3,12,9,3,0.75,13,4,9,0.308,5,4,2,2,217.4,223.2,220.3
2019-11-20,1610612761,1610612753,2019,113.0,97.0,210.0,115.4,106.8,105.9,102.6,13,9,4,0.6920000000000001,13,6,7,0.462,5,4,6,0,232.2,218.0,225.1
2019-11-20,1610612742,1610612744,2019,142.0,94.0,236.0,113.3,110.4,106.7,112.7,13,8,5,0.615,15,3,12,0.2,4,4,1,2,217.8,219.4,218.60000000000002
2019-11-20,1610612741,1610612765,2019,109.0,89.0,198.0,107.0,111.6,108.1,110.7,14,4,10,0.28600000000000003,13,4,9,0.308,2,2,3,1,221.4,219.6,220.5
2019-11-20,1610612750,1610612762,2019,95.0,103.0,198.0,115.2,117.4,105.9,104.3,14,8,6,0.5710000000000001,13,8,5,0.615,3,5,6,2,233.6,213.2,223.39999999999998
2019-11-20,1610612743,1610612745,2019,105.0,95.0,200.0,106.7,102.8,116.1,107.1,12,9,3,0.75,14,11,3,0.7859999999999999,4,5,6,5,210.0,223.4,216.7
2019-11-20,1610612746,1610612738,2019,107.0,104.0,211.0,114.8,110.3,113.4,103.9,14,9,5,0.643,13,11,2,0.846,8,1,5,6,215.2,228.0,221.6
2019-11-19,1610612763,1610612744,2019,95.0,114.0,209.0,109.0,118.7,106.5,116.1,13,5,8,0.385,14,2,12,0.14300000000000002,3,2,1,1,236.6,219.4,228.0
2019-11-19,1610612740,1610612757,2019,115.0,104.0,219.0,114.3,117.3,112.0,117.2,13,4,9,0.308,14,5,9,0.35700000000000004,3,1,1,4,232.0,231.2,231.6
2019-11-19,1610612758,1610612756,2019,120.0,116.0,236.0,104.6,105.5,113.8,111.6,12,5,7,0.417,12,7,5,0.583,3,2,5,2,206.4,228.8,217.60000000000002
2019-11-19,1610612747,1610612760,2019,112.0,107.0,219.0,110.5,103.0,106.9,108.4,13,11,2,0.846,13,5,8,0.385,7,4,5,0,205.0,224.6,214.8
2019-11-18,1610612752,1610612739,2019,123.0,105.0,228.0,98.7,106.8,105.8,109.9,13,3,10,0.231,12,4,8,0.333,2,1,2,2,203.4,223.2,213.3
2019-11-18,1610612751,1610612754,2019,86.0,115.0,201.0,116.0,117.9,107.8,103.3,12,5,7,0.417,13,7,6,0.5379999999999999,3,2,5,2,240.0,205.8,222.9
2019-11-18,1610612761,1610612766,2019,132.0,96.0,228.0,111.3,107.7,106.1,109.3,12,8,4,0.667,13,6,7,0.462,4,4,3,3,225.8,222.6,224.2
2019-11-18,1610612741,1610612749,2019,101.0,115.0,216.0,108.1,110.7,119.8,109.4,13,4,9,0.308,12,9,3,0.75,2,2,3,6,221.8,234.2,228.0
2019-11-18,1610612745,1610612757,2019,132.0,108.0,240.0,115.5,108.6,111.4,113.9,13,10,3,0.769,13,5,8,0.385,5,5,1,4,225.2,231.2,228.2
2019-11-18,1610612742,1610612759,2019,117.0,110.0,227.0,113.5,111.5,110.4,114.5,12,7,5,0.583,13,5,8,0.385,3,4,4,1,220.4,228.2,224.3
2019-11-18,1610612756,1610612738,2019,85.0,99.0,184.0,116.7,112.6,115.4,106.7,11,7,4,0.636,12,10,2,0.833,5,2,5,5,236.6,228.0,232.3
2019-11-18,1610612762,1610612750,2019,102.0,112.0,214.0,107.0,101.2,116.1,117.1,12,8,4,0.667,13,7,6,0.5379999999999999,6,2,3,4,209.2,233.6,221.39999999999998
2019-11-18,1610612746,1610612760,2019,90.0,88.0,178.0,116.3,110.9,105.1,110.1,13,8,5,0.615,12,5,7,0.417,7,1,5,0,219.4,224.6,222.0
2019-11-17,1610612739,1610612755,2019,95.0,114.0,209.0,107.3,108.4,105.5,106.2,11,4,7,0.364,12,7,5,0.583,2,2,4,3,223.2,206.4,214.8
2019-11-17,1610612758,1610612738,2019,100.0,99.0,199.0,105.8,107.8,117.3,106.2,11,4,7,0.364,11,10,1,0.909,2,2,5,5,213.4,228.0,220.7
2019-11-17,1610612753,1610612764,2019,125.0,121.0,246.0,102.1,99.6,118.5,120.3,12,5,7,0.417,10,3,7,0.3,5,0,1,2,204.4,241.4,222.9
2019-11-17,1610612763,1610612743,2019,114.0,131.0,245.0,108.1,117.0,104.4,101.4,12,5,7,0.417,11,8,3,0.727,3,2,4,4,231.4,210.0,220.7
2019-11-17,1610612740,1610612744,2019,108.0,100.0,208.0,115.8,120.7,109.9,117.6,12,3,9,0.25,13,2,11,0.154,2,1,1,1,241.8,219.4,230.60000000000002
2019-11-17,1610612747,1610612737,2019,122.0,101.0,223.0,110.3,102.0,105.8,118.0,12,10,2,0.833,12,4,8,0.333,6,4,2,2,202.6,211.0,206.8
2019-11-16,1610612741,1610612751,2019,111.0,117.0,228.0,105.4,109.8,115.2,118.1,12,4,8,0.333,11,4,7,0.364,2,2,3,1,214.6,240.0,227.3
2019-11-16,1610612754,1610612749,2019,83.0,102.0,185.0,109.7,102.6,121.9,110.2,12,7,5,0.583,11,8,3,0.727,5,2,3,5,208.2,234.2,221.2
2019-11-16,1610612752,1610612766,2019,102.0,103.0,205.0,98.0,108.3,105.9,111.1,12,3,9,0.25,12,5,7,0.417,2,1,3,2,205.0,222.6,213.8
2019-11-16,1610612748,1610612740,2019,109.0,94.0,203.0,111.8,105.6,118.6,122.8,11,8,3,0.727,11,3,8,0.273,4,4,2,1,232.2,241.8,237.0
2019-11-16,1610612750,1610612745,2019,105.0,125.0,230.0,116.2,118.0,114.6,110.4,12,7,5,0.583,12,9,3,0.75,3,4,5,4,235.6,225.2,230.39999999999998
2019-11-16,1610612742,1610612761,2019,110.0,102.0,212.0,113.3,111.3,111.6,108.2,11,6,5,0.545,11,8,3,0.727,2,4,4,4,219.6,225.8,222.7
2019-11-16,1610612759,1610612757,2019,116.0,121.0,237.0,110.1,113.4,110.3,113.6,12,5,7,0.417,12,4,8,0.333,4,1,1,3,225.4,231.2,228.3
2019-11-16,1610612746,1610612737,2019,150.0,101.0,251.0,111.6,110.5,107.4,113.0,12,7,5,0.583,11,4,7,0.364,6,1,2,2,209.2,211.0,210.1
2019-11-15,1610612766,1610612765,2019,109.0,106.0,215.0,104.9,112.6,108.8,112.3,11,4,7,0.364,12,4,8,0.333,2,2,3,1,223.6,219.6,221.6
2019-11-15,1610612753,1610612759,2019,111.0,109.0,220.0,100.1,101.0,112.0,113.7,11,4,7,0.364,11,5,6,0.455,4,0,4,1,203.2,225.4,214.3
2019-11-15,1610612745,1610612754,2019,111.0,102.0,213.0,114.6,111.9,109.4,102.5,11,8,3,0.727,11,7,4,0.636,4,4,5,2,228.2,208.2,218.2
2019-11-15,1610612763,1610612762,2019,107.0,106.0,213.0,110.8,119.7,105.0,100.0,11,4,7,0.364,11,8,3,0.727,2,2,6,2,242.2,209.2,225.7
2019-11-15,1610612750,1610612764,2019,116.0,137.0,253.0,116.2,115.2,114.8,119.5,11,7,4,0.636,9,2,7,0.222,3,4,1,1,230.0,241.4,235.7
2019-11-15,1610612760,1610612755,2019,127.0,119.0,246.0,102.3,108.4,106.5,106.3,11,4,7,0.364,11,7,4,0.636,4,0,4,3,215.6,206.4,211.0
2019-11-15,1610612744,1610612738,2019,100.0,105.0,205.0,110.9,119.2,116.1,106.9,12,2,10,0.16699999999999998,10,9,1,0.9,1,1,5,4,224.6,228.0,226.3
2019-11-15,1610612747,1610612758,2019,99.0,97.0,196.0,112.4,102.4,105.6,110.3,11,9,2,0.818,10,4,6,0.4,5,4,2,2,207.6,213.4,210.5
2019-11-14,1610612739,1610612748,2019,97.0,108.0,205.0,107.1,109.4,111.9,107.5,10,4,6,0.4,10,7,3,0.7,2,2,4,3,224.8,232.2,228.5
2019-11-14,1610612752,1610612742,2019,106.0,103.0,209.0,99.0,109.7,115.3,112.3,11,2,9,0.182,10,6,4,0.6,1,1,2,4,209.8,219.6,214.7
2019-11-14,1610612749,1610612741,2019,124.0,115.0,239.0,122.8,108.6,104.9,107.6,10,7,3,0.7,11,4,7,0.364,2,5,2,2,232.8,214.6,223.7
2019-11-14,1610612740,1610612746,2019,132.0,127.0,259.0,117.0,122.4,111.8,109.4,10,2,8,0.2,11,7,4,0.636,1,1,6,1,237.8,209.2,223.5
2019-11-14,1610612756,1610612737,2019,128.0,112.0,240.0,113.4,111.0,105.5,111.3,10,6,4,0.6,10,4,6,0.4,4,2,2,2,226.8,211.0,218.9
2019-11-14,1610612743,1610612751,2019,101.0,93.0,194.0,105.1,102.8,119.2,121.4,10,7,3,0.7,10,4,6,0.4,3,4,3,1,214.2,240.0,227.1
2019-11-13,1610612766,1610612763,2019,117.0,119.0,236.0,105.8,113.2,108.0,118.4,10,4,6,0.4,10,3,7,0.3,2,2,2,1,226.6,242.2,234.39999999999998
2019-11-13,1610612753,1610612755,2019,112.0,97.0,209.0,98.4,99.6,107.3,105.4,10,3,7,0.3,10,7,3,0.7,3,0,4,3,197.0,206.4,201.7
2019-11-13,1610612738,1610612764,2019,140.0,133.0,273.0,113.9,100.8,112.7,114.8,9,8,1,0.889,8,2,6,0.25,4,4,1,1,211.4,241.4,226.4
2019-11-13,1610612745,1610612746,2019,102.0,93.0,195.0,115.8,115.4,116.0,112.3,10,7,3,0.7,10,7,3,0.7,3,4,6,1,237.6,209.2,223.39999999999998
2019-11-13,1610612750,1610612759,2019,129.0,114.0,243.0,113.3,115.8,109.5,111.5,10,6,4,0.6,10,5,5,0.5,2,4,4,1,225.4,225.4,225.4
2019-11-13,1610612747,1610612744,2019,120.0,94.0,214.0,109.9,101.6,110.7,119.2,10,8,2,0.8,11,2,9,0.182,4,4,1,1,201.0,224.6,212.8
2019-11-13,1610612757,1610612761,2019,106.0,114.0,220.0,111.5,115.6,111.0,106.0,11,4,7,0.364,10,7,3,0.7,1,3,4,3,237.6,225.8,231.7
2019-11-12,1610612754,1610612760,2019,111.0,85.0,196.0,109.3,105.9,105.3,109.1,10,6,4,0.6,10,4,6,0.4,4,2,4,0,214.8,215.6,215.2
2019-11-12,1610612755,1610612739,2019,98.0,97.0,195.0,108.1,104.3,105.9,109.0,9,6,3,0.667,9,4,5,0.444,3,3,2,2,205.8,224.8,215.3
2019-11-12,1610612748,1610612765,2019,117.0,108.0,225.0,112.2,105.4,109.9,111.6,9,6,3,0.667,11,4,7,0.364,3,3,3,1,228.6,219.6,224.1
2019-11-12,1610612741,1610612752,2019,120.0,102.0,222.0,104.0,106.7,99.7,109.0,10,3,7,0.3,10,2,8,0.2,1,2,1,1,211.0,209.8,210.4
2019-11-12,1610612743,1610612737,2019,121.0,125.0,246.0,104.0,100.7,103.0,108.8,9,7,2,0.778,9,3,6,0.333,3,4,2,1,207.8,211.0,209.4
2019-11-12,1610612756,1610612747,2019,115.0,123.0,238.0,114.9,110.9,107.9,102.5,9,6,3,0.667,9,7,2,0.778,4,2,4,3,229.6,201.0,215.3
2019-11-12,1610612762,1610612751,2019,119.0,114.0,233.0,103.1,98.1,119.2,120.6,10,7,3,0.7,9,4,5,0.444,5,2,3,1,201.6,240.0,220.8
2019-11-12,1610612758,1610612757,2019,107.0,99.0,206.0,105.4,109.2,113.7,116.8,9,3,6,0.333,10,4,6,0.4,1,2,1,3,210.8,237.6,224.2
2019-11-11,1610612765,1610612750,2019,114.0,120.0,234.0,108.5,111.3,114.0,117.0,10,4,6,0.4,9,5,4,0.556,3,1,2,3,216.2,225.4,220.8
2019-11-11,1610612738,1610612742,2019,116.0,106.0,222.0,113.0,100.8,114.9,109.4,8,7,1,0.875,9,6,3,0.667,3,4,2,4,209.6,219.6,214.6
2019-11-11,1610612759,1610612763,2019,109.0,113.0,222.0,111.0,112.4,109.1,119.4,9,5,4,0.556,9,2,7,0.222,4,1,2,0,230.2,242.2,236.2
2019-11-11,1610612740,1610612745,2019,116.0,122.0,238.0,118.2,122.9,119.5,119.6,9,2,7,0.222,9,6,3,0.667,1,1,3,3,241.2,237.6,239.39999999999998
2019-11-11,1610612744,1610612762,2019,108.0,122.0,230.0,112.1,121.1,103.6,100.1,10,2,8,0.2,9,6,3,0.667,1,1,5,1,231.2,201.6,216.39999999999998
2019-11-11,1610612746,1610612761,2019,98.0,88.0,186.0,117.3,113.1,112.8,107.4,9,6,3,0.667,9,7,2,0.778,5,1,4,3,213.4,225.8,219.60000000000002
2019-11-10,1610612750,1610612743,2019,98.0,100.0,198.0,116.8,120.2,104.7,101.1,8,5,3,0.625,8,6,2,0.75,2,3,3,3,237.4,207.8,222.60000000000002
2019-11-10,1610612753,1610612754,2019,102.0,109.0,211.0,97.6,97.2,111.6,108.8,9,3,6,0.333,9,5,4,0.556,3,0,4,1,190.6,214.8,202.7
2019-11-10,1610612755,1610612766,2019,114.0,106.0,220.0,107.9,103.8,107.2,111.7,8,5,3,0.625,9,4,5,0.444,2,3,2,2,204.4,226.6,215.5
2019-11-10,1610612760,1610612749,2019,119.0,121.0,240.0,105.4,106.2,121.2,108.3,9,4,5,0.444,9,6,3,0.667,4,0,2,4,210.0,232.8,221.4
2019-11-10,1610612752,1610612739,2019,87.0,108.0,195.0,100.6,108.2,102.3,112.1,9,2,7,0.222,8,3,5,0.375,1,1,2,1,210.0,224.8,217.4
2019-11-10,1610612756,1610612751,2019,138.0,112.0,250.0,113.5,109.2,118.0,119.0,8,5,3,0.625,8,4,4,0.5,3,2,3,1,223.4,240.0,231.7
2019-11-10,1610612757,1610612737,2019,124.0,113.0,237.0,110.7,116.0,100.4,108.4,9,3,6,0.333,8,3,5,0.375,0,3,2,1,230.0,211.0,220.5
2019-11-10,1610612747,1610612761,2019,104.0,113.0,217.0,110.1,100.5,113.8,107.7,8,7,1,0.875,8,6,2,0.75,4,3,4,2,201.4,225.8,213.60000000000002
2019-11-09,1610612759,1610612738,2019,115.0,135.0,250.0,111.5,110.0,111.3,98.8,8,5,3,0.625,7,6,1,0.857,4,1,3,3,226.4,209.6,218.0
2019-11-09,1610612766,1610612740,2019,110.0,115.0,225.0,107.2,111.8,118.4,123.5,8,4,4,0.5,8,1,7,0.125,2,2,1,0,226.8,241.2,234.0
2019-11-09,1610612741,1610612745,2019,94.0,117.0,211.0,107.1,107.7,122.2,123.5,9,3,6,0.333,8,5,3,0.625,1,2,3,2,219.2,237.6,228.39999999999998
2019-11-09,1610612763,1610612742,2019,122.0,138.0,260.0,107.1,116.6,112.8,109.6,8,2,6,0.25,8,5,3,0.625,2,0,2,3,232.6,219.6,226.1
2019-11-09,1610612760,1610612744,2019,114.0,108.0,222.0,102.5,105.1,110.6,122.3,8,3,5,0.375,9,2,7,0.222,3,0,1,1,202.0,231.2,216.6
2019-11-08,1610612754,1610612765,2019,112.0,106.0,218.0,111.5,110.1,109.5,111.1,8,4,4,0.5,9,4,5,0.444,3,1,3,1,217.2,216.2,216.7
2019-11-08,1610612753,1610612763,2019,118.0,86.0,204.0,95.6,99.3,107.8,114.8,8,2,6,0.25,7,2,5,0.28600000000000003,2,0,2,0,190.8,232.6,211.7
2019-11-08,1610612764,1610612739,2019,100.0,113.0,213.0,112.6,113.9,101.5,113.0,7,2,5,0.28600000000000003,7,2,5,0.28600000000000003,1,1,2,0,239.4,224.8,232.10000000000002
2019-11-08,1610612737,1610612758,2019,109.0,121.0,230.0,99.8,106.2,106.1,109.8,7,3,4,0.429,8,2,6,0.25,2,1,1,1,205.4,210.8,208.10000000000002
2019-11-08,1610612750,1610612744,2019,125.0,119.0,244.0,115.4,119.2,108.5,120.2,7,4,3,0.5710000000000001,8,2,6,0.25,1,3,1,1,232.6,231.2,231.89999999999998
2019-11-08,1610612740,1610612761,2019,104.0,122.0,226.0,118.3,122.5,112.7,109.1,7,1,6,0.14300000000000002,7,5,2,0.7140000000000001,1,0,4,1,239.0,225.8,232.4
2019-11-08,1610612742,1610612752,2019,102.0,106.0,208.0,113.3,106.0,101.1,110.0,7,5,2,0.7140000000000001,8,1,7,0.125,2,3,1,0,213.4,210.0,211.7
2019-11-08,1610612743,1610612755,2019,100.0,97.0,197.0,104.3,101.4,109.9,104.9,7,5,2,0.7140000000000001,7,5,2,0.7140000000000001,2,3,2,3,207.6,204.4,206.0
2019-11-08,1610612762,1610612749,2019,103.0,100.0,203.0,105.1,102.7,122.9,109.1,8,5,3,0.625,8,6,2,0.75,4,1,2,4,209.8,232.8,221.3
2019-11-08,1610612757,1610612751,2019,115.0,119.0,234.0,110.9,116.0,118.4,122.0,8,3,5,0.375,7,3,4,0.429,0,3,3,0,230.4,240.0,235.2
2019-11-08,1610612747,1610612748,2019,95.0,80.0,175.0,111.0,102.3,117.3,108.5,7,6,1,0.857,8,6,2,0.75,3,3,3,3,206.8,228.6,217.7
2019-11-07,1610612766,1610612738,2019,87.0,108.0,195.0,107.2,111.0,110.5,97.6,7,4,3,0.5710000000000001,6,5,1,0.833,2,2,3,2,225.2,209.6,217.39999999999998
2019-11-07,1610612759,1610612760,2019,121.0,112.0,233.0,109.8,107.9,100.7,104.4,7,4,3,0.5710000000000001,7,3,4,0.429,3,1,3,0,218.8,202.0,210.4
2019-11-07,1610612756,1610612748,2019,108.0,124.0,232.0,112.9,107.5,115.6,107.5,7,5,2,0.7140000000000001,7,5,2,0.7140000000000001,3,2,3,2,218.8,228.6,223.7
2019-11-07,1610612746,1610612757,2019,107.0,101.0,208.0,117.8,113.2,113.0,116.5,8,5,3,0.625,7,3,4,0.429,4,1,0,3,214.6,230.4,222.5
2019-11-06,1610612765,1610612752,2019,122.0,102.0,224.0,108.2,111.4,101.3,107.7,8,3,5,0.375,7,1,6,0.14300000000000002,2,1,1,0,214.2,210.0,212.1
2019-11-06,1610612754,1610612764,2019,121.0,106.0,227.0,109.9,108.2,113.5,111.7,7,3,4,0.429,6,2,4,0.333,2,1,1,1,210.2,239.4,224.8
2019-11-06,1610612737,1610612741,2019,93.0,113.0,206.0,99.3,104.6,108.3,111.0,6,3,3,0.5,8,2,6,0.25,2,1,1,1,201.2,219.2,210.2
2019-11-06,1610612761,1610612758,2019,124.0,120.0,244.0,113.7,110.0,104.7,110.4,6,4,2,0.667,7,2,5,0.28600000000000003,3,1,1,1,229.6,210.8,220.2
2019-11-06,1610612745,1610612744,2019,129.0,112.0,241.0,121.1,123.4,107.9,117.8,7,4,3,0.5710000000000001,7,2,5,0.28600000000000003,2,2,1,1,235.2,231.2,233.2
2019-11-06,1610612763,1610612750,2019,137.0,121.0,258.0,104.0,114.7,112.9,117.3,6,1,5,0.16699999999999998,6,4,2,0.667,1,0,1,3,224.8,232.6,228.7
2019-11-06,1610612742,1610612753,2019,107.0,106.0,213.0,113.7,107.2,96.5,97.7,6,4,2,0.667,7,2,5,0.28600000000000003,1,3,2,0,216.6,190.8,203.7
2019-11-06,1610612762,1610612755,2019,106.0,104.0,210.0,106.0,105.1,112.1,103.7,7,4,3,0.5710000000000001,6,5,1,0.833,3,1,2,3,216.4,204.4,210.4
2019-11-06,1610612746,1610612749,2019,124.0,129.0,253.0,114.1,110.5,121.5,107.5,7,5,2,0.7140000000000001,7,5,2,0.7140000000000001,4,1,2,3,201.8,232.8,217.3
2019-11-05,1610612766,1610612754,2019,122.0,120.0,242.0,104.4,109.8,107.0,105.9,6,3,3,0.5,6,3,3,0.5,1,2,2,1,217.2,210.2,213.7
2019-11-05,1610612739,1610612738,2019,113.0,119.0,232.0,99.9,113.5,107.7,97.9,6,2,4,0.333,5,4,1,0.8,2,0,3,1,222.6,209.6,216.1
2019-11-05,1610612737,1610612759,2019,108.0,100.0,208.0,99.4,107.9,108.4,106.1,5,2,3,0.4,6,4,2,0.667,1,1,3,1,208.0,218.8,213.4
2019-11-05,1610612741,1610612747,2019,112.0,118.0,230.0,108.3,111.4,106.9,100.2,7,2,5,0.28600000000000003,6,5,1,0.833,1,1,3,2,220.0,206.8,213.4
2019-11-05,1610612760,1610612753,2019,102.0,94.0,196.0,102.4,107.4,99.6,96.4,6,2,4,0.333,6,2,4,0.333,2,0,2,0,211.4,190.8,201.10000000000002
2019-11-05,1610612743,1610612748,2019,109.0,89.0,198.0,105.8,102.3,117.5,106.0,6,4,2,0.667,6,5,1,0.833,1,3,3,2,212.4,228.6,220.5
2019-11-04,1610612764,1610612765,2019,115.0,99.0,214.0,113.0,113.4,106.9,110.5,5,1,4,0.2,7,3,4,0.429,0,1,2,1,241.8,214.2,228.0
2019-11-04,1610612751,1610612740,2019,135.0,125.0,260.0,115.6,121.8,118.1,120.4,6,2,4,0.333,6,1,5,0.16699999999999998,2,0,1,0,234.0,239.0,236.5
2019-11-04,1610612763,1610612745,2019,100.0,107.0,207.0,107.2,115.7,123.3,126.8,5,1,4,0.2,6,3,3,0.5,1,0,2,1,233.2,235.2,234.2
2019-11-04,1610612750,1610612749,2019,106.0,134.0,240.0,114.5,117.1,119.9,108.0,5,4,1,0.8,6,4,2,0.667,1,3,2,2,235.4,232.8,234.10000000000002
2019-11-04,1610612756,1610612755,2019,114.0,109.0,223.0,112.6,107.2,111.2,101.0,6,4,2,0.667,5,5,0,1.0,2,2,2,3,217.6,204.4,211.0
2019-11-04,1610612744,1610612757,2019,127.0,118.0,245.0,107.6,116.3,111.6,114.8,6,1,5,0.16699999999999998,6,3,3,0.5,0,1,0,3,227.6,230.4,229.0
2019-11-03,1610612754,1610612741,2019,108.0,95.0,203.0,109.2,107.0,109.3,109.7,5,2,3,0.4,6,2,4,0.333,1,1,1,1,216.8,220.0,218.4
2019-11-03,1610612748,1610612745,2019,129.0,100.0,229.0,115.3,104.9,124.2,123.5,5,4,1,0.8,5,3,2,0.6,2,2,2,1,222.0,235.2,228.6
2019-11-03,1610612752,1610612758,2019,92.0,113.0,205.0,102.0,107.9,106.5,114.8,6,1,5,0.16699999999999998,6,1,5,0.16699999999999998,1,0,1,0,211.8,210.8,211.3
2019-11-03,1610612759,1610612747,2019,96.0,103.0,199.0,110.2,108.1,108.9,100.7,5,4,1,0.8,5,4,1,0.8,3,1,3,1,226.4,206.8,216.60000000000002
2019-11-03,1610612739,1610612742,2019,111.0,131.0,242.0,97.8,111.6,111.0,108.0,5,2,3,0.4,5,3,2,0.6,2,0,1,2,214.6,216.6,215.6
2019-11-03,1610612746,1610612762,2019,105.0,94.0,199.0,112.7,112.2,106.5,107.9,6,4,2,0.667,6,4,2,0.667,3,1,3,1,202.4,216.4,209.4
2019-11-02,1610612760,1610612740,2019,115.0,104.0,219.0,102.8,107.4,120.4,121.4,5,1,4,0.2,5,1,4,0.2,1,0,1,0,212.2,239.0,225.6
2019-11-02,1610612765,1610612751,2019,113.0,109.0,222.0,108.0,111.3,115.8,120.7,6,2,4,0.333,5,2,3,0.4,1,1,2,0,218.0,234.0,226.0
2019-11-02,1610612753,1610612743,2019,87.0,91.0,178.0,100.3,99.9,107.8,102.7,5,2,3,0.4,5,3,2,0.6,2,0,1,2,199.2,212.4,205.8
2019-11-02,1610612764,1610612750,2019,109.0,131.0,240.0,113.3,113.2,113.3,117.3,4,1,3,0.25,4,3,1,0.75,0,1,1,2,242.0,235.4,238.7
2019-11-02,1610612763,1610612756,2019,105.0,114.0,219.0,109.4,117.2,112.1,108.7,4,1,3,0.25,5,3,2,0.6,1,0,2,1,240.6,217.6,229.1
2019-11-02,1610612749,1610612761,2019,115.0,105.0,220.0,118.3,108.0,114.6,109.5,5,3,2,0.6,5,4,1,0.8,1,2,3,1,229.6,229.6,229.6
2019-11-02,1610612744,1610612766,2019,87.0,93.0,180.0,113.2,119.3,105.7,111.8,5,1,4,0.2,5,2,3,0.4,0,1,1,1,244.8,217.2,231.0
2019-11-02,1610612757,1610612755,2019,128.0,129.0,257.0,108.7,112.9,107.3,97.4,5,3,2,0.6,4,4,0,1.0,0,3,2,2,220.8,204.4,212.60000000000002
2019-11-01,1610612751,1610612745,2019,123.0,116.0,239.0,112.6,116.8,122.5,121.6,4,1,3,0.25,4,3,1,0.75,1,0,2,1,219.8,235.2,227.5
2019-11-01,1610612754,1610612739,2019,102.0,95.0,197.0,109.6,108.5,99.7,113.4,4,1,3,0.25,4,2,2,0.5,0,1,2,0,220.6,214.6,217.6
2019-11-01,1610612753,1610612749,2019,91.0,123.0,214.0,98.7,97.6,118.2,110.1,4,2,2,0.5,4,2,2,0.5,2,0,1,1,191.4,229.6,210.5
2019-11-01,1610612738,1610612752,2019,104.0,102.0,206.0,107.4,99.0,101.4,106.1,4,3,1,0.75,5,1,4,0.2,2,1,1,0,211.2,211.8,211.5
2019-11-01,1610612741,1610612765,2019,112.0,106.0,218.0,106.7,108.7,107.3,112.1,5,1,4,0.2,5,2,3,0.4,0,1,1,1,212.8,218.0,215.4
2019-11-01,1610612742,1610612747,2019,110.0,119.0,229.0,112.0,107.0,109.2,101.4,4,3,1,0.75,4,3,1,0.75,1,2,3,0,216.6,206.8,211.7
2019-11-01,1610612758,1610612762,2019,102.0,101.0,203.0,109.4,117.9,105.7,107.7,5,0,5,0.0,5,4,1,0.8,0,0,3,1,222.8,216.4,219.60000000000002
2019-11-01,1610612744,1610612759,2019,110.0,127.0,237.0,112.3,118.9,106.5,107.9,4,1,3,0.25,4,3,1,0.75,0,1,3,0,242.2,226.4,234.3
2019-10-31,1610612737,1610612748,2019,97.0,106.0,203.0,103.1,110.8,114.1,106.5,4,2,2,0.5,4,3,1,0.75,1,1,2,1,221.2,222.0,221.6
2019-10-31,1610612740,1610612743,2019,122.0,107.0,229.0,119.1,122.2,107.6,99.9,4,0,4,0.0,4,3,1,0.75,0,0,1,2,238.0,212.4,225.2
2019-10-31,1610612746,1610612759,2019,103.0,97.0,200.0,112.0,113.4,107.3,109.0,5,3,2,0.6,3,3,0,1.0,2,1,3,0,203.4,226.4,214.9
2019-10-30,1610612739,1610612741,2019,117.0,111.0,228.0,98.6,113.9,104.3,107.5,3,1,2,0.333,4,1,3,0.25,1,0,0,1,213.4,212.8,213.10000000000002
2019-10-30,1610612753,1610612752,2019,95.0,83.0,178.0,97.7,100.0,102.7,108.6,3,1,2,0.333,4,1,3,0.25,1,0,1,0,194.2,211.8,203.0
2019-10-30,1610612755,1610612750,2019,117.0,95.0,212.0,105.2,98.0,116.1,119.9,3,3,0,1.0,3,3,0,1.0,1,2,1,2,201.4,235.4,218.4
2019-10-30,1610612738,1610612749,2019,116.0,105.0,221.0,107.4,100.8,117.1,108.5,3,2,1,0.667,3,2,1,0.667,1,1,1,1,214.8,229.6,222.2
2019-10-30,1610612751,1610612754,2019,108.0,118.0,226.0,112.6,116.2,105.2,106.1,3,1,2,0.333,3,0,3,0.0,1,0,0,0,218.6,220.6,219.6
2019-10-30,1610612761,1610612765,2019,125.0,113.0,238.0,112.6,108.8,104.6,111.7,4,3,1,0.75,4,2,2,0.5,2,1,1,1,224.2,218.0,221.1
2019-10-30,1610612764,1610612745,2019,158.0,159.0,317.0,108.9,108.8,117.5,117.3,3,1,2,0.333,3,2,1,0.667,0,1,2,0,224.4,235.2,229.8
2019-10-30,1610612760,1610612757,2019,99.0,102.0,201.0,102.7,108.3,111.1,114.8,4,1,3,0.25,4,2,2,0.5,1,0,0,2,213.8,220.8,217.3
2019-10-30,1610612762,1610612746,2019,110.0,96.0,206.0,105.4,107.2,112.8,114.5,4,3,1,0.75,4,3,1,0.75,2,1,2,1,214.8,203.4,209.10000000000002
2019-10-30,1610612758,1610612766,2019,111.0,118.0,229.0,111.2,119.4,106.3,110.4,4,0,4,0.0,4,1,3,0.25,0,0,1,0,229.4,217.2,223.3
2019-10-30,1610612744,1610612756,2019,110.0,121.0,231.0,112.3,118.2,111.3,112.6,3,1,2,0.333,4,2,2,0.5,0,1,2,0,240.8,217.6,229.2
2019-10-29,1610612748,1610612737,2019,112.0,97.0,209.0,115.1,106.7,104.1,111.1,3,2,1,0.667,3,2,1,0.667,1,1,1,1,224.4,221.2,222.8
2019-10-29,1610612743,1610612742,2019,106.0,109.0,215.0,106.0,98.7,110.5,106.9,3,3,0,1.0,3,2,1,0.667,1,2,1,1,206.8,216.6,211.7
2019-10-29,1610612747,1610612763,2019,120.0,91.0,211.0,108.3,103.7,112.5,116.4,3,2,1,0.667,3,1,2,0.333,2,0,1,0,209.6,240.6,225.1
2019-10-28,1610612765,1610612754,2019,96.0,94.0,190.0,104.1,113.8,109.3,109.9,3,1,2,0.333,2,0,2,0.0,0,1,0,0,221.2,220.6,220.89999999999998
2019-10-28,1610612752,1610612741,2019,105.0,98.0,203.0,101.1,110.3,105.4,109.5,3,0,3,0.0,3,1,2,0.333,0,0,0,1,212.0,212.8,212.4
2019-10-28,1610612737,1610612755,2019,103.0,105.0,208.0,106.8,112.8,103.6,100.2,2,2,0,1.0,2,2,0,1.0,1,1,1,1,230.0,201.4,215.7
2019-10-28,1610612761,1610612753,2019,104.0,95.0,199.0,112.6,110.2,97.8,101.1,3,2,1,0.667,2,1,1,0.5,1,1,1,0,227.0,194.2,210.6
2019-10-28,1610612745,1610612760,2019,116.0,112.0,228.0,117.2,117.9,101.4,107.1,2,1,1,0.5,3,1,2,0.333,1,0,1,0,235.8,213.8,224.8
2019-10-28,1610612749,1610612739,2019,129.0,112.0,241.0,116.7,107.6,97.8,112.7,2,1,1,0.5,2,1,1,0.5,0,1,1,0,227.0,213.4,220.2
2019-10-28,1610612740,1610612744,2019,123.0,134.0,257.0,117.0,121.8,109.8,116.3,3,0,3,0.0,2,0,2,0.0,0,0,0,0,233.0,240.8,236.9
2019-10-28,1610612759,1610612757,2019,113.0,110.0,223.0,104.9,110.5,111.2,114.9,2,2,0,1.0,3,2,1,0.667,2,0,0,2,224.6,220.8,222.7
2019-10-28,1610612756,1610612762,2019,95.0,96.0,191.0,115.1,115.6,105.6,109.5,3,2,1,0.667,3,2,1,0.667,2,0,2,0,231.2,214.8,223.0
2019-10-28,1610612758,1610612743,2019,94.0,101.0,195.0,113.5,119.7,106.7,101.2,3,0,3,0.0,2,2,0,1.0,0,0,1,1,234.6,206.8,220.7
2019-10-28,1610612746,1610612766,2019,111.0,96.0,207.0,112.7,117.8,107.1,108.4,3,2,1,0.667,3,1,2,0.333,1,1,1,0,209.8,217.2,213.5
2019-10-27,1610612760,1610612744,2019,120.0,92.0,212.0,101.4,108.7,111.5,116.1,2,0,2,0.0,1,0,1,0.0,0,0,0,0,217.0,240.8,228.9
2019-10-27,1610612763,1610612751,2019,134.0,133.0,267.0,109.4,114.9,110.1,112.4,2,0,2,0.0,2,1,1,0.5,0,0,1,0,231.4,218.6,225.0
2019-10-27,1610612742,1610612757,2019,119.0,121.0,240.0,109.8,107.0,108.5,114.6,2,2,0,1.0,2,1,1,0.5,1,1,0,1,215.4,220.8,218.10000000000002
2019-10-27,1610612750,1610612748,2019,116.0,109.0,225.0,115.4,120.8,115.1,106.8,2,2,0,1.0,2,2,0,1.0,0,2,1,1,235.8,224.4,230.10000000000002
2019-10-27,1610612747,1610612766,2019,120.0,101.0,221.0,106.4,104.0,108.5,107.3,2,1,1,0.5,2,1,1,0.5,1,0,1,0,206.4,217.2,211.8
2019-10-26,1610612749,1610612748,2019,126.0,131.0,257.0,114.9,104.5,112.9,105.3,1,1,0,1.0,1,1,0,1.0,0,1,1,0,217.2,224.4,220.8
2019-10-26,1610612765,1610612755,2019,111.0,117.0,228.0,103.4,114.8,101.3,98.0,2,1,1,0.5,1,1,0,1.0,0,1,1,0,221.8,201.4,211.60000000000002
2019-10-26,1610612737,1610612753,2019,103.0,99.0,202.0,110.1,116.4,96.1,101.9,1,1,0,1.0,1,1,0,1.0,0,1,1,0,243.8,194.2,219.0
2019-10-26,1610612752,1610612738,2019,95.0,118.0,213.0,102.9,109.5,105.8,103.6,2,0,2,0.0,2,1,1,0.5,0,0,1,0,214.0,214.8,214.4
2019-10-26,1610612739,1610612754,2019,110.0,99.0,209.0,97.6,113.8,110.2,107.8,1,0,1,0.0,1,0,1,0.0,0,0,0,0,215.2,220.6,217.89999999999998
2019-10-26,1610612741,1610612761,2019,84.0,108.0,192.0,106.6,110.3,112.3,111.0,2,1,1,0.5,2,1,1,0.5,0,1,1,0,216.8,227.0,221.9
2019-10-26,1610612745,1610612740,2019,126.0,123.0,249.0,115.8,116.4,118.0,120.1,1,0,1,0.0,2,0,2,0.0,0,0,0,0,230.0,233.0,231.5
2019-10-26,1610612759,1610612764,2019,124.0,122.0,246.0,104.5,108.6,107.7,107.7,1,1,0,1.0,2,1,1,0.5,1,0,0,1,220.0,224.4,222.2
2019-10-26,1610612762,1610612758,2019,113.0,81.0,194.0,104.4,111.8,115.2,120.3,2,1,1,0.5,2,0,2,0.0,1,0,0,0,217.0,234.6,225.8
2019-10-26,1610612756,1610612746,2019,130.0,122.0,252.0,111.8,115.2,110.9,117.9,2,1,1,0.5,2,2,0,1.0,1,0,1,1,223.8,209.8,216.8
2019-10-25,1610612738,1610612761,2019,112.0,106.0,218.0,104.5,102.1,114.0,110.7,1,0,1,0.0,1,1,0,1.0,0,0,1,0,209.2,227.0,218.1
2019-10-25,1610612766,1610612750,2019,99.0,121.0,220.0,110.0,107.4,113.9,122.0,1,1,0,1.0,1,1,0,1.0,1,0,0,1,220.4,235.8,228.10000000000002
2019-10-25,1610612751,1610612752,2019,113.0,109.0,222.0,110.3,114.6,102.0,109.6,1,0,1,0.0,1,0,1,0.0,0,0,0,0,223.4,214.0,218.7
2019-10-25,1610612763,1610612741,2019,102.0,110.0,212.0,110.7,114.2,107.1,111.5,1,0,1,0.0,1,0,1,0.0,0,0,0,0,232.6,216.8,224.7
2019-10-25,1610612740,1610612742,2019,116.0,123.0,239.0,118.5,119.6,110.4,108.1,1,0,1,0.0,1,1,0,1.0,0,0,1,0,233.0,215.4,224.2
2019-10-25,1610612760,1610612764,2019,85.0,97.0,182.0,104.1,110.1,107.5,108.2,1,0,1,0.0,1,0,1,0.0,0,0,0,0,225.2,224.4,224.8
2019-10-25,1610612743,1610612756,2019,108.0,107.0,215.0,108.0,101.8,110.3,116.9,1,1,0,1.0,1,1,0,1.0,0,1,1,0,210.6,223.8,217.2
2019-10-25,1610612758,1610612757,2019,112.0,122.0,234.0,114.5,121.1,106.3,113.0,1,0,1,0.0,1,0,1,0.0,0,0,0,0,234.8,220.8,227.8
2019-10-25,1610612747,1610612762,2019,95.0,86.0,181.0,108.2,106.3,104.8,114.5,1,0,1,0.0,1,1,0,1.0,0,0,1,0,214.6,217.0,215.8
2019-10-24,1610612765,1610612737,2019,100.0,117.0,217.0,103.7,115.0,109.7,121.3,1,1,0,1.0,0,0,0,0.0,0,1,0,0,222.8,243.8,233.3
2019-10-24,1610612745,1610612749,2019,111.0,117.0,228.0,117.3,116.8,113.4,105.4,0,0,0,0.0,0,0,0,0.0,0,0,0,0,233.8,217.2,225.5
2019-10-24,1610612744,1610612746,2019,122.0,141.0,263.0,108.5,112.5,108.6,118.5,0,0,0,0.0,1,1,0,1.0,0,0,1,0,227.6,209.8,218.7
2019-10-23,1610612766,1610612741,2019,126.0,125.0,251.0,108.7,106.0,105.1,110.2,0,0,0,0.0,0,0,0,0.0,0,0,0,0,215.0,216.8,215.9
2019-10-23,1610612754,1610612765,2019,110.0,119.0,229.0,108.8,106.3,103.3,112.9,0,0,0,0.0,0,0,0,0.0,0,0,0,0,214.8,222.8,218.8
2019-10-23,1610612753,1610612739,2019,94.0,85.0,179.0,96.0,103.2,100.4,116.6,0,0,0,0.0,0,0,0,0.0,0,0,0,0,196.6,215.2,205.89999999999998
2019-10-23,1610612751,1610612750,2019,126.0,127.0,253.0,109.0,111.3,110.7,119.3,0,0,0,0.0,0,0,0,0.0,0,0,0,0,214.2,235.8,225.0
2019-10-23,1610612748,1610612763,2019,120.0,101.0,221.0,111.1,106.4,109.5,113.8,0,0,0,0.0,0,0,0,0.0,0,0,0,0,223.0,232.6,227.8
2019-10-23,1610612755,1610612738,2019,107.0,93.0,200.0,102.2,98.2,106.4,100.4,0,0,0,0.0,0,0,0,0.0,0,0,0,0,203.6,209.2,206.39999999999998
2019-10-23,1610612742,1610612764,2019,108.0,100.0,208.0,110.4,109.1,109.9,110.2,0,0,0,0.0,0,0,0,0.0,0,0,0,0,217.4,224.4,220.9
2019-10-23,1610612759,1610612752,2019,120.0,111.0,231.0,102.8,109.2,100.1,110.4,0,0,0,0.0,0,0,0,0.0,0,0,0,0,217.8,214.0,215.9
2019-10-23,1610612762,1610612760,2019,100.0,95.0,195.0,106.6,115.8,107.3,111.7,0,0,0,0.0,0,0,0,0.0,0,0,0,0,223.2,225.2,224.2
2019-10-23,1610612756,1610612758,2019,124.0,95.0,219.0,110.1,118.7,116.3,119.3,0,0,0,0.0,0,0,0,0.0,0,0,0,0,227.0,234.8,230.9
2019-10-23,1610612757,1610612743,2019,100.0,108.0,208.0,108.2,113.0,108.8,103.0,0,0,0,0.0,0,0,0,0.0,0,0,0,0,224.6,210.6,217.6
2019-10-22,1610612761,1610612740,2019,130.0,122.0,252.0,112.8,109.4,119.6,119.5,0,0,0,0.0,0,0,0,0.0,0,0,0,0,222.0,233.0,227.5
2019-10-22,1610612746,1610612747,2019,112.0,102.0,214.0,107.9,119.6,108.3,107.0,0,0,0,0.0,0,0,0,0.0,0,0,0,0,210.6,214.6,212.6
2019-10-18,1610612755,1610612764,2019,93.0,112.0,205.0,105.1,97.0,111.1,113.0,0,0,0,0.0,0,0,0,0.0,0,0,0,0,207.0,224.4,215.7
2019-10-18,1610612751,1610612761,2019,107.0,123.0,230.0,108.8,110.5,111.0,108.6,0,0,0,0.0,0,0,0,0.0,0,0,0,0,212.2,222.0,217.1
2019-10-18,1610612748,1610612745,2019,133.0,144.0,277.0,108.3,101.9,112.9,113.9,0,0,0,0.0,0,0,0,0.0,0,0,0,0,208.4,233.8,221.10000000000002
2019-10-18,1610612752,1610612740,2019,116.0,117.0,233.0,99.8,109.2,120.5,121.2,0,0,0,0.0,0,0,0,0.0,0,0,0,0,211.0,233.0,222.0
2019-10-18,1610612759,1610612763,2019,104.0,91.0,195.0,104.2,110.9,110.0,114.7,0,0,0,0.0,0,0,0,0.0,0,0,0,0,224.0,232.6,228.3
2019-10-18,1610612744,1610612747,2019,124.0,103.0,227.0,107.0,114.5,111.0,104.8,0,0,0,0.0,0,0,0,0.0,0,0,0,0,228.6,214.6,221.6
2019-10-17,1610612753,1610612748,2019,98.0,107.0,205.0,101.1,103.8,108.1,103.1,0,0,0,0.0,0,0,0,0.0,0,0,0,0,208.0,208.4,208.2
2019-10-17,1610612741,1610612737,2019,111.0,93.0,204.0,104.1,113.3,111.5,121.9,0,0,0,0.0,0,0,0,0.0,0,0,0,0,221.0,243.8,232.4
2019-10-17,1610612749,1610612750,2019,118.0,96.0,214.0,113.2,104.9,112.1,118.3,0,0,0,0.0,0,0,0,0.0,0,0,0,0,215.8,235.8,225.8
2019-10-17,1610612743,1610612757,2019,110.0,104.0,214.0,106.8,101.2,107.6,114.4,0,0,0,0.0,0,0,0,0.0,0,0,0,0,203.0,224.6,213.8
2019-10-17,1610612746,1610612742,2019,87.0,102.0,189.0,109.7,122.6,110.8,110.7,0,0,0,0.0,0,0,0,0.0,0,0,0,0,220.2,217.4,218.8
2019-10-16,1610612766,1610612765,2019,110.0,116.0,226.0,110.2,106.0,102.7,114.2,0,0,0,0.0,0,0,0,0.0,0,0,0,0,218.0,222.8,220.4
2019-10-16,1610612752,1610612737,2019,96.0,100.0,196.0,99.4,109.2,114.5,124.3,0,0,0,0.0,0,0,0,0.0,0,0,0,0,210.2,243.8,227.0
2019-10-16,1610612745,1610612759,2019,114.0,128.0,242.0,111.5,110.4,101.5,109.1,0,0,0,0.0,0,0,0,0.0,0,0,0,0,224.0,224.0,224.0
2019-10-16,1610612760,1610612763,2019,119.0,124.0,243.0,107.7,110.3,109.6,114.3,0,0,0,0.0,0,0,0,0.0,0,0,0,0,223.2,232.6,227.89999999999998
2019-10-16,1610612762,1610612757,2019,118.0,126.0,244.0,106.7,113.0,104.7,111.6,0,0,0,0.0,0,0,0,0.0,0,0,0,0,217.8,224.6,221.2
2019-10-16,1610612747,1610612744,2019,126.0,93.0,219.0,107.4,106.3,109.6,113.6,0,0,0,0.0,0,0,0,0.0,0,0,0,0,210.4,228.6,219.5
2019-10-15,1610612739,1610612738,2019,95.0,118.0,213.0,101.6,115.0,105.6,101.5,0,0,0,0.0,0,0,0,0.0,0,0,0,0,214.4,209.2,211.8
2019-10-15,1610612754,1610612750,2019,111.0,119.0,230.0,107.3,105.2,111.4,117.1,0,0,0,0.0,0,0,0,0.0,0,0,0,0,209.6,235.8,222.7
2019-10-15,1610612755,1610612765,2019,106.0,86.0,192.0,109.0,100.7,104.3,114.7,0,0,0,0.0,0,0,0,0.0,0,0,0,0,222.2,222.8,222.5
2019-10-14,1610612748,1610612737,2019,120.0,87.0,207.0,106.0,104.8,114.9,122.4,0,0,0,0.0,0,0,0,0.0,0,0,0,0,207.6,243.8,225.7
2019-10-14,1610612763,1610612766,2019,99.0,120.0,219.0,109.6,113.5,108.4,107.2,0,0,0,0.0,0,0,0,0.0,0,0,0,0,231.0,218.0,224.5
2019-10-14,1610612742,1610612760,2019,107.0,70.0,177.0,112.3,113.9,113.9,112.2,0,0,0,0.0,0,0,0,0.0,0,0,0,0,226.8,223.2,225.0
2019-10-14,1610612762,1610612758,2019,115.0,128.0,243.0,106.3,110.4,114.3,119.7,0,0,0,0.0,0,0,0,0.0,0,0,0,0,211.8,234.8,223.3
2019-10-14,1610612756,1610612743,2019,102.0,107.0,209.0,111.4,120.0,109.8,105.0,0,0,0,0.0,0,0,0,0.0,0,0,0,0,232.2,203.0,217.6
2019-10-14,1610612747,1610612744,2019,104.0,98.0,202.0,109.9,108.0,110.8,113.1,0,0,0,0.0,0,0,0,0.0,0,0,0,0,218.8,228.6,223.7
2019-10-13,1610612738,1610612739,2019,118.0,72.0,190.0,102.2,101.7,105.2,116.4,0,0,0,0.0,0,0,0,0.0,0,0,0,0,202.8,214.4,208.60000000000002
2019-10-13,1610612759,1610612740,2019,114.0,123.0,237.0,100.6,106.2,117.8,121.7,0,0,0,0.0,0,0,0,0.0,0,0,0,0,216.4,233.0,224.7
2019-10-13,1610612753,1610612755,2019,94.0,126.0,220.0,103.1,101.2,105.9,102.1,0,0,0,0.0,0,0,0,0.0,0,0,0,0,206.8,222.2,214.5
2019-10-13,1610612761,1610612741,2019,91.0,105.0,196.0,111.9,107.5,103.9,115.4,0,0,0,0.0,0,0,0,0.0,0,0,0,0,221.6,221.0,221.3
2019-10-13,1610612764,1610612749,2019,108.0,115.0,223.0,111.1,112.8,112.9,105.9,0,0,0,0.0,0,0,0,0.0,0,0,0,0,224.0,215.8,219.9
2019-10-12,1610612751,1610612747,2019,91.0,77.0,168.0,111.8,115.9,112.2,110.4,0,0,0,0.0,0,0,0,0.0,0,0,0,0,229.0,218.8,223.9
2019-10-12,1610612757,1610612756,2019,118.0,134.0,252.0,104.1,109.8,108.3,119.4,0,0,0,0.0,0,0,0,0.0,0,0,0,0,219.8,232.2,226.0
2019-10-11,1610612765,1610612739,2019,109.0,105.0,214.0,103.4,113.5,105.7,117.1,0,0,0,0.0,0,0,0,0.0,0,0,0,0,218.6,214.4,216.5
2019-10-11,1610612754,1610612741,2019,105.0,87.0,192.0,106.5,108.2,106.8,115.0,0,0,0,0.0,0,0,0,0.0,0,0,0,0,214.0,221.0,217.5
2019-10-11,1610612753,1610612738,2019,75.0,100.0,175.0,107.5,101.0,102.6,103.8,0,0,0,0.0,0,0,0,0.0,0,0,0,0,215.2,202.8,209.0
2019-10-11,1610612766,1610612755,2019,87.0,100.0,187.0,112.1,108.9,107.1,104.2,0,0,0,0.0,0,0,0,0.0,0,0,0,0,228.8,222.2,225.5
2019-10-11,1610612752,1610612764,2019,99.0,115.0,214.0,98.7,109.4,110.2,115.3,0,0,0,0.0,0,0,0,0.0,0,0,0,0,209.2,224.0,216.6
2019-10-11,1610612740,1610612762,2019,128.0,127.0,255.0,117.0,122.0,107.3,111.9,0,0,0,0.0,0,0,0,0.0,0,0,0,0,232.0,211.8,221.9
2019-10-11,1610612742,1610612749,2019,111.0,118.0,229.0,113.3,114.6,112.4,104.9,0,0,0,0.0,0,0,0,0.0,0,0,0,0,230.2,215.8,223.0
2019-10-10,1610612745,1610612761,2019,118.0,111.0,229.0,111.5,109.1,111.1,108.2,0,0,0,0.0,0,0,0,0.0,0,0,0,0,221.4,221.6,221.5
2019-10-10,1610612747,1610612751,2019,111.0,114.0,225.0,113.5,109.6,113.7,117.6,0,0,0,0.0,0,0,0,0.0,0,0,0,0,219.8,229.0,224.4
2019-10-10,1610612758,1610612756,2019,105.0,88.0,193.0,115.0,121.2,113.3,122.5,0,0,0,0.0,0,0,0,0.0,0,0,0,0,239.2,232.2,235.7
2019-10-10,1610612744,1610612750,2019,143.0,123.0,266.0,107.9,111.9,109.7,114.1,0,0,0,0.0,0,0,0,0.0,0,0,0,0,220.4,235.8,228.10000000000002
2019-10-10,1610612746,1610612743,2019,91.0,111.0,202.0,114.9,125.2,109.0,107.9,0,0,0,0.0,0,0,0,0.0,0,0,0,0,235.8,203.0,219.4
2019-10-09,1610612765,1610612742,2019,124.0,117.0,241.0,100.1,112.2,111.5,112.7,0,0,0,0.0,0,0,0,0.0,0,0,0,0,209.4,230.2,219.8
2019-10-09,1610612737,1610612753,2019,88.0,97.0,185.0,115.9,124.5,108.2,102.3,0,0,0,0.0,0,0,0,0.0,0,0,0,0,250.0,215.2,232.6
2019-10-09,1610612766,1610612748,2019,94.0,108.0,202.0,114.0,108.7,105.2,104.6,0,0,0,0.0,0,0,0,0.0,0,0,0,0,232.2,207.6,219.89999999999998
2019-10-09,1610612741,1610612740,2019,125.0,127.0,252.0,104.1,114.1,117.2,122.0,0,0,0,0.0,0,0,0,0.0,0,0,0,0,213.8,232.0,222.9
2019-10-09,1610612749,1610612762,2019,133.0,99.0,232.0,111.4,105.2,108.3,109.9,0,0,0,0.0,0,0,0,0.0,0,0,0,0,214.4,211.8,213.10000000000002
2019-10-08,1610612761,1610612745,2019,134.0,129.0,263.0,109.7,105.5,107.7,106.4,0,0,0,0.0,0,0,0,0.0,0,0,0,0,213.4,221.4,217.4
2019-10-08,1610612748,1610612759,2019,107.0,89.0,196.0,103.8,103.2,102.9,104.5,0,0,0,0.0,0,0,0,0.0,0,0,0,0,202.0,216.4,209.2
2019-10-08,1610612760,1610612742,2019,119.0,104.0,223.0,113.9,112.1,113.7,109.9,0,0,0,0.0,0,0,0,0.0,0,0,0,0,223.0,230.2,226.6
2019-10-08,1610612756,1610612750,2019,111.0,106.0,217.0,114.3,124.3,109.3,114.7,0,0,0,0.0,0,0,0,0.0,0,0,0,0,237.8,235.8,236.8
2019-10-08,1610612757,1610612743,2019,94.0,105.0,199.0,108.7,113.0,110.2,108.8,0,0,0,0.0,0,0,0,0.0,0,0,0,0,235.4,203.0,219.2
2019-10-07,1610612765,1610612753,2019,91.0,115.0,206.0,99.9,111.5,108.9,104.6,0,0,0,0.0,0,0,0,0.0,0,0,0,0,207.6,215.2,211.39999999999998
2019-10-07,1610612764,1610612752,2019,99.0,104.0,203.0,111.1,116.2,96.6,110.4,0,0,0,0.0,0,0,0,0.0,0,0,0,0,227.6,209.2,218.39999999999998
2019-10-07,1610612737,1610612740,2019,109.0,133.0,242.0,117.9,123.9,115.5,123.9,0,0,0,0.0,0,0,0,0.0,0,0,0,0,252.8,232.0,242.4
2019-10-07,1610612741,1610612749,2019,112.0,122.0,234.0,101.2,113.3,111.5,105.6,0,0,0,0.0,0,0,0,0.0,0,0,0,0,206.4,214.4,210.4
2019-10-06,1610612738,1610612766,2019,107.0,106.0,213.0,102.7,104.8,112.4,111.7,0,0,0,0.0,0,0,0,0.0,0,0,0,0,205.0,232.2,218.6
2019-10-05,1610612754,1610612758,2019,130.0,106.0,236.0,104.6,107.8,116.2,120.3,0,0,0,0.0,0,0,0,0.0,0,0,0,0,209.4,239.2,224.3
2019-10-05,1610612744,1610612747,2019,101.0,123.0,224.0,109.4,109.0,111.3,111.0,0,0,0,0.0,0,0,0,0.0,0,0,0,0,217.6,219.8,218.7
2019-10-05,1610612759,1610612753,2019,89.0,125.0,214.0,105.7,103.1,108.0,106.5,0,0,0,0.0,0,0,0,0.0,0,0,0,0,219.2,215.2,217.2
2019-10-04,1610612746,1610612745,2019,96.0,109.0,205.0,117.0,126.5,107.2,106.9,0,0,0,0.0,0,0,0,0.0,0,0,0,0,242.6,221.4,232.0
2019-10-04,1610612758,1610612754,2019,131.0,132.0,263.0,114.7,117.1,102.6,106.1,0,0,0,0.0,0,0,0,0.0,0,0,0,0,229.8,209.4,219.60000000000002
2019-06-13,1610612744,1610612761,2018,110.0,114.0,224.0,108.8,107.5,108.3,105.3,82,57,25,0.695,82,58,24,0.7070000000000001,30,27,32,26,213.4,213.4,213.4
2019-06-10,1610612761,1610612744,2018,105.0,106.0,211.0,109.6,105.9,110.0,108.3,82,58,24,0.7070000000000001,82,57,25,0.695,32,26,30,27,217.2,213.4,215.3
2019-06-07,1610612744,1610612761,2018,92.0,105.0,197.0,112.3,108.7,109.2,107.9,82,57,25,0.695,82,58,24,0.7070000000000001,30,27,32,26,218.8,217.2,218.0
2019-06-05,1610612744,1610612761,2018,109.0,123.0,232.0,111.8,106.4,107.0,106.6,82,57,25,0.695,82,58,24,0.7070000000000001,30,27,32,26,213.2,217.2,215.2
2019-06-02,1610612761,1610612744,2018,104.0,109.0,213.0,105.8,104.7,111.7,107.2,82,58,24,0.7070000000000001,82,57,25,0.695,32,26,30,27,211.0,213.2,212.1
2019-05-30,1610612761,1610612744,2018,118.0,109.0,227.0,106.5,102.7,112.9,108.0,82,58,24,0.7070000000000001,82,57,25,0.695,32,26,30,27,208.4,213.2,210.8
2019-05-25,1610612761,1610612749,2018,100.0,94.0,194.0,105.4,102.7,114.8,106.0,82,58,24,0.7070000000000001,82,60,22,0.732,32,26,33,27,206.2,214.4,210.3
2019-05-23,1610612749,1610612761,2018,99.0,105.0,204.0,113.9,106.7,104.4,104.4,82,60,22,0.732,82,58,24,0.7070000000000001,33,27,32,26,214.0,206.2,210.1
2019-05-21,1610612761,1610612749,2018,120.0,102.0,222.0,103.2,103.7,115.6,105.0,82,58,24,0.7070000000000001,82,60,22,0.732,32,26,33,27,202.4,214.0,208.2
2019-05-20,1610612757,1610612744,2018,117.0,119.0,236.0,108.8,112.6,113.9,107.3,82,53,29,0.6459999999999999,82,57,25,0.695,32,21,30,27,234.8,213.2,224.0
2019-05-19,1610612761,1610612749,2018,118.0,112.0,230.0,102.9,102.1,117.2,105.4,82,58,24,0.7070000000000001,82,60,22,0.732,32,26,33,27,198.6,214.0,206.3
2019-05-18,1610612757,1610612744,2018,99.0,110.0,209.0,110.3,111.0,114.2,107.9,82,53,29,0.6459999999999999,82,57,25,0.695,32,21,30,27,234.6,213.2,223.89999999999998
2019-05-17,1610612749,1610612761,2018,125.0,103.0,228.0,116.7,105.0,103.3,98.1,82,60,22,0.732,82,58,24,0.7070000000000001,33,27,32,26,212.2,198.6,205.39999999999998
2019-05-16,1610612744,1610612757,2018,114.0,111.0,225.0,114.9,109.7,110.5,111.7,82,57,25,0.695,82,53,29,0.6459999999999999,30,27,32,21,218.2,234.6,226.39999999999998
2019-05-15,1610612749,1610612761,2018,108.0,100.0,208.0,118.0,103.6,103.1,96.6,82,60,22,0.732,82,58,24,0.7070000000000001,33,27,32,26,212.0,198.6,205.3
2019-05-14,1610612744,1610612757,2018,116.0,94.0,210.0,116.4,113.8,112.2,109.9,82,57,25,0.695,82,53,29,0.6459999999999999,30,27,32,21,229.4,234.6,232.0
2019-05-12,1610612743,1610612757,2018,96.0,100.0,196.0,111.4,107.8,113.0,112.3,82,54,28,0.659,82,53,29,0.6459999999999999,34,20,32,21,203.4,234.6,219.0
2019-05-12,1610612761,1610612755,2018,92.0,90.0,182.0,105.0,95.8,111.2,106.5,82,58,24,0.7070000000000001,82,51,31,0.622,32,26,31,20,200.8,222.2,211.5
2019-05-10,1610612745,1610612744,2018,113.0,118.0,231.0,108.1,104.1,117.8,113.0,82,53,29,0.6459999999999999,82,57,25,0.695,31,22,30,27,217.6,229.4,223.5
2019-05-09,1610612755,1610612761,2018,112.0,101.0,213.0,110.2,107.5,106.9,94.6,82,51,31,0.622,82,58,24,0.7070000000000001,31,20,32,26,222.2,200.8,211.5
2019-05-09,1610612757,1610612743,2018,119.0,108.0,227.0,111.5,111.4,111.4,107.7,82,53,29,0.6459999999999999,82,54,28,0.659,32,21,34,20,229.8,203.4,216.60000000000002
2019-05-08,1610612749,1610612738,2018,116.0,91.0,207.0,118.0,107.2,105.2,104.2,82,60,22,0.732,82,49,33,0.598,33,27,28,21,219.2,205.0,212.1
2019-05-08,1610612744,1610612745,2018,104.0,99.0,203.0,119.5,113.5,109.3,104.9,82,57,25,0.695,82,53,29,0.6459999999999999,30,27,31,22,233.8,217.6,225.7
2019-05-07,1610612761,1610612755,2018,125.0,89.0,214.0,104.5,96.1,111.2,107.2,82,58,24,0.7070000000000001,82,51,31,0.622,32,26,31,20,199.0,222.2,210.6
2019-05-07,1610612743,1610612757,2018,124.0,98.0,222.0,110.4,108.4,112.1,109.1,82,54,28,0.659,82,53,29,0.6459999999999999,34,20,32,21,202.8,229.8,216.3
2019-05-06,1610612738,1610612749,2018,101.0,113.0,214.0,106.1,103.4,119.8,109.2,82,49,33,0.598,82,60,22,0.732,28,21,33,27,205.2,219.2,212.2
2019-05-06,1610612745,1610612744,2018,112.0,108.0,220.0,113.0,105.4,120.4,115.5,82,53,29,0.6459999999999999,82,57,25,0.695,31,22,30,27,226.0,233.8,229.9
2019-05-05,1610612755,1610612761,2018,96.0,101.0,197.0,114.1,108.0,105.5,97.8,82,51,31,0.622,82,58,24,0.7070000000000001,31,20,32,26,229.6,199.0,214.3
2019-05-05,1610612757,1610612743,2018,112.0,116.0,228.0,114.5,110.6,109.6,109.0,82,53,29,0.6459999999999999,82,54,28,0.659,32,21,34,20,237.6,202.8,220.2
2019-05-04,1610612745,1610612744,2018,126.0,121.0,247.0,112.4,102.9,119.5,113.2,82,53,29,0.6459999999999999,82,57,25,0.695,31,22,30,27,219.8,233.8,226.8
2019-05-03,1610612738,1610612749,2018,116.0,123.0,239.0,105.9,102.3,121.0,111.2,82,49,33,0.598,82,60,22,0.732,28,21,33,27,202.6,219.2,210.89999999999998
2019-05-03,1610612757,1610612743,2018,140.0,137.0,277.0,112.0,107.7,106.7,106.5,82,53,29,0.6459999999999999,82,54,28,0.659,32,21,34,20,226.8,202.8,214.8
2019-05-02,1610612755,1610612761,2018,116.0,95.0,211.0,114.7,111.3,107.5,96.7,82,51,31,0.622,82,58,24,0.7070000000000001,31,20,32,26,237.4,199.0,218.2
2019-05-01,1610612743,1610612757,2018,90.0,97.0,187.0,107.3,106.9,113.3,110.6,82,54,28,0.659,82,53,29,0.6459999999999999,34,20,32,21,204.8,226.8,215.8
2019-04-30,1610612749,1610612738,2018,123.0,102.0,225.0,120.2,111.7,107.4,99.7,82,60,22,0.732,82,49,33,0.598,33,27,28,21,218.6,202.6,210.6
2019-04-30,1610612744,1610612745,2018,115.0,109.0,224.0,121.1,112.7,115.0,101.7,82,57,25,0.695,82,53,29,0.6459999999999999,30,27,31,22,236.0,219.8,227.9
2019-04-29,1610612761,1610612755,2018,89.0,94.0,183.0,110.3,98.2,116.9,112.0,82,58,24,0.7070000000000001,82,51,31,0.622,32,26,31,20,207.6,237.4,222.5
2019-04-29,1610612743,1610612757,2018,121.0,113.0,234.0,105.1,105.1,115.2,110.7,82,54,28,0.659,82,53,29,0.6459999999999999,34,20,32,21,196.8,226.8,211.8
2019-04-28,1610612749,1610612738,2018,90.0,112.0,202.0,124.0,113.8,107.4,100.9,82,60,22,0.732,82,49,33,0.598,33,27,28,21,230.4,202.6,216.5
2019-04-28,1610612744,1610612745,2018,104.0,100.0,204.0,122.7,114.1,118.0,101.8,82,57,25,0.695,82,53,29,0.6459999999999999,30,27,31,22,242.0,219.8,230.9
2019-04-27,1610612761,1610612755,2018,108.0,95.0,203.0,111.6,99.6,119.6,114.2,82,58,24,0.7070000000000001,82,51,31,0.622,32,26,31,20,213.0,237.4,225.2
2019-04-27,1610612743,1610612759,2018,90.0,86.0,176.0,108.0,107.5,110.0,105.3,82,54,28,0.659,82,48,34,0.585,34,20,32,16,207.4,219.2,213.3
2019-04-26,1610612746,1610612744,2018,110.0,129.0,239.0,116.3,127.1,120.6,112.1,82,48,34,0.585,82,57,25,0.695,26,22,30,27,242.4,242.0,242.2
2019-04-25,1610612759,1610612743,2018,120.0,103.0,223.0,108.6,106.3,107.9,107.1,82,48,34,0.585,82,54,28,0.659,32,16,34,20,218.4,207.4,212.9
2019-04-24,1610612745,1610612762,2018,100.0,93.0,193.0,119.9,103.3,110.8,109.6,82,53,29,0.6459999999999999,82,50,32,0.61,31,22,29,21,226.6,211.8,219.2
2019-04-24,1610612744,1610612746,2018,121.0,129.0,250.0,120.1,109.4,115.6,126.1,82,57,25,0.695,82,48,34,0.585,30,27,26,22,235.6,242.4,239.0
2019-04-23,1610612761,1610612753,2018,115.0,96.0,211.0,111.3,100.3,109.3,107.1,82,58,24,0.7070000000000001,82,42,40,0.512,32,26,25,17,213.8,215.2,214.5
2019-04-23,1610612755,1610612751,2018,122.0,100.0,222.0,119.7,115.2,114.7,117.7,82,51,31,0.622,82,42,40,0.512,31,20,23,19,239.6,229.0,234.3
2019-04-23,1610612743,1610612759,2018,108.0,90.0,198.0,108.4,106.6,108.1,106.8,82,54,28,0.659,82,48,34,0.585,34,20,32,16,207.4,218.4,212.9
2019-04-23,1610612757,1610612760,2018,118.0,115.0,233.0,115.0,108.1,112.7,111.8,82,53,29,0.6459999999999999,82,49,33,0.598,32,21,27,22,221.2,223.0,222.1
2019-04-22,1610612765,1610612749,2018,104.0,127.0,231.0,99.4,107.8,121.5,114.1,82,41,41,0.5,82,60,22,0.732,26,15,33,27,199.2,230.4,214.8
2019-04-22,1610612762,1610612745,2018,107.0,91.0,198.0,112.9,112.9,120.2,103.4,82,50,32,0.61,82,53,29,0.6459999999999999,29,21,31,22,222.6,226.6,224.6
2019-04-21,1610612754,1610612738,2018,106.0,110.0,216.0,103.6,107.2,106.0,101.3,82,48,34,0.585,82,49,33,0.598,29,19,28,21,213.6,202.6,208.1
2019-04-21,1610612746,1610612744,2018,105.0,113.0,218.0,116.4,124.4,121.8,112.0,82,48,34,0.585,82,57,25,0.695,26,22,30,27,240.6,235.6,238.1
2019-04-21,1610612753,1610612761,2018,85.0,107.0,192.0,113.1,108.3,113.0,101.9,82,42,40,0.512,82,58,24,0.7070000000000001,25,17,32,26,225.2,213.8,219.5
2019-04-21,1610612760,1610612757,2018,98.0,111.0,209.0,113.2,111.3,112.9,108.2,82,49,33,0.598,82,53,29,0.6459999999999999,27,22,32,21,223.0,221.2,222.1
2019-04-20,1610612751,1610612755,2018,108.0,112.0,220.0,114.9,116.1,118.7,116.6,82,42,40,0.512,82,51,31,0.622,23,19,31,20,226.2,239.6,232.89999999999998
2019-04-20,1610612759,1610612743,2018,103.0,117.0,220.0,109.4,106.1,108.2,106.8,82,48,34,0.585,82,54,28,0.659,32,16,34,20,219.6,207.4,213.5
2019-04-20,1610612765,1610612749,2018,103.0,119.0,222.0,100.6,105.7,120.9,113.6,82,41,41,0.5,82,60,22,0.732,26,15,33,27,197.4,230.4,213.9
2019-04-20,1610612762,1610612745,2018,101.0,104.0,205.0,114.3,112.5,121.1,102.3,82,50,32,0.61,82,53,29,0.6459999999999999,29,21,31,22,224.6,226.6,225.6
2019-04-19,1610612753,1610612761,2018,93.0,98.0,191.0,115.7,108.1,114.9,101.8,82,42,40,0.512,82,58,24,0.7070000000000001,25,17,32,26,230.0,213.8,221.9
2019-04-19,1610612754,1610612738,2018,96.0,104.0,200.0,106.4,105.6,107.2,102.3,82,48,34,0.585,82,49,33,0.598,29,19,28,21,216.0,202.6,209.3
2019-04-19,1610612760,1610612757,2018,120.0,108.0,228.0,111.7,112.0,113.9,106.0,82,49,33,0.598,82,53,29,0.6459999999999999,27,22,32,21,221.4,221.2,221.3
2019-04-18,1610612751,1610612755,2018,115.0,131.0,246.0,113.7,110.5,117.4,116.0,82,42,40,0.512,82,51,31,0.622,23,19,31,20,212.6,239.6,226.1
2019-04-18,1610612759,1610612743,2018,118.0,108.0,226.0,108.1,106.3,105.9,106.2,82,48,34,0.585,82,54,28,0.659,32,16,34,20,217.4,207.4,212.4
2019-04-18,1610612746,1610612744,2018,105.0,132.0,237.0,119.1,122.0,120.4,111.8,82,48,34,0.585,82,57,25,0.695,26,22,30,27,241.2,235.6,238.39999999999998
2019-04-17,1610612738,1610612754,2018,99.0,91.0,190.0,106.9,104.7,107.2,106.4,82,49,33,0.598,82,48,34,0.585,28,21,29,19,206.8,216.0,211.4
2019-04-17,1610612749,1610612765,2018,120.0,99.0,219.0,121.7,115.5,99.9,103.2,82,60,22,0.732,82,41,41,0.5,33,27,26,15,235.8,197.4,216.60000000000002
2019-04-17,1610612745,1610612762,2018,118.0,98.0,216.0,120.5,101.0,115.9,109.0,82,53,29,0.6459999999999999,82,50,32,0.61,31,22,29,21,222.8,224.6,223.7
2019-04-16,1610612761,1610612753,2018,111.0,82.0,193.0,115.2,105.1,119.6,108.6,82,58,24,0.7070000000000001,82,42,40,0.512,32,26,25,17,221.0,230.0,225.5
2019-04-16,1610612743,1610612759,2018,114.0,105.0,219.0,103.5,105.2,109.2,107.4,82,54,28,0.659,82,48,34,0.585,34,20,32,16,200.6,217.4,209.0
2019-04-16,1610612757,1610612760,2018,114.0,94.0,208.0,117.3,111.0,113.9,111.5,82,53,29,0.6459999999999999,82,49,33,0.598,32,21,27,22,238.0,221.4,229.7
2019-04-15,1610612755,1610612751,2018,145.0,123.0,268.0,114.7,115.2,115.8,110.8,82,51,31,0.622,82,42,40,0.512,31,20,23,19,232.6,212.6,222.6
2019-04-15,1610612744,1610612746,2018,131.0,135.0,266.0,121.0,107.3,118.0,120.2,82,57,25,0.695,82,48,34,0.585,30,27,26,22,227.8,241.2,234.5
2019-04-14,1610612738,1610612754,2018,84.0,74.0,158.0,109.0,108.7,108.7,109.2,82,49,33,0.598,82,48,34,0.585,28,21,29,19,219.0,216.0,217.5
2019-04-14,1610612757,1610612760,2018,104.0,99.0,203.0,118.6,112.3,114.6,111.9,82,53,29,0.6459999999999999,82,49,33,0.598,32,21,27,22,243.2,221.4,232.3
2019-04-14,1610612749,1610612765,2018,121.0,86.0,207.0,120.4,116.3,102.7,103.2,82,60,22,0.732,82,41,41,0.5,33,27,26,15,234.8,197.4,216.10000000000002
2019-04-14,1610612745,1610612762,2018,122.0,90.0,212.0,119.4,102.5,118.3,108.5,82,53,29,0.6459999999999999,82,50,32,0.61,31,22,29,21,223.6,224.6,224.1
2019-04-13,1610612755,1610612751,2018,102.0,111.0,213.0,116.8,115.5,115.8,111.2,82,51,31,0.622,82,42,40,0.512,31,20,23,19,237.4,212.6,225.0
2019-04-13,1610612761,1610612753,2018,101.0,104.0,205.0,116.0,106.3,119.0,110.0,82,58,24,0.7070000000000001,82,42,40,0.512,32,26,25,17,225.0,230.0,227.5
2019-04-13,1610612744,1610612746,2018,121.0,104.0,225.0,121.0,108.3,118.6,118.9,82,57,25,0.695,82,48,34,0.585,30,27,26,22,229.8,241.2,235.5
2019-04-13,1610612743,1610612759,2018,96.0,101.0,197.0,103.4,104.3,110.6,107.4,82,54,28,0.659,82,48,34,0.585,34,20,32,16,198.6,217.4,208.0
2019-04-10,1610612737,1610612754,2018,134.0,135.0,269.0,116.2,121.8,106.1,107.3,81,29,52,0.358,81,47,34,0.58,17,12,29,18,245.2,216.0,230.6
2019-04-10,1610612751,1610612748,2018,113.0,94.0,207.0,115.8,112.5,105.7,102.7,81,41,40,0.506,81,39,42,0.481,22,19,19,20,215.2,202.0,208.6
2019-04-10,1610612766,1610612753,2018,114.0,122.0,236.0,112.4,111.3,117.2,108.5,81,39,42,0.481,81,41,40,0.506,25,14,25,16,231.4,230.0,230.7
2019-04-10,1610612752,1610612765,2018,89.0,115.0,204.0,99.0,111.3,102.4,106.0,81,17,64,0.21,81,40,41,0.494,9,8,26,14,215.8,197.4,206.60000000000002
2019-04-10,1610612755,1610612741,2018,125.0,109.0,234.0,114.9,114.5,100.5,113.7,81,50,31,0.617,81,22,59,0.272,30,20,9,13,231.6,206.4,219.0
2019-04-10,1610612763,1610612744,2018,132.0,117.0,249.0,109.0,114.3,121.0,105.8,81,32,49,0.395,81,57,24,0.7040000000000001,20,12,30,27,231.4,229.8,230.60000000000002
2019-04-10,1610612749,1610612760,2018,116.0,127.0,243.0,121.5,114.1,111.7,109.2,81,60,21,0.741,81,48,33,0.593,33,27,27,21,232.6,221.4,227.0
2019-04-10,1610612759,1610612742,2018,105.0,94.0,199.0,111.2,108.5,114.3,111.0,81,47,34,0.58,81,33,48,0.407,31,16,24,9,220.8,230.2,225.5
2019-04-10,1610612743,1610612750,2018,99.0,95.0,194.0,103.7,104.8,109.8,116.8,81,53,28,0.654,81,36,45,0.444,33,20,25,11,200.2,235.8,218.0
2019-04-10,1610612746,1610612762,2018,143.0,137.0,280.0,115.8,116.1,118.3,105.8,81,47,34,0.58,81,50,31,0.617,25,22,29,21,230.0,224.6,227.3
2019-04-10,1610612757,1610612758,2018,136.0,131.0,267.0,117.6,111.0,114.1,115.6,81,52,29,0.642,81,39,42,0.481,31,21,24,15,238.6,229.8,234.2
2019-04-09,1610612739,1610612766,2018,97.0,124.0,221.0,108.6,116.6,111.5,114.5,81,19,62,0.235,80,38,42,0.475,13,6,25,13,219.2,231.4,225.3
2019-04-09,1610612765,1610612763,2018,100.0,93.0,193.0,103.4,107.4,111.6,116.6,80,39,41,0.488,80,32,48,0.4,25,14,20,12,202.2,231.4,216.8
2019-04-09,1610612764,1610612738,2018,110.0,116.0,226.0,109.6,116.2,109.1,110.1,81,32,49,0.395,81,48,33,0.593,22,10,28,20,224.6,219.0,221.8
2019-04-09,1610612748,1610612755,2018,122.0,99.0,221.0,103.3,104.1,114.8,114.2,80,38,42,0.475,80,50,30,0.625,18,20,30,20,200.0,231.6,215.8
2019-04-09,1610612741,1610612752,2018,86.0,96.0,182.0,104.5,116.1,99.2,113.0,80,22,58,0.275,80,16,64,0.2,9,13,9,7,219.2,215.8,217.5
2019-04-09,1610612750,1610612761,2018,100.0,120.0,220.0,112.9,117.8,116.3,107.7,80,36,44,0.45,81,57,24,0.7040000000000001,25,11,32,25,244.0,225.0,234.5
2019-04-09,1610612740,1610612744,2018,103.0,112.0,215.0,114.2,124.0,120.3,106.6,81,33,48,0.407,80,56,24,0.7,19,14,30,26,229.6,229.8,229.7
2019-04-09,1610612742,1610612756,2018,120.0,109.0,229.0,114.8,113.0,113.6,123.1,80,32,48,0.4,81,19,62,0.235,23,9,12,7,235.2,237.8,236.5
2019-04-09,1610612762,1610612743,2018,118.0,108.0,226.0,119.0,104.2,101.7,105.4,80,49,31,0.613,80,53,27,0.6629999999999999,28,21,33,20,222.8,200.2,211.5
2019-04-09,1610612760,1610612745,2018,112.0,111.0,223.0,111.2,108.0,120.8,103.9,80,47,33,0.588,81,53,28,0.654,26,21,31,22,218.0,223.6,220.8
2019-04-09,1610612747,1610612757,2018,101.0,104.0,205.0,112.3,111.2,119.0,110.7,81,37,44,0.457,80,51,29,0.638,22,15,31,20,222.2,238.6,230.39999999999998
2019-04-07,1610612761,1610612748,2018,117.0,109.0,226.0,117.4,106.0,101.1,104.0,80,56,24,0.7,79,38,41,0.481,31,25,18,20,223.8,200.0,211.9
2019-04-07,1610612739,1610612759,2018,90.0,112.0,202.0,112.2,115.5,110.5,110.6,80,19,61,0.238,80,46,34,0.575,13,6,31,15,224.2,220.8,222.5
2019-04-07,1610612750,1610612760,2018,126.0,132.0,258.0,111.4,116.8,109.0,107.2,79,36,43,0.456,79,46,33,0.5820000000000001,25,11,26,20,239.0,218.0,228.5
2019-04-07,1610612765,1610612766,2018,91.0,104.0,195.0,105.4,106.7,112.6,116.8,79,39,40,0.494,79,37,42,0.468,25,14,25,12,204.8,231.4,218.10000000000002
2019-04-07,1610612754,1610612751,2018,96.0,108.0,204.0,107.3,107.1,117.3,115.0,80,47,33,0.588,80,40,40,0.5,29,18,22,18,218.0,215.2,216.6
2019-04-07,1610612763,1610612742,2018,127.0,129.0,256.0,109.4,113.4,113.7,112.9,79,32,47,0.405,79,31,48,0.392,20,12,23,8,220.6,235.2,227.89999999999998
2019-04-07,1610612745,1610612756,2018,149.0,113.0,262.0,117.6,102.8,113.8,119.3,80,52,28,0.65,80,19,61,0.238,30,22,12,7,215.0,237.8,226.4
2019-04-07,1610612749,1610612737,2018,115.0,107.0,222.0,121.6,112.1,117.5,123.2,80,59,21,0.738,80,29,51,0.363,32,27,17,12,228.8,245.2,237.0
2019-04-07,1610612738,1610612753,2018,108.0,116.0,224.0,111.2,110.5,114.6,107.7,80,48,32,0.6,80,40,40,0.5,28,20,25,15,224.0,230.0,227.0
2019-04-07,1610612752,1610612764,2018,113.0,110.0,223.0,97.2,113.1,110.6,117.5,79,15,64,0.19,80,32,48,0.4,8,7,22,10,212.0,224.6,218.3
2019-04-07,1610612744,1610612746,2018,131.0,104.0,235.0,116.3,108.8,116.7,113.5,79,55,24,0.696,80,47,33,0.588,29,26,25,22,226.2,230.0,228.1
2019-04-07,1610612757,1610612743,2018,115.0,108.0,223.0,118.1,109.7,102.0,103.2,79,50,29,0.633,79,53,26,0.6709999999999999,30,20,33,20,234.8,200.2,217.5
2019-04-07,1610612758,1610612740,2018,129.0,133.0,262.0,113.3,114.6,112.4,122.3,80,39,41,0.488,80,32,48,0.4,24,15,19,13,226.2,229.6,227.89999999999998
2019-04-07,1610612747,1610612762,2018,113.0,109.0,222.0,111.6,111.4,119.7,102.4,80,36,44,0.45,79,49,30,0.62,21,15,28,21,221.2,222.8,222.0
2019-04-06,1610612749,1610612751,2018,128.0,133.0,261.0,120.3,108.9,115.6,114.1,79,59,20,0.747,79,39,40,0.494,32,27,22,17,219.8,215.2,217.5
2019-04-06,1610612741,1610612755,2018,96.0,116.0,212.0,105.6,116.8,115.9,117.5,79,22,57,0.278,79,49,30,0.62,9,13,30,19,222.8,231.6,227.2
2019-04-05,1610612766,1610612761,2018,113.0,111.0,224.0,112.5,116.8,117.0,105.7,78,36,42,0.462,79,56,23,0.7090000000000001,24,12,31,25,231.2,223.8,227.5
2019-04-05,1610612753,1610612737,2018,149.0,113.0,262.0,109.8,105.5,117.5,119.7,79,39,40,0.494,79,29,50,0.3670000000000001,24,15,17,12,216.0,245.2,230.6
2019-04-05,1610612764,1610612759,2018,112.0,129.0,241.0,112.9,117.4,108.8,109.9,79,32,47,0.405,79,45,34,0.57,22,10,31,14,229.0,220.8,224.9
2019-04-05,1610612754,1610612738,2018,97.0,117.0,214.0,107.9,105.2,111.0,112.6,79,47,32,0.595,79,47,32,0.595,29,18,28,19,215.4,224.0,219.7
2019-04-05,1610612745,1610612752,2018,120.0,96.0,216.0,116.4,103.4,96.8,111.4,79,51,28,0.6459999999999999,78,15,63,0.192,29,22,8,7,213.8,212.0,212.9
2019-04-05,1610612750,1610612748,2018,111.0,109.0,220.0,111.0,117.6,101.2,103.4,78,35,43,0.449,78,38,40,0.487,24,11,18,20,239.8,200.0,219.9
2019-04-05,1610612760,1610612765,2018,123.0,110.0,233.0,108.1,108.5,106.2,104.2,78,45,33,0.5770000000000001,78,39,39,0.5,25,20,25,14,218.8,204.8,211.8
2019-04-05,1610612742,1610612763,2018,112.0,122.0,234.0,114.6,112.3,110.0,115.7,78,31,47,0.397,78,31,47,0.397,23,8,20,11,235.8,220.6,228.2
2019-04-05,1610612762,1610612758,2018,119.0,98.0,217.0,119.2,102.4,114.1,113.8,78,48,30,0.615,79,39,40,0.494,27,21,24,15,221.8,226.2,224.0
2019-04-05,1610612756,1610612740,2018,133.0,126.0,259.0,110.3,118.5,111.8,120.2,79,18,61,0.228,79,32,47,0.405,11,7,19,13,229.2,229.6,229.39999999999998
2019-04-05,1610612743,1610612757,2018,119.0,110.0,229.0,100.1,102.1,117.4,108.6,78,52,26,0.667,78,50,28,0.6409999999999999,32,20,30,20,194.2,234.8,214.5
2019-04-05,1610612744,1610612739,2018,120.0,114.0,234.0,115.5,106.3,111.3,116.2,78,54,24,0.6920000000000001,79,19,60,0.241,28,26,13,6,219.6,224.2,221.89999999999998
2019-04-05,1610612746,1610612747,2018,117.0,122.0,239.0,116.9,112.9,111.7,112.1,79,47,32,0.595,79,35,44,0.443,25,22,21,14,229.2,221.2,225.2
2019-04-04,1610612755,1610612749,2018,122.0,128.0,250.0,114.3,113.6,120.5,108.0,78,49,29,0.628,78,58,20,0.7440000000000001,30,19,32,26,220.6,219.8,220.2
2019-04-04,1610612758,1610612739,2018,117.0,104.0,221.0,115.3,113.6,112.5,116.6,78,38,40,0.487,78,19,59,0.244,23,15,13,6,228.2,224.2,226.2
2019-04-04,1610612747,1610612744,2018,90.0,108.0,198.0,113.4,113.3,115.7,106.1,78,35,43,0.449,77,53,24,0.688,21,14,28,25,227.0,219.6,223.3
2019-04-03,1610612765,1610612754,2018,89.0,108.0,197.0,110.4,104.2,106.9,106.9,77,39,38,0.506,78,46,32,0.59,25,14,29,17,213.2,215.4,214.3
2019-04-03,1610612753,1610612752,2018,114.0,100.0,214.0,110.4,104.6,96.4,110.7,78,38,40,0.487,77,15,62,0.195,23,15,8,7,215.4,212.0,213.7
2019-04-03,1610612764,1610612741,2018,114.0,115.0,229.0,112.5,117.5,106.2,118.2,78,32,46,0.41,78,21,57,0.269,22,10,9,12,228.4,222.8,225.60000000000002
2019-04-03,1610612737,1610612755,2018,130.0,122.0,252.0,115.0,119.6,113.9,112.0,78,28,50,0.359,77,49,28,0.636,16,12,30,19,240.0,220.6,230.3
2019-04-03,1610612751,1610612761,2018,105.0,115.0,220.0,117.8,111.4,115.6,107.8,78,39,39,0.5,78,55,23,0.705,22,17,31,24,214.2,223.8,219.0
2019-04-03,1610612748,1610612738,2018,102.0,112.0,214.0,101.8,99.6,111.3,116.4,77,38,39,0.494,78,46,32,0.59,18,20,28,18,193.6,224.0,208.8
2019-04-03,1610612740,1610612766,2018,109.0,115.0,224.0,114.5,122.5,108.5,115.2,78,32,46,0.41,77,35,42,0.455,19,13,24,11,239.6,231.2,235.39999999999998
2019-04-03,1610612742,1610612750,2018,108.0,110.0,218.0,114.3,112.5,110.7,120.1,77,31,46,0.403,77,34,43,0.442,23,8,24,10,235.6,239.8,237.7
2019-04-03,1610612743,1610612759,2018,113.0,85.0,198.0,102.1,104.3,111.4,109.0,77,51,26,0.662,78,45,33,0.5770000000000001,31,20,31,14,202.6,220.8,211.7
2019-04-03,1610612756,1610612762,2018,97.0,118.0,215.0,110.7,118.3,118.8,102.4,78,18,60,0.231,77,47,30,0.61,11,7,27,20,229.6,221.8,225.7
2019-04-03,1610612757,1610612763,2018,116.0,89.0,205.0,118.5,111.7,112.2,117.3,77,49,28,0.636,77,31,46,0.403,29,20,20,11,243.2,220.6,231.89999999999998
2019-04-03,1610612746,1610612745,2018,103.0,135.0,238.0,119.4,111.5,115.0,103.6,78,47,31,0.603,78,50,28,0.6409999999999999,25,22,29,21,231.4,213.8,222.60000000000002
2019-04-02,1610612760,1610612747,2018,119.0,103.0,222.0,106.9,109.8,112.8,112.5,77,44,33,0.5710000000000001,77,35,42,0.455,24,20,21,14,219.0,227.0,223.0
2019-04-02,1610612759,1610612737,2018,117.0,111.0,228.0,110.5,108.2,116.2,119.7,77,44,33,0.5710000000000001,77,28,49,0.364,30,14,16,12,217.4,240.0,228.7
2019-04-02,1610612758,1610612745,2018,105.0,130.0,235.0,115.7,111.7,111.4,102.4,77,38,39,0.494,77,49,28,0.636,23,15,29,20,225.2,213.8,219.5
2019-04-02,1610612744,1610612743,2018,116.0,102.0,218.0,115.2,107.4,103.2,103.5,76,52,24,0.684,76,51,25,0.6709999999999999,27,25,31,20,221.2,202.6,211.89999999999998
2019-04-01,1610612754,1610612765,2018,111.0,102.0,213.0,106.3,106.3,112.1,105.7,77,45,32,0.584,76,39,37,0.513,28,17,25,14,213.0,213.2,213.1
2019-04-01,1610612738,1610612748,2018,110.0,105.0,215.0,112.9,117.9,102.9,99.3,77,45,32,0.584,76,38,38,0.5,27,18,18,20,230.2,193.6,211.89999999999998
2019-04-01,1610612751,1610612749,2018,121.0,131.0,252.0,116.9,110.6,118.8,108.0,77,39,38,0.506,77,57,20,0.74,22,17,32,25,210.8,219.8,215.3
2019-04-01,1610612752,1610612741,2018,113.0,105.0,218.0,96.7,113.9,106.5,120.0,76,14,62,0.184,77,21,56,0.273,7,7,9,12,219.0,222.8,220.9
2019-04-01,1610612761,1610612753,2018,121.0,109.0,230.0,114.6,106.7,109.2,103.0,77,54,23,0.701,77,38,39,0.494,30,24,23,15,219.6,215.4,217.5
2019-04-01,1610612750,1610612757,2018,122.0,132.0,254.0,108.8,116.1,117.5,110.5,76,34,42,0.447,76,48,28,0.632,24,10,29,19,228.0,243.2,235.6
2019-04-01,1610612742,1610612755,2018,122.0,102.0,224.0,111.4,111.7,116.7,112.3,76,30,46,0.395,76,49,27,0.645,22,8,30,19,228.2,220.6,224.39999999999998
2019-04-01,1610612762,1610612766,2018,111.0,102.0,213.0,119.7,102.2,109.9,115.1,76,46,30,0.605,76,35,41,0.461,26,20,24,11,223.2,231.2,227.2
2019-04-01,1610612756,1610612739,2018,122.0,113.0,235.0,108.2,118.4,110.3,116.4,77,17,60,0.221,77,19,58,0.247,10,7,13,6,224.8,224.2,224.5
2019-03-31,1610612737,1610612749,2018,136.0,135.0,271.0,115.8,117.3,115.8,105.8,76,27,49,0.355,76,57,19,0.75,15,12,32,25,234.4,219.8,227.10000000000002
2019-03-31,1610612760,1610612742,2018,103.0,106.0,209.0,105.4,110.2,110.7,111.4,76,44,32,0.579,75,29,46,0.387,24,20,22,7,216.8,228.2,222.5
2019-03-31,1610612740,1610612747,2018,102.0,130.0,232.0,115.3,121.7,109.6,113.4,77,32,45,0.416,76,34,42,0.447,19,13,21,13,239.6,227.0,233.3
2019-03-31,1610612759,1610612758,2018,106.0,113.0,219.0,110.8,105.2,115.8,113.4,76,44,32,0.579,76,37,39,0.487,30,14,23,14,212.0,225.2,218.6
2019-03-31,1610612743,1610612764,2018,90.0,95.0,185.0,105.4,106.0,116.0,122.0,75,51,24,0.68,77,31,46,0.403,31,20,22,9,212.0,228.4,220.2
2019-03-31,1610612744,1610612766,2018,137.0,90.0,227.0,113.7,108.9,111.5,113.2,75,51,24,0.68,75,35,40,0.467,26,25,24,11,221.2,231.2,226.2
2019-03-31,1610612746,1610612763,2018,113.0,96.0,209.0,118.5,114.4,112.1,115.9,77,46,31,0.597,76,31,45,0.408,24,22,20,11,235.4,220.6,228.0
2019-03-30,1610612746,1610612739,2018,132.0,108.0,240.0,119.3,115.1,109.4,113.8,76,45,31,0.5920000000000001,76,19,57,0.25,23,22,13,6,238.4,224.2,231.3
2019-03-30,1610612751,1610612738,2018,110.0,96.0,206.0,117.5,113.5,115.3,117.6,76,38,38,0.5,76,45,31,0.5920000000000001,21,17,27,18,217.8,230.2,224.0
2019-03-30,1610612745,1610612758,2018,119.0,108.0,227.0,109.9,102.2,117.0,114.1,76,48,28,0.632,75,37,38,0.493,28,20,23,14,210.4,225.2,217.8
2019-03-30,1610612765,1610612757,2018,99.0,90.0,189.0,115.3,108.1,121.0,111.0,75,38,37,0.507,75,48,27,0.64,24,14,29,19,224.4,243.2,233.8
2019-03-30,1610612754,1610612753,2018,116.0,121.0,237.0,105.9,105.9,107.7,102.8,76,45,31,0.5920000000000001,76,37,39,0.487,28,17,23,14,211.4,215.4,213.4
2019-03-30,1610612752,1610612748,2018,92.0,100.0,192.0,99.9,116.2,102.0,98.5,75,14,61,0.187,75,37,38,0.493,7,7,18,19,230.0,193.6,211.8
2019-03-30,1610612741,1610612761,2018,101.0,124.0,225.0,106.8,118.8,114.7,107.0,76,21,55,0.276,76,53,23,0.6970000000000001,9,12,30,23,221.0,219.6,220.3
2019-03-30,1610612750,1610612755,2018,109.0,118.0,227.0,111.4,117.3,114.0,112.1,75,34,41,0.453,75,48,27,0.64,24,10,30,18,235.6,220.6,228.1
2019-03-30,1610612756,1610612763,2018,115.0,120.0,235.0,107.4,116.0,111.2,112.5,76,17,59,0.224,75,30,45,0.4,10,7,20,10,218.4,220.6,219.5
2019-03-29,1610612738,1610612754,2018,114.0,112.0,226.0,114.3,117.9,104.7,104.7,75,44,31,0.5870000000000001,75,45,30,0.6,26,18,28,17,228.8,211.4,220.10000000000002
2019-03-29,1610612737,1610612757,2018,98.0,118.0,216.0,118.8,117.1,120.3,113.2,75,27,48,0.36,74,47,27,0.635,15,12,29,18,240.0,243.2,241.6
2019-03-29,1610612750,1610612744,2018,131.0,130.0,261.0,111.4,116.3,111.3,106.2,74,33,41,0.446,74,51,23,0.6890000000000001,23,10,26,25,233.6,221.2,227.39999999999998
2019-03-29,1610612760,1610612743,2018,105.0,115.0,220.0,105.7,108.3,105.3,106.0,75,44,31,0.5870000000000001,74,50,24,0.6759999999999999,24,20,31,19,213.6,212.0,212.8
2019-03-29,1610612762,1610612764,2018,128.0,124.0,252.0,115.8,99.6,114.7,120.4,75,45,30,0.6,76,31,45,0.408,25,20,22,9,210.2,228.4,219.3
2019-03-29,1610612747,1610612766,2018,129.0,115.0,244.0,106.6,113.4,111.4,113.4,75,33,42,0.44,74,35,39,0.473,20,13,24,11,221.0,231.2,226.1
2019-03-28,1610612765,1610612753,2018,115.0,98.0,213.0,115.0,109.0,107.2,102.0,74,37,37,0.5,75,37,38,0.493,23,14,23,14,225.6,215.4,220.5
2019-03-28,1610612755,1610612751,2018,123.0,110.0,233.0,113.1,111.7,116.3,112.6,74,47,27,0.635,75,38,37,0.507,29,18,21,17,218.0,217.8,217.9
2019-03-28,1610612748,1610612742,2018,105.0,99.0,204.0,101.9,101.1,111.4,112.0,74,36,38,0.486,74,29,45,0.392,17,19,22,7,198.6,228.2,213.39999999999998
2019-03-28,1610612752,1610612761,2018,92.0,117.0,209.0,100.1,114.7,115.7,108.2,74,14,60,0.189,75,52,23,0.693,7,7,30,22,227.4,219.6,223.5
2019-03-28,1610612745,1610612743,2018,112.0,85.0,197.0,110.5,104.3,107.3,107.0,75,47,28,0.627,73,50,23,0.685,27,20,31,19,215.8,212.0,213.9
2019-03-28,1610612749,1610612746,2018,128.0,118.0,246.0,115.5,107.0,119.1,113.2,75,56,19,0.747,75,45,30,0.6,31,25,23,22,221.6,238.4,230.0
2019-03-28,1610612740,1610612758,2018,121.0,118.0,239.0,114.5,122.9,116.7,114.1,76,31,45,0.408,74,37,37,0.5,18,13,23,14,240.4,225.2,232.8
2019-03-28,1610612759,1610612739,2018,116.0,110.0,226.0,111.3,105.6,109.4,114.8,75,43,32,0.573,75,19,56,0.253,29,14,13,6,213.8,224.2,219.0
2019-03-27,1610612741,1610612757,2018,98.0,118.0,216.0,107.8,117.7,120.3,114.2,75,21,54,0.28,73,46,27,0.63,9,12,29,17,220.8,243.2,232.0
2019-03-27,1610612763,1610612744,2018,103.0,118.0,221.0,112.3,111.1,111.5,107.6,74,30,44,0.405,73,50,23,0.685,20,10,26,24,220.0,221.2,220.6
2019-03-27,1610612760,1610612754,2018,107.0,99.0,206.0,104.9,107.9,103.7,104.6,74,43,31,0.581,74,45,29,0.608,23,20,28,17,211.2,211.4,211.3
2019-03-27,1610612756,1610612764,2018,121.0,124.0,245.0,106.7,114.1,111.9,119.0,75,17,58,0.227,75,30,45,0.4,10,7,22,8,213.2,228.4,220.8
2019-03-27,1610612762,1610612747,2018,115.0,100.0,215.0,115.5,101.1,108.9,112.6,74,44,30,0.595,74,33,41,0.446,24,20,20,13,212.6,221.0,216.8
2019-03-26,1610612766,1610612759,2018,125.0,116.0,241.0,107.3,110.9,108.2,103.2,73,34,39,0.466,74,43,31,0.581,23,11,29,14,218.0,213.8,215.9
2019-03-26,1610612739,1610612738,2018,106.0,116.0,222.0,109.5,112.5,113.8,118.2,74,19,55,0.257,74,43,31,0.581,13,6,26,17,219.8,228.8,224.3
2019-03-26,1610612748,1610612753,2018,99.0,104.0,203.0,104.6,101.7,108.5,103.3,73,36,37,0.493,74,36,38,0.486,17,19,23,13,205.2,215.4,210.3
2019-03-26,1610612761,1610612741,2018,112.0,103.0,215.0,114.0,108.6,107.1,117.0,74,51,23,0.6890000000000001,74,21,53,0.284,29,22,9,12,217.0,220.8,218.9
2019-03-26,1610612749,1610612745,2018,108.0,94.0,202.0,117.8,109.0,111.8,103.0,74,55,19,0.743,74,47,27,0.635,30,25,27,20,230.2,215.8,223.0
2019-03-26,1610612750,1610612746,2018,111.0,122.0,233.0,111.5,114.6,117.4,113.2,73,33,40,0.452,74,44,30,0.595,23,10,23,21,230.4,238.4,234.4
2019-03-26,1610612740,1610612737,2018,120.0,130.0,250.0,112.9,122.6,116.9,117.0,75,31,44,0.413,74,26,48,0.35100000000000003,18,13,15,11,236.6,240.0,238.3
2019-03-26,1610612742,1610612758,2018,121.0,125.0,246.0,107.4,110.6,114.4,111.4,73,29,44,0.397,73,36,37,0.493,22,7,23,13,217.4,225.2,221.3
2019-03-26,1610612743,1610612765,2018,95.0,92.0,187.0,108.2,108.9,113.2,110.3,72,49,23,0.6809999999999999,73,37,36,0.507,30,19,23,14,217.6,225.6,221.6
2019-03-26,1610612747,1610612764,2018,124.0,106.0,230.0,107.0,113.3,113.8,118.2,73,32,41,0.438,74,30,44,0.405,19,13,22,8,218.6,228.4,223.5
2019-03-25,1610612753,1610612755,2018,119.0,98.0,217.0,107.7,104.1,114.0,110.6,73,35,38,0.479,73,47,26,0.644,22,13,29,18,215.4,218.0,216.7
2019-03-25,1610612763,1610612760,2018,115.0,103.0,218.0,112.8,111.9,107.5,108.5,73,29,44,0.397,73,43,30,0.589,19,10,23,20,222.6,211.2,216.89999999999998
2019-03-25,1610612762,1610612756,2018,125.0,92.0,217.0,114.5,103.0,109.5,114.3,73,43,30,0.589,74,17,57,0.23,23,20,10,7,214.4,213.2,213.8
2019-03-25,1610612757,1610612751,2018,148.0,144.0,292.0,117.6,112.7,111.5,108.6,72,45,27,0.625,74,38,36,0.514,28,17,21,17,234.8,217.8,226.3
2019-03-24,1610612752,1610612746,2018,113.0,124.0,237.0,100.6,114.8,114.6,114.2,73,14,59,0.192,73,43,30,0.589,7,7,23,20,228.6,238.4,233.5
2019-03-24,1610612749,1610612739,2018,127.0,105.0,232.0,116.8,108.3,109.7,111.1,73,54,19,0.74,73,19,54,0.26,29,25,13,6,226.8,219.8,223.3
2019-03-24,1610612754,1610612743,2018,124.0,88.0,212.0,103.5,107.3,110.9,106.4,73,44,29,0.603,71,49,22,0.69,27,17,30,19,216.4,217.6,217.0
2019-03-24,1610612761,1610612766,2018,114.0,115.0,229.0,114.5,108.8,108.1,110.7,73,51,22,0.6990000000000001,72,33,39,0.458,29,22,23,10,218.4,218.0,218.2
2019-03-24,1610612740,1610612745,2018,90.0,113.0,203.0,114.3,122.7,112.0,104.4,74,31,43,0.419,73,46,27,0.63,18,13,27,19,239.6,215.8,227.7
2019-03-24,1610612738,1610612759,2018,96.0,115.0,211.0,114.9,116.3,108.5,106.6,73,43,30,0.589,73,42,31,0.575,26,17,29,13,227.2,213.8,220.5
2019-03-24,1610612744,1610612765,2018,121.0,114.0,235.0,108.9,109.0,109.3,108.5,72,49,23,0.6809999999999999,72,37,35,0.514,25,24,23,14,218.8,225.6,222.2
2019-03-24,1610612747,1610612758,2018,111.0,106.0,217.0,107.9,115.8,114.3,111.5,72,31,41,0.431,72,36,36,0.5,18,13,23,13,225.4,225.2,225.3
2019-03-23,1610612766,1610612738,2018,124.0,117.0,241.0,106.5,110.8,116.0,113.4,71,32,39,0.451,72,43,29,0.597,22,10,26,17,215.0,227.2,221.1
2019-03-23,1610612764,1610612748,2018,108.0,113.0,221.0,113.0,115.9,105.1,103.0,73,30,43,0.411,72,35,37,0.486,22,8,17,18,222.2,205.2,213.7
2019-03-23,1610612737,1610612755,2018,129.0,127.0,256.0,115.2,115.7,112.1,108.1,73,25,48,0.342,72,47,25,0.653,14,11,29,18,234.0,218.0,226.0
2019-03-23,1610612741,1610612762,2018,83.0,114.0,197.0,110.6,117.9,113.5,106.1,73,21,52,0.28800000000000003,72,42,30,0.583,9,12,23,19,229.6,214.4,222.0
2019-03-23,1610612763,1610612750,2018,99.0,112.0,211.0,113.6,111.6,111.7,117.8,72,29,43,0.403,72,32,40,0.444,19,10,23,9,223.6,230.4,227.0
2019-03-23,1610612744,1610612742,2018,91.0,126.0,217.0,111.0,108.2,107.1,114.7,71,49,22,0.69,72,28,44,0.389,25,24,22,6,221.4,217.4,219.4
2019-03-23,1610612757,1610612765,2018,117.0,112.0,229.0,118.8,112.2,109.3,107.2,71,44,27,0.62,71,37,34,0.521,27,17,23,14,236.2,225.6,230.89999999999998
2019-03-23,1610612758,1610612756,2018,112.0,103.0,215.0,114.6,112.0,111.6,115.2,71,35,36,0.493,73,17,56,0.233,22,13,10,7,226.8,213.2,220.0
2019-03-22,1610612753,1610612763,2018,123.0,119.0,242.0,105.7,101.8,112.4,110.5,72,34,38,0.472,71,29,42,0.408,21,13,19,10,206.8,223.6,215.2
2019-03-22,1610612739,1610612746,2018,108.0,110.0,218.0,108.2,113.0,114.8,114.0,72,19,53,0.264,72,42,30,0.583,13,6,23,19,220.6,238.4,229.5
2019-03-22,1610612752,1610612743,2018,93.0,111.0,204.0,102.1,114.0,110.1,107.5,72,14,58,0.194,70,48,22,0.6859999999999999,7,7,30,18,230.0,217.6,223.8
2019-03-22,1610612761,1610612760,2018,109.0,116.0,225.0,115.4,106.7,107.9,110.7,72,51,21,0.708,72,42,30,0.583,29,22,23,19,216.0,211.2,213.6
2019-03-22,1610612745,1610612759,2018,111.0,105.0,216.0,111.6,103.0,109.7,107.5,72,45,27,0.625,72,42,30,0.583,26,19,29,13,212.2,213.8,213.0
2019-03-22,1610612749,1610612748,2018,116.0,87.0,203.0,119.2,112.4,106.6,102.0,72,53,19,0.736,71,35,36,0.493,28,25,17,18,239.8,205.2,222.5
2019-03-22,1610612747,1610612751,2018,106.0,111.0,217.0,109.8,116.6,111.8,109.2,71,31,40,0.4370000000000001,73,37,36,0.507,18,13,21,16,230.8,217.8,224.3
2019-03-21,1610612766,1610612750,2018,113.0,106.0,219.0,106.5,112.0,113.2,120.0,70,31,39,0.443,71,32,39,0.451,21,10,23,9,217.4,230.4,223.9
2019-03-21,1610612764,1610612743,2018,108.0,113.0,221.0,114.3,116.1,110.2,107.1,72,30,42,0.417,69,47,22,0.6809999999999999,22,8,30,17,225.2,217.6,221.39999999999998
2019-03-21,1610612737,1610612762,2018,117.0,114.0,231.0,113.9,115.4,113.5,104.8,72,24,48,0.333,71,42,29,0.5920000000000001,13,11,23,19,230.8,214.4,222.60000000000002
2019-03-21,1610612756,1610612765,2018,98.0,118.0,216.0,113.6,114.3,110.4,106.7,72,17,55,0.236,70,36,34,0.514,10,7,23,13,215.4,225.6,220.5
2019-03-21,1610612758,1610612742,2018,116.0,100.0,216.0,113.9,113.6,105.9,115.8,70,34,36,0.486,71,28,43,0.394,21,13,22,6,228.6,217.4,223.0
2019-03-21,1610612744,1610612754,2018,112.0,89.0,201.0,112.3,111.6,104.4,107.8,70,48,22,0.6859999999999999,72,44,28,0.611,24,24,27,17,230.8,216.4,223.60000000000002
2019-03-20,1610612739,1610612749,2018,107.0,102.0,209.0,108.5,115.1,120.1,113.2,71,18,53,0.254,71,53,18,0.746,12,6,28,25,225.4,239.8,232.60000000000002
2019-03-20,1610612753,1610612740,2018,119.0,96.0,215.0,104.7,103.2,117.7,122.4,71,33,38,0.465,73,31,42,0.425,20,13,18,13,207.6,239.6,223.6
2019-03-20,1610612755,1610612738,2018,118.0,115.0,233.0,112.0,108.6,114.0,113.4,71,46,25,0.648,71,43,28,0.606,28,18,26,17,218.8,227.2,223.0
2019-03-20,1610612752,1610612762,2018,116.0,137.0,253.0,103.5,112.1,110.9,103.6,71,14,57,0.197,70,41,29,0.586,7,7,23,18,229.0,214.4,221.7
2019-03-20,1610612741,1610612764,2018,126.0,120.0,246.0,108.6,117.6,113.3,115.8,72,20,52,0.278,71,30,41,0.423,8,12,22,8,225.0,225.2,225.1
2019-03-20,1610612763,1610612745,2018,126.0,125.0,251.0,110.8,108.5,110.9,101.7,70,28,42,0.4,71,45,26,0.634,18,10,26,19,216.4,212.2,214.3
2019-03-20,1610612759,1610612748,2018,105.0,110.0,215.0,109.6,106.8,106.8,101.6,71,42,29,0.5920000000000001,70,34,36,0.486,29,13,17,17,212.2,205.2,208.7
2019-03-20,1610612760,1610612761,2018,114.0,123.0,237.0,106.9,109.2,113.8,106.5,71,42,29,0.5920000000000001,71,50,21,0.7040000000000001,23,19,29,21,206.2,216.0,211.1
2019-03-20,1610612757,1610612742,2018,126.0,118.0,244.0,118.9,112.2,105.3,115.3,70,43,27,0.614,70,28,42,0.4,26,17,22,6,236.4,217.4,226.9
2019-03-19,1610612766,1610612755,2018,114.0,118.0,232.0,106.1,112.3,111.3,108.2,69,31,38,0.449,70,45,25,0.643,21,10,28,17,217.2,218.8,218.0
2019-03-19,1610612737,1610612745,2018,105.0,121.0,226.0,119.5,120.1,110.6,102.4,71,24,47,0.338,70,44,26,0.629,13,11,26,18,251.4,212.2,231.8
2019-03-19,1610612749,1610612747,2018,115.0,101.0,216.0,118.4,112.8,110.6,116.9,70,52,18,0.743,70,31,39,0.443,27,25,18,13,235.6,230.8,233.2
2019-03-19,1610612750,1610612744,2018,107.0,117.0,224.0,114.6,119.4,110.2,111.2,70,32,38,0.457,69,47,22,0.6809999999999999,23,9,24,23,232.0,230.8,231.4
2019-03-19,1610612758,1610612751,2018,121.0,123.0,244.0,115.8,115.4,108.3,108.8,69,34,35,0.493,72,36,36,0.5,21,13,21,15,236.0,217.8,226.9
2019-03-19,1610612746,1610612754,2018,115.0,109.0,224.0,115.1,114.1,103.6,107.3,71,41,30,0.5770000000000001,71,44,27,0.62,22,19,27,17,239.2,216.4,227.8
2019-03-18,1610612739,1610612765,2018,126.0,119.0,245.0,107.1,113.9,107.8,104.6,70,17,53,0.243,69,36,33,0.522,11,6,23,13,220.2,225.6,222.89999999999998
2019-03-18,1610612764,1610612762,2018,95.0,116.0,211.0,117.0,116.5,114.0,108.9,70,30,40,0.429,69,40,29,0.58,22,8,23,17,234.0,214.4,224.2
2019-03-18,1610612738,1610612743,2018,105.0,114.0,219.0,112.7,111.7,109.8,108.3,70,43,27,0.614,68,46,22,0.6759999999999999,26,17,30,16,221.2,217.6,219.39999999999998
2019-03-18,1610612761,1610612752,2018,128.0,92.0,220.0,110.8,108.6,105.1,110.8,70,49,21,0.7,70,14,56,0.2,28,21,7,7,214.2,229.0,221.6
2019-03-18,1610612760,1610612748,2018,107.0,116.0,223.0,107.8,109.5,103.9,101.2,70,42,28,0.6,69,33,36,0.478,23,19,17,16,208.6,205.2,206.89999999999998
2019-03-18,1610612759,1610612744,2018,111.0,105.0,216.0,110.1,106.5,112.2,112.7,70,41,29,0.586,68,47,21,0.691,28,13,24,23,212.6,230.8,221.7
2019-03-18,1610612742,1610612740,2018,125.0,129.0,254.0,103.8,112.5,116.7,122.4,69,28,41,0.406,72,30,42,0.417,22,6,18,12,208.8,239.6,224.2
2019-03-18,1610612756,1610612741,2018,101.0,116.0,217.0,115.1,115.7,113.8,123.6,71,17,54,0.239,71,19,52,0.268,10,7,8,11,221.2,225.0,223.1
2019-03-18,1610612757,1610612754,2018,106.0,98.0,204.0,119.1,114.2,104.7,108.0,69,42,27,0.609,70,44,26,0.629,25,17,27,17,240.8,216.4,228.60000000000002
2019-03-17,1610612752,1610612747,2018,124.0,123.0,247.0,103.1,110.0,108.8,115.5,69,13,56,0.188,69,31,38,0.449,6,7,18,13,223.4,230.8,227.10000000000002
2019-03-17,1610612748,1610612766,2018,93.0,75.0,168.0,106.0,105.0,107.5,115.7,68,32,36,0.471,68,31,37,0.456,16,16,21,10,217.0,217.2,217.1
2019-03-17,1610612749,1610612755,2018,125.0,130.0,255.0,114.2,110.1,110.9,106.8,69,52,17,0.754,69,44,25,0.638,27,25,28,16,221.8,218.8,220.3
2019-03-17,1610612765,1610612761,2018,110.0,107.0,217.0,108.1,104.8,110.5,107.5,68,35,33,0.515,69,49,20,0.71,22,13,28,21,226.6,214.2,220.39999999999998
2019-03-17,1610612753,1610612737,2018,101.0,91.0,192.0,107.3,103.0,124.1,122.9,70,32,38,0.457,70,24,46,0.343,19,13,13,11,212.4,251.4,231.9
2019-03-17,1610612758,1610612741,2018,129.0,102.0,231.0,114.6,115.6,114.5,121.4,68,33,35,0.485,70,19,51,0.271,20,13,8,11,234.0,225.0,229.5
2019-03-17,1610612745,1610612750,2018,117.0,102.0,219.0,111.0,104.0,115.9,119.9,69,43,26,0.623,69,32,37,0.464,25,18,23,9,216.2,232.0,224.1
2019-03-17,1610612746,1610612751,2018,119.0,116.0,235.0,116.0,113.2,108.4,108.4,70,40,30,0.5710000000000001,71,36,35,0.507,21,19,21,15,239.2,217.8,228.5
2019-03-16,1610612738,1610612737,2018,129.0,120.0,249.0,111.6,110.7,123.9,121.2,69,42,27,0.609,69,24,45,0.348,25,17,13,11,217.0,251.4,234.2
2019-03-16,1610612764,1610612763,2018,135.0,128.0,263.0,117.0,115.8,109.0,107.2,69,29,40,0.42,69,28,41,0.406,21,8,18,10,232.6,216.4,224.5
2019-03-16,1610612740,1610612756,2018,136.0,138.0,274.0,114.1,119.7,112.5,114.1,71,30,41,0.423,70,16,54,0.229,18,12,10,6,229.0,221.2,225.1
2019-03-16,1610612742,1610612739,2018,121.0,116.0,237.0,102.1,112.3,108.0,113.6,68,27,41,0.397,69,17,52,0.246,21,6,11,6,205.0,220.2,212.6
2019-03-16,1610612760,1610612744,2018,88.0,110.0,198.0,113.8,113.2,113.3,114.9,69,42,27,0.609,67,46,21,0.687,23,19,24,22,228.0,230.8,229.4
2019-03-16,1610612759,1610612757,2018,108.0,103.0,211.0,109.8,105.5,120.5,115.3,69,40,29,0.58,68,42,26,0.618,27,13,25,17,210.0,240.8,225.4
2019-03-16,1610612743,1610612754,2018,102.0,100.0,202.0,111.7,109.5,106.6,109.0,67,45,22,0.672,69,44,25,0.638,29,16,27,17,223.8,216.4,220.10000000000002
2019-03-16,1610612762,1610612751,2018,114.0,98.0,212.0,113.7,109.6,113.4,110.9,68,39,29,0.574,70,36,34,0.514,22,17,21,15,215.2,217.8,216.5
2019-03-15,1610612765,1610612747,2018,111.0,97.0,208.0,109.1,106.3,110.6,117.2,67,34,33,0.507,68,31,37,0.456,21,13,18,13,231.6,230.8,231.2
2019-03-15,1610612755,1610612758,2018,123.0,114.0,237.0,110.1,108.4,115.1,114.9,68,43,25,0.632,67,33,34,0.493,27,16,20,13,220.4,234.0,227.2
2019-03-15,1610612764,1610612766,2018,110.0,116.0,226.0,117.2,116.1,104.9,114.6,68,29,39,0.426,67,30,37,0.448,21,8,21,9,233.6,217.2,225.39999999999998
2019-03-15,1610612748,1610612749,2018,98.0,113.0,211.0,107.9,102.5,116.0,112.3,67,32,35,0.478,68,51,17,0.75,16,16,27,24,215.8,221.8,218.8
2019-03-15,1610612745,1610612756,2018,108.0,102.0,210.0,112.1,104.9,112.1,114.4,68,42,26,0.618,69,16,53,0.232,24,18,10,6,220.2,221.2,220.7
2019-03-15,1610612740,1610612757,2018,110.0,122.0,232.0,115.9,119.0,118.0,113.5,70,30,40,0.429,67,41,26,0.612,18,12,25,16,231.2,240.8,236.0
2019-03-15,1610612759,1610612752,2018,109.0,83.0,192.0,110.2,108.0,105.5,111.9,68,39,29,0.574,68,13,55,0.191,26,13,6,7,215.8,223.4,219.60000000000002
2019-03-15,1610612746,1610612741,2018,128.0,121.0,249.0,115.3,112.3,113.4,119.5,69,39,30,0.565,69,19,50,0.275,20,19,8,11,236.0,225.0,230.5
2019-03-14,1610612754,1610612760,2018,108.0,106.0,214.0,108.4,109.5,113.4,114.0,68,43,25,0.632,68,42,26,0.618,26,17,23,19,221.0,228.0,224.5
2019-03-14,1610612753,1610612739,2018,120.0,91.0,211.0,107.5,105.1,107.9,112.1,69,31,38,0.449,68,17,51,0.25,18,13,11,6,217.0,220.2,218.6
2019-03-14,1610612738,1610612758,2018,126.0,120.0,246.0,110.2,111.0,115.4,114.8,68,41,27,0.603,66,33,33,0.5,24,17,20,13,214.8,234.0,224.4
2019-03-14,1610612761,1610612747,2018,111.0,98.0,209.0,111.4,109.4,112.1,117.8,68,48,20,0.706,67,31,36,0.463,27,21,18,13,219.8,230.8,225.3
2019-03-14,1610612762,1610612750,2018,120.0,100.0,220.0,114.2,110.5,118.2,121.0,67,38,29,0.5670000000000001,68,32,36,0.471,21,17,23,9,218.0,232.0,225.0
2019-03-14,1610612743,1610612742,2018,100.0,99.0,199.0,114.0,109.2,103.1,114.8,66,44,22,0.667,67,27,40,0.403,28,16,21,6,227.8,205.0,216.4
2019-03-13,1610612764,1610612753,2018,100.0,90.0,190.0,119.1,117.7,108.8,105.9,67,28,39,0.418,68,31,37,0.456,20,8,18,13,240.6,217.0,228.8
2019-03-13,1610612760,1610612751,2018,108.0,96.0,204.0,114.6,115.5,116.3,112.8,67,41,26,0.612,69,36,33,0.522,22,19,21,15,233.4,217.8,225.60000000000002
2019-03-13,1610612748,1610612765,2018,108.0,74.0,182.0,109.7,107.6,113.6,105.1,66,31,35,0.47,66,34,32,0.515,15,16,21,13,229.6,231.6,230.6
2019-03-13,1610612737,1610612763,2018,132.0,111.0,243.0,123.8,122.4,107.4,105.7,68,23,45,0.338,68,28,40,0.412,12,11,18,10,253.6,216.4,235.0
2019-03-13,1610612745,1610612744,2018,104.0,106.0,210.0,113.7,104.7,113.4,117.4,67,42,25,0.627,66,45,21,0.682,24,18,24,21,223.0,230.8,226.9
2019-03-13,1610612756,1610612762,2018,97.0,114.0,211.0,113.1,114.7,113.6,112.3,68,16,52,0.235,66,37,29,0.561,10,6,21,16,223.8,218.0,220.9
2019-03-12,1610612754,1610612752,2018,103.0,98.0,201.0,107.8,110.3,106.3,110.7,67,42,25,0.627,67,13,54,0.194,25,17,6,7,221.4,223.4,222.4
2019-03-12,1610612755,1610612739,2018,106.0,99.0,205.0,110.1,108.7,108.6,113.4,67,42,25,0.627,67,17,50,0.254,26,16,11,6,221.0,220.2,220.6
2019-03-12,1610612741,1610612747,2018,107.0,123.0,230.0,115.3,118.8,111.8,121.4,68,19,49,0.279,66,30,36,0.455,8,11,18,12,227.4,230.8,229.10000000000002
2019-03-12,1610612740,1610612749,2018,113.0,130.0,243.0,117.7,118.2,117.1,115.0,69,30,39,0.435,67,50,17,0.746,18,12,27,23,233.2,221.8,227.5
2019-03-12,1610612742,1610612759,2018,105.0,112.0,217.0,102.7,114.8,109.8,108.2,66,27,39,0.409,67,38,29,0.5670000000000001,21,6,26,12,204.2,215.8,210.0
2019-03-12,1610612743,1610612750,2018,133.0,107.0,240.0,112.7,110.3,120.3,121.7,65,43,22,0.662,67,32,35,0.478,27,16,23,9,227.4,232.0,229.7
2019-03-12,1610612746,1610612757,2018,104.0,125.0,229.0,118.3,110.5,117.8,114.1,68,39,29,0.574,66,40,26,0.606,20,19,25,15,238.4,240.8,239.60000000000002
2019-03-11,1610612739,1610612761,2018,126.0,101.0,227.0,107.1,113.1,113.2,106.9,66,16,50,0.242,67,48,19,0.716,10,6,27,21,216.6,219.8,218.2
2019-03-11,1610612764,1610612758,2018,121.0,115.0,236.0,119.9,119.9,115.7,114.7,66,27,39,0.409,65,33,32,0.508,19,8,20,13,246.6,234.0,240.3
2019-03-11,1610612751,1610612765,2018,103.0,75.0,178.0,116.1,113.8,118.6,107.0,68,35,33,0.515,65,34,31,0.523,20,15,21,13,219.4,231.6,225.5
2019-03-11,1610612745,1610612766,2018,118.0,106.0,224.0,113.1,105.8,107.2,114.8,66,41,25,0.621,66,30,36,0.455,23,18,21,9,224.0,217.2,220.6
2019-03-11,1610612762,1610612760,2018,89.0,98.0,187.0,117.2,113.0,116.0,118.7,65,37,28,0.569,66,40,26,0.606,21,16,22,18,226.6,233.4,230.0
2019-03-11,1610612746,1610612738,2018,140.0,115.0,255.0,116.3,111.3,110.3,109.6,67,38,29,0.5670000000000001,67,41,26,0.612,19,19,24,17,236.0,214.8,225.4
2019-03-10,1610612765,1610612741,2018,131.0,108.0,239.0,117.5,106.5,117.0,116.3,64,33,31,0.516,67,19,48,0.284,20,13,8,11,228.4,227.4,227.9
2019-03-10,1610612748,1610612761,2018,104.0,125.0,229.0,111.4,107.5,112.6,107.2,65,31,34,0.477,66,47,19,0.7120000000000001,15,16,27,20,232.8,219.8,226.3
2019-03-10,1610612755,1610612754,2018,106.0,89.0,195.0,110.4,111.0,109.8,110.4,66,41,25,0.621,66,42,24,0.636,25,16,25,17,226.2,221.4,223.8
2019-03-10,1610612737,1610612740,2018,128.0,116.0,244.0,123.0,122.0,117.2,118.0,67,22,45,0.328,68,30,38,0.441,11,11,18,12,251.2,233.2,242.2
2019-03-10,1610612763,1610612753,2018,105.0,97.0,202.0,107.5,107.2,110.4,105.2,67,27,40,0.403,67,31,36,0.463,17,10,18,13,219.6,217.0,218.3
2019-03-10,1610612742,1610612745,2018,93.0,94.0,187.0,103.6,115.5,114.3,107.6,65,27,38,0.415,65,40,25,0.615,21,6,23,17,207.4,224.0,215.7
2019-03-10,1610612750,1610612752,2018,103.0,92.0,195.0,123.0,124.5,107.5,111.1,66,31,35,0.47,66,13,53,0.197,22,9,6,7,243.0,223.4,233.2
2019-03-10,1610612759,1610612749,2018,121.0,114.0,235.0,109.4,108.2,117.4,113.5,66,37,29,0.561,66,50,16,0.758,25,12,27,23,215.0,221.8,218.4
2019-03-10,1610612744,1610612756,2018,111.0,115.0,226.0,113.8,116.7,112.3,117.0,65,45,20,0.6920000000000001,67,15,52,0.224,24,21,10,5,230.2,223.8,227.0
2019-03-09,1610612752,1610612758,2018,94.0,102.0,196.0,109.2,113.5,116.3,117.5,65,13,52,0.2,64,32,32,0.5,6,7,20,12,231.6,234.0,232.8
2019-03-09,1610612737,1610612751,2018,112.0,114.0,226.0,124.0,123.1,113.6,112.8,66,22,44,0.333,67,34,33,0.507,11,11,20,14,255.4,219.4,237.4
2019-03-09,1610612750,1610612764,2018,135.0,130.0,265.0,120.1,122.2,118.9,119.3,65,30,35,0.462,65,27,38,0.415,21,9,19,8,232.6,246.6,239.6
2019-03-09,1610612747,1610612738,2018,107.0,120.0,227.0,112.2,120.0,108.0,108.7,65,30,35,0.462,66,40,26,0.606,18,12,24,16,228.8,214.8,221.8
2019-03-09,1610612749,1610612766,2018,131.0,114.0,245.0,119.1,115.0,105.1,111.6,65,49,16,0.754,65,30,35,0.462,26,23,21,9,228.2,217.2,222.7
2019-03-09,1610612757,1610612756,2018,127.0,120.0,247.0,118.3,112.6,110.7,116.0,65,39,26,0.6,66,15,51,0.227,24,15,10,5,238.8,223.8,231.3
2019-03-08,1610612766,1610612764,2018,112.0,111.0,223.0,105.4,112.2,119.0,120.2,64,29,35,0.453,64,27,37,0.422,20,9,19,8,219.0,246.6,232.8
2019-03-08,1610612753,1610612742,2018,111.0,106.0,217.0,109.5,103.5,103.4,116.4,66,30,36,0.455,64,27,37,0.422,17,13,21,6,211.8,207.4,209.60000000000002
2019-03-08,1610612748,1610612739,2018,126.0,110.0,236.0,108.4,108.4,106.5,110.6,64,30,34,0.469,65,16,49,0.246,14,16,10,6,228.6,216.6,222.6
2019-03-08,1610612741,1610612765,2018,104.0,112.0,216.0,118.8,116.1,117.3,107.9,66,19,47,0.28800000000000003,63,32,31,0.508,8,11,20,12,230.6,228.4,229.5
2019-03-08,1610612745,1610612755,2018,107.0,91.0,198.0,115.2,110.6,112.1,111.8,64,39,25,0.609,65,41,24,0.631,22,17,25,16,231.8,226.2,229.0
2019-03-08,1610612763,1610612762,2018,114.0,104.0,218.0,106.8,107.6,117.3,114.8,66,26,40,0.394,64,37,27,0.578,16,10,21,16,219.0,226.6,222.8
2019-03-08,1610612740,1610612761,2018,104.0,127.0,231.0,115.6,117.1,112.2,108.8,67,30,37,0.448,65,46,19,0.708,18,12,27,19,228.2,219.8,224.0
2019-03-08,1610612744,1610612743,2018,122.0,105.0,227.0,113.6,118.0,115.2,111.6,64,44,20,0.688,64,43,21,0.672,23,21,27,16,232.4,227.4,229.9
2019-03-08,1610612746,1610612760,2018,118.0,110.0,228.0,116.3,112.6,117.2,120.0,66,37,29,0.561,65,40,25,0.615,18,19,22,18,238.6,233.4,236.0
2019-03-07,1610612749,1610612754,2018,117.0,98.0,215.0,118.2,115.1,109.5,107.5,64,48,16,0.75,65,42,23,0.6459999999999999,25,23,25,17,226.6,221.4,224.0
2019-03-07,1610612757,1610612760,2018,121.0,129.0,250.0,118.2,110.8,116.0,119.1,64,39,25,0.609,64,39,25,0.609,24,15,22,17,235.0,233.4,234.2
2019-03-06,1610612766,1610612748,2018,84.0,91.0,175.0,109.3,114.1,111.1,112.0,63,29,34,0.46,63,29,34,0.46,20,9,14,15,230.6,228.6,229.6
2019-03-06,1610612765,1610612750,2018,131.0,114.0,245.0,117.1,106.8,120.2,119.5,62,31,31,0.5,64,30,34,0.469,19,12,21,9,225.8,232.6,229.2
2019-03-06,1610612764,1610612742,2018,132.0,123.0,255.0,117.3,121.0,102.2,113.0,63,26,37,0.413,63,27,36,0.429,18,8,21,6,244.8,207.4,226.10000000000002
2019-03-06,1610612737,1610612759,2018,104.0,111.0,215.0,122.7,122.6,108.8,110.3,65,22,43,0.338,65,36,29,0.5539999999999999,11,11,25,11,251.8,215.0,233.4
2019-03-06,1610612751,1610612739,2018,113.0,107.0,220.0,112.2,113.4,106.1,111.6,66,33,33,0.5,64,16,48,0.25,19,14,10,6,217.8,216.6,217.2
2019-03-06,1610612741,1610612755,2018,108.0,107.0,215.0,117.9,116.6,112.7,111.4,65,18,47,0.277,64,41,23,0.6409999999999999,7,11,25,16,229.8,226.2,228.0
2019-03-06,1610612740,1610612762,2018,104.0,114.0,218.0,117.4,117.4,118.4,115.5,66,30,36,0.455,63,36,27,0.5710000000000001,18,12,21,15,232.4,226.6,229.5
2019-03-06,1610612756,1610612752,2018,107.0,96.0,203.0,111.0,118.2,109.9,114.8,65,14,51,0.215,64,13,51,0.203,9,5,6,7,228.8,231.6,230.2
2019-03-06,1610612758,1610612738,2018,109.0,111.0,220.0,115.6,116.0,108.1,108.7,63,32,31,0.508,65,39,26,0.6,20,12,24,15,229.6,214.8,222.2
2019-03-06,1610612747,1610612743,2018,99.0,115.0,214.0,112.8,120.6,114.0,114.6,64,30,34,0.469,63,42,21,0.667,18,12,27,15,231.2,227.4,229.3
2019-03-05,1610612754,1610612741,2018,105.0,96.0,201.0,108.9,106.9,120.1,118.6,64,41,23,0.6409999999999999,64,18,46,0.281,24,17,7,11,219.0,229.8,224.4
2019-03-05,1610612755,1610612753,2018,114.0,106.0,220.0,115.6,112.8,110.7,100.9,63,40,23,0.635,65,30,35,0.462,24,16,17,13,234.8,211.8,223.3
2019-03-05,1610612761,1610612745,2018,95.0,107.0,202.0,115.6,110.1,115.6,113.2,64,46,18,0.7190000000000001,63,38,25,0.603,27,19,22,16,229.2,231.8,230.5
2019-03-05,1610612763,1610612757,2018,120.0,111.0,231.0,104.7,105.5,120.1,110.3,65,25,40,0.385,63,39,24,0.619,15,10,24,15,210.6,235.0,222.8
2019-03-05,1610612750,1610612760,2018,131.0,120.0,251.0,117.0,117.2,116.9,119.4,63,29,34,0.46,63,39,24,0.619,20,9,22,17,221.6,233.4,227.5
2019-03-05,1610612744,1610612738,2018,95.0,128.0,223.0,118.2,115.4,105.6,108.8,63,44,19,0.698,64,38,26,0.594,23,21,24,14,236.4,214.8,225.60000000000002
2019-03-04,1610612751,1610612742,2018,127.0,88.0,215.0,110.1,117.1,102.3,109.6,65,32,33,0.4920000000000001,62,27,35,0.435,18,14,21,6,221.0,207.4,214.2
2019-03-04,1610612748,1610612737,2018,114.0,113.0,227.0,108.5,110.2,122.6,124.0,62,28,34,0.452,64,22,42,0.344,13,15,11,11,219.8,251.8,235.8
2019-03-04,1610612759,1610612743,2018,104.0,103.0,207.0,111.0,112.4,114.4,114.8,64,35,29,0.547,62,42,20,0.677,24,11,27,15,223.6,227.4,225.5
2019-03-04,1610612756,1610612749,2018,114.0,105.0,219.0,110.8,119.5,118.3,113.4,64,13,51,0.203,63,48,15,0.762,8,5,25,23,231.0,226.6,228.8
2019-03-04,1610612762,1610612740,2018,112.0,115.0,227.0,118.8,112.8,114.9,116.1,62,36,26,0.581,65,29,36,0.446,21,15,18,11,222.0,232.4,227.2
2019-03-04,1610612758,1610612752,2018,115.0,108.0,223.0,114.2,117.9,108.3,113.4,62,31,31,0.5,63,13,50,0.206,19,12,6,7,230.6,231.6,231.1
2019-03-04,1610612747,1610612746,2018,105.0,113.0,218.0,113.9,119.5,117.0,115.1,63,30,33,0.476,65,36,29,0.5539999999999999,18,12,18,18,231.2,238.6,234.89999999999998
2019-03-03,1610612766,1610612757,2018,108.0,118.0,226.0,110.0,114.0,119.6,109.4,62,29,33,0.468,62,38,24,0.613,20,9,24,14,231.8,235.0,233.4
2019-03-03,1610612738,1610612745,2018,104.0,115.0,219.0,108.0,110.2,116.8,112.9,63,38,25,0.603,62,37,25,0.597,24,14,22,15,222.4,231.8,227.10000000000002
2019-03-03,1610612741,1610612737,2018,118.0,123.0,241.0,120.8,119.7,121.6,125.7,63,18,45,0.28600000000000003,63,21,42,0.333,7,11,11,10,233.4,251.8,242.60000000000002
2019-03-03,1610612746,1610612752,2018,128.0,107.0,235.0,116.4,115.2,107.5,111.5,64,35,29,0.547,62,13,49,0.21,17,18,6,7,237.6,231.6,234.6
2019-03-03,1610612739,1610612753,2018,107.0,93.0,200.0,109.3,117.1,113.8,101.0,63,15,48,0.238,64,30,34,0.469,9,6,17,13,234.0,211.8,222.9
2019-03-03,1610612765,1610612761,2018,112.0,107.0,219.0,116.0,107.2,116.8,111.0,61,30,31,0.4920000000000001,63,46,17,0.73,18,12,27,19,224.4,229.2,226.8
2019-03-03,1610612764,1610612750,2018,135.0,121.0,256.0,114.5,117.8,116.6,115.9,62,25,37,0.403,62,29,33,0.468,17,8,20,9,232.8,221.6,227.2
2019-03-03,1610612760,1610612763,2018,99.0,95.0,194.0,118.7,119.4,104.8,104.0,62,38,24,0.613,64,25,39,0.391,21,17,15,10,237.0,210.6,223.8
2019-03-02,1610612739,1610612765,2018,93.0,129.0,222.0,110.7,114.6,113.6,107.1,62,15,47,0.242,60,29,31,0.483,9,6,18,11,231.8,224.4,228.10000000000002
2019-03-02,1610612754,1610612753,2018,112.0,117.0,229.0,108.2,104.2,112.4,98.1,63,41,22,0.6509999999999999,63,29,34,0.46,24,17,17,12,212.2,211.8,212.0
2019-03-02,1610612748,1610612751,2018,117.0,88.0,205.0,107.0,113.2,112.7,117.1,61,27,34,0.443,64,32,32,0.5,12,15,18,14,222.8,221.0,221.9
2019-03-02,1610612755,1610612744,2018,117.0,120.0,237.0,115.6,111.8,117.9,114.4,62,40,22,0.645,62,43,19,0.6940000000000001,24,16,23,20,232.8,236.4,234.60000000000002
2019-03-02,1610612742,1610612763,2018,81.0,111.0,192.0,104.9,110.7,102.9,105.9,61,27,34,0.443,63,24,39,0.381,21,6,15,9,214.8,210.6,212.7
2019-03-02,1610612759,1610612760,2018,116.0,102.0,218.0,112.6,114.1,120.3,118.0,63,34,29,0.54,61,38,23,0.623,23,11,21,17,230.2,237.0,233.6
2019-03-02,1610612743,1610612740,2018,112.0,120.0,232.0,113.5,111.5,115.4,116.9,61,42,19,0.6890000000000001,64,28,36,0.438,27,15,18,10,219.0,232.4,225.7
2019-03-02,1610612756,1610612747,2018,118.0,109.0,227.0,109.6,120.6,115.9,120.5,63,12,51,0.19,62,30,32,0.484,7,5,18,12,230.8,231.2,231.0
2019-03-02,1610612762,1610612749,2018,115.0,111.0,226.0,117.1,114.2,118.4,111.8,61,35,26,0.574,62,48,14,0.774,20,15,25,23,221.4,226.6,224.0
2019-03-01,1610612737,1610612741,2018,161.0,168.0,329.0,117.2,120.2,114.5,112.5,62,21,41,0.339,62,17,45,0.274,11,10,7,10,232.0,233.4,232.7
2019-03-01,1610612751,1610612766,2018,112.0,123.0,235.0,115.0,117.8,107.1,115.4,63,32,31,0.508,61,28,33,0.459,18,14,20,8,227.0,231.8,229.4
2019-03-01,1610612761,1610612757,2018,119.0,117.0,236.0,117.6,111.8,119.0,109.5,62,45,17,0.726,61,38,23,0.623,26,19,24,14,232.4,235.0,233.7
2019-03-01,1610612738,1610612764,2018,107.0,96.0,203.0,110.7,113.5,118.3,119.6,62,37,25,0.597,61,25,36,0.41,23,14,17,8,234.4,232.8,233.60000000000002
2019-03-01,1610612756,1610612740,2018,116.0,130.0,246.0,107.1,119.4,113.2,116.6,62,12,50,0.194,63,27,36,0.429,7,5,18,9,223.4,232.4,227.9
2019-03-01,1610612758,1610612746,2018,109.0,116.0,225.0,116.0,117.5,117.1,115.5,61,31,30,0.508,63,34,29,0.54,19,12,17,17,233.4,237.6,235.5
2019-03-01,1610612747,1610612749,2018,120.0,131.0,251.0,114.4,119.4,117.5,110.5,61,30,31,0.4920000000000001,61,47,14,0.77,18,12,25,22,226.0,226.6,226.3
2019-02-28,1610612754,1610612750,2018,122.0,115.0,237.0,107.6,101.9,116.3,115.9,62,40,22,0.645,61,29,32,0.475,23,17,20,9,206.4,221.6,214.0
2019-02-28,1610612753,1610612744,2018,103.0,96.0,199.0,112.8,98.5,121.5,114.1,62,28,34,0.452,61,43,18,0.705,16,12,23,20,213.4,236.4,224.9
2019-02-28,1610612752,1610612739,2018,118.0,125.0,243.0,105.6,109.4,108.4,115.2,61,13,48,0.213,61,14,47,0.23,6,7,9,5,223.6,231.8,227.7
2019-02-28,1610612745,1610612748,2018,121.0,118.0,239.0,115.0,110.9,104.8,111.3,61,36,25,0.59,60,27,33,0.45,21,15,12,15,224.2,222.8,223.5
2019-02-28,1610612760,1610612755,2018,104.0,108.0,212.0,123.1,119.4,116.9,111.9,60,38,22,0.633,61,39,22,0.639,21,17,24,15,245.4,232.8,239.10000000000002
2019-02-28,1610612743,1610612762,2018,104.0,111.0,215.0,116.7,112.6,118.9,114.7,60,42,18,0.7,60,34,26,0.5670000000000001,27,15,20,14,227.6,221.4,224.5
2019-02-27,1610612766,1610612745,2018,113.0,118.0,231.0,108.3,115.4,115.0,110.6,60,28,32,0.467,60,35,25,0.583,20,8,21,14,234.2,224.2,229.2
2019-02-27,1610612737,1610612750,2018,131.0,123.0,254.0,114.9,120.3,114.6,113.6,61,20,41,0.328,60,29,31,0.483,10,10,20,9,227.6,221.6,224.6
2019-02-27,1610612751,1610612764,2018,116.0,125.0,241.0,112.8,116.6,118.7,122.8,62,32,30,0.516,60,24,36,0.4,18,14,17,7,220.2,232.8,226.5
2019-02-27,1610612748,1610612744,2018,126.0,125.0,251.0,101.1,109.3,120.5,112.6,59,26,33,0.441,60,43,17,0.7170000000000001,11,15,23,20,211.4,236.4,223.9
2019-02-27,1610612738,1610612757,2018,92.0,97.0,189.0,114.1,113.2,119.4,110.5,61,37,24,0.607,60,37,23,0.617,23,14,24,13,240.6,235.0,237.8
2019-02-27,1610612763,1610612741,2018,107.0,109.0,216.0,103.0,105.6,115.3,114.0,62,24,38,0.387,61,16,45,0.262,15,9,7,9,210.2,233.4,221.8
2019-02-27,1610612759,1610612765,2018,105.0,93.0,198.0,111.6,115.1,114.4,107.2,62,33,29,0.532,59,29,30,0.4920000000000001,22,11,18,11,230.2,224.4,227.3
2019-02-27,1610612742,1610612754,2018,110.0,101.0,211.0,103.8,109.9,107.5,101.6,60,26,34,0.433,61,40,21,0.6559999999999999,20,6,23,17,211.0,206.4,208.7
2019-02-27,1610612762,1610612746,2018,111.0,105.0,216.0,120.6,115.4,115.8,116.0,59,33,26,0.5589999999999999,62,34,28,0.5479999999999999,19,14,17,17,226.2,237.6,231.89999999999998
2019-02-27,1610612758,1610612749,2018,140.0,141.0,281.0,113.5,114.2,114.7,105.9,60,31,29,0.517,60,46,14,0.767,19,12,25,21,221.8,226.6,224.2
2019-02-27,1610612747,1610612740,2018,125.0,119.0,244.0,113.0,120.5,113.4,115.7,60,29,31,0.483,62,27,35,0.435,17,12,18,9,225.4,232.4,228.9
2019-02-26,1610612752,1610612753,2018,108.0,103.0,211.0,104.0,109.6,114.7,100.9,60,12,48,0.2,61,28,33,0.459,5,7,16,12,220.8,213.4,217.10000000000002
2019-02-26,1610612761,1610612738,2018,118.0,95.0,213.0,117.9,112.6,115.9,111.3,61,44,17,0.721,60,37,23,0.617,25,19,23,14,234.6,240.6,237.6
2019-02-26,1610612743,1610612760,2018,121.0,112.0,233.0,117.2,112.4,124.5,119.0,59,41,18,0.695,59,38,21,0.644,26,15,21,17,228.2,245.4,236.8
2019-02-25,1610612766,1610612744,2018,110.0,121.0,231.0,107.3,112.5,121.0,113.4,59,28,31,0.475,59,42,17,0.7120000000000001,20,8,23,19,226.4,236.4,231.4
2019-02-25,1610612739,1610612757,2018,110.0,123.0,233.0,107.0,113.2,119.1,110.1,60,14,46,0.233,59,36,23,0.61,9,5,24,12,225.0,235.0,230.0
2019-02-25,1610612765,1610612754,2018,113.0,109.0,222.0,112.4,105.2,105.5,101.0,58,28,30,0.483,60,40,20,0.667,17,11,23,17,216.4,206.4,211.4
2019-02-25,1610612751,1610612759,2018,101.0,85.0,186.0,114.9,119.8,114.9,117.7,61,31,30,0.508,61,33,28,0.541,17,14,22,11,230.8,230.2,230.5
2019-02-25,1610612748,1610612756,2018,121.0,124.0,245.0,98.9,108.0,103.5,118.9,58,26,32,0.448,61,11,50,0.18,11,15,7,4,204.4,223.4,213.9
2019-02-25,1610612741,1610612749,2018,106.0,117.0,223.0,116.7,114.8,116.1,106.8,60,16,44,0.267,59,45,14,0.763,7,9,25,20,237.8,226.6,232.2
2019-02-25,1610612745,1610612737,2018,119.0,111.0,230.0,115.2,111.4,116.1,120.2,59,34,25,0.5760000000000001,60,20,40,0.333,20,14,10,10,226.2,227.6,226.89999999999998
2019-02-25,1610612763,1610612747,2018,110.0,105.0,215.0,101.2,104.6,111.9,123.1,61,23,38,0.377,59,29,30,0.4920000000000001,14,9,17,12,204.6,225.4,215.0
2019-02-25,1610612750,1610612758,2018,112.0,105.0,217.0,114.5,115.6,112.9,112.6,59,28,31,0.475,59,31,28,0.525,19,9,19,12,225.4,221.8,223.60000000000002
2019-02-25,1610612740,1610612755,2018,110.0,111.0,221.0,113.1,115.5,116.8,113.5,61,27,34,0.443,60,38,22,0.633,18,9,24,14,231.4,232.8,232.10000000000002
2019-02-25,1610612746,1610612742,2018,121.0,112.0,233.0,113.1,116.0,104.0,106.8,61,33,28,0.541,59,26,33,0.441,16,17,20,6,232.2,211.0,221.6
2019-02-24,1610612761,1610612753,2018,98.0,113.0,211.0,117.3,111.8,113.2,101.4,60,44,16,0.733,60,27,33,0.45,25,19,16,11,231.8,213.4,222.60000000000002
2019-02-24,1610612743,1610612746,2018,123.0,96.0,219.0,118.1,112.3,115.2,115.2,58,40,18,0.69,60,33,27,0.55,25,15,16,17,229.8,232.2,231.0
2019-02-24,1610612752,1610612759,2018,130.0,118.0,248.0,99.4,107.4,113.3,118.8,59,11,48,0.18600000000000005,60,33,27,0.55,4,7,22,11,207.2,230.2,218.7
2019-02-23,1610612755,1610612757,2018,115.0,130.0,245.0,116.0,112.4,117.5,110.9,59,38,21,0.644,58,35,23,0.603,24,14,24,11,229.0,235.0,232.0
2019-02-23,1610612737,1610612756,2018,120.0,112.0,232.0,116.1,121.9,104.7,119.5,59,19,40,0.322,60,11,49,0.183,9,10,7,4,231.0,223.4,227.2
2019-02-23,1610612766,1610612751,2018,115.0,117.0,232.0,105.9,110.0,113.6,119.5,58,28,30,0.483,60,30,30,0.5,20,8,17,13,218.6,230.8,224.7
2019-02-23,1610612739,1610612763,2018,112.0,107.0,219.0,105.6,113.6,100.2,103.3,59,13,46,0.22,60,23,37,0.383,8,5,14,9,223.0,204.6,213.8
2019-02-23,1610612764,1610612754,2018,112.0,119.0,231.0,119.3,123.5,103.9,100.4,59,24,35,0.407,59,39,20,0.6609999999999999,17,7,23,16,235.4,206.4,220.9
2019-02-23,1610612740,1610612747,2018,128.0,115.0,243.0,110.2,114.5,110.5,121.8,60,26,34,0.433,58,29,29,0.5,17,9,17,12,223.6,225.4,224.5
2019-02-23,1610612748,1610612765,2018,96.0,119.0,215.0,100.5,106.9,110.3,105.0,57,26,31,0.456,57,27,30,0.474,11,15,17,10,205.4,216.4,210.9
2019-02-23,1610612741,1610612738,2018,126.0,116.0,242.0,114.2,113.6,115.6,109.2,59,15,44,0.254,59,37,22,0.627,6,9,23,14,230.4,240.6,235.5
2019-02-23,1610612760,1610612758,2018,116.0,119.0,235.0,124.7,118.3,111.5,113.0,58,38,20,0.655,58,30,28,0.517,21,17,19,11,244.4,221.8,233.10000000000002
2019-02-23,1610612749,1610612750,2018,140.0,128.0,268.0,113.7,104.6,111.9,112.2,58,44,14,0.759,58,28,30,0.483,24,20,19,9,217.4,225.4,221.4
2019-02-23,1610612744,1610612745,2018,112.0,118.0,230.0,121.3,111.7,115.9,110.0,58,42,16,0.7240000000000001,58,33,25,0.569,23,19,20,13,233.6,226.2,229.89999999999998
2019-02-23,1610612762,1610612742,2018,125.0,109.0,234.0,118.7,114.7,103.7,105.9,58,32,26,0.552,58,26,32,0.448,18,14,20,6,221.0,211.0,216.0
2019-02-22,1610612766,1610612764,2018,123.0,110.0,233.0,107.1,110.5,119.6,122.8,57,27,30,0.474,58,24,34,0.414,19,8,17,7,222.0,235.4,228.7
2019-02-22,1610612754,1610612740,2018,126.0,111.0,237.0,104.9,98.7,110.7,114.1,58,38,20,0.655,59,26,33,0.441,22,16,17,9,205.0,223.6,214.3
2019-02-22,1610612753,1610612741,2018,109.0,110.0,219.0,114.0,103.0,113.6,111.5,59,27,32,0.458,58,14,44,0.241,16,11,6,8,218.2,230.4,224.3
2019-02-22,1610612761,1610612759,2018,120.0,117.0,237.0,117.3,110.6,112.8,119.5,59,43,16,0.7290000000000001,59,33,26,0.5589999999999999,24,19,22,11,229.4,230.2,229.8
2019-02-22,1610612737,1610612765,2018,122.0,125.0,247.0,114.0,121.3,106.5,102.9,58,19,39,0.328,56,26,30,0.464,9,10,17,9,225.6,216.4,221.0
2019-02-22,1610612752,1610612750,2018,104.0,115.0,219.0,98.9,107.2,112.4,112.3,58,11,47,0.19,57,27,30,0.474,4,7,19,8,205.8,225.4,215.60000000000002
2019-02-22,1610612763,1610612746,2018,106.0,112.0,218.0,100.2,102.4,114.3,116.7,59,23,36,0.39,59,32,27,0.542,14,9,16,16,202.8,232.2,217.5
2019-02-22,1610612742,1610612743,2018,104.0,114.0,218.0,105.3,106.8,117.2,111.8,57,26,31,0.456,57,39,18,0.684,20,6,25,14,216.0,229.8,222.9
2019-02-22,1610612760,1610612762,2018,148.0,147.0,295.0,122.1,115.2,114.2,111.3,57,37,20,0.649,57,32,25,0.561,20,17,18,14,233.0,221.0,227.0
2019-02-21,1610612739,1610612756,2018,111.0,98.0,209.0,106.1,115.1,105.1,120.0,58,12,46,0.207,59,11,48,0.18600000000000005,7,5,7,4,227.0,223.4,225.2
2019-02-21,1610612755,1610612748,2018,106.0,102.0,208.0,117.6,114.2,102.1,107.1,58,37,21,0.638,56,26,30,0.464,23,14,11,15,235.8,205.4,220.60000000000002
2019-02-21,1610612751,1610612757,2018,99.0,113.0,212.0,114.6,118.1,117.1,111.4,59,30,29,0.508,57,34,23,0.596,17,13,24,10,230.0,235.0,232.5
2019-02-21,1610612749,1610612738,2018,98.0,97.0,195.0,116.3,103.5,116.1,110.3,57,43,14,0.754,58,37,21,0.638,23,20,23,14,220.4,240.6,230.5
2019-02-21,1610612744,1610612758,2018,125.0,123.0,248.0,119.2,110.7,108.6,112.8,57,41,16,0.7190000000000001,57,30,27,0.526,22,19,19,11,227.4,221.8,224.60000000000002
2019-02-21,1610612747,1610612745,2018,111.0,106.0,217.0,110.1,121.2,117.5,112.5,57,28,29,0.491,57,33,24,0.579,16,12,20,13,223.4,226.2,224.8
2019-02-14,1610612753,1610612766,2018,127.0,89.0,216.0,110.4,103.6,108.1,108.6,58,26,32,0.448,56,27,29,0.482,15,11,19,8,212.2,222.0,217.1
2019-02-14,1610612737,1610612752,2018,91.0,106.0,197.0,115.2,122.9,98.3,108.2,57,19,38,0.333,57,10,47,0.175,9,10,4,6,231.2,205.8,218.5
2019-02-14,1610612740,1610612760,2018,131.0,122.0,253.0,109.0,114.5,122.6,113.0,58,25,33,0.431,56,37,19,0.6609999999999999,16,9,20,17,221.0,233.0,227.0
2019-02-13,1610612739,1610612751,2018,139.0,148.0,287.0,101.6,110.3,111.5,115.7,57,12,45,0.211,58,29,29,0.5,7,5,17,12,208.4,230.0,219.2
2019-02-13,1610612754,1610612749,2018,97.0,106.0,203.0,105.2,101.3,116.2,103.0,57,38,19,0.667,56,42,14,0.75,22,16,23,19,210.8,220.4,215.60000000000002
2019-02-13,1610612738,1610612765,2018,118.0,110.0,228.0,115.5,109.7,104.9,101.1,57,36,21,0.632,55,26,29,0.473,22,14,17,9,238.2,216.4,227.3
2019-02-13,1610612752,1610612755,2018,111.0,126.0,237.0,96.2,107.0,117.0,112.7,56,10,46,0.179,57,36,21,0.632,4,6,23,13,199.2,235.8,217.5
2019-02-13,1610612761,1610612764,2018,129.0,120.0,249.0,116.3,107.6,119.5,123.1,58,42,16,0.7240000000000001,57,24,33,0.421,23,19,17,7,221.4,235.4,228.4
2019-02-13,1610612741,1610612763,2018,122.0,110.0,232.0,111.5,111.1,98.2,102.1,57,13,44,0.228,58,23,35,0.397,5,8,14,9,225.4,202.8,214.10000000000002
2019-02-13,1610612750,1610612745,2018,121.0,111.0,232.0,111.9,112.6,117.8,111.4,56,26,30,0.464,56,33,23,0.589,18,8,20,13,225.0,226.2,225.6
2019-02-13,1610612742,1610612748,2018,101.0,112.0,213.0,105.8,105.7,101.5,106.7,56,26,30,0.464,55,25,30,0.455,20,6,11,14,214.8,205.4,210.10000000000002
2019-02-13,1610612743,1610612758,2018,120.0,118.0,238.0,117.6,110.2,107.1,110.9,56,38,18,0.679,56,30,26,0.536,24,14,19,11,227.4,221.8,224.60000000000002
2019-02-13,1610612757,1610612744,2018,129.0,107.0,236.0,117.0,111.9,121.5,108.9,56,33,23,0.589,56,41,15,0.732,23,10,22,19,235.8,227.4,231.60000000000002
2019-02-13,1610612746,1610612756,2018,134.0,107.0,241.0,111.8,118.9,103.9,119.8,58,31,27,0.534,58,11,47,0.19,15,16,7,4,231.6,223.4,227.5
2019-02-12,1610612737,1610612747,2018,117.0,113.0,230.0,114.0,122.9,111.1,121.5,56,18,38,0.321,56,28,28,0.5,8,10,16,12,228.8,223.4,226.10000000000002
2019-02-12,1610612755,1610612738,2018,109.0,112.0,221.0,118.2,110.8,114.6,109.3,56,36,20,0.643,56,35,21,0.625,23,13,22,13,234.4,238.2,236.3
2019-02-12,1610612763,1610612759,2018,107.0,108.0,215.0,97.1,101.2,114.6,120.2,57,23,34,0.404,58,32,26,0.552,14,9,22,10,198.8,230.2,214.5
2019-02-12,1610612740,1610612753,2018,88.0,118.0,206.0,109.6,112.5,109.6,106.2,57,25,32,0.439,57,25,32,0.439,16,9,15,10,218.2,212.2,215.2
2019-02-12,1610612744,1610612762,2018,115.0,108.0,223.0,124.7,112.1,114.4,110.3,55,40,15,0.727,56,32,24,0.5710000000000001,21,19,18,14,240.2,221.0,230.6
2019-02-11,1610612739,1610612752,2018,107.0,104.0,211.0,99.7,110.3,95.3,108.5,56,11,45,0.196,55,10,45,0.182,6,5,4,6,204.6,199.2,201.89999999999998
2019-02-11,1610612765,1610612764,2018,121.0,112.0,233.0,103.3,101.4,117.8,120.1,54,25,29,0.463,56,24,32,0.429,16,9,17,7,213.8,235.4,224.60000000000002
2019-02-11,1610612754,1610612766,2018,99.0,90.0,189.0,106.3,102.9,110.9,109.4,56,37,19,0.6609999999999999,55,27,28,0.491,21,16,19,8,216.2,222.0,219.1
2019-02-11,1610612761,1610612751,2018,127.0,125.0,252.0,114.7,106.0,113.5,117.2,57,41,16,0.7190000000000001,57,29,28,0.509,22,19,17,12,215.0,230.0,222.5
2019-02-11,1610612741,1610612749,2018,99.0,112.0,211.0,111.7,112.0,116.5,103.6,56,13,43,0.232,55,41,14,0.745,5,8,23,18,227.6,220.4,224.0
2019-02-11,1610612745,1610612742,2018,120.0,104.0,224.0,119.6,114.4,105.3,104.8,55,32,23,0.5820000000000001,55,26,29,0.473,19,13,20,6,235.8,214.8,225.3
2019-02-11,1610612750,1610612746,2018,130.0,120.0,250.0,110.2,112.2,110.9,116.0,55,25,30,0.455,57,31,26,0.544,17,8,15,16,220.8,231.6,226.2
2019-02-11,1610612760,1610612757,2018,120.0,111.0,231.0,122.9,113.3,116.6,111.4,55,36,19,0.655,55,33,22,0.6,19,17,23,10,234.2,235.8,235.0
2019-02-11,1610612743,1610612748,2018,103.0,87.0,190.0,120.8,112.0,102.8,105.8,55,37,18,0.6729999999999999,54,25,29,0.463,23,14,11,14,237.4,205.4,221.4
2019-02-10,1610612742,1610612757,2018,102.0,101.0,203.0,105.7,104.5,117.8,112.8,54,25,29,0.463,54,33,21,0.611,19,6,23,10,215.0,235.8,225.4
2019-02-10,1610612755,1610612747,2018,143.0,120.0,263.0,115.4,110.5,112.5,121.0,55,35,20,0.636,55,28,27,0.509,22,13,16,12,228.2,223.4,225.8
2019-02-10,1610612758,1610612756,2018,117.0,104.0,221.0,108.9,111.8,104.9,119.7,55,29,26,0.527,57,11,46,0.193,18,11,7,4,227.2,223.4,225.3
2019-02-10,1610612737,1610612753,2018,108.0,124.0,232.0,117.4,123.1,109.4,105.7,55,18,37,0.327,56,24,32,0.429,8,10,15,9,236.0,212.2,224.1
2019-02-10,1610612744,1610612748,2018,120.0,118.0,238.0,127.3,111.2,100.9,104.5,54,39,15,0.722,53,25,28,0.472,20,19,11,14,243.6,205.4,224.5
2019-02-09,1610612762,1610612759,2018,125.0,105.0,230.0,113.3,110.6,116.1,119.9,55,31,24,0.564,57,32,25,0.561,17,14,22,10,219.4,230.2,224.8
2019-02-09,1610612754,1610612739,2018,105.0,90.0,195.0,107.8,103.4,100.6,111.3,55,36,19,0.655,55,11,44,0.2,20,16,6,5,220.2,204.6,212.39999999999998
2019-02-09,1610612737,1610612766,2018,120.0,129.0,249.0,116.8,123.5,107.5,109.4,54,18,36,0.333,54,26,28,0.481,8,10,19,7,235.6,222.0,228.8
2019-02-09,1610612752,1610612761,2018,99.0,104.0,203.0,95.1,108.7,114.9,107.1,54,10,44,0.185,56,40,16,0.7140000000000001,4,6,22,18,199.2,215.0,207.1
2019-02-09,1610612738,1610612746,2018,112.0,123.0,235.0,114.5,108.5,109.2,114.9,55,35,20,0.636,56,30,26,0.536,22,13,15,15,236.4,231.6,234.0
2019-02-09,1610612741,1610612764,2018,125.0,134.0,259.0,109.5,110.3,115.9,120.8,55,13,42,0.236,55,23,32,0.418,5,8,17,6,219.8,235.4,227.60000000000002
2019-02-09,1610612763,1610612740,2018,99.0,90.0,189.0,97.9,104.0,111.1,111.1,56,22,34,0.393,56,25,31,0.446,13,9,16,9,206.0,218.2,212.1
2019-02-09,1610612745,1610612760,2018,112.0,117.0,229.0,122.6,117.2,122.9,113.6,54,32,22,0.593,54,35,19,0.648,19,13,19,16,247.4,234.2,240.8
2019-02-09,1610612749,1610612753,2018,83.0,103.0,186.0,119.6,103.5,110.6,109.4,54,41,13,0.759,55,23,32,0.418,23,18,15,8,226.4,212.2,219.3
2019-02-08,1610612765,1610612752,2018,120.0,103.0,223.0,101.4,101.4,94.9,107.8,53,24,29,0.453,53,10,43,0.189,15,9,4,6,210.0,199.2,204.6
2019-02-08,1610612755,1610612743,2018,117.0,110.0,227.0,118.6,110.2,119.3,109.5,54,34,20,0.63,54,37,17,0.685,21,13,23,14,234.0,237.4,235.7
2019-02-08,1610612764,1610612739,2018,119.0,106.0,225.0,114.1,118.9,101.2,112.3,54,22,32,0.407,54,11,43,0.204,16,6,6,5,228.0,204.6,216.3
2019-02-08,1610612751,1610612741,2018,106.0,125.0,231.0,114.3,115.7,107.5,113.2,56,29,27,0.518,54,12,42,0.222,17,12,5,7,228.6,219.8,224.2
2019-02-08,1610612742,1610612749,2018,107.0,122.0,229.0,105.1,102.8,118.6,104.6,53,25,28,0.472,53,40,13,0.755,19,6,23,17,210.4,226.4,218.4
2019-02-08,1610612756,1610612744,2018,107.0,117.0,224.0,104.4,117.3,126.8,109.9,56,11,45,0.196,53,38,15,0.7170000000000001,7,4,20,18,217.6,243.6,230.6
2019-02-08,1610612740,1610612750,2018,122.0,117.0,239.0,112.9,111.8,110.3,109.1,55,24,31,0.436,54,25,29,0.463,15,9,17,8,223.2,220.8,222.0
2019-02-08,1610612758,1610612748,2018,102.0,96.0,198.0,110.2,112.9,103.0,104.6,54,28,26,0.519,52,25,27,0.481,17,11,11,14,232.0,205.4,218.7
2019-02-07,1610612754,1610612746,2018,116.0,92.0,208.0,107.3,104.1,111.1,113.2,54,35,19,0.648,55,30,25,0.545,19,16,15,15,220.6,231.6,226.1
2019-02-07,1610612753,1610612750,2018,122.0,112.0,234.0,109.2,110.0,109.8,111.8,54,22,32,0.407,53,25,28,0.472,14,8,17,8,210.6,220.8,215.7
2019-02-07,1610612737,1610612761,2018,101.0,119.0,220.0,117.3,119.8,113.8,108.7,53,18,35,0.34,55,39,16,0.7090000000000001,8,10,22,17,229.2,215.0,222.1
2019-02-07,1610612738,1610612747,2018,128.0,129.0,257.0,114.0,105.9,113.4,121.0,54,35,19,0.648,54,27,27,0.5,22,13,16,11,230.2,223.4,226.8
2019-02-07,1610612760,1610612763,2018,117.0,95.0,212.0,124.0,117.9,100.0,104.5,53,34,19,0.642,55,22,33,0.4,18,16,13,9,245.0,206.0,225.5
2019-02-07,1610612757,1610612759,2018,127.0,118.0,245.0,118.0,112.2,115.9,118.5,53,32,21,0.604,56,32,24,0.5710000000000001,22,10,22,10,235.0,230.2,232.6
2019-02-06,1610612751,1610612743,2018,135.0,130.0,265.0,113.1,112.1,117.1,107.4,55,28,27,0.509,53,37,16,0.698,16,12,23,14,219.0,237.4,228.2
2019-02-06,1610612741,1610612740,2018,120.0,125.0,245.0,105.5,112.4,111.6,112.6,53,12,41,0.226,54,23,31,0.426,5,7,15,8,214.2,223.2,218.7
2019-02-06,1610612749,1610612764,2018,148.0,129.0,277.0,115.4,104.0,112.8,113.9,52,39,13,0.75,53,22,31,0.415,22,17,16,6,218.8,228.0,223.4
2019-02-06,1610612742,1610612766,2018,99.0,93.0,192.0,106.6,105.4,109.0,108.8,52,24,28,0.462,53,26,27,0.491,18,6,19,7,218.6,222.0,220.3
2019-02-06,1610612762,1610612756,2018,116.0,88.0,204.0,112.1,112.7,107.1,119.2,54,30,24,0.556,55,11,44,0.2,16,14,7,4,221.2,217.6,219.39999999999998
2019-02-06,1610612758,1610612745,2018,101.0,127.0,228.0,110.5,109.9,119.2,119.2,53,28,25,0.528,53,31,22,0.585,17,11,19,12,226.6,247.4,237.0
2019-02-06,1610612744,1610612759,2018,141.0,102.0,243.0,124.9,109.2,116.2,114.5,52,37,15,0.7120000000000001,55,32,23,0.5820000000000001,19,18,22,10,238.4,230.2,234.3
2019-02-05,1610612766,1610612746,2018,115.0,117.0,232.0,108.9,106.6,109.2,112.3,52,26,26,0.5,54,29,25,0.537,19,7,15,14,217.4,231.6,224.5
2019-02-05,1610612739,1610612738,2018,96.0,103.0,199.0,103.1,114.3,113.6,107.8,53,11,42,0.208,53,34,19,0.642,6,5,22,12,212.4,230.2,221.3
2019-02-05,1610612754,1610612747,2018,136.0,94.0,230.0,103.3,106.7,113.5,118.7,53,34,19,0.642,53,27,26,0.509,18,16,16,11,217.8,223.4,220.60000000000002
2019-02-05,1610612752,1610612765,2018,92.0,105.0,197.0,96.7,108.7,101.8,102.6,52,10,42,0.192,52,23,29,0.442,4,6,15,8,204.6,210.0,207.3
2019-02-05,1610612755,1610612761,2018,107.0,119.0,226.0,120.0,110.6,115.9,111.8,53,34,19,0.642,54,38,16,0.7040000000000001,21,13,22,16,237.6,215.0,226.3
2019-02-05,1610612763,1610612750,2018,108.0,106.0,214.0,97.7,104.4,111.1,112.7,54,21,33,0.389,52,25,27,0.481,12,9,17,8,201.2,220.8,211.0
2019-02-05,1610612760,1610612753,2018,132.0,122.0,254.0,123.0,116.9,106.3,107.4,52,33,19,0.635,53,22,31,0.415,17,16,14,8,241.0,210.6,225.8
2019-02-05,1610612757,1610612748,2018,108.0,118.0,226.0,119.9,110.0,100.5,103.6,52,32,20,0.615,51,24,27,0.471,22,10,11,13,234.4,205.4,219.9
2019-02-04,1610612765,1610612743,2018,129.0,103.0,232.0,98.7,101.6,116.1,104.7,51,22,29,0.431,52,37,15,0.7120000000000001,14,8,23,14,201.8,237.4,219.60000000000002
2019-02-04,1610612764,1610612737,2018,129.0,137.0,266.0,110.0,110.2,114.7,118.9,52,22,30,0.423,52,17,35,0.327,16,6,8,9,215.0,229.2,222.1
2019-02-04,1610612751,1610612749,2018,94.0,113.0,207.0,114.6,111.0,115.9,105.4,54,28,26,0.519,51,38,13,0.745,16,12,22,16,219.8,218.8,219.3
2019-02-04,1610612740,1610612754,2018,107.0,109.0,216.0,112.3,111.2,104.5,106.6,53,23,30,0.434,52,33,19,0.635,15,8,18,15,221.8,217.8,219.8
2019-02-04,1610612756,1610612745,2018,110.0,118.0,228.0,107.6,118.5,118.3,119.8,54,11,43,0.204,52,30,22,0.5770000000000001,7,4,19,11,217.2,247.4,232.3
2019-02-04,1610612758,1610612759,2018,127.0,112.0,239.0,109.0,108.9,116.2,114.0,52,27,25,0.519,54,32,22,0.593,16,11,22,10,221.6,230.2,225.89999999999998
2019-02-03,1610612752,1610612763,2018,84.0,96.0,180.0,99.2,111.8,97.5,107.2,51,10,41,0.196,53,20,33,0.377,4,6,12,8,215.8,201.2,208.5
2019-02-03,1610612738,1610612760,2018,134.0,129.0,263.0,110.9,104.8,122.7,117.7,52,33,19,0.635,51,33,18,0.647,21,12,17,16,218.8,241.0,229.9
2019-02-03,1610612761,1610612746,2018,121.0,103.0,224.0,116.0,112.0,109.2,109.7,53,37,16,0.698,53,29,24,0.547,21,16,15,14,215.6,231.6,223.6
2019-02-02,1610612765,1610612746,2018,101.0,111.0,212.0,100.6,102.0,108.1,111.7,50,22,28,0.44,52,28,24,0.5379999999999999,14,8,15,13,206.4,231.6,219.0
2019-02-02,1610612766,1610612741,2018,125.0,118.0,243.0,104.8,107.0,103.7,110.6,51,25,26,0.49,52,12,40,0.231,18,7,5,7,210.0,214.2,212.1
2019-02-02,1610612753,1610612751,2018,102.0,89.0,191.0,107.6,110.2,116.2,113.0,52,21,31,0.404,53,28,25,0.528,13,8,16,12,218.8,219.8,219.3
2019-02-02,1610612764,1610612749,2018,115.0,131.0,246.0,112.3,111.1,113.9,104.0,51,22,29,0.431,50,37,13,0.74,16,6,22,15,221.4,218.8,220.10000000000002
2019-02-02,1610612739,1610612742,2018,98.0,111.0,209.0,103.1,116.5,107.4,107.1,52,11,41,0.212,51,23,28,0.451,6,5,18,5,216.8,218.6,217.7
2019-02-02,1610612748,1610612754,2018,88.0,95.0,183.0,103.2,104.0,105.8,111.3,50,24,26,0.48,51,32,19,0.627,11,13,18,14,211.6,217.8,214.7
2019-02-02,1610612759,1610612740,2018,113.0,108.0,221.0,114.2,114.0,115.5,114.6,53,31,22,0.585,52,23,29,0.442,21,10,15,8,226.2,221.8,224.0
2019-02-02,1610612744,1610612747,2018,115.0,101.0,216.0,126.8,112.6,114.1,116.9,51,36,15,0.706,52,27,25,0.519,18,18,16,11,249.0,223.4,236.2
2019-02-02,1610612750,1610612743,2018,106.0,107.0,213.0,111.5,112.6,115.7,104.0,51,25,26,0.49,51,36,15,0.706,17,8,23,13,221.4,237.4,229.4
2019-02-02,1610612756,1610612737,2018,112.0,118.0,230.0,107.7,118.6,115.0,117.8,53,11,42,0.208,51,16,35,0.314,7,4,8,8,217.6,229.2,223.39999999999998
2019-02-02,1610612762,1610612745,2018,98.0,125.0,223.0,113.8,110.1,115.9,121.0,53,30,23,0.5660000000000001,51,29,22,0.569,16,14,19,10,219.4,247.4,233.4
2019-02-02,1610612758,1610612755,2018,115.0,108.0,223.0,108.6,107.6,120.0,109.6,51,26,25,0.51,52,34,18,0.654,15,11,21,13,218.2,237.6,227.89999999999998
2019-02-01,1610612766,1610612763,2018,100.0,92.0,192.0,107.3,107.8,99.1,108.4,50,24,26,0.48,52,20,32,0.385,17,7,12,8,216.6,201.2,208.89999999999998
2019-02-01,1610612752,1610612738,2018,99.0,113.0,212.0,99.8,111.3,110.7,106.9,50,10,40,0.2,51,32,19,0.627,4,6,21,11,216.0,218.8,217.4
2019-02-01,1610612748,1610612760,2018,102.0,118.0,220.0,102.9,102.5,125.6,122.9,49,24,25,0.49,50,32,18,0.64,11,13,17,15,208.0,241.0,224.5
2019-02-01,1610612762,1610612737,2018,128.0,112.0,240.0,111.0,108.3,116.1,117.1,52,29,23,0.5579999999999999,50,16,34,0.32,15,14,8,8,210.2,229.2,219.7
2019-02-01,1610612743,1610612745,2018,136.0,122.0,258.0,113.2,106.0,117.2,120.8,50,35,15,0.7,50,29,21,0.58,22,13,19,10,236.4,247.4,241.9
2019-01-31,1610612765,1610612742,2018,93.0,89.0,182.0,102.0,105.0,108.5,108.4,49,21,28,0.429,50,23,27,0.46,13,8,18,5,215.2,218.6,216.89999999999998
2019-01-31,1610612753,1610612754,2018,107.0,100.0,207.0,108.5,111.1,108.1,112.1,51,20,31,0.392,50,32,18,0.64,12,8,18,14,222.4,217.8,220.10000000000002
2019-01-31,1610612761,1610612749,2018,92.0,105.0,197.0,117.2,111.6,116.7,106.2,52,37,15,0.7120000000000001,49,36,13,0.735,21,16,22,14,217.2,218.8,218.0
2019-01-31,1610612759,1610612751,2018,117.0,114.0,231.0,117.9,117.3,114.3,112.9,52,30,22,0.5770000000000001,52,28,24,0.5379999999999999,20,10,16,12,240.2,219.8,230.0
2019-01-31,1610612744,1610612755,2018,104.0,113.0,217.0,127.3,112.3,119.3,111.5,50,36,14,0.72,51,33,18,0.647,18,18,21,12,249.4,237.6,243.5
2019-01-31,1610612746,1610612747,2018,120.0,123.0,243.0,107.8,111.5,110.4,115.7,51,28,23,0.5489999999999999,51,26,25,0.51,15,13,16,10,230.6,223.4,227.0
2019-01-30,1610612738,1610612766,2018,126.0,94.0,220.0,110.3,109.1,107.6,105.6,50,31,19,0.62,49,24,25,0.49,20,11,17,7,222.4,216.6,219.5
2019-01-30,1610612748,1610612741,2018,89.0,105.0,194.0,105.5,102.9,103.4,112.7,48,24,24,0.5,51,11,40,0.21600000000000005,11,13,5,6,214.0,214.2,214.1
2019-01-30,1610612752,1610612742,2018,90.0,114.0,204.0,101.4,112.0,106.4,110.8,49,10,39,0.204,49,22,27,0.449,4,6,18,4,220.6,218.6,219.6
2019-01-30,1610612764,1610612754,2018,107.0,89.0,196.0,112.9,112.8,109.7,113.5,50,21,29,0.42,49,32,17,0.653,15,6,18,14,226.0,217.8,221.9
2019-01-30,1610612750,1610612763,2018,99.0,97.0,196.0,113.1,114.8,98.9,109.9,50,24,26,0.48,51,20,31,0.392,16,8,12,8,229.0,201.2,215.1
2019-01-30,1610612740,1610612743,2018,99.0,105.0,204.0,117.9,115.5,114.0,108.6,51,23,28,0.451,49,34,15,0.6940000000000001,15,8,22,12,228.4,236.4,232.4
2019-01-30,1610612758,1610612737,2018,135.0,113.0,248.0,107.4,109.0,114.8,115.2,50,25,25,0.5,49,16,33,0.327,14,11,8,8,218.6,229.2,223.89999999999998
2019-01-30,1610612757,1610612762,2018,132.0,105.0,237.0,119.1,110.7,112.2,104.2,51,31,20,0.608,51,29,22,0.569,21,10,15,14,234.2,210.2,222.2
2019-01-29,1610612739,1610612764,2018,116.0,113.0,229.0,100.6,116.9,112.5,112.7,51,10,41,0.196,49,21,28,0.429,5,5,15,6,212.6,226.0,219.3
2019-01-29,1610612765,1610612749,2018,105.0,115.0,220.0,102.0,104.5,115.8,107.0,48,21,27,0.438,48,35,13,0.7290000000000001,13,8,22,13,214.2,218.8,216.5
2019-01-29,1610612753,1610612760,2018,117.0,126.0,243.0,107.3,108.8,124.1,122.1,50,20,30,0.4,49,31,18,0.633,12,8,17,14,215.4,241.0,228.2
2019-01-29,1610612751,1610612741,2018,122.0,117.0,239.0,113.7,111.2,102.6,115.1,51,27,24,0.529,50,11,39,0.22,15,12,5,6,215.2,214.2,214.7
2019-01-29,1610612745,1610612740,2018,116.0,121.0,237.0,116.8,118.1,117.9,115.6,49,29,20,0.5920000000000001,50,22,28,0.44,19,10,15,7,241.2,228.4,234.8
2019-01-29,1610612759,1610612756,2018,126.0,124.0,250.0,116.1,113.7,106.2,117.1,51,29,22,0.569,52,11,41,0.212,19,10,7,4,229.4,217.6,223.5
2019-01-29,1610612747,1610612755,2018,105.0,121.0,226.0,109.4,113.7,120.4,113.7,50,26,24,0.52,50,32,18,0.64,16,10,21,11,217.4,237.6,227.5
2019-01-28,1610612766,1610612752,2018,101.0,92.0,193.0,107.5,105.1,104.1,113.1,48,23,25,0.479,48,10,38,0.208,16,7,4,6,215.4,220.6,218.0
2019-01-28,1610612754,1610612744,2018,100.0,132.0,232.0,112.8,110.0,128.3,113.4,48,32,16,0.667,49,35,14,0.7140000000000001,18,14,18,17,217.0,249.4,233.2
2019-01-28,1610612738,1610612751,2018,112.0,104.0,216.0,110.8,109.5,115.0,110.0,49,30,19,0.612,50,27,23,0.54,19,11,15,12,224.2,215.2,219.7
2019-01-28,1610612763,1610612743,2018,92.0,95.0,187.0,99.8,111.5,116.2,110.7,50,20,30,0.4,48,33,15,0.688,12,8,22,11,206.2,236.4,221.3
2019-01-28,1610612746,1610612737,2018,118.0,123.0,241.0,106.4,110.1,112.6,113.8,50,28,22,0.56,48,15,33,0.313,15,13,8,7,225.0,229.2,227.1
2019-01-27,1610612741,1610612739,2018,101.0,104.0,205.0,104.1,116.6,100.3,116.3,49,11,38,0.224,50,9,41,0.18,5,6,5,4,220.2,212.6,216.39999999999998
2019-01-27,1610612746,1610612758,2018,122.0,108.0,230.0,107.0,110.2,106.1,108.2,49,27,22,0.551,49,25,24,0.51,14,13,14,11,226.4,218.6,222.5
2019-01-27,1610612760,1610612749,2018,118.0,112.0,230.0,124.0,122.8,116.2,106.1,48,30,18,0.625,47,35,12,0.745,16,14,22,13,242.2,218.8,230.5
2019-01-27,1610612745,1610612753,2018,103.0,98.0,201.0,120.6,119.6,107.0,109.6,48,28,20,0.583,49,20,29,0.408,18,10,12,8,251.8,215.4,233.60000000000002
2019-01-27,1610612742,1610612761,2018,120.0,123.0,243.0,104.8,107.9,117.2,111.2,48,22,26,0.458,51,36,15,0.706,18,4,21,15,209.6,217.2,213.39999999999998
2019-01-27,1610612750,1610612762,2018,111.0,125.0,236.0,112.8,110.9,111.3,105.3,49,24,25,0.49,50,28,22,0.56,16,8,15,13,220.6,210.2,215.39999999999998
2019-01-27,1610612759,1610612764,2018,132.0,119.0,251.0,115.4,112.5,110.1,110.1,50,28,22,0.56,48,21,27,0.438,18,10,15,6,225.6,226.0,225.8
2019-01-27,1610612752,1610612748,2018,97.0,106.0,203.0,103.9,113.4,103.5,105.6,47,10,37,0.213,47,23,24,0.489,4,6,11,12,220.8,214.0,217.4
2019-01-27,1610612747,1610612756,2018,116.0,102.0,218.0,109.1,113.5,105.7,118.6,49,25,24,0.51,51,11,40,0.21600000000000005,15,10,7,4,216.4,217.6,217.0
2019-01-26,1610612740,1610612759,2018,114.0,126.0,240.0,116.9,113.8,111.4,110.7,49,22,27,0.449,49,27,22,0.551,15,7,18,9,222.8,225.6,224.2
2019-01-26,1610612763,1610612754,2018,106.0,103.0,209.0,98.8,109.8,114.4,111.0,49,19,30,0.388,47,32,15,0.6809999999999999,11,8,18,14,200.8,217.0,208.9
2019-01-26,1610612738,1610612744,2018,111.0,115.0,226.0,113.2,108.8,128.7,113.7,48,30,18,0.625,48,34,14,0.708,19,11,18,16,227.6,249.4,238.5
2019-01-26,1610612743,1610612755,2018,126.0,110.0,236.0,115.2,111.0,121.3,112.4,47,32,15,0.6809999999999999,49,32,17,0.653,21,11,21,11,235.0,237.6,236.3
2019-01-26,1610612757,1610612737,2018,120.0,111.0,231.0,118.2,109.7,112.7,116.2,50,30,20,0.6,47,15,32,0.319,20,10,8,7,230.4,229.2,229.8
2019-01-25,1610612753,1610612764,2018,91.0,95.0,186.0,108.8,110.8,109.5,111.5,48,20,28,0.417,47,20,27,0.426,12,8,15,5,221.4,226.0,223.7
2019-01-25,1610612751,1610612752,2018,109.0,99.0,208.0,116.7,112.2,104.8,114.0,49,26,23,0.531,46,10,36,0.217,14,12,4,6,223.0,220.8,221.9
2019-01-25,1610612739,1610612748,2018,94.0,100.0,194.0,100.1,118.0,101.7,106.8,49,9,40,0.184,46,22,24,0.478,5,4,11,11,215.6,214.0,214.8
2019-01-25,1610612741,1610612746,2018,101.0,106.0,207.0,102.4,117.2,108.5,111.2,48,11,37,0.229,48,26,22,0.542,5,6,14,12,218.0,226.4,222.2
2019-01-25,1610612745,1610612761,2018,121.0,119.0,240.0,119.4,119.3,116.0,111.6,47,27,20,0.574,50,36,14,0.72,17,10,21,15,248.8,217.2,233.0
2019-01-25,1610612763,1610612758,2018,96.0,99.0,195.0,99.2,110.8,107.3,110.1,48,19,29,0.396,48,24,24,0.5,11,8,14,10,203.6,218.6,211.1
2019-01-25,1610612742,1610612765,2018,106.0,101.0,207.0,103.9,108.5,102.1,105.1,47,21,26,0.447,47,21,26,0.447,17,4,13,8,209.0,214.2,211.6
2019-01-25,1610612749,1610612766,2018,108.0,99.0,207.0,119.8,107.4,107.2,107.0,46,34,12,0.7390000000000001,47,23,24,0.489,21,13,16,7,228.6,215.4,222.0
2019-01-25,1610612743,1610612756,2018,132.0,95.0,227.0,114.1,111.5,105.6,115.8,46,31,15,0.674,50,11,39,0.22,20,11,7,4,233.8,217.6,225.7
2019-01-25,1610612762,1610612750,2018,106.0,102.0,208.0,111.7,105.3,112.8,111.8,49,27,22,0.551,48,24,24,0.5,14,13,16,8,211.0,220.6,215.8
2019-01-24,1610612764,1610612744,2018,118.0,126.0,244.0,110.0,109.5,128.8,114.2,46,20,26,0.435,47,33,14,0.7020000000000001,15,5,18,15,223.0,249.4,236.2
2019-01-24,1610612760,1610612740,2018,122.0,116.0,238.0,121.6,122.8,115.9,112.6,47,29,18,0.617,48,22,26,0.458,15,14,15,7,237.4,222.8,230.10000000000002
2019-01-24,1610612756,1610612757,2018,106.0,120.0,226.0,106.1,115.9,117.5,109.9,49,11,38,0.224,49,29,20,0.5920000000000001,7,4,20,9,218.8,230.4,224.60000000000002
2019-01-24,1610612747,1610612750,2018,105.0,120.0,225.0,109.8,113.4,112.2,113.6,48,25,23,0.521,47,23,24,0.489,15,10,16,7,217.6,220.6,219.1
2019-01-23,1610612754,1610612761,2018,110.0,106.0,216.0,115.0,111.2,114.1,112.2,46,31,15,0.674,49,36,13,0.735,17,14,21,15,218.6,217.2,217.89999999999998
2019-01-23,1610612738,1610612739,2018,123.0,103.0,226.0,112.5,108.0,101.1,119.8,47,29,18,0.617,48,9,39,0.188,18,11,5,4,224.6,215.6,220.1
2019-01-23,1610612751,1610612753,2018,114.0,110.0,224.0,118.7,114.4,107.4,110.0,48,25,23,0.521,47,20,27,0.426,13,12,12,8,231.4,221.4,226.4
2019-01-23,1610612748,1610612746,2018,99.0,111.0,210.0,102.2,107.0,109.2,112.0,45,22,23,0.489,47,25,22,0.532,11,11,14,11,215.4,226.4,220.9
2019-01-23,1610612752,1610612745,2018,110.0,114.0,224.0,104.5,114.0,118.8,118.7,45,10,35,0.222,46,26,20,0.565,4,6,17,9,220.2,248.8,234.5
2019-01-23,1610612755,1610612759,2018,122.0,120.0,242.0,122.3,111.9,111.3,109.2,48,31,17,0.6459999999999999,48,27,21,0.563,20,11,18,9,238.6,225.6,232.1
2019-01-23,1610612741,1610612737,2018,101.0,121.0,222.0,101.7,117.0,110.4,117.5,47,11,36,0.234,46,14,32,0.304,5,6,8,6,216.2,229.2,222.7
2019-01-23,1610612763,1610612766,2018,107.0,118.0,225.0,97.9,109.1,106.3,109.1,47,19,28,0.404,46,22,24,0.478,11,8,16,6,197.6,215.4,206.5
2019-01-23,1610612740,1610612765,2018,94.0,98.0,192.0,117.9,114.0,102.3,107.0,47,22,25,0.468,46,20,26,0.435,15,7,13,7,229.6,214.2,221.89999999999998
2019-01-23,1610612762,1610612743,2018,114.0,108.0,222.0,111.6,104.0,115.5,111.9,48,26,22,0.542,45,31,14,0.6890000000000001,13,13,20,11,208.2,233.8,221.0
2019-01-22,1610612761,1610612758,2018,120.0,105.0,225.0,114.2,112.2,108.2,110.2,48,35,13,0.7290000000000001,47,24,23,0.511,20,15,14,10,217.4,218.6,218.0
2019-01-22,1610612760,1610612757,2018,123.0,114.0,237.0,121.5,121.6,117.1,108.5,46,28,18,0.609,48,29,19,0.604,14,14,20,9,234.8,230.4,232.60000000000002
2019-01-22,1610612742,1610612746,2018,106.0,98.0,204.0,103.8,109.0,112.1,114.3,46,20,26,0.435,46,25,21,0.5429999999999999,16,4,14,11,209.8,226.4,218.10000000000002
2019-01-22,1610612756,1610612750,2018,91.0,118.0,209.0,109.7,117.3,111.7,114.9,48,11,37,0.229,46,22,24,0.478,7,4,16,6,228.8,220.6,224.7
2019-01-21,1610612752,1610612760,2018,109.0,127.0,236.0,104.6,114.1,119.5,120.7,44,10,34,0.227,45,27,18,0.6,4,6,14,13,220.6,234.8,227.7
2019-01-21,1610612739,1610612741,2018,88.0,104.0,192.0,101.5,120.6,102.5,120.6,47,9,38,0.191,46,10,36,0.217,5,4,5,5,218.0,216.2,217.1
2019-01-21,1610612764,1610612765,2018,101.0,87.0,188.0,111.3,110.6,103.7,106.3,45,19,26,0.422,45,20,25,0.444,14,5,13,7,227.8,214.2,221.0
2019-01-21,1610612749,1610612742,2018,116.0,106.0,222.0,120.3,106.6,105.4,105.8,45,33,12,0.733,45,20,25,0.444,20,13,16,4,228.0,209.8,218.9
2019-01-21,1610612737,1610612753,2018,103.0,122.0,225.0,111.2,116.1,105.5,111.7,45,14,31,0.311,46,19,27,0.413,8,6,12,7,228.0,221.4,224.7
2019-01-21,1610612751,1610612758,2018,123.0,94.0,217.0,117.5,115.3,110.6,110.6,47,24,23,0.511,46,24,22,0.522,12,12,14,10,230.8,218.6,224.7
2019-01-21,1610612763,1610612740,2018,85.0,105.0,190.0,99.7,109.8,120.7,115.3,46,19,27,0.413,46,21,25,0.457,11,8,15,6,202.6,229.6,216.1
2019-01-21,1610612738,1610612748,2018,107.0,99.0,206.0,113.2,107.4,104.0,105.5,46,28,18,0.609,44,22,22,0.5,17,11,11,11,224.8,215.4,220.10000000000002
2019-01-21,1610612755,1610612745,2018,121.0,93.0,214.0,120.8,112.6,119.4,116.7,47,30,17,0.638,45,26,19,0.578,19,11,17,9,237.0,248.8,242.9
2019-01-21,1610612762,1610612757,2018,104.0,109.0,213.0,111.8,102.4,115.8,109.8,47,26,21,0.5529999999999999,47,28,19,0.596,13,13,20,8,205.4,230.4,217.9
2019-01-21,1610612747,1610612744,2018,111.0,130.0,241.0,108.7,111.1,129.0,114.0,47,25,22,0.532,46,32,14,0.696,15,10,18,14,210.8,249.4,230.10000000000002
2019-01-20,1610612754,1610612766,2018,120.0,95.0,215.0,115.5,110.5,108.7,108.4,45,30,15,0.667,45,22,23,0.489,16,14,16,6,218.2,215.4,216.8
2019-01-20,1610612750,1610612756,2018,116.0,114.0,230.0,112.1,113.8,110.5,117.7,45,21,24,0.467,47,11,36,0.234,15,6,7,4,219.2,228.8,224.0
2019-01-20,1610612759,1610612746,2018,95.0,103.0,198.0,113.8,110.0,112.2,115.8,47,27,20,0.574,45,24,21,0.5329999999999999,18,9,14,10,232.2,226.4,229.3
2019-01-19,1610612755,1610612760,2018,115.0,117.0,232.0,121.9,111.0,118.1,119.7,46,30,16,0.652,44,26,18,0.591,19,11,14,12,236.0,234.8,235.4
2019-01-19,1610612766,1610612756,2018,135.0,115.0,250.0,105.0,105.5,109.3,115.3,44,21,23,0.477,46,11,35,0.239,15,6,7,4,202.2,228.8,215.5
2019-01-19,1610612765,1610612758,2018,101.0,103.0,204.0,104.2,105.5,110.8,113.7,44,20,24,0.455,45,23,22,0.511,13,7,14,9,213.6,218.6,216.1
2019-01-19,1610612754,1610612742,2018,111.0,99.0,210.0,114.9,109.5,105.7,106.9,44,29,15,0.659,44,20,24,0.455,15,14,16,4,215.0,209.8,212.4
2019-01-19,1610612753,1610612749,2018,108.0,118.0,226.0,106.3,108.6,119.4,105.3,45,19,26,0.422,44,32,12,0.727,12,7,20,12,216.8,228.0,222.4
2019-01-19,1610612737,1610612738,2018,105.0,113.0,218.0,112.8,117.7,113.1,107.2,44,14,30,0.318,45,27,18,0.6,8,6,17,10,234.4,224.8,229.60000000000002
2019-01-19,1610612761,1610612763,2018,119.0,90.0,209.0,114.5,114.8,99.5,108.7,47,34,13,0.723,45,19,26,0.422,19,15,11,8,223.2,202.6,212.89999999999998
2019-01-19,1610612741,1610612748,2018,103.0,117.0,220.0,101.2,116.9,103.8,104.3,45,10,35,0.222,43,21,22,0.488,5,5,11,10,206.2,215.4,210.8
2019-01-19,1610612745,1610612747,2018,138.0,134.0,272.0,118.1,114.6,106.9,109.0,44,25,19,0.568,46,25,21,0.5429999999999999,16,9,15,10,242.0,210.8,226.4
2019-01-19,1610612743,1610612739,2018,124.0,102.0,226.0,115.4,112.7,103.7,122.2,44,30,14,0.682,46,9,37,0.196,19,11,5,4,235.2,218.0,226.6
2019-01-18,1610612738,1610612763,2018,122.0,116.0,238.0,112.4,105.8,98.0,107.8,44,26,18,0.591,44,19,25,0.4320000000000001,16,10,11,8,220.6,202.6,211.6
2019-01-18,1610612765,1610612748,2018,98.0,93.0,191.0,103.9,106.0,104.7,104.1,43,19,24,0.442,42,21,21,0.5,12,7,11,10,214.0,215.4,214.7
2019-01-18,1610612753,1610612751,2018,115.0,117.0,232.0,106.8,109.1,116.7,113.8,44,19,25,0.4320000000000001,46,23,23,0.5,12,7,12,11,218.8,230.8,224.8
2019-01-18,1610612750,1610612759,2018,113.0,116.0,229.0,112.8,114.5,114.4,109.8,44,21,23,0.477,46,26,20,0.565,15,6,18,8,222.0,232.2,227.1
2019-01-18,1610612762,1610612739,2018,115.0,99.0,214.0,113.2,102.2,104.6,121.8,46,25,21,0.5429999999999999,45,9,36,0.2,12,13,5,4,207.8,218.0,212.9
2019-01-18,1610612746,1610612744,2018,94.0,112.0,206.0,113.4,114.2,129.3,115.1,44,24,20,0.545,45,31,14,0.6890000000000001,14,10,18,13,225.6,249.4,237.5
2019-01-18,1610612757,1610612740,2018,128.0,112.0,240.0,114.0,108.7,121.6,115.1,46,27,19,0.5870000000000001,45,21,24,0.467,19,8,15,6,224.6,229.6,227.1
2019-01-17,1610612764,1610612752,2018,101.0,100.0,201.0,114.2,113.2,104.3,116.9,44,18,26,0.409,43,10,33,0.233,13,5,4,6,238.8,220.6,229.7
2019-01-17,1610612766,1610612758,2018,114.0,95.0,209.0,104.6,105.9,113.3,113.6,43,20,23,0.465,44,23,21,0.523,14,6,14,9,202.2,218.6,210.39999999999998
2019-01-17,1610612754,1610612755,2018,96.0,120.0,216.0,114.4,106.7,119.4,114.3,43,29,14,0.674,45,29,16,0.644,15,14,19,10,208.4,236.0,222.2
2019-01-17,1610612761,1610612756,2018,111.0,109.0,220.0,112.9,112.8,113.0,119.1,46,33,13,0.7170000000000001,45,11,34,0.244,18,15,7,4,216.0,228.8,222.4
2019-01-17,1610612743,1610612741,2018,135.0,105.0,240.0,113.4,113.0,99.6,112.9,43,29,14,0.674,44,10,34,0.227,18,11,5,5,231.8,206.2,219.0
2019-01-17,1610612760,1610612747,2018,128.0,138.0,266.0,116.5,117.3,105.8,106.3,43,26,17,0.605,45,24,21,0.5329999999999999,14,12,15,9,226.8,210.8,218.8
2019-01-16,1610612765,1610612753,2018,120.0,115.0,235.0,102.3,105.2,106.5,105.5,42,18,24,0.429,43,19,24,0.442,11,7,12,7,209.2,218.8,214.0
2019-01-16,1610612738,1610612761,2018,117.0,108.0,225.0,112.8,106.4,112.7,111.5,43,25,18,0.581,45,33,12,0.733,15,10,18,15,222.6,216.0,219.3
2019-01-16,1610612745,1610612751,2018,142.0,145.0,287.0,115.2,110.2,113.7,112.5,43,25,18,0.581,45,22,23,0.489,16,9,12,10,227.4,230.8,229.10000000000002
2019-01-16,1610612763,1610612749,2018,101.0,111.0,212.0,97.4,105.4,117.0,104.6,43,19,24,0.442,43,31,12,0.721,11,8,20,11,196.6,228.0,212.3
2019-01-16,1610612742,1610612759,2018,101.0,105.0,206.0,107.8,108.3,113.8,109.9,43,20,23,0.465,45,25,20,0.556,16,4,18,7,216.8,232.2,224.5
2019-01-16,1610612757,1610612739,2018,129.0,112.0,241.0,112.0,108.6,102.8,120.7,45,26,19,0.578,44,9,35,0.205,18,8,5,4,220.4,218.0,219.2
2019-01-16,1610612744,1610612740,2018,147.0,140.0,287.0,124.7,113.8,119.5,112.6,44,30,14,0.682,44,21,23,0.477,17,13,15,6,237.6,229.6,233.6
2019-01-16,1610612746,1610612762,2018,109.0,129.0,238.0,113.8,113.2,112.3,100.3,43,24,19,0.5579999999999999,45,24,21,0.5329999999999999,14,10,12,12,224.4,207.8,216.10000000000002
2019-01-15,1610612754,1610612756,2018,131.0,97.0,228.0,112.3,106.9,114.4,116.3,42,28,14,0.667,44,11,33,0.25,14,14,7,4,204.6,228.8,216.7
2019-01-15,1610612755,1610612750,2018,149.0,107.0,256.0,117.6,114.5,114.0,109.0,44,28,16,0.636,43,21,22,0.488,18,10,15,6,232.8,222.0,227.4
2019-01-15,1610612737,1610612760,2018,142.0,126.0,268.0,110.4,116.1,115.7,113.3,43,13,30,0.302,42,26,16,0.619,7,6,14,12,226.4,226.8,226.60000000000002
2019-01-15,1610612749,1610612748,2018,124.0,86.0,210.0,117.5,107.5,106.1,101.4,42,30,12,0.7140000000000001,41,21,20,0.512,19,11,11,10,234.8,215.4,225.10000000000002
2019-01-15,1610612743,1610612744,2018,111.0,142.0,253.0,112.5,108.7,120.8,113.5,42,29,13,0.69,43,29,14,0.674,18,11,17,12,221.4,237.6,229.5
2019-01-15,1610612747,1610612741,2018,107.0,100.0,207.0,107.2,107.7,99.7,111.4,44,23,21,0.523,43,10,33,0.233,14,9,5,5,216.4,206.2,211.3
2019-01-14,1610612751,1610612738,2018,109.0,102.0,211.0,113.4,113.7,113.9,108.2,44,21,23,0.477,42,25,17,0.595,11,10,15,10,232.6,222.6,227.6
2019-01-14,1610612745,1610612763,2018,112.0,94.0,206.0,116.7,112.1,98.7,104.1,42,24,18,0.5710000000000001,42,19,23,0.452,15,9,11,8,234.2,196.6,215.39999999999998
2019-01-14,1610612759,1610612766,2018,93.0,108.0,201.0,115.6,109.4,104.8,108.9,44,25,19,0.568,42,19,23,0.452,18,7,14,5,234.8,202.2,218.5
2019-01-14,1610612762,1610612765,2018,100.0,94.0,194.0,112.0,102.3,102.7,107.3,44,23,21,0.523,41,18,23,0.439,11,12,11,7,211.2,209.2,210.2
2019-01-14,1610612758,1610612757,2018,115.0,107.0,222.0,113.1,114.6,114.4,109.8,43,22,21,0.512,44,26,18,0.591,13,9,18,8,220.2,220.4,220.3
2019-01-14,1610612746,1610612740,2018,117.0,121.0,238.0,113.2,113.3,119.1,113.1,42,24,18,0.5710000000000001,43,20,23,0.465,14,10,15,5,223.4,229.6,226.5
2019-01-13,1610612752,1610612755,2018,105.0,108.0,213.0,104.5,118.0,118.2,113.7,42,10,32,0.238,43,27,16,0.628,4,6,18,9,223.2,232.8,228.0
2019-01-13,1610612764,1610612761,2018,138.0,140.0,278.0,109.6,109.3,108.8,110.3,43,18,25,0.419,44,32,12,0.727,13,5,18,14,221.8,216.0,218.9
2019-01-13,1610612737,1610612749,2018,114.0,133.0,247.0,109.6,112.6,116.2,106.8,42,13,29,0.31,41,29,12,0.7070000000000001,7,6,19,10,217.8,234.8,226.3
2019-01-13,1610612753,1610612745,2018,116.0,109.0,225.0,104.0,106.1,116.3,110.2,42,18,24,0.429,41,24,17,0.585,11,7,15,9,215.0,234.2,224.6
2019-01-13,1610612742,1610612744,2018,114.0,119.0,233.0,107.7,108.4,121.9,114.6,42,20,22,0.476,42,28,14,0.667,16,4,17,11,216.8,237.6,227.2
2019-01-13,1610612743,1610612757,2018,116.0,113.0,229.0,113.5,109.2,111.4,107.4,41,28,13,0.6829999999999999,43,26,17,0.605,17,11,18,8,224.4,220.4,222.4
2019-01-13,1610612747,1610612739,2018,95.0,101.0,196.0,108.4,109.4,101.4,120.7,43,23,20,0.535,43,8,35,0.18600000000000005,14,9,5,3,222.2,218.0,220.1
2019-01-12,1610612746,1610612765,2018,104.0,109.0,213.0,115.5,114.2,102.5,107.8,41,24,17,0.585,40,17,23,0.425,14,10,11,6,229.8,209.2,219.5
2019-01-12,1610612748,1610612763,2018,112.0,108.0,220.0,106.7,100.0,97.8,103.1,40,20,20,0.5,41,19,22,0.463,10,10,11,8,213.8,196.6,205.2
2019-01-12,1610612753,1610612738,2018,105.0,103.0,208.0,102.5,108.7,114.0,109.0,41,17,24,0.415,41,25,16,0.61,10,7,15,10,217.2,222.6,219.89999999999998
2019-01-12,1610612750,1610612740,2018,110.0,106.0,216.0,115.3,111.3,118.9,113.3,42,20,22,0.476,42,20,22,0.476,14,6,15,5,229.2,229.6,229.39999999999998
2019-01-12,1610612760,1610612759,2018,122.0,112.0,234.0,115.6,111.7,114.5,108.0,41,25,16,0.61,43,25,18,0.581,13,12,18,7,223.4,234.8,229.10000000000002
2019-01-12,1610612756,1610612743,2018,102.0,93.0,195.0,115.1,120.2,114.5,110.1,43,10,33,0.233,40,28,12,0.7,6,4,17,11,238.0,224.4,231.2
2019-01-12,1610612758,1610612766,2018,104.0,97.0,201.0,113.5,116.2,107.7,111.5,42,21,21,0.5,41,19,22,0.463,12,9,14,5,224.2,202.2,213.2
2019-01-12,1610612762,1610612741,2018,110.0,102.0,212.0,112.7,101.7,100.7,109.6,43,22,21,0.512,42,10,32,0.238,10,12,5,5,211.4,206.2,208.8
2019-01-11,1610612755,1610612737,2018,121.0,123.0,244.0,116.2,112.7,108.1,112.1,42,27,15,0.643,41,12,29,0.293,18,9,7,5,226.8,217.8,222.3
2019-01-11,1610612764,1610612749,2018,113.0,106.0,219.0,113.2,113.3,116.3,105.9,42,17,25,0.405,40,29,11,0.725,12,5,19,10,237.0,234.8,235.9
2019-01-11,1610612752,1610612754,2018,106.0,121.0,227.0,104.3,117.1,113.1,108.4,41,10,31,0.244,41,27,14,0.659,4,6,14,13,221.0,204.6,212.8
2019-01-11,1610612761,1610612751,2018,122.0,105.0,227.0,109.2,110.8,111.6,111.5,43,31,12,0.721,43,21,22,0.488,17,14,11,10,217.8,232.6,225.2
2019-01-11,1610612745,1610612739,2018,141.0,113.0,254.0,113.5,109.8,101.1,119.2,40,23,17,0.575,42,8,34,0.19,14,9,5,3,227.8,218.0,222.9
2019-01-11,1610612750,1610612742,2018,115.0,119.0,234.0,117.0,109.9,107.0,108.3,41,20,21,0.488,41,19,22,0.463,14,6,16,3,229.8,216.8,223.3
2019-01-11,1610612762,1610612747,2018,113.0,95.0,208.0,112.0,102.9,109.9,109.6,42,21,21,0.5,42,23,19,0.5479999999999999,9,12,14,9,212.4,222.2,217.3
2019-01-11,1610612757,1610612766,2018,127.0,96.0,223.0,111.6,107.3,111.3,112.2,42,25,17,0.595,40,19,21,0.475,17,8,14,5,220.6,202.2,211.39999999999998
2019-01-11,1610612744,1610612741,2018,146.0,109.0,255.0,120.2,116.4,99.4,107.1,41,27,14,0.659,41,10,31,0.244,16,11,5,5,237.8,206.2,222.0
2019-01-10,1610612748,1610612738,2018,115.0,99.0,214.0,105.6,100.7,117.1,110.0,39,19,20,0.487,40,25,15,0.625,9,10,15,10,213.0,222.6,217.8
2019-01-10,1610612743,1610612746,2018,121.0,100.0,221.0,111.9,108.7,114.2,114.6,39,27,12,0.6920000000000001,40,24,16,0.6,16,11,14,10,216.4,229.8,223.10000000000002
2019-01-10,1610612759,1610612760,2018,154.0,147.0,301.0,111.5,103.1,111.8,107.6,42,24,18,0.5710000000000001,40,25,15,0.625,17,7,13,12,219.0,223.4,221.2
2019-01-10,1610612758,1610612765,2018,112.0,102.0,214.0,114.0,117.6,101.1,109.1,41,20,21,0.488,39,17,22,0.436,11,9,11,6,228.0,209.2,218.6
2019-01-09,1610612738,1610612754,2018,135.0,108.0,243.0,115.5,109.5,113.7,105.5,39,24,15,0.615,40,27,13,0.675,14,10,14,13,218.4,204.6,211.5
2019-01-09,1610612764,1610612755,2018,123.0,106.0,229.0,113.7,113.7,117.0,112.5,41,16,25,0.39,41,27,14,0.659,11,5,18,9,238.8,226.8,232.8
2019-01-09,1610612751,1610612737,2018,116.0,100.0,216.0,111.5,112.5,110.4,112.5,42,20,22,0.476,40,12,28,0.3,10,10,7,5,234.4,217.8,226.10000000000002
2019-01-09,1610612745,1610612749,2018,109.0,116.0,225.0,113.4,108.3,116.1,105.2,39,23,16,0.59,39,28,11,0.718,14,9,19,9,224.6,234.8,229.7
2019-01-09,1610612763,1610612759,2018,96.0,86.0,182.0,97.9,105.0,115.8,102.5,40,18,22,0.45,41,24,17,0.585,10,8,17,7,200.6,219.0,209.8
2019-01-09,1610612740,1610612739,2018,140.0,124.0,264.0,114.5,111.1,98.6,116.2,41,19,22,0.463,41,8,33,0.195,14,5,5,3,216.4,218.0,217.2
2019-01-09,1610612742,1610612756,2018,104.0,94.0,198.0,108.0,109.6,118.5,120.8,40,18,22,0.45,42,10,32,0.238,15,3,6,4,221.4,238.0,229.7
2019-01-09,1610612762,1610612753,2018,106.0,93.0,199.0,112.2,103.9,103.2,110.6,41,20,21,0.488,40,17,23,0.425,8,12,10,7,214.8,217.2,216.0
2019-01-09,1610612757,1610612741,2018,124.0,112.0,236.0,109.7,107.6,98.0,104.0,41,24,17,0.585,40,10,30,0.25,16,8,5,5,217.4,206.2,211.8
2019-01-09,1610612747,1610612765,2018,113.0,100.0,213.0,108.5,110.3,99.7,107.6,41,22,19,0.537,38,17,21,0.447,13,9,11,6,220.8,209.2,215.0
2019-01-08,1610612739,1610612754,2018,115.0,123.0,238.0,97.6,116.7,111.0,103.9,40,8,32,0.2,39,26,13,0.667,5,3,14,12,217.0,204.6,210.8
2019-01-08,1610612755,1610612764,2018,132.0,115.0,247.0,116.2,113.7,114.0,114.1,40,26,14,0.65,40,16,24,0.4,17,9,11,5,227.6,238.8,233.2
2019-01-08,1610612748,1610612743,2018,99.0,103.0,202.0,105.1,99.1,112.7,112.0,38,19,19,0.5,38,26,12,0.684,9,10,16,10,208.8,216.4,212.60000000000002
2019-01-08,1610612761,1610612737,2018,104.0,101.0,205.0,108.7,110.3,110.1,111.6,42,30,12,0.7140000000000001,39,12,27,0.308,16,14,7,5,215.8,217.8,216.8
2019-01-08,1610612760,1610612750,2018,117.0,119.0,236.0,111.1,106.1,116.5,109.4,39,25,14,0.6409999999999999,40,19,21,0.475,13,12,14,5,219.0,229.8,224.4
2019-01-08,1610612756,1610612758,2018,115.0,111.0,226.0,118.8,121.9,113.7,115.0,41,9,32,0.22,40,20,20,0.5,5,4,11,9,240.8,228.0,234.4
2019-01-08,1610612744,1610612752,2018,122.0,95.0,217.0,120.0,118.5,104.4,116.1,40,26,14,0.65,40,10,30,0.25,15,11,4,6,241.6,221.0,231.3
2019-01-08,1610612746,1610612766,2018,128.0,109.0,237.0,114.6,114.8,110.7,111.3,39,23,16,0.59,39,19,20,0.487,13,10,14,5,231.0,202.2,216.6
2019-01-07,1610612765,1610612759,2018,107.0,119.0,226.0,100.3,106.1,115.2,103.9,37,17,20,0.459,40,23,17,0.575,11,6,17,6,207.4,219.0,213.2
2019-01-07,1610612738,1610612751,2018,116.0,95.0,211.0,114.6,112.0,111.6,110.2,38,23,15,0.605,41,20,21,0.488,13,10,10,10,221.6,234.4,228.0
2019-01-07,1610612745,1610612743,2018,125.0,113.0,238.0,114.5,108.8,111.2,110.1,38,22,16,0.579,37,26,11,0.703,13,9,16,10,227.8,216.4,222.10000000000002
2019-01-07,1610612749,1610612762,2018,114.0,102.0,216.0,115.9,104.6,111.7,102.7,38,27,11,0.711,40,20,20,0.5,18,9,8,12,233.2,214.8,224.0
2019-01-07,1610612740,1610612763,2018,114.0,95.0,209.0,114.9,113.0,97.6,103.5,40,18,22,0.45,39,18,21,0.462,13,5,10,8,221.0,200.6,210.8
2019-01-07,1610612742,1610612747,2018,97.0,107.0,204.0,108.4,106.5,108.8,113.4,39,18,21,0.462,40,21,19,0.525,15,3,13,8,216.0,220.8,218.4
2019-01-07,1610612757,1610612752,2018,111.0,101.0,212.0,110.7,109.3,105.2,118.1,40,23,17,0.575,39,10,29,0.256,15,8,4,6,222.8,221.0,221.9
2019-01-07,1610612758,1610612753,2018,111.0,95.0,206.0,114.8,117.2,101.7,108.5,39,19,20,0.487,39,17,22,0.436,10,9,10,7,234.6,217.2,225.89999999999998
2019-01-06,1610612741,1610612751,2018,100.0,117.0,217.0,97.3,101.9,112.6,112.6,39,10,29,0.256,40,19,21,0.475,5,5,10,9,200.6,234.4,217.5
2019-01-06,1610612750,1610612747,2018,108.0,86.0,194.0,117.8,111.2,113.0,112.6,39,18,21,0.462,39,21,18,0.5379999999999999,13,5,13,8,236.0,220.8,228.4
2019-01-06,1610612746,1610612753,2018,106.0,96.0,202.0,116.5,117.3,99.7,108.0,38,22,16,0.579,38,17,21,0.447,12,10,10,7,239.8,217.2,228.5
2019-01-06,1610612737,1610612748,2018,106.0,82.0,188.0,111.2,116.5,105.3,99.6,38,11,27,0.289,37,19,18,0.514,6,5,9,10,229.8,208.8,219.3
2019-01-06,1610612760,1610612764,2018,98.0,116.0,214.0,113.5,105.8,113.4,116.1,38,25,13,0.6579999999999999,39,15,24,0.385,13,12,11,4,223.2,238.8,231.0
2019-01-06,1610612761,1610612754,2018,121.0,105.0,226.0,106.5,110.2,111.8,101.9,41,29,12,0.7070000000000001,38,26,12,0.684,15,14,14,12,211.2,204.6,207.89999999999998
2019-01-06,1610612756,1610612766,2018,113.0,119.0,232.0,117.7,121.8,110.7,110.7,40,9,31,0.225,38,18,20,0.474,5,4,14,4,238.4,202.2,220.3
2019-01-05,1610612743,1610612766,2018,123.0,110.0,233.0,109.8,108.9,110.1,110.5,36,25,11,0.6940000000000001,37,18,19,0.486,15,10,14,4,211.2,202.2,206.7
2019-01-05,1610612765,1610612762,2018,105.0,110.0,215.0,100.6,106.7,109.6,101.8,36,17,19,0.472,39,19,20,0.487,11,6,8,11,209.2,214.8,212.0
2019-01-05,1610612755,1610612742,2018,106.0,100.0,206.0,117.2,113.9,110.2,108.0,39,25,14,0.6409999999999999,38,18,20,0.474,16,9,15,3,230.0,216.0,223.0
2019-01-05,1610612739,1610612740,2018,98.0,133.0,231.0,98.0,114.8,113.1,115.5,39,8,31,0.205,39,17,22,0.436,5,3,13,4,214.0,221.0,217.5
2019-01-05,1610612749,1610612761,2018,116.0,123.0,239.0,116.6,103.8,102.8,108.1,37,27,10,0.73,40,28,12,0.7,18,9,15,13,233.0,211.2,222.1
2019-01-05,1610612759,1610612763,2018,108.0,88.0,196.0,116.7,104.7,98.1,103.7,39,22,17,0.564,38,18,20,0.474,16,6,10,8,223.6,200.6,212.1
2019-01-05,1610612757,1610612745,2018,110.0,101.0,211.0,108.7,111.2,114.8,108.5,39,22,17,0.564,37,22,15,0.595,14,8,13,9,222.6,227.8,225.2
2019-01-05,1610612758,1610612744,2018,123.0,127.0,250.0,112.7,114.4,117.8,115.7,38,19,19,0.5,39,25,14,0.6409999999999999,10,9,15,10,224.8,241.6,233.2
2019-01-04,1610612739,1610612762,2018,91.0,117.0,208.0,100.2,113.7,109.2,104.9,38,8,30,0.211,38,18,20,0.474,5,3,8,10,216.2,214.8,215.5
2019-01-04,1610612738,1610612742,2018,114.0,93.0,207.0,113.5,113.8,112.5,108.6,37,22,15,0.595,37,18,19,0.486,12,10,15,3,223.0,216.0,219.5
2019-01-04,1610612748,1610612764,2018,115.0,109.0,224.0,103.9,98.6,114.3,117.1,36,18,18,0.5,38,15,23,0.395,8,10,11,4,204.0,238.8,221.4
2019-01-04,1610612741,1610612754,2018,116.0,119.0,235.0,94.6,100.8,111.1,99.3,38,10,28,0.263,37,25,12,0.6759999999999999,5,5,14,11,193.0,204.6,198.8
2019-01-04,1610612763,1610612751,2018,100.0,109.0,209.0,97.8,102.8,112.9,113.0,37,18,19,0.486,39,18,21,0.462,10,8,10,8,198.2,234.4,216.3
2019-01-04,1610612750,1610612753,2018,120.0,103.0,223.0,116.1,110.0,99.9,105.0,38,17,21,0.447,37,17,20,0.459,12,5,10,7,230.2,217.2,223.7
2019-01-04,1610612749,1610612737,2018,144.0,112.0,256.0,113.0,101.8,111.4,112.8,36,26,10,0.722,37,11,26,0.297,17,9,6,5,221.8,229.8,225.8
2019-01-04,1610612756,1610612746,2018,111.0,121.0,232.0,117.3,119.6,116.7,118.1,39,9,30,0.231,37,21,16,0.568,5,4,12,9,233.2,239.8,236.5
2019-01-04,1610612747,1610612752,2018,112.0,119.0,231.0,113.0,111.1,103.2,117.9,38,21,17,0.5529999999999999,38,9,29,0.237,13,8,4,5,217.8,221.0,219.4
2019-01-04,1610612757,1610612760,2018,109.0,111.0,220.0,107.7,109.3,113.1,105.5,38,22,16,0.579,37,24,13,0.649,14,8,13,11,216.8,223.2,220.0
2019-01-03,1610612759,1610612761,2018,125.0,107.0,232.0,113.5,103.8,104.3,108.4,38,21,17,0.5529999999999999,39,28,11,0.718,15,6,15,13,215.4,211.2,213.3
2019-01-03,1610612758,1610612743,2018,113.0,117.0,230.0,112.7,115.9,108.8,108.9,37,19,18,0.514,35,24,11,0.6859999999999999,10,9,15,9,227.8,211.2,219.5
2019-01-03,1610612744,1610612745,2018,134.0,135.0,269.0,115.4,111.5,110.4,106.9,38,25,13,0.6579999999999999,36,21,15,0.583,15,10,13,8,228.4,227.8,228.10000000000002
2019-01-02,1610612766,1610612742,2018,84.0,122.0,206.0,111.7,111.1,112.4,112.7,36,18,18,0.5,36,17,19,0.472,14,4,15,2,206.6,216.0,211.3
2019-01-02,1610612739,1610612748,2018,92.0,117.0,209.0,102.6,112.1,102.7,100.2,37,8,29,0.21600000000000005,35,17,18,0.486,5,3,8,9,217.8,204.0,210.9
2019-01-02,1610612764,1610612737,2018,114.0,98.0,212.0,115.4,120.3,114.3,115.8,37,14,23,0.378,36,11,25,0.306,10,4,6,5,247.4,229.8,238.60000000000002
2019-01-02,1610612751,1610612740,2018,126.0,121.0,247.0,114.7,113.6,111.0,114.2,38,17,21,0.447,38,17,21,0.447,9,8,13,4,239.2,221.0,230.1
2019-01-02,1610612738,1610612750,2018,115.0,102.0,217.0,114.9,114.4,115.7,110.9,36,21,15,0.583,37,17,20,0.459,11,10,12,5,227.0,230.2,228.6
2019-01-02,1610612741,1610612753,2018,84.0,112.0,196.0,93.9,102.9,98.6,105.1,37,10,27,0.27,36,16,20,0.444,5,5,10,6,195.8,217.2,206.5
2019-01-02,1610612763,1610612765,2018,94.0,101.0,195.0,97.6,101.0,103.4,109.6,36,18,18,0.5,35,16,19,0.457,10,8,11,5,194.2,209.2,201.7
2019-01-02,1610612756,1610612755,2018,127.0,132.0,259.0,114.5,115.3,113.6,113.5,38,9,29,0.237,38,24,14,0.632,5,4,16,8,219.0,230.0,224.5
2019-01-02,1610612747,1610612760,2018,100.0,107.0,207.0,113.8,110.9,115.6,106.8,37,21,16,0.568,36,23,13,0.639,13,8,13,10,219.0,223.2,221.1
2019-01-01,1610612761,1610612762,2018,122.0,116.0,238.0,103.4,107.0,107.3,103.7,38,27,11,0.711,37,18,19,0.486,14,13,8,10,206.6,214.8,210.7
2019-01-01,1610612749,1610612765,2018,121.0,98.0,219.0,110.4,102.5,104.3,108.3,35,25,10,0.7140000000000001,34,16,18,0.471,16,9,11,5,218.0,209.2,213.6
2019-01-01,1610612743,1610612752,2018,115.0,108.0,223.0,107.8,108.0,105.0,118.8,34,23,11,0.6759999999999999,37,9,28,0.243,14,9,4,5,207.4,221.0,214.2
2019-01-01,1610612758,1610612757,2018,108.0,113.0,221.0,114.4,117.6,106.8,109.6,36,19,17,0.528,37,21,16,0.568,10,9,14,7,234.6,216.8,225.7
2019-01-01,1610612746,1610612755,2018,113.0,119.0,232.0,118.1,119.3,114.5,112.7,36,21,15,0.583,37,23,14,0.622,12,9,16,7,245.0,230.0,237.5
2018-12-31,1610612754,1610612737,2018,116.0,108.0,224.0,110.8,98.2,114.3,117.1,36,24,12,0.667,35,11,24,0.314,13,11,6,5,201.8,229.8,215.8
2018-12-31,1610612766,1610612753,2018,125.0,100.0,225.0,111.6,113.7,99.8,104.1,35,17,18,0.486,35,16,19,0.457,13,4,10,6,211.6,217.2,214.39999999999998
2018-12-31,1610612745,1610612763,2018,113.0,101.0,214.0,109.3,106.5,97.4,100.2,35,20,15,0.5710000000000001,35,18,17,0.514,12,8,10,8,224.8,194.2,209.5
2018-12-31,1610612759,1610612738,2018,120.0,111.0,231.0,114.0,101.4,117.1,110.1,37,20,17,0.541,35,21,14,0.6,14,6,11,10,211.6,227.0,219.3
2018-12-31,1610612740,1610612750,2018,123.0,114.0,237.0,109.0,113.5,114.2,109.3,37,16,21,0.4320000000000001,36,17,19,0.472,12,4,12,5,215.6,230.2,222.89999999999998
2018-12-31,1610612760,1610612742,2018,122.0,102.0,224.0,115.8,107.5,114.0,113.1,35,22,13,0.629,35,17,18,0.486,12,10,15,2,225.0,216.0,220.5
2018-12-31,1610612756,1610612744,2018,109.0,132.0,241.0,115.5,114.4,115.1,111.1,37,9,28,0.243,37,24,13,0.649,5,4,15,9,219.2,228.4,223.8
2018-12-30,1610612753,1610612765,2018,109.0,107.0,216.0,98.5,102.3,103.8,109.0,34,15,19,0.441,33,16,17,0.485,9,6,11,5,211.0,209.2,210.1
2018-12-30,1610612748,1610612750,2018,104.0,113.0,217.0,101.3,99.4,115.9,113.0,34,17,17,0.5,35,16,19,0.457,8,9,12,4,199.6,230.2,214.89999999999998
2018-12-30,1610612761,1610612741,2018,95.0,89.0,184.0,104.2,108.7,94.1,103.1,37,26,11,0.703,36,10,26,0.278,13,13,5,5,211.6,195.8,203.7
2018-12-30,1610612742,1610612760,2018,105.0,103.0,208.0,114.2,113.2,115.3,107.9,34,16,18,0.471,34,22,12,0.647,14,2,12,10,216.6,225.0,220.8
2018-12-30,1610612757,1610612755,2018,129.0,95.0,224.0,106.7,112.3,116.7,110.9,36,20,16,0.556,36,23,13,0.639,13,7,16,7,222.0,230.0,226.0
2018-12-30,1610612747,1610612758,2018,121.0,114.0,235.0,113.8,110.8,112.7,116.2,36,20,16,0.556,35,19,16,0.5429999999999999,12,8,10,9,218.8,234.6,226.7
2018-12-29,1610612749,1610612751,2018,129.0,115.0,244.0,109.0,100.2,112.0,110.9,34,24,10,0.706,37,17,20,0.459,15,9,9,8,210.6,239.2,224.89999999999998
2018-12-29,1610612740,1610612745,2018,104.0,108.0,212.0,111.8,113.3,107.6,106.4,36,16,20,0.444,34,19,15,0.5589999999999999,12,4,12,7,220.8,224.8,222.8
2018-12-29,1610612764,1610612766,2018,130.0,126.0,256.0,112.6,116.5,111.3,113.1,36,13,23,0.361,34,17,17,0.5,9,4,13,4,234.2,211.6,222.89999999999998
2018-12-29,1610612737,1610612739,2018,111.0,108.0,219.0,114.3,119.1,101.0,110.1,34,10,24,0.294,36,8,28,0.222,5,5,5,3,233.8,217.8,225.8
2018-12-29,1610612763,1610612738,2018,103.0,112.0,215.0,95.9,100.1,117.7,110.7,34,18,16,0.529,34,20,14,0.588,10,8,11,9,191.0,227.0,209.0
2018-12-29,1610612762,1610612752,2018,129.0,97.0,226.0,105.5,102.4,105.9,117.2,36,17,19,0.472,36,9,27,0.25,7,10,4,5,208.6,221.0,214.8
2018-12-29,1610612756,1610612743,2018,118.0,122.0,240.0,113.5,113.7,108.0,108.0,36,9,27,0.25,33,22,11,0.667,5,4,14,8,213.8,207.4,210.60000000000002
2018-12-29,1610612757,1610612744,2018,105.0,115.0,220.0,107.5,111.3,116.4,111.7,35,20,15,0.5710000000000001,36,23,13,0.639,13,7,15,8,221.6,228.4,225.0
2018-12-29,1610612746,1610612759,2018,111.0,122.0,233.0,116.9,119.4,112.3,104.2,35,21,14,0.6,36,19,17,0.528,12,9,14,5,242.8,211.6,227.2
2018-12-28,1610612766,1610612751,2018,100.0,87.0,187.0,112.1,115.1,114.6,112.8,33,16,17,0.485,36,17,19,0.472,12,4,9,8,217.2,239.2,228.2
2018-12-28,1610612754,1610612765,2018,125.0,88.0,213.0,109.2,99.5,104.2,108.0,35,23,12,0.657,32,16,16,0.5,12,11,11,5,201.2,209.2,205.2
2018-12-28,1610612753,1610612761,2018,116.0,87.0,203.0,96.6,102.7,106.8,106.4,33,14,19,0.424,36,26,10,0.722,8,6,13,13,208.0,211.6,209.8
2018-12-28,1610612764,1610612741,2018,92.0,101.0,193.0,116.9,119.5,93.0,103.5,35,13,22,0.371,35,9,26,0.257,9,4,5,4,248.8,195.8,222.3
2018-12-28,1610612748,1610612739,2018,118.0,94.0,212.0,99.7,100.0,100.8,109.1,33,16,17,0.485,35,8,27,0.229,7,9,5,3,197.6,217.8,207.7
2018-12-28,1610612750,1610612737,2018,120.0,123.0,243.0,114.8,112.5,112.7,118.5,34,16,18,0.471,33,9,24,0.273,12,4,5,4,227.0,233.8,230.4
2018-12-28,1610612740,1610612742,2018,114.0,112.0,226.0,113.0,115.0,111.9,111.7,35,15,20,0.429,33,16,17,0.485,11,4,14,2,226.6,216.6,221.6
2018-12-28,1610612743,1610612759,2018,102.0,99.0,201.0,109.5,106.6,111.3,106.8,32,21,11,0.6559999999999999,35,19,16,0.5429999999999999,13,8,14,5,207.6,211.6,209.6
2018-12-28,1610612756,1610612760,2018,102.0,118.0,220.0,113.8,114.1,114.9,109.5,35,9,26,0.257,33,21,12,0.636,5,4,12,9,215.2,225.0,220.1
2018-12-28,1610612747,1610612746,2018,107.0,118.0,225.0,115.1,108.6,113.7,118.3,35,20,15,0.5710000000000001,34,20,14,0.588,12,8,12,8,217.0,242.8,229.9
2018-12-27,1610612745,1610612738,2018,127.0,113.0,240.0,107.5,106.2,118.8,108.7,33,18,15,0.545,33,20,13,0.606,11,7,11,9,224.2,227.0,225.6
2018-12-27,1610612749,1610612752,2018,112.0,96.0,208.0,109.4,101.9,106.3,118.8,33,23,10,0.6970000000000001,35,9,26,0.257,14,9,4,5,214.8,221.0,217.9
2018-12-27,1610612758,1610612747,2018,117.0,116.0,233.0,115.1,117.6,114.6,109.5,34,18,16,0.529,34,20,14,0.588,9,9,12,8,242.2,217.0,229.6
2018-12-27,1610612762,1610612755,2018,97.0,114.0,211.0,107.6,100.1,115.5,112.5,35,17,18,0.486,35,22,13,0.629,7,10,16,6,208.2,230.0,219.1
2018-12-27,1610612744,1610612757,2018,109.0,110.0,219.0,114.8,112.0,106.7,111.5,35,23,12,0.657,34,19,15,0.5589999999999999,15,8,13,6,225.8,221.6,223.7
2018-12-26,1610612765,1610612764,2018,106.0,95.0,201.0,104.7,110.2,117.5,119.8,31,15,16,0.484,34,13,21,0.382,10,5,9,4,214.6,248.8,231.7
2018-12-26,1610612753,1610612756,2018,120.0,122.0,242.0,93.6,101.7,110.2,113.2,32,14,18,0.438,34,8,26,0.235,8,6,5,3,200.0,215.2,207.6
2018-12-26,1610612737,1610612754,2018,121.0,129.0,250.0,113.0,117.9,107.3,98.5,32,9,23,0.281,34,22,12,0.647,5,4,12,10,233.2,201.2,217.2
2018-12-26,1610612751,1610612766,2018,134.0,132.0,266.0,113.7,111.4,109.3,112.6,35,16,19,0.457,32,16,16,0.5,8,8,12,4,234.6,217.2,225.89999999999998
2018-12-26,1610612748,1610612761,2018,104.0,106.0,210.0,99.9,99.5,108.5,105.9,32,16,16,0.5,35,25,10,0.7140000000000001,7,9,13,12,197.0,211.6,204.3
2018-12-26,1610612741,1610612750,2018,94.0,119.0,213.0,95.0,102.8,113.7,114.7,34,9,25,0.265,33,15,18,0.455,5,4,12,3,198.4,227.0,212.7
2018-12-26,1610612763,1610612739,2018,95.0,87.0,182.0,96.0,100.0,102.0,109.3,33,17,16,0.515,34,8,26,0.235,9,8,5,3,191.0,217.8,204.4
2018-12-26,1610612742,1610612740,2018,122.0,119.0,241.0,110.8,110.0,112.7,113.6,32,15,17,0.469,34,15,19,0.441,13,2,11,4,211.0,226.6,218.8
2018-12-26,1610612759,1610612743,2018,111.0,103.0,214.0,111.3,105.1,109.8,105.8,34,18,16,0.529,31,21,10,0.677,13,5,13,8,208.2,207.6,207.89999999999998
2018-12-26,1610612746,1610612758,2018,127.0,118.0,245.0,110.8,118.6,116.2,115.9,33,19,14,0.5760000000000001,33,18,15,0.545,11,8,9,9,237.6,242.2,239.89999999999998
2018-12-25,1610612752,1610612749,2018,95.0,109.0,204.0,107.5,118.9,108.2,103.7,34,9,25,0.265,32,22,10,0.688,4,5,14,8,223.6,214.8,219.2
2018-12-25,1610612745,1610612760,2018,113.0,109.0,222.0,107.3,105.7,115.2,109.6,32,17,15,0.531,32,21,11,0.6559999999999999,10,7,12,9,222.8,225.0,223.9
2018-12-25,1610612738,1610612755,2018,121.0,114.0,235.0,118.0,107.3,116.8,112.9,32,19,13,0.594,34,22,12,0.647,10,9,16,6,222.6,230.0,226.3
2018-12-25,1610612744,1610612747,2018,101.0,127.0,228.0,116.3,110.1,113.0,108.2,34,23,11,0.6759999999999999,33,19,14,0.5760000000000001,15,8,12,7,225.0,217.0,221.0
2018-12-25,1610612762,1610612757,2018,117.0,96.0,213.0,109.8,101.0,108.9,112.9,34,16,18,0.471,33,19,14,0.5760000000000001,6,10,13,6,214.4,221.6,218.0
2018-12-23,1610612765,1610612737,2018,95.0,98.0,193.0,103.5,111.4,114.1,120.8,30,15,15,0.5,31,8,23,0.258,10,5,5,3,214.6,233.2,223.89999999999998
2018-12-23,1610612754,1610612764,2018,105.0,89.0,194.0,107.5,99.3,118.7,120.9,33,21,12,0.636,33,13,20,0.394,11,10,9,4,203.2,248.8,226.0
2018-12-23,1610612738,1610612766,2018,119.0,103.0,222.0,118.9,107.0,107.9,112.0,31,18,13,0.581,31,16,15,0.516,9,9,12,4,223.8,217.2,220.5
2018-12-23,1610612751,1610612756,2018,111.0,103.0,214.0,113.2,111.6,108.5,112.9,34,15,19,0.441,33,8,25,0.242,7,8,5,3,234.0,215.2,224.6
2018-12-23,1610612739,1610612741,2018,92.0,112.0,204.0,103.8,111.0,94.3,105.7,33,8,25,0.242,33,8,25,0.242,5,3,5,3,224.8,198.4,211.60000000000002
2018-12-23,1610612753,1610612748,2018,91.0,115.0,206.0,96.3,102.6,100.5,100.2,31,14,17,0.452,31,15,16,0.484,8,6,7,8,207.2,197.0,202.1
2018-12-23,1610612758,1610612740,2018,122.0,117.0,239.0,115.1,115.2,112.9,112.3,32,17,15,0.531,33,15,18,0.455,8,9,11,4,238.6,226.6,232.6
2018-12-23,1610612760,1610612750,2018,112.0,114.0,226.0,114.0,106.5,112.8,114.8,31,21,10,0.677,32,14,18,0.438,12,9,12,2,216.4,227.0,221.7
2018-12-23,1610612744,1610612746,2018,129.0,127.0,256.0,115.0,108.4,111.0,118.3,33,22,11,0.667,32,19,13,0.594,14,8,11,8,219.0,237.6,228.3
2018-12-23,1610612757,1610612742,2018,121.0,118.0,239.0,107.6,109.7,109.6,111.1,32,18,14,0.563,31,15,16,0.484,12,6,13,2,212.6,211.0,211.8
2018-12-23,1610612747,1610612763,2018,99.0,107.0,206.0,114.5,107.8,96.0,100.4,32,19,13,0.594,32,16,16,0.5,12,7,9,7,219.2,191.0,205.1
2018-12-22,1610612746,1610612743,2018,132.0,111.0,243.0,109.3,117.1,110.0,103.8,31,18,13,0.581,30,21,9,0.7,10,8,13,8,231.8,207.6,219.7
2018-12-22,1610612764,1610612756,2018,149.0,146.0,295.0,116.2,117.7,103.5,110.0,32,12,20,0.375,32,8,24,0.25,8,4,5,3,237.4,215.2,226.3
2018-12-22,1610612755,1610612761,2018,126.0,101.0,227.0,114.5,112.3,108.9,103.9,33,21,12,0.636,34,25,9,0.735,15,6,13,12,224.2,211.6,217.89999999999998
2018-12-22,1610612748,1610612749,2018,94.0,87.0,181.0,102.4,103.0,109.9,104.2,30,14,16,0.467,31,22,9,0.71,6,8,14,8,206.4,214.8,210.60000000000002
2018-12-22,1610612745,1610612759,2018,108.0,101.0,209.0,108.6,106.1,112.0,105.0,31,16,15,0.516,33,18,15,0.545,9,7,13,5,226.2,208.2,217.2
2018-12-22,1610612744,1610612742,2018,120.0,116.0,236.0,114.7,108.4,108.3,110.5,32,21,11,0.6559999999999999,30,15,15,0.5,13,8,13,2,218.4,211.0,214.7
2018-12-22,1610612762,1610612760,2018,106.0,107.0,213.0,108.0,102.4,114.7,107.1,33,16,17,0.485,30,20,10,0.667,6,10,12,8,213.6,216.4,215.0
2018-12-21,1610612766,1610612765,2018,98.0,86.0,184.0,109.4,114.1,107.3,114.2,30,15,15,0.5,29,15,14,0.517,11,4,10,5,224.4,214.6,219.5
2018-12-21,1610612761,1610612739,2018,126.0,110.0,236.0,109.4,105.7,102.3,111.2,33,24,9,0.727,32,8,24,0.25,12,12,5,3,216.2,224.8,220.5
2018-12-21,1610612751,1610612754,2018,106.0,114.0,220.0,113.8,111.6,105.7,99.1,33,15,18,0.455,32,20,12,0.625,7,8,11,9,235.2,203.2,219.2
2018-12-21,1610612752,1610612737,2018,107.0,114.0,221.0,110.4,120.9,112.1,120.9,33,9,24,0.273,30,7,23,0.233,4,5,5,2,233.4,233.2,233.3
2018-12-21,1610612738,1610612749,2018,107.0,120.0,227.0,121.0,104.5,111.3,107.1,30,18,12,0.6,30,21,9,0.7,9,9,14,7,223.0,214.8,218.9
2018-12-21,1610612741,1610612753,2018,90.0,80.0,170.0,96.0,108.5,99.3,105.2,32,7,25,0.219,30,14,16,0.467,4,3,8,6,207.4,207.2,207.3
2018-12-21,1610612759,1610612750,2018,124.0,98.0,222.0,110.6,104.9,113.2,111.9,32,17,15,0.531,31,14,17,0.452,12,5,12,2,205.2,227.0,216.1
2018-12-21,1610612757,1610612762,2018,90.0,120.0,210.0,109.8,109.0,106.0,103.6,31,18,13,0.581,32,15,17,0.469,12,6,6,9,215.6,213.6,214.6
2018-12-21,1610612758,1610612763,2018,102.0,99.0,201.0,117.0,118.6,95.6,100.5,31,16,15,0.516,31,16,15,0.516,7,9,9,7,249.2,191.0,220.1
2018-12-21,1610612747,1610612740,2018,112.0,104.0,216.0,113.7,107.0,112.6,111.7,31,18,13,0.581,32,15,17,0.469,11,7,11,4,216.0,226.6,221.3
2018-12-20,1610612748,1610612745,2018,101.0,99.0,200.0,101.5,103.5,112.3,106.5,29,13,16,0.448,30,16,14,0.5329999999999999,5,8,9,7,205.6,226.2,215.89999999999998
2018-12-20,1610612746,1610612742,2018,125.0,121.0,246.0,108.0,115.7,109.0,108.8,30,17,13,0.5670000000000001,29,15,14,0.517,9,8,13,2,226.4,211.0,218.7
2018-12-19,1610612766,1610612739,2018,110.0,99.0,209.0,109.3,116.1,100.7,110.2,29,14,15,0.483,31,8,23,0.258,10,4,5,3,228.2,224.8,226.5
2018-12-19,1610612753,1610612759,2018,90.0,129.0,219.0,99.4,101.6,110.6,109.4,29,14,15,0.483,31,16,15,0.516,8,6,12,4,200.2,205.2,202.7
2018-12-19,1610612755,1610612752,2018,131.0,109.0,240.0,113.7,111.2,108.6,119.5,32,20,12,0.625,32,9,23,0.281,14,6,4,5,220.4,233.4,226.9
2018-12-19,1610612738,1610612756,2018,103.0,111.0,214.0,121.6,105.1,102.3,111.2,29,18,11,0.621,31,7,24,0.226,9,9,5,2,225.4,215.2,220.3
2018-12-19,1610612761,1610612754,2018,99.0,96.0,195.0,112.0,107.6,107.0,99.6,32,23,9,0.7190000000000001,31,20,11,0.645,11,12,11,9,225.2,203.2,214.2
2018-12-19,1610612741,1610612751,2018,93.0,96.0,189.0,96.3,109.2,114.6,111.5,31,7,24,0.226,32,14,18,0.438,4,3,7,7,209.4,235.2,222.3
2018-12-19,1610612745,1610612764,2018,136.0,118.0,254.0,109.5,107.5,117.5,115.8,29,15,14,0.517,31,12,19,0.387,8,7,8,4,222.6,237.4,230.0
2018-12-19,1610612749,1610612740,2018,123.0,115.0,238.0,112.5,108.5,112.5,111.8,29,20,9,0.69,31,15,16,0.484,13,7,11,4,220.0,226.6,223.3
2018-12-19,1610612750,1610612765,2018,123.0,129.0,252.0,113.7,107.9,105.0,112.3,30,14,16,0.467,28,14,14,0.5,12,2,10,4,220.0,214.6,217.3
2018-12-19,1610612762,1610612744,2018,108.0,103.0,211.0,106.2,105.2,114.6,108.7,31,14,17,0.452,31,21,10,0.677,5,9,13,8,217.2,218.4,217.8
2018-12-19,1610612757,1610612763,2018,99.0,92.0,191.0,111.4,111.0,99.5,103.1,30,17,13,0.5670000000000001,30,16,14,0.5329999999999999,11,6,9,7,222.8,191.0,206.9
2018-12-19,1610612758,1610612760,2018,113.0,132.0,245.0,116.9,118.7,112.5,104.1,30,16,14,0.5329999999999999,29,19,10,0.655,7,9,12,7,249.2,216.4,232.8
2018-12-18,1610612754,1610612739,2018,91.0,92.0,183.0,107.5,99.4,103.6,112.3,30,20,10,0.667,30,7,23,0.233,11,9,5,2,203.8,224.8,214.3
2018-12-18,1610612737,1610612764,2018,118.0,110.0,228.0,109.9,121.3,117.5,114.7,29,6,23,0.207,30,12,18,0.4,4,2,8,4,229.6,237.4,233.5
2018-12-18,1610612751,1610612747,2018,115.0,110.0,225.0,112.8,110.4,114.7,108.8,31,13,18,0.419,30,18,12,0.6,6,7,11,7,229.4,216.0,222.7
2018-12-18,1610612743,1610612742,2018,126.0,118.0,244.0,108.6,100.7,106.0,106.0,29,20,9,0.69,28,15,13,0.536,12,8,13,2,198.6,211.0,204.8
2018-12-17,1610612765,1610612749,2018,104.0,107.0,211.0,105.7,111.8,112.5,109.1,27,14,13,0.519,28,19,9,0.679,10,4,13,6,215.0,220.0,217.5
2018-12-17,1610612752,1610612756,2018,110.0,128.0,238.0,109.0,117.6,100.2,112.0,31,9,22,0.29,30,6,24,0.2,4,5,5,1,230.4,215.2,222.8
2018-12-17,1610612745,1610612762,2018,102.0,97.0,199.0,111.9,110.2,108.4,106.1,28,14,14,0.5,30,14,16,0.467,7,7,5,9,232.8,217.2,225.0
2018-12-17,1610612750,1610612758,2018,132.0,105.0,237.0,111.6,107.0,118.6,116.0,29,13,16,0.448,29,16,13,0.552,11,2,7,9,214.0,249.2,231.6
2018-12-17,1610612760,1610612741,2018,121.0,96.0,217.0,110.2,105.0,95.5,107.8,28,18,10,0.643,30,7,23,0.233,11,7,4,3,213.6,209.4,211.5
2018-12-17,1610612759,1610612755,2018,123.0,96.0,219.0,111.6,111.8,116.3,110.8,30,15,15,0.5,31,20,11,0.645,11,4,14,6,212.0,220.4,216.2
2018-12-17,1610612744,1610612763,2018,110.0,93.0,203.0,116.1,109.1,100.9,103.3,30,20,10,0.667,29,16,13,0.552,12,8,9,7,222.2,191.0,206.6
2018-12-17,1610612746,1610612757,2018,127.0,131.0,258.0,106.9,113.7,108.0,110.8,29,17,12,0.586,29,16,13,0.552,9,8,11,5,220.2,222.8,221.5
2018-12-16,1610612751,1610612737,2018,144.0,127.0,271.0,110.9,110.8,108.7,118.2,30,12,18,0.4,28,6,22,0.214,5,7,4,2,226.4,229.6,228.0
2018-12-16,1610612739,1610612755,2018,105.0,128.0,233.0,103.6,112.4,114.1,111.4,29,7,22,0.241,30,19,11,0.633,5,2,14,5,225.0,220.4,222.7
2018-12-16,1610612754,1610612752,2018,110.0,99.0,209.0,106.5,100.6,109.9,118.1,29,19,10,0.655,30,9,21,0.3,10,9,4,5,204.2,230.4,217.3
2018-12-16,1610612764,1610612747,2018,128.0,110.0,238.0,117.2,115.5,112.2,107.7,29,11,18,0.379,29,18,11,0.621,7,4,11,7,238.4,216.0,227.2
2018-12-16,1610612742,1610612758,2018,113.0,120.0,233.0,106.1,105.0,118.2,116.4,27,15,12,0.556,28,15,13,0.536,13,2,7,8,209.2,249.2,229.2
2018-12-16,1610612740,1610612748,2018,96.0,102.0,198.0,115.4,112.0,102.8,103.7,30,15,15,0.5,28,12,16,0.429,11,4,5,7,232.8,205.6,219.2
2018-12-16,1610612743,1610612761,2018,95.0,86.0,181.0,112.9,101.4,114.0,107.6,28,19,9,0.679,31,23,8,0.742,11,8,11,12,208.6,225.2,216.89999999999998
2018-12-15,1610612753,1610612762,2018,96.0,89.0,185.0,102.9,104.4,109.6,105.6,28,13,15,0.464,29,14,15,0.483,7,6,5,9,212.8,217.2,215.0
2018-12-15,1610612766,1610612747,2018,100.0,128.0,228.0,110.4,115.2,110.3,108.2,28,14,14,0.5,28,17,11,0.607,10,4,11,6,228.6,216.0,222.3
2018-12-15,1610612765,1610612738,2018,113.0,104.0,217.0,105.1,110.2,121.6,105.1,26,13,13,0.5,28,18,10,0.643,9,4,9,9,210.6,225.4,218.0
2018-12-15,1610612763,1610612745,2018,97.0,105.0,202.0,102.6,105.0,114.5,114.0,28,16,12,0.5710000000000001,27,13,14,0.481,9,7,7,6,197.8,232.8,215.3
2018-12-15,1610612759,1610612741,2018,93.0,98.0,191.0,115.4,113.8,97.0,110.1,29,15,14,0.517,29,6,23,0.207,11,4,4,2,223.6,209.4,216.5
2018-12-15,1610612760,1610612746,2018,110.0,104.0,214.0,110.1,105.0,107.5,114.1,27,17,10,0.63,28,17,11,0.607,10,7,9,8,213.4,220.2,216.8
2018-12-15,1610612756,1610612750,2018,107.0,99.0,206.0,98.0,112.0,112.9,106.5,29,5,24,0.172,28,13,15,0.464,4,1,11,2,210.8,214.0,212.4
2018-12-14,1610612738,1610612737,2018,129.0,108.0,237.0,117.3,104.1,106.8,115.0,27,17,10,0.63,27,6,21,0.222,8,9,4,2,214.8,229.6,222.2
2018-12-14,1610612766,1610612752,2018,124.0,126.0,250.0,108.8,112.0,107.6,115.5,27,14,13,0.519,29,8,21,0.276,10,4,4,4,219.0,230.4,224.7
2018-12-14,1610612751,1610612764,2018,125.0,118.0,243.0,107.5,109.1,115.2,115.3,29,11,18,0.379,28,11,17,0.393,4,7,7,4,216.2,238.4,227.3
2018-12-14,1610612739,1610612749,2018,102.0,114.0,216.0,102.9,111.6,113.2,110.3,28,7,21,0.25,27,18,9,0.667,5,2,13,5,222.0,220.0,221.0
2018-12-14,1610612755,1610612754,2018,101.0,113.0,214.0,115.7,109.2,107.3,99.3,29,19,10,0.655,28,18,10,0.643,14,5,10,8,219.2,204.2,211.7
2018-12-14,1610612763,1610612748,2018,97.0,100.0,197.0,102.7,105.3,104.3,106.5,27,16,11,0.593,27,11,16,0.407,9,7,5,6,198.6,205.6,202.1
2018-12-14,1610612743,1610612760,2018,109.0,98.0,207.0,111.9,102.5,112.6,103.6,27,18,9,0.667,26,17,9,0.654,10,8,10,7,208.8,213.4,211.10000000000002
2018-12-14,1610612757,1610612761,2018,128.0,122.0,250.0,105.2,109.0,114.0,106.2,28,15,13,0.536,30,23,7,0.767,10,5,11,12,213.6,225.2,219.39999999999998
2018-12-14,1610612758,1610612744,2018,125.0,130.0,255.0,117.4,114.7,115.9,109.7,27,15,12,0.556,29,19,10,0.655,7,8,12,7,244.2,222.2,233.2
2018-12-13,1610612745,1610612747,2018,126.0,111.0,237.0,115.1,114.1,110.5,105.3,26,12,14,0.462,27,17,10,0.63,6,6,11,6,234.2,216.0,225.1
2018-12-13,1610612759,1610612746,2018,125.0,87.0,212.0,113.4,118.7,112.1,113.7,28,14,14,0.5,27,17,10,0.63,10,4,9,8,229.4,220.2,224.8
2018-12-13,1610612753,1610612741,2018,97.0,91.0,188.0,106.2,107.0,97.5,111.5,27,12,15,0.444,28,6,22,0.214,6,6,4,2,224.6,209.4,217.0
2018-12-13,1610612756,1610612742,2018,99.0,89.0,188.0,98.5,114.0,107.5,104.9,28,4,24,0.14300000000000002,26,15,11,0.5770000000000001,3,1,13,2,215.8,209.2,212.5
2018-12-12,1610612766,1610612765,2018,108.0,107.0,215.0,109.0,112.0,106.8,110.3,26,13,13,0.5,25,13,12,0.52,9,4,9,4,219.4,210.6,215.0
2018-12-12,1610612739,1610612752,2018,113.0,106.0,219.0,101.1,111.2,108.7,115.1,27,6,21,0.222,28,8,20,0.28600000000000003,4,2,4,4,217.6,230.4,224.0
2018-12-12,1610612754,1610612749,2018,113.0,97.0,210.0,108.1,99.0,116.1,111.8,27,17,10,0.63,26,18,8,0.6920000000000001,9,8,13,5,205.2,220.0,212.6
2018-12-12,1610612755,1610612751,2018,124.0,127.0,251.0,114.5,108.6,106.3,107.1,28,19,9,0.679,28,10,18,0.35700000000000004,14,5,4,6,215.6,216.2,215.89999999999998
2018-12-12,1610612764,1610612738,2018,125.0,130.0,255.0,113.6,114.2,115.7,101.2,27,11,16,0.407,26,16,10,0.615,7,4,8,8,233.0,214.8,223.9
2018-12-12,1610612763,1610612757,2018,92.0,83.0,175.0,103.3,105.8,106.9,114.1,26,15,11,0.5770000000000001,27,15,12,0.556,8,7,10,5,200.8,213.6,207.2
2018-12-12,1610612740,1610612760,2018,118.0,114.0,232.0,114.3,113.0,112.5,103.5,29,14,15,0.483,25,17,8,0.68,10,4,10,7,232.6,213.4,223.0
2018-12-12,1610612742,1610612737,2018,114.0,107.0,221.0,107.4,104.6,105.4,117.4,25,14,11,0.56,26,6,20,0.231,12,2,4,2,208.4,229.6,219.0
2018-12-12,1610612762,1610612748,2018,111.0,84.0,195.0,110.8,108.7,106.2,105.0,28,13,15,0.464,26,11,15,0.423,4,9,5,6,225.8,205.6,215.7
2018-12-12,1610612758,1610612750,2018,141.0,130.0,271.0,113.7,111.6,110.9,104.5,26,14,12,0.5379999999999999,27,13,14,0.481,6,8,11,2,230.6,214.0,222.3
2018-12-12,1610612744,1610612761,2018,93.0,113.0,206.0,116.1,110.7,115.1,107.7,28,19,9,0.679,29,22,7,0.759,12,7,11,11,224.6,225.2,224.89999999999998
2018-12-11,1610612745,1610612757,2018,111.0,104.0,215.0,114.7,112.3,108.3,114.4,25,11,14,0.44,26,15,11,0.5770000000000001,5,6,10,5,229.8,213.6,221.7
2018-12-11,1610612759,1610612756,2018,111.0,86.0,197.0,112.6,120.5,101.5,114.3,27,13,14,0.481,27,4,23,0.14800000000000002,9,4,3,1,231.4,215.8,223.60000000000002
2018-12-11,1610612746,1610612761,2018,99.0,123.0,222.0,114.3,113.0,112.1,106.9,26,17,9,0.654,28,21,7,0.75,9,8,11,10,223.2,225.2,224.2
2018-12-10,1610612754,1610612764,2018,109.0,101.0,210.0,106.9,97.8,113.9,115.8,26,16,10,0.615,26,11,15,0.423,8,8,7,4,200.4,233.0,216.7
2018-12-10,1610612755,1610612765,2018,116.0,102.0,218.0,115.0,110.4,106.9,108.3,27,18,9,0.667,24,13,11,0.542,13,5,9,4,220.2,210.6,215.39999999999998
2018-12-10,1610612738,1610612740,2018,113.0,100.0,213.0,116.7,102.8,115.2,113.1,25,15,10,0.6,28,14,14,0.5,7,8,10,4,220.0,232.6,226.3
2018-12-10,1610612741,1610612758,2018,89.0,108.0,197.0,101.0,112.3,114.8,113.7,27,6,21,0.222,25,13,12,0.52,4,2,6,7,218.0,230.6,224.3
2018-12-10,1610612749,1610612739,2018,108.0,92.0,200.0,116.7,114.2,102.1,111.7,25,17,8,0.68,26,6,20,0.231,12,5,4,2,226.0,217.6,221.8
2018-12-10,1610612760,1610612762,2018,122.0,113.0,235.0,113.1,102.5,112.8,107.7,24,16,8,0.667,27,13,14,0.481,9,7,4,9,212.6,225.8,219.2
2018-12-10,1610612742,1610612753,2018,101.0,76.0,177.0,109.2,108.3,109.4,107.3,24,13,11,0.542,26,12,14,0.462,11,2,6,6,219.4,224.6,222.0
2018-12-10,1610612743,1610612763,2018,105.0,99.0,204.0,112.8,104.7,103.8,105.6,26,17,9,0.654,25,15,10,0.6,9,8,8,7,215.0,200.8,207.9
2018-12-10,1610612756,1610612746,2018,119.0,123.0,242.0,99.6,113.0,112.4,111.1,26,4,22,0.154,25,16,9,0.64,3,1,9,7,209.4,223.2,216.3
2018-12-10,1610612744,1610612750,2018,116.0,108.0,224.0,115.5,110.2,111.1,104.3,27,18,9,0.667,26,13,13,0.5,11,7,11,2,222.4,214.0,218.2
2018-12-10,1610612747,1610612748,2018,108.0,105.0,213.0,110.1,105.6,104.8,104.1,26,16,10,0.615,25,11,14,0.44,10,6,5,6,215.8,205.6,210.7
2018-12-09,1610612765,1610612740,2018,108.0,116.0,224.0,107.6,107.5,115.6,114.4,23,13,10,0.565,27,13,14,0.481,9,4,10,3,210.4,232.6,221.5
2018-12-09,1610612761,1610612749,2018,99.0,104.0,203.0,114.7,107.2,119.7,115.4,27,21,6,0.778,24,16,8,0.667,11,10,12,4,231.0,226.0,228.5
2018-12-09,1610612759,1610612762,2018,110.0,97.0,207.0,112.0,120.0,111.4,105.7,26,12,14,0.462,26,13,13,0.5,8,4,4,9,229.2,225.8,227.5
2018-12-09,1610612752,1610612766,2018,107.0,119.0,226.0,109.4,115.0,108.4,111.6,27,8,19,0.29600000000000004,25,12,13,0.48,4,4,9,3,231.6,219.4,225.5
2018-12-08,1610612742,1610612745,2018,107.0,104.0,211.0,109.7,108.8,115.1,113.3,23,12,11,0.522,24,11,13,0.458,10,2,5,6,221.4,229.8,225.60000000000002
2018-12-08,1610612754,1610612758,2018,107.0,97.0,204.0,106.1,97.2,116.3,116.2,25,15,10,0.6,24,13,11,0.542,7,8,6,7,197.6,230.6,214.1
2018-12-08,1610612737,1610612743,2018,106.0,98.0,204.0,105.6,120.0,113.5,103.9,25,5,20,0.2,25,17,8,0.68,3,2,9,8,235.2,215.0,225.1
2018-12-08,1610612739,1610612764,2018,116.0,101.0,217.0,102.2,112.4,114.5,116.7,25,5,20,0.2,25,11,14,0.44,3,2,7,4,219.2,233.0,226.1
2018-12-08,1610612752,1610612751,2018,104.0,112.0,216.0,107.9,115.3,106.4,108.7,26,8,18,0.308,27,9,18,0.333,4,4,4,5,229.2,216.2,222.7
2018-12-08,1610612741,1610612738,2018,77.0,133.0,210.0,101.6,111.2,114.6,106.8,26,6,20,0.231,24,14,10,0.583,4,2,7,7,217.0,220.0,218.5
2018-12-08,1610612763,1610612747,2018,88.0,111.0,199.0,106.2,104.9,110.7,109.8,24,15,9,0.625,25,15,10,0.6,8,7,10,5,204.2,215.8,210.0
2018-12-08,1610612757,1610612750,2018,113.0,105.0,218.0,107.0,113.3,111.5,105.0,25,14,11,0.56,25,13,12,0.52,9,5,11,2,208.8,214.0,211.4
2018-12-08,1610612746,1610612748,2018,98.0,121.0,219.0,115.4,111.6,104.7,105.0,24,16,8,0.667,24,10,14,0.417,9,7,5,5,230.2,205.6,217.89999999999998
2018-12-07,1610612766,1610612743,2018,113.0,107.0,220.0,109.8,111.8,113.1,102.7,24,11,13,0.458,24,17,7,0.708,8,3,9,8,222.6,215.0,218.8
2018-12-07,1610612765,1610612755,2018,111.0,117.0,228.0,108.3,106.5,115.7,110.7,22,13,9,0.591,26,17,9,0.654,9,4,13,4,209.8,220.2,215.0
2018-12-07,1610612753,1610612754,2018,90.0,112.0,202.0,111.5,106.7,105.8,100.9,25,12,13,0.48,24,14,10,0.583,6,6,7,7,227.6,197.6,212.6
2018-12-07,1610612751,1610612761,2018,106.0,105.0,211.0,108.3,110.9,116.4,104.9,26,8,18,0.308,26,21,5,0.8079999999999999,3,5,11,10,224.4,231.0,227.7
2018-12-07,1610612739,1610612758,2018,110.0,129.0,239.0,101.7,110.4,113.8,116.4,24,5,19,0.208,23,12,11,0.522,3,2,6,6,214.2,230.6,222.39999999999998
2018-12-07,1610612741,1610612760,2018,114.0,112.0,226.0,100.0,110.3,112.9,101.1,25,5,20,0.2,23,16,7,0.696,3,2,9,7,212.0,212.6,212.3
2018-12-07,1610612740,1610612763,2018,103.0,107.0,210.0,119.3,116.3,105.5,103.3,26,13,13,0.5,23,14,9,0.609,10,3,8,6,243.8,204.2,224.0
2018-12-07,1610612759,1610612747,2018,133.0,120.0,253.0,108.3,116.9,108.8,105.1,25,11,14,0.44,24,15,9,0.625,7,4,10,5,215.6,215.8,215.7
2018-12-07,1610612756,1610612748,2018,98.0,115.0,213.0,101.4,111.1,105.2,106.7,25,4,21,0.16,23,9,14,0.391,3,1,5,4,209.2,205.6,207.39999999999998
2018-12-07,1610612749,1610612744,2018,95.0,105.0,200.0,124.5,114.9,114.2,111.1,23,16,7,0.696,26,17,9,0.654,12,4,11,6,234.6,222.4,228.5
2018-12-06,1610612738,1610612752,2018,128.0,100.0,228.0,112.9,105.0,109.6,115.6,23,13,10,0.565,25,8,17,0.32,6,7,4,4,213.0,229.2,221.1
2018-12-06,1610612757,1610612756,2018,108.0,86.0,194.0,107.8,115.2,104.4,112.7,24,13,11,0.542,24,4,20,0.16699999999999998,8,5,3,1,214.2,209.2,211.7
2018-12-06,1610612762,1610612745,2018,118.0,91.0,209.0,111.3,106.8,117.1,113.1,25,12,13,0.48,23,11,12,0.478,3,9,5,6,227.8,229.8,228.8
2018-12-05,1610612739,1610612744,2018,105.0,129.0,234.0,102.5,106.4,112.2,111.8,23,5,18,0.217,25,16,9,0.64,3,2,11,5,207.8,222.4,215.10000000000002
2018-12-05,1610612753,1610612743,2018,118.0,124.0,242.0,111.4,105.1,110.5,101.3,24,12,12,0.5,23,16,7,0.696,6,6,9,7,224.2,215.0,219.6
2018-12-05,1610612737,1610612764,2018,117.0,131.0,248.0,105.8,119.6,113.0,116.0,24,5,19,0.208,24,10,14,0.417,3,2,7,3,234.8,233.0,233.9
2018-12-05,1610612751,1610612760,2018,112.0,114.0,226.0,107.3,110.7,111.1,101.0,25,8,17,0.32,22,15,7,0.682,3,5,9,6,222.0,212.6,217.3
2018-12-05,1610612761,1610612755,2018,113.0,102.0,215.0,115.5,105.3,116.1,110.6,25,20,5,0.8,25,17,8,0.68,10,10,13,4,230.0,220.2,225.1
2018-12-05,1610612763,1610612746,2018,96.0,86.0,182.0,104.7,104.3,118.6,114.5,22,13,9,0.591,23,16,7,0.696,7,6,9,7,204.6,230.2,217.39999999999998
2018-12-05,1610612749,1610612765,2018,115.0,92.0,207.0,123.4,115.5,109.0,105.9,22,15,7,0.682,21,13,8,0.619,11,4,9,4,233.6,209.8,221.7
2018-12-05,1610612750,1610612766,2018,121.0,104.0,225.0,109.5,104.9,112.6,113.0,24,12,12,0.5,23,11,12,0.478,10,2,8,3,209.8,222.6,216.2
2018-12-05,1610612740,1610612742,2018,132.0,106.0,238.0,118.6,117.2,109.3,107.3,25,12,13,0.48,22,12,10,0.545,9,3,10,2,244.2,221.4,232.8
2018-12-05,1610612747,1610612759,2018,121.0,113.0,234.0,105.7,102.1,108.1,114.8,23,14,9,0.609,24,11,13,0.458,9,5,7,4,203.6,215.6,209.6
2018-12-04,1610612754,1610612741,2018,96.0,90.0,186.0,105.6,101.9,101.4,113.0,23,13,10,0.565,24,5,19,0.208,6,7,3,2,199.2,212.0,205.6
2018-12-04,1610612748,1610612753,2018,90.0,105.0,195.0,105.9,107.5,109.6,107.3,22,9,13,0.409,23,11,12,0.478,5,4,6,5,208.6,224.2,216.39999999999998
2018-12-04,1610612742,1610612757,2018,111.0,102.0,213.0,110.0,103.9,109.5,115.0,21,11,10,0.524,23,13,10,0.565,9,2,8,5,216.0,214.2,215.1
2018-12-04,1610612756,1610612758,2018,105.0,122.0,227.0,104.8,112.1,112.5,120.3,23,4,19,0.174,22,11,11,0.5,3,1,6,5,208.8,230.6,219.7
2018-12-04,1610612762,1610612759,2018,139.0,105.0,244.0,108.5,108.7,110.2,114.9,24,11,13,0.458,23,11,12,0.478,2,9,7,4,226.0,215.6,220.8
2018-12-03,1610612765,1610612760,2018,83.0,110.0,193.0,112.3,106.0,109.6,101.3,20,13,7,0.65,21,14,7,0.667,9,4,9,5,216.6,212.6,214.6
2018-12-03,1610612737,1610612744,2018,111.0,128.0,239.0,105.6,119.2,108.0,111.4,23,5,18,0.217,24,15,9,0.625,3,2,11,4,233.6,222.4,228.0
2018-12-03,1610612751,1610612739,2018,97.0,99.0,196.0,109.5,113.5,102.1,108.6,24,8,16,0.333,22,4,18,0.182,3,5,3,1,232.0,207.8,219.9
2018-12-03,1610612752,1610612764,2018,107.0,110.0,217.0,110.4,116.2,112.8,117.0,24,8,16,0.333,23,9,14,0.391,4,4,7,2,232.0,233.0,232.5
2018-12-03,1610612761,1610612743,2018,103.0,106.0,209.0,116.2,107.3,111.4,103.5,24,20,4,0.833,22,15,7,0.682,10,10,9,6,235.4,215.0,225.2
2018-12-03,1610612750,1610612745,2018,103.0,91.0,194.0,107.9,105.8,118.9,112.7,23,11,12,0.478,22,11,11,0.5,9,2,5,6,208.4,229.8,219.10000000000002
2018-12-03,1610612740,1610612746,2018,126.0,129.0,255.0,118.9,116.7,118.4,113.8,24,12,12,0.5,22,15,7,0.682,9,3,9,6,243.8,230.2,237.0
2018-12-02,1610612747,1610612756,2018,120.0,96.0,216.0,106.3,104.2,106.6,112.0,22,13,9,0.591,22,4,18,0.182,8,5,3,1,209.0,208.8,208.9
2018-12-02,1610612766,1610612740,2018,109.0,119.0,228.0,113.4,112.3,117.0,116.5,22,11,11,0.5,23,11,12,0.478,8,3,9,2,222.8,243.8,233.3
2018-12-02,1610612748,1610612762,2018,102.0,100.0,202.0,107.1,109.9,107.9,110.6,21,8,13,0.381,23,11,12,0.478,4,4,2,9,215.8,226.0,220.9
2018-12-02,1610612755,1610612763,2018,103.0,95.0,198.0,117.7,112.5,106.8,105.3,24,16,8,0.667,21,13,8,0.619,12,4,7,6,227.2,204.6,215.89999999999998
2018-12-02,1610612742,1610612746,2018,114.0,110.0,224.0,109.7,102.5,120.1,114.3,20,10,10,0.5,21,15,6,0.7140000000000001,8,2,9,6,212.6,230.2,221.39999999999998
2018-12-02,1610612759,1610612757,2018,131.0,118.0,249.0,108.1,114.8,107.3,113.1,22,10,12,0.455,22,13,9,0.591,6,4,8,5,211.2,214.2,212.7
2018-12-01,1610612752,1610612749,2018,136.0,134.0,270.0,106.9,113.5,120.3,113.7,23,7,16,0.304,21,15,6,0.7140000000000001,3,4,11,4,219.6,233.6,226.6
2018-12-01,1610612765,1610612744,2018,111.0,102.0,213.0,112.5,106.0,109.4,112.4,19,12,7,0.632,23,15,8,0.652,8,4,11,4,217.0,222.4,219.7
2018-12-01,1610612764,1610612751,2018,102.0,88.0,190.0,113.0,119.7,110.7,114.9,22,8,14,0.364,23,8,15,0.348,6,2,3,5,238.8,232.0,235.4
2018-12-01,1610612739,1610612761,2018,95.0,106.0,201.0,101.2,107.5,117.2,110.1,21,4,17,0.19,23,19,4,0.826,3,1,10,9,203.8,235.4,219.60000000000002
2018-12-01,1610612745,1610612741,2018,121.0,105.0,226.0,118.3,112.5,99.1,112.0,21,10,11,0.476,23,5,18,0.217,4,6,3,2,228.2,212.0,220.1
2018-12-01,1610612750,1610612738,2018,109.0,118.0,227.0,108.2,103.6,110.5,104.1,22,11,11,0.5,22,12,10,0.545,9,2,6,6,204.6,213.0,208.8
2018-12-01,1610612758,1610612754,2018,111.0,110.0,221.0,110.0,119.4,104.9,102.3,21,10,11,0.476,22,13,9,0.591,5,5,6,7,223.8,199.2,211.5
2018-11-30,1610612738,1610612739,2018,128.0,95.0,223.0,109.4,105.9,101.5,104.6,21,11,10,0.524,20,4,16,0.2,5,6,3,1,214.4,203.8,209.10000000000002
2018-11-30,1610612766,1610612762,2018,111.0,119.0,230.0,114.2,112.6,105.8,108.1,21,11,10,0.524,22,10,12,0.455,8,3,2,8,225.0,226.0,225.5
2018-11-30,1610612765,1610612741,2018,107.0,88.0,195.0,112.1,108.5,100.1,112.0,18,11,7,0.611,22,5,17,0.227,7,4,3,2,221.2,212.0,216.6
2018-11-30,1610612755,1610612764,2018,123.0,98.0,221.0,116.7,113.4,113.2,119.3,23,15,8,0.652,21,8,13,0.381,11,4,6,2,227.0,238.8,232.9
2018-11-30,1610612751,1610612763,2018,125.0,131.0,256.0,108.9,113.8,103.8,104.5,22,8,14,0.364,20,12,8,0.6,3,5,7,5,226.2,204.6,215.39999999999998
2018-11-30,1610612748,1610612740,2018,106.0,101.0,207.0,107.5,111.4,119.5,116.9,20,7,13,0.35,22,11,11,0.5,3,4,9,2,219.6,243.8,231.7
2018-11-30,1610612760,1610612737,2018,124.0,109.0,233.0,109.0,100.5,105.0,117.8,20,13,7,0.65,22,5,17,0.227,8,5,3,2,209.8,233.6,221.7
2018-11-30,1610612759,1610612745,2018,105.0,136.0,241.0,108.5,110.7,113.6,111.6,21,10,11,0.476,20,9,11,0.45,6,4,4,5,203.8,228.2,216.0
2018-11-30,1610612756,1610612753,2018,85.0,99.0,184.0,106.3,112.5,110.6,110.5,21,4,17,0.19,22,10,12,0.455,3,1,6,4,209.2,224.2,216.7
2018-11-30,1610612747,1610612742,2018,114.0,103.0,217.0,105.6,104.5,110.7,102.5,21,12,9,0.5710000000000001,19,10,9,0.526,7,5,8,2,208.2,212.6,210.39999999999998
2018-11-30,1610612757,1610612743,2018,112.0,113.0,225.0,107.9,112.1,108.8,101.2,21,13,8,0.619,21,14,7,0.667,8,5,9,5,213.4,215.0,214.2
2018-11-29,1610612761,1610612744,2018,131.0,128.0,259.0,116.9,108.5,111.5,111.7,22,18,4,0.818,22,15,7,0.682,9,9,11,4,231.6,222.4,227.0
2018-11-29,1610612747,1610612754,2018,104.0,96.0,200.0,106.6,105.9,106.3,102.1,20,11,9,0.55,21,13,8,0.619,6,5,6,7,213.0,199.2,206.1
2018-11-29,1610612758,1610612746,2018,121.0,133.0,254.0,110.0,117.1,117.3,113.8,20,10,10,0.5,20,14,6,0.7,5,5,9,5,219.2,230.2,224.7
2018-11-28,1610612766,1610612737,2018,108.0,94.0,202.0,114.7,113.4,106.2,117.7,20,10,10,0.5,21,5,16,0.238,7,3,3,2,227.6,233.6,230.6
2018-11-28,1610612755,1610612752,2018,117.0,91.0,208.0,118.3,117.5,110.2,114.7,22,14,8,0.636,22,7,15,0.318,10,4,3,4,238.4,219.6,229.0
2018-11-28,1610612751,1610612762,2018,91.0,101.0,192.0,112.0,113.4,106.4,110.3,21,8,13,0.381,21,9,12,0.429,3,5,2,7,231.6,226.0,228.8
2018-11-28,1610612745,1610612742,2018,108.0,128.0,236.0,111.3,109.2,108.7,103.0,19,9,10,0.474,18,9,9,0.5,4,5,8,1,218.8,212.6,215.7
2018-11-28,1610612749,1610612741,2018,116.0,113.0,229.0,121.0,112.8,100.4,111.9,20,14,6,0.7,21,5,16,0.238,10,4,3,2,233.2,212.0,222.6
2018-11-28,1610612750,1610612759,2018,128.0,89.0,217.0,106.1,104.7,110.7,109.5,21,10,11,0.476,20,10,10,0.5,8,2,6,4,202.6,203.8,203.2
2018-11-28,1610612740,1610612764,2018,125.0,104.0,229.0,118.9,116.4,112.3,117.5,21,10,11,0.476,20,8,12,0.4,8,2,6,2,241.6,238.8,240.2
2018-11-28,1610612760,1610612739,2018,100.0,83.0,183.0,108.8,100.2,103.2,104.8,19,12,7,0.632,19,4,15,0.211,7,5,3,1,208.8,203.8,206.3
2018-11-28,1610612757,1610612753,2018,115.0,112.0,227.0,107.5,109.0,110.9,107.9,20,12,8,0.6,21,10,11,0.476,7,5,6,4,206.4,224.2,215.3
2018-11-28,1610612746,1610612756,2018,115.0,99.0,214.0,117.8,114.8,106.5,112.8,19,13,6,0.684,20,4,16,0.2,8,5,3,1,233.2,209.2,221.2
2018-11-27,1610612765,1610612752,2018,115.0,108.0,223.0,112.1,109.7,109.7,116.0,17,10,7,0.588,21,7,14,0.333,6,4,3,4,223.6,219.6,221.6
2018-11-27,1610612748,1610612737,2018,113.0,115.0,228.0,106.4,110.9,104.9,117.7,19,7,12,0.368,20,4,16,0.2,3,4,3,1,216.4,233.6,225.0
2018-11-27,1610612763,1610612761,2018,114.0,122.0,236.0,103.6,102.9,116.1,107.6,19,12,7,0.632,21,17,4,0.81,7,5,9,8,201.0,231.6,216.3
2018-11-27,1610612743,1610612747,2018,117.0,85.0,202.0,108.1,103.9,109.5,105.2,20,13,7,0.65,19,11,8,0.579,8,5,6,5,219.0,213.0,216.0
2018-11-27,1610612756,1610612754,2018,104.0,109.0,213.0,106.3,111.9,106.1,102.2,19,4,15,0.211,20,12,8,0.6,3,1,6,6,207.0,199.2,203.1
2018-11-26,1610612766,1610612749,2018,110.0,107.0,217.0,116.3,112.1,121.6,113.5,19,9,10,0.474,19,14,5,0.737,6,3,10,4,228.2,233.2,230.7
2018-11-26,1610612739,1610612750,2018,95.0,102.0,197.0,102.8,105.6,104.0,106.3,18,4,14,0.222,20,9,11,0.45,3,1,8,1,204.6,202.6,203.6
2018-11-26,1610612764,1610612745,2018,135.0,131.0,266.0,110.7,113.9,106.2,105.5,19,7,12,0.368,18,9,9,0.5,5,2,4,5,228.4,218.8,223.60000000000002
2018-11-26,1610612741,1610612759,2018,107.0,108.0,215.0,99.6,110.9,109.5,110.4,20,5,15,0.25,19,9,10,0.474,3,2,6,3,208.4,203.8,206.10000000000002
2018-11-26,1610612740,1610612738,2018,107.0,124.0,231.0,118.9,113.8,108.5,107.5,20,10,10,0.5,20,10,10,0.5,8,2,5,5,236.4,214.4,225.4
2018-11-26,1610612762,1610612754,2018,88.0,121.0,209.0,107.6,109.2,104.7,103.5,20,9,11,0.45,19,11,8,0.579,2,7,6,5,226.2,199.2,212.7
2018-11-26,1610612744,1610612753,2018,116.0,110.0,226.0,111.5,110.7,111.6,107.3,21,14,7,0.667,20,10,10,0.5,10,4,6,4,220.4,224.2,222.3
2018-11-25,1610612747,1610612753,2018,104.0,108.0,212.0,109.8,106.5,109.9,108.2,18,11,7,0.611,19,9,10,0.474,6,5,6,3,216.2,224.2,220.2
2018-11-25,1610612765,1610612756,2018,118.0,107.0,225.0,109.2,109.9,105.5,112.0,16,9,7,0.563,18,4,14,0.222,5,4,3,1,218.2,207.0,212.6
2018-11-25,1610612737,1610612766,2018,124.0,123.0,247.0,103.2,116.6,114.3,110.2,19,3,16,0.158,18,9,9,0.5,2,1,6,3,228.0,228.2,228.1
2018-11-25,1610612751,1610612755,2018,125.0,127.0,252.0,110.6,112.6,115.6,114.4,20,8,12,0.4,21,13,8,0.619,3,5,10,3,227.2,238.4,232.8
2018-11-25,1610612761,1610612748,2018,125.0,115.0,240.0,116.5,107.3,106.7,110.7,20,16,4,0.8,18,7,11,0.389,8,8,3,4,231.8,216.4,224.10000000000002
2018-11-25,1610612763,1610612752,2018,98.0,103.0,201.0,102.7,101.3,110.6,119.0,18,12,6,0.667,20,6,14,0.3,7,5,3,3,196.0,219.6,207.8
2018-11-25,1610612758,1610612762,2018,112.0,133.0,245.0,109.3,115.2,101.1,109.8,19,10,9,0.526,19,8,11,0.421,5,5,2,6,214.0,226.2,220.1
2018-11-25,1610612757,1610612746,2018,100.0,104.0,204.0,108.5,110.0,119.4,114.3,19,12,7,0.632,18,12,6,0.667,7,5,8,4,210.4,233.2,221.8
2018-11-24,1610612739,1610612745,2018,117.0,108.0,225.0,104.7,106.2,105.2,103.2,17,3,14,0.17600000000000002,17,9,8,0.529,2,1,4,5,209.6,218.8,214.2
2018-11-24,1610612764,1610612740,2018,124.0,114.0,238.0,110.0,113.4,119.1,113.6,18,6,12,0.333,19,10,9,0.526,4,2,8,2,226.0,236.4,231.2
2018-11-24,1610612750,1610612741,2018,111.0,96.0,207.0,104.9,108.0,99.7,108.3,19,8,11,0.421,19,5,14,0.263,7,1,3,2,207.8,208.4,208.10000000000002
2018-11-24,1610612760,1610612743,2018,98.0,105.0,203.0,111.2,101.3,108.6,103.2,18,12,6,0.667,19,12,7,0.632,7,5,8,4,215.8,219.0,217.4
2018-11-24,1610612742,1610612738,2018,113.0,104.0,217.0,109.3,102.6,109.7,107.1,17,8,9,0.471,19,10,9,0.526,7,1,5,5,213.0,214.4,213.7
2018-11-24,1610612749,1610612759,2018,135.0,129.0,264.0,119.4,112.2,106.5,107.3,18,13,5,0.722,18,9,9,0.5,9,4,6,3,226.2,203.8,215.0
2018-11-24,1610612744,1610612758,2018,117.0,116.0,233.0,110.9,112.5,112.3,115.0,20,13,7,0.65,18,10,8,0.556,9,4,5,5,222.8,214.0,218.4
2018-11-23,1610612751,1610612750,2018,102.0,112.0,214.0,112.4,113.3,103.6,109.4,19,8,11,0.421,18,7,11,0.389,3,5,7,0,232.2,207.8,220.0
2018-11-23,1610612746,1610612763,2018,112.0,107.0,219.0,121.8,114.0,102.0,100.3,17,11,6,0.647,17,12,5,0.706,7,4,7,5,237.4,196.0,216.7
2018-11-23,1610612765,1610612745,2018,116.0,111.0,227.0,108.6,109.1,103.7,100.4,15,8,7,0.5329999999999999,16,9,7,0.563,4,4,4,5,215.4,218.8,217.10000000000002
2018-11-23,1610612737,1610612738,2018,96.0,114.0,210.0,105.9,117.0,109.0,109.0,18,3,15,0.16699999999999998,18,9,9,0.5,2,1,5,4,234.2,214.4,224.3
2018-11-23,1610612752,1610612740,2018,114.0,109.0,223.0,110.7,117.7,117.7,113.1,19,5,14,0.263,18,10,8,0.556,2,3,8,2,217.2,236.4,226.8
2018-11-23,1610612755,1610612739,2018,112.0,121.0,233.0,115.3,112.2,102.0,107.6,20,13,7,0.65,16,2,14,0.125,10,3,2,0,233.4,209.6,221.5
2018-11-23,1610612761,1610612764,2018,125.0,107.0,232.0,115.6,107.3,109.7,114.5,19,15,4,0.789,17,6,11,0.353,7,8,4,2,230.0,226.0,228.0
2018-11-23,1610612754,1610612759,2018,100.0,111.0,211.0,104.1,102.2,104.2,106.8,18,11,7,0.611,17,8,9,0.471,6,5,6,2,195.4,203.8,199.60000000000002
2018-11-23,1610612741,1610612748,2018,96.0,103.0,199.0,98.9,107.6,107.7,113.6,18,5,13,0.278,17,6,11,0.353,3,2,3,3,205.4,216.4,210.9
2018-11-23,1610612760,1610612766,2018,109.0,104.0,213.0,113.1,101.9,114.9,110.5,17,11,6,0.647,17,9,8,0.529,6,5,6,3,220.8,228.2,224.5
2018-11-23,1610612749,1610612756,2018,114.0,116.0,230.0,122.4,111.5,104.9,112.3,17,13,4,0.765,17,3,14,0.17600000000000002,9,4,3,0,230.8,207.0,218.9
2018-11-23,1610612743,1610612753,2018,112.0,87.0,199.0,108.9,105.2,110.5,106.0,18,11,7,0.611,18,9,9,0.5,7,4,6,3,223.6,224.2,223.89999999999998
2018-11-23,1610612744,1610612757,2018,125.0,97.0,222.0,110.1,112.9,110.5,110.1,19,12,7,0.632,18,12,6,0.667,8,4,7,5,222.0,210.4,216.2
2018-11-23,1610612747,1610612762,2018,90.0,83.0,173.0,112.2,109.5,102.4,109.6,17,10,7,0.588,18,8,10,0.444,5,5,2,6,227.0,226.2,226.6
2018-11-21,1610612766,1610612754,2018,127.0,109.0,236.0,112.9,110.7,105.1,100.2,16,8,8,0.5,17,11,6,0.647,5,3,6,5,224.6,195.4,210.0
2018-11-21,1610612755,1610612740,2018,121.0,120.0,241.0,115.4,111.5,117.6,114.2,19,12,7,0.632,17,10,7,0.588,9,3,8,2,232.2,236.4,234.3
2018-11-21,1610612737,1610612761,2018,108.0,124.0,232.0,106.6,119.2,115.6,107.6,17,3,14,0.17600000000000002,18,14,4,0.778,2,1,7,7,240.0,230.0,235.0
2018-11-21,1610612738,1610612752,2018,109.0,117.0,226.0,108.9,107.8,110.2,117.5,17,9,8,0.529,18,4,14,0.222,5,4,2,2,211.8,217.2,214.5
2018-11-21,1610612739,1610612747,2018,105.0,109.0,214.0,102.2,108.6,113.3,111.4,15,2,13,0.133,16,9,7,0.563,2,0,5,4,212.0,227.0,219.5
2018-11-21,1610612741,1610612756,2018,124.0,116.0,240.0,97.0,106.7,102.9,111.6,17,4,13,0.235,16,3,13,0.188,2,2,3,0,199.8,207.0,203.4
2018-11-21,1610612745,1610612765,2018,126.0,124.0,250.0,102.4,101.3,108.1,108.5,15,8,7,0.5329999999999999,14,8,6,0.5710000000000001,3,5,4,4,218.0,215.4,216.7
2018-11-21,1610612749,1610612757,2018,143.0,100.0,243.0,120.5,112.4,110.9,104.3,16,12,4,0.75,17,12,5,0.706,8,4,7,5,228.8,210.4,219.60000000000002
2018-11-21,1610612750,1610612743,2018,101.0,103.0,204.0,106.3,111.6,109.4,105.8,17,7,10,0.412,17,10,7,0.588,7,0,7,3,217.6,223.6,220.6
2018-11-21,1610612742,1610612751,2018,119.0,113.0,232.0,108.0,103.1,112.3,112.4,16,7,9,0.438,18,8,10,0.444,6,1,3,5,211.4,232.2,221.8
2018-11-21,1610612759,1610612763,2018,103.0,104.0,207.0,105.2,107.2,102.6,100.0,16,8,8,0.5,16,11,5,0.688,6,2,7,4,206.6,196.0,201.3
2018-11-21,1610612762,1610612758,2018,110.0,119.0,229.0,99.8,106.9,111.1,113.9,17,8,9,0.471,17,9,8,0.529,2,6,5,4,215.6,214.0,214.8
2018-11-21,1610612744,1610612760,2018,95.0,123.0,218.0,112.2,110.5,114.2,103.5,18,12,6,0.667,16,10,6,0.625,8,4,6,4,221.4,220.8,221.10000000000002
2018-11-20,1610612753,1610612761,2018,91.0,93.0,184.0,111.0,107.0,118.4,109.2,17,9,8,0.529,17,13,4,0.765,6,3,7,6,227.2,230.0,228.6
2018-11-20,1610612764,1610612746,2018,125.0,118.0,243.0,108.0,112.2,121.3,113.7,16,5,11,0.313,16,11,5,0.688,3,2,7,4,218.0,237.4,227.7
2018-11-20,1610612748,1610612751,2018,92.0,104.0,196.0,108.0,112.0,112.3,111.4,16,6,10,0.375,17,7,10,0.412,3,3,3,4,213.8,232.2,223.0
2018-11-20,1610612752,1610612757,2018,114.0,118.0,232.0,108.8,118.5,109.4,102.2,17,4,13,0.235,16,11,5,0.688,2,2,7,4,216.4,210.4,213.4
2018-11-19,1610612766,1610612738,2018,117.0,112.0,229.0,113.7,110.8,107.8,106.3,15,7,8,0.467,16,9,7,0.563,4,3,5,4,226.4,211.8,219.10000000000002
2018-11-19,1610612765,1610612739,2018,113.0,102.0,215.0,110.1,111.5,102.3,108.3,13,7,6,0.5379999999999999,14,2,12,0.14300000000000002,3,4,2,0,225.4,212.0,218.7
2018-11-19,1610612754,1610612762,2018,121.0,94.0,215.0,103.2,100.9,99.2,105.1,16,10,6,0.625,16,8,8,0.5,5,5,2,6,193.0,215.6,204.3
2018-11-19,1610612755,1610612756,2018,119.0,114.0,233.0,114.8,109.3,101.8,112.0,18,11,7,0.611,15,3,12,0.2,8,3,3,0,226.6,207.0,216.8
2018-11-19,1610612737,1610612746,2018,119.0,127.0,246.0,103.2,116.2,119.6,114.6,16,3,13,0.188,15,10,5,0.667,2,1,7,3,227.2,237.4,232.3
2018-11-19,1610612763,1610612742,2018,98.0,88.0,186.0,103.5,100.7,109.9,104.9,15,10,5,0.667,15,7,8,0.467,6,4,6,1,199.2,211.4,205.3
2018-11-19,1610612749,1610612743,2018,104.0,98.0,202.0,121.4,111.7,111.0,107.5,15,11,4,0.733,16,10,6,0.625,7,4,7,3,229.2,223.6,226.39999999999998
2018-11-19,1610612740,1610612759,2018,140.0,126.0,266.0,114.7,114.8,104.6,102.2,16,9,7,0.563,15,8,7,0.5329999999999999,7,2,6,2,231.8,206.6,219.2
2018-11-19,1610612758,1610612760,2018,117.0,113.0,230.0,111.0,113.8,114.0,102.5,16,8,8,0.5,15,10,5,0.667,4,4,6,4,213.6,220.8,217.2
2018-11-18,1610612750,1610612763,2018,87.0,100.0,187.0,110.0,113.6,102.7,101.7,16,7,9,0.438,14,9,5,0.643,7,0,6,3,229.0,199.2,214.1
2018-11-18,1610612748,1610612747,2018,97.0,113.0,210.0,109.6,113.0,112.6,112.7,15,6,9,0.4,15,8,7,0.5329999999999999,3,3,5,3,219.0,227.0,223.0
2018-11-18,1610612753,1610612752,2018,131.0,117.0,248.0,108.1,105.3,106.6,116.2,16,8,8,0.5,16,4,12,0.25,5,3,2,2,218.0,216.4,217.2
2018-11-18,1610612764,1610612757,2018,109.0,119.0,228.0,108.2,113.7,108.6,103.3,15,5,10,0.333,15,10,5,0.667,3,2,7,3,221.4,210.4,215.9
2018-11-18,1610612759,1610612744,2018,104.0,92.0,196.0,105.2,103.6,115.0,111.5,14,7,7,0.5,17,12,5,0.706,5,2,8,4,210.6,221.4,216.0
2018-11-17,1610612751,1610612746,2018,119.0,127.0,246.0,111.8,110.7,120.2,114.0,16,7,9,0.438,14,9,5,0.643,3,4,7,2,229.8,237.4,233.60000000000002
2018-11-17,1610612766,1610612755,2018,119.0,122.0,241.0,115.3,109.2,112.3,109.6,14,7,7,0.5,17,10,7,0.588,4,3,8,2,226.4,226.6,226.5
2018-11-17,1610612754,1610612737,2018,97.0,89.0,186.0,102.8,102.3,105.7,120.1,15,9,6,0.6,15,3,12,0.2,4,5,2,1,195.0,227.2,211.1
2018-11-17,1610612753,1610612747,2018,130.0,117.0,247.0,104.6,105.6,114.0,111.0,15,7,8,0.467,14,8,6,0.5710000000000001,4,3,5,3,211.6,227.0,219.3
2018-11-17,1610612740,1610612743,2018,125.0,115.0,240.0,113.9,114.8,110.2,104.8,15,8,7,0.5329999999999999,15,10,5,0.667,6,2,7,3,230.2,223.6,226.89999999999998
2018-11-17,1610612738,1610612762,2018,86.0,98.0,184.0,108.2,105.8,101.9,109.3,15,9,6,0.6,15,7,8,0.467,5,4,2,5,211.6,215.6,213.6
2018-11-17,1610612741,1610612761,2018,83.0,122.0,205.0,99.4,105.3,116.9,110.7,16,4,12,0.25,16,12,4,0.75,2,2,7,5,201.8,230.0,215.9
2018-11-17,1610612745,1610612758,2018,132.0,112.0,244.0,98.1,100.1,112.1,111.9,14,7,7,0.5,15,8,7,0.5329999999999999,2,5,4,4,207.0,213.6,210.3
2018-11-17,1610612742,1610612744,2018,112.0,109.0,221.0,109.1,105.3,116.9,110.3,14,6,8,0.429,16,12,4,0.75,5,1,8,4,210.6,221.4,216.0
2018-11-17,1610612756,1610612760,2018,100.0,110.0,210.0,101.6,111.7,112.2,103.3,14,3,11,0.214,14,9,5,0.643,3,0,6,3,206.0,220.8,213.4
2018-11-16,1610612738,1610612761,2018,123.0,116.0,239.0,106.4,102.9,116.2,110.8,14,8,6,0.5710000000000001,15,12,3,0.8,4,4,7,5,202.2,230.0,216.1
2018-11-16,1610612754,1610612748,2018,99.0,91.0,190.0,106.1,104.4,111.8,114.3,14,8,6,0.5710000000000001,14,6,8,0.429,3,5,3,3,205.8,219.0,212.4
2018-11-16,1610612755,1610612762,2018,113.0,107.0,220.0,111.5,109.2,102.5,108.4,16,9,7,0.563,14,7,7,0.5,7,2,2,5,224.2,215.6,219.89999999999998
2018-11-16,1610612764,1610612751,2018,104.0,115.0,219.0,109.1,113.9,109.9,111.8,14,5,9,0.35700000000000004,15,6,9,0.4,3,2,3,3,223.6,229.8,226.7
2018-11-16,1610612763,1610612758,2018,112.0,104.0,216.0,103.2,100.9,112.9,113.3,13,8,5,0.615,14,8,6,0.5710000000000001,5,3,4,4,198.6,213.6,206.1
2018-11-16,1610612750,1610612757,2018,112.0,96.0,208.0,108.3,116.5,111.8,103.5,15,6,9,0.4,14,10,4,0.7140000000000001,6,0,7,3,231.4,210.4,220.9
2018-11-16,1610612740,1610612752,2018,129.0,124.0,253.0,112.6,113.3,106.0,113.9,14,7,7,0.5,15,4,11,0.267,5,2,2,2,224.6,216.4,220.5
2018-11-16,1610612749,1610612741,2018,123.0,104.0,227.0,121.4,112.1,99.6,106.5,14,10,4,0.7140000000000001,15,4,11,0.267,6,4,2,2,230.0,201.8,215.9
2018-11-15,1610612745,1610612744,2018,107.0,86.0,193.0,98.6,104.6,118.1,109.6,13,6,7,0.462,15,12,3,0.8,1,5,8,4,217.0,221.4,219.2
2018-11-15,1610612743,1610612737,2018,138.0,93.0,231.0,106.7,104.3,105.6,117.6,14,9,5,0.643,14,3,11,0.214,6,3,2,1,215.6,227.2,221.39999999999998
2018-11-15,1610612746,1610612759,2018,116.0,111.0,227.0,120.1,114.1,108.4,106.2,13,8,5,0.615,13,7,6,0.5379999999999999,6,2,5,2,237.4,210.6,224.0
2018-11-14,1610612753,1610612755,2018,111.0,106.0,217.0,103.4,105.7,112.1,111.0,14,6,8,0.429,15,9,6,0.6,3,3,7,2,209.4,224.2,216.8
2018-11-14,1610612764,1610612739,2018,119.0,95.0,214.0,108.4,115.7,105.1,109.5,13,4,9,0.308,13,2,11,0.154,2,2,2,0,225.8,212.0,218.9
2018-11-14,1610612738,1610612741,2018,111.0,82.0,193.0,104.8,104.9,102.3,106.9,13,7,6,0.5379999999999999,14,4,10,0.28600000000000003,3,4,2,2,203.0,201.8,202.4
2018-11-14,1610612751,1610612748,2018,107.0,120.0,227.0,109.9,110.3,109.9,114.0,14,6,8,0.429,13,5,8,0.385,3,3,3,2,226.8,219.0,222.9
2018-11-14,1610612761,1610612765,2018,104.0,106.0,210.0,117.0,110.7,110.0,111.9,14,12,2,0.857,12,6,6,0.5,7,5,3,3,231.4,225.4,228.4
2018-11-14,1610612749,1610612763,2018,113.0,116.0,229.0,122.5,111.8,100.8,98.0,13,10,3,0.769,12,7,5,0.583,6,4,5,2,231.6,198.6,215.1
2018-11-14,1610612750,1610612740,2018,107.0,100.0,207.0,107.7,115.6,114.7,115.7,14,5,9,0.35700000000000004,13,7,6,0.5379999999999999,5,0,5,2,228.4,224.6,226.5
2018-11-14,1610612760,1610612752,2018,128.0,103.0,231.0,111.1,104.0,104.4,112.1,13,8,5,0.615,14,4,10,0.28600000000000003,5,3,2,2,220.0,216.4,218.2
2018-11-14,1610612742,1610612762,2018,118.0,68.0,186.0,108.8,109.4,108.9,107.7,13,5,8,0.385,13,7,6,0.5379999999999999,4,1,2,5,218.2,215.6,216.89999999999998
2018-11-14,1610612756,1610612759,2018,116.0,96.0,212.0,99.0,114.1,109.6,106.7,13,2,11,0.154,12,7,5,0.583,2,0,5,2,205.6,210.6,208.1
2018-11-14,1610612747,1610612757,2018,126.0,117.0,243.0,113.5,110.7,111.6,100.2,13,7,6,0.5379999999999999,13,10,3,0.769,4,3,7,3,225.4,210.4,217.9
2018-11-13,1610612739,1610612766,2018,113.0,89.0,202.0,102.4,110.8,117.0,110.6,12,1,11,0.083,13,7,6,0.5379999999999999,1,0,4,3,209.2,226.4,217.8
2018-11-13,1610612743,1610612745,2018,99.0,109.0,208.0,108.4,104.5,99.6,105.8,13,9,4,0.6920000000000001,12,5,7,0.417,6,3,1,4,219.4,217.0,218.2
2018-11-13,1610612744,1610612737,2018,110.0,103.0,213.0,120.2,111.4,108.6,117.7,14,11,3,0.7859999999999999,13,3,10,0.231,7,4,2,1,229.2,227.2,228.2
2018-11-12,1610612764,1610612753,2018,117.0,109.0,226.0,108.8,116.2,104.0,105.6,12,3,9,0.25,13,6,7,0.462,1,2,3,3,227.6,209.4,218.5
2018-11-12,1610612748,1610612755,2018,114.0,124.0,238.0,110.5,112.7,110.5,111.9,12,5,7,0.417,14,8,6,0.5710000000000001,3,2,7,1,217.6,224.2,220.89999999999998
2018-11-12,1610612761,1610612740,2018,110.0,126.0,236.0,118.7,108.7,113.2,116.3,13,12,1,0.923,12,6,6,0.5,7,5,5,1,230.8,224.6,227.7
2018-11-12,1610612741,1610612742,2018,98.0,103.0,201.0,104.9,111.5,108.9,110.7,13,4,9,0.308,12,4,8,0.333,2,2,4,0,216.2,218.2,217.2
2018-11-12,1610612763,1610612762,2018,88.0,96.0,184.0,105.1,100.1,109.3,107.8,11,7,4,0.636,12,6,6,0.5,5,2,2,4,211.4,215.6,213.5
2018-11-12,1610612750,1610612751,2018,120.0,113.0,233.0,108.8,116.6,110.1,110.0,13,4,9,0.308,13,6,7,0.462,4,0,3,3,232.6,226.8,229.7
2018-11-12,1610612760,1610612756,2018,118.0,101.0,219.0,108.8,104.0,98.0,114.2,12,7,5,0.583,12,2,10,0.16699999999999998,4,3,2,0,215.4,205.6,210.5
2018-11-12,1610612758,1610612759,2018,104.0,99.0,203.0,112.2,112.6,109.7,104.4,13,7,6,0.5379999999999999,11,7,4,0.636,3,4,5,2,210.8,210.6,210.7
2018-11-12,1610612746,1610612744,2018,121.0,116.0,237.0,118.8,111.7,121.0,111.6,12,7,5,0.583,13,11,2,0.846,5,2,7,4,230.0,229.2,229.6
2018-11-11,1610612765,1610612766,2018,103.0,113.0,216.0,110.0,110.6,117.0,111.5,11,6,5,0.545,12,6,6,0.5,3,3,4,2,222.8,226.4,224.60000000000002
2018-11-11,1610612745,1610612754,2018,115.0,103.0,218.0,98.1,106.5,107.4,102.5,11,4,7,0.364,13,8,5,0.615,0,4,3,5,215.4,205.8,210.60000000000002
2018-11-11,1610612752,1610612753,2018,89.0,115.0,204.0,105.6,110.9,101.4,105.7,13,4,9,0.308,12,5,7,0.417,2,2,3,2,216.4,209.4,212.9
2018-11-11,1610612743,1610612749,2018,114.0,121.0,235.0,109.6,103.6,122.9,109.9,12,9,3,0.75,12,9,3,0.75,6,3,6,3,220.0,231.6,225.8
2018-11-11,1610612757,1610612738,2018,100.0,94.0,194.0,114.8,102.7,106.3,103.8,12,9,3,0.75,12,7,5,0.583,6,3,3,4,221.8,203.0,212.4
2018-11-11,1610612747,1610612737,2018,107.0,106.0,213.0,117.0,114.4,109.7,120.1,12,6,6,0.5,12,3,9,0.25,3,3,2,1,239.8,227.2,233.5
2018-11-10,1610612761,1610612752,2018,128.0,112.0,240.0,117.2,107.6,105.7,110.5,12,11,1,0.917,12,4,8,0.333,6,5,2,2,225.6,216.4,221.0
2018-11-10,1610612746,1610612749,2018,128.0,126.0,254.0,115.8,109.8,121.6,108.3,11,6,5,0.545,11,9,2,0.818,4,2,6,3,220.2,231.6,225.89999999999998
2018-11-10,1610612740,1610612756,2018,119.0,99.0,218.0,116.2,119.3,96.4,113.9,11,5,6,0.455,11,2,9,0.182,4,1,2,0,236.6,205.6,221.1
2018-11-10,1610612748,1610612764,2018,110.0,116.0,226.0,110.5,109.8,108.4,116.8,11,5,6,0.455,11,2,9,0.182,3,2,1,1,211.8,227.6,219.7
2018-11-10,1610612741,1610612739,2018,99.0,98.0,197.0,106.2,112.7,103.0,112.5,12,3,9,0.25,11,1,10,0.091,1,2,1,0,221.2,209.2,215.2
2018-11-10,1610612763,1610612755,2018,112.0,106.0,218.0,104.2,101.6,113.1,114.0,10,6,4,0.6,13,8,5,0.615,4,2,7,1,212.6,224.2,218.39999999999998
2018-11-10,1610612759,1610612745,2018,96.0,89.0,185.0,109.7,107.1,100.4,108.4,10,6,4,0.6,10,4,6,0.4,4,2,0,4,216.0,215.4,215.7
2018-11-10,1610612744,1610612751,2018,116.0,100.0,216.0,123.8,113.8,110.3,107.0,12,10,2,0.833,12,6,6,0.5,6,4,3,3,239.2,226.8,233.0
2018-11-10,1610612742,1610612760,2018,111.0,96.0,207.0,111.8,114.7,109.2,103.7,11,3,8,0.273,11,7,4,0.636,3,0,4,3,232.0,215.4,223.7
2018-11-10,1610612758,1610612747,2018,86.0,101.0,187.0,115.3,114.8,118.8,118.6,12,7,5,0.583,11,5,6,0.455,3,4,3,2,221.4,239.8,230.60000000000002
2018-11-09,1610612753,1610612764,2018,117.0,108.0,225.0,101.1,107.7,109.8,119.5,11,4,7,0.364,10,2,8,0.2,2,2,1,1,212.8,227.6,220.2
2018-11-09,1610612755,1610612766,2018,133.0,132.0,265.0,111.4,112.3,115.8,107.0,12,7,5,0.583,11,6,5,0.545,6,1,4,2,217.4,226.4,221.9
2018-11-09,1610612737,1610612765,2018,109.0,124.0,233.0,109.9,118.1,109.4,111.3,11,3,8,0.273,10,5,5,0.5,2,1,3,2,223.6,222.8,223.2
2018-11-09,1610612748,1610612754,2018,102.0,110.0,212.0,111.5,110.1,105.5,102.4,10,5,5,0.5,12,7,5,0.583,3,2,3,4,214.4,205.8,210.10000000000002
2018-11-09,1610612743,1610612751,2018,110.0,112.0,222.0,108.6,102.2,110.3,109.2,11,9,2,0.818,11,5,6,0.455,6,3,3,2,215.2,226.8,221.0
2018-11-09,1610612762,1610612738,2018,123.0,115.0,238.0,109.3,108.7,104.9,101.0,11,5,6,0.455,11,7,4,0.636,1,4,3,4,217.4,203.0,210.2
2018-11-09,1610612758,1610612750,2018,121.0,110.0,231.0,112.5,117.0,108.3,115.7,11,6,5,0.545,12,4,8,0.333,2,4,4,0,220.2,232.6,226.39999999999998
2018-11-08,1610612760,1610612745,2018,98.0,80.0,178.0,111.4,108.8,104.8,110.1,10,6,4,0.6,9,4,5,0.444,3,3,0,4,230.0,215.4,222.7
2018-11-08,1610612756,1610612738,2018,109.0,116.0,225.0,96.8,115.4,103.6,100.2,10,2,8,0.2,10,6,4,0.6,2,0,3,3,209.4,203.0,206.2
2018-11-08,1610612757,1610612746,2018,116.0,105.0,221.0,115.6,104.7,116.2,109.8,11,8,3,0.727,10,6,4,0.6,5,3,4,2,227.4,220.2,223.8
2018-11-08,1610612744,1610612749,2018,111.0,134.0,245.0,125.0,110.7,119.7,109.1,11,10,1,0.909,10,8,2,0.8,6,4,6,2,235.4,231.6,233.5
2018-11-07,1610612739,1610612760,2018,86.0,95.0,181.0,105.5,116.3,113.2,110.3,10,1,9,0.1,9,5,4,0.556,1,0,3,2,221.8,230.0,225.9
2018-11-07,1610612753,1610612765,2018,96.0,103.0,199.0,100.3,109.4,112.0,112.7,10,4,6,0.4,9,4,5,0.444,2,2,3,1,214.6,222.8,218.7
2018-11-07,1610612737,1610612752,2018,107.0,112.0,219.0,112.2,119.6,105.0,110.5,10,3,7,0.3,11,3,8,0.273,2,1,2,1,231.2,216.4,223.8
2018-11-07,1610612748,1610612759,2018,95.0,88.0,183.0,113.9,112.6,113.6,110.6,9,4,5,0.444,9,6,3,0.667,2,2,4,2,224.2,216.0,220.1
2018-11-07,1610612754,1610612755,2018,94.0,100.0,194.0,107.2,100.7,110.1,113.4,11,7,4,0.636,11,6,5,0.545,3,4,6,0,205.8,217.4,211.60000000000002
2018-11-07,1610612763,1610612743,2018,89.0,87.0,176.0,106.2,103.3,109.7,102.6,9,5,4,0.556,10,9,1,0.9,3,2,6,3,220.0,215.2,217.6
2018-11-07,1610612740,1610612741,2018,107.0,98.0,205.0,117.4,122.9,107.2,114.7,10,4,6,0.4,11,3,8,0.273,3,1,1,2,246.2,221.2,233.7
2018-11-07,1610612762,1610612742,2018,117.0,102.0,219.0,108.1,107.5,111.6,115.1,10,4,6,0.4,10,3,7,0.3,0,4,3,0,212.6,232.0,222.3
2018-11-07,1610612758,1610612761,2018,105.0,114.0,219.0,110.12553191489364,112.84893617021277,117.5,108.4,10,6,4,0.6,11,10,1,0.909,2,4,6,4,208.0744680851064,225.6,216.83723404255318
2018-11-07,1610612747,1610612750,2018,114.0,110.0,224.0,118.9,120.0,110.9,118.3,10,4,6,0.4,11,4,7,0.364,2,2,4,0,242.8,232.6,237.7
2018-11-06,1610612766,1610612737,2018,113.0,102.0,215.0,115.7,108.1,112.7,120.9,10,5,5,0.5,9,3,6,0.333,3,2,2,1,228.4,231.2,229.8
2018-11-06,1610612742,1610612764,2018,119.0,100.0,219.0,111.5,117.4,112.3,120.0,9,2,7,0.222,9,2,7,0.222,2,0,1,1,236.4,227.6,232.0
2018-11-06,1610612756,1610612751,2018,82.0,104.0,186.0,100.7,115.0,109.9,111.3,9,2,7,0.222,10,4,6,0.4,2,0,3,1,216.4,226.8,221.60000000000002
2018-11-06,1610612757,1610612749,2018,118.0,103.0,221.0,115.9,105.2,121.9,108.0,10,7,3,0.7,9,8,1,0.889,4,3,6,2,229.0,231.6,230.3
2018-11-05,1610612765,1610612748,2018,115.0,120.0,235.0,110.2,110.9,113.3,113.2,8,4,4,0.5,8,3,5,0.375,3,1,2,1,215.6,224.2,219.89999999999998
2018-11-05,1610612754,1610612745,2018,94.0,98.0,192.0,107.48958333333334,102.46875,107.1,111.0,10,7,3,0.7,8,3,5,0.375,3,4,0,3,208.64798850574712,215.4,212.02399425287356
2018-11-05,1610612753,1610612739,2018,102.0,100.0,202.0,100.5,109.5,105.7,115.6,9,3,6,0.333,9,1,8,0.111,1,2,1,0,215.2,221.8,218.5
2018-11-05,1610612752,1610612741,2018,115.0,116.0,231.0,106.1,109.6,106.0,114.2,10,3,7,0.3,10,2,8,0.2,2,1,1,1,216.8,221.2,219.0
2018-11-05,1610612760,1610612740,2018,122.0,116.0,238.0,112.9,110.2,118.9,121.9,8,4,4,0.5,9,4,5,0.444,2,2,3,1,229.2,246.2,237.7
2018-11-05,1610612743,1610612738,2018,115.0,107.0,222.0,110.1,101.0,103.0,100.0,9,8,1,0.889,9,6,3,0.667,5,3,3,3,212.8,203.0,207.9
2018-11-05,1610612762,1610612761,2018,111.0,124.0,235.0,107.85882352941178,102.37254901960785,118.5,109.2,9,4,5,0.444,10,9,1,0.9,0,4,6,3,205.9138286893705,225.6,215.75691434468524
2018-11-05,1610612744,1610612763,2018,117.0,101.0,218.0,124.1,110.6,104.4,102.7,10,9,1,0.9,8,5,3,0.625,5,4,3,2,233.4,220.0,226.7
2018-11-05,1610612746,1610612750,2018,120.0,109.0,229.0,115.1,109.2,110.8,117.5,9,5,4,0.556,10,4,6,0.4,3,2,4,0,216.8,232.6,224.7
2018-11-04,1610612749,1610612758,2018,144.0,109.0,253.0,119.3,107.2,112.32553191489363,110.44893617021276,8,7,1,0.875,9,6,3,0.667,5,2,2,4,224.8,207.67446808510638,216.2372340425532
2018-11-04,1610612751,1610612755,2018,122.0,97.0,219.0,107.9,112.3,112.4,112.6,9,3,6,0.333,10,6,4,0.6,2,1,6,0,224.8,217.4,221.10000000000002
2018-11-04,1610612764,1610612752,2018,108.0,95.0,203.0,113.6,122.9,107.3,109.0,8,1,7,0.125,9,3,6,0.333,0,1,2,1,236.0,216.8,226.4
2018-11-04,1610612759,1610612753,2018,110.0,117.0,227.0,113.8,109.7,100.2,110.5,8,6,2,0.75,8,2,6,0.25,4,2,1,1,214.6,215.2,214.89999999999998
2018-11-04,1610612756,1610612763,2018,102.0,100.0,202.0,99.8,116.5,103.0,102.7,8,1,7,0.125,7,5,2,0.7140000000000001,1,0,3,2,217.6,220.0,218.8
2018-11-04,1610612757,1610612750,2018,111.0,81.0,192.0,117.6,109.0,114.8,120.7,9,6,3,0.667,9,4,5,0.444,3,3,4,0,240.0,232.6,236.3
2018-11-04,1610612747,1610612761,2018,107.0,121.0,228.0,120.5,119.2,115.4,109.0,9,4,5,0.444,9,8,1,0.889,2,2,6,2,244.4,225.6,235.0
2018-11-03,1610612755,1610612765,2018,109.0,99.0,208.0,114.2,113.5,109.6,111.7,9,5,4,0.556,7,4,3,0.5710000000000001,5,0,3,1,222.8,215.6,219.2
2018-11-03,1610612766,1610612739,2018,126.0,94.0,220.0,114.1,109.1,106.94482758620691,112.28275862068966,9,4,5,0.444,8,1,7,0.125,2,2,1,0,227.2,221.8,224.5
2018-11-03,1610612754,1610612738,2018,102.0,101.0,203.0,107.54255319148935,102.48936170212768,103.1,101.1,9,6,3,0.667,8,6,2,0.75,2,4,3,3,208.72157006603084,203.0,205.86078503301542
2018-11-03,1610612737,1610612748,2018,123.0,118.0,241.0,112.0,119.3,112.8,113.1,8,2,6,0.25,7,3,4,0.429,1,1,2,1,226.6,224.2,225.39999999999998
2018-11-03,1610612741,1610612745,2018,88.0,96.0,184.0,108.8,116.4,108.3,111.5,9,2,7,0.222,7,2,5,0.28600000000000003,1,1,0,2,231.2,215.4,223.3
2018-11-03,1610612759,1610612740,2018,109.0,95.0,204.0,112.2,111.0,122.2,125.0,7,5,2,0.7140000000000001,8,4,4,0.5,3,2,3,1,214.0,246.2,230.1
2018-11-03,1610612743,1610612762,2018,103.0,88.0,191.0,109.38478260869564,103.59782608695652,111.35882352941178,103.77254901960785,8,7,1,0.875,8,4,4,0.5,4,3,0,4,217.75430680885972,206.08315826330534,211.91873253608253
2018-11-03,1610612757,1610612747,2018,110.0,114.0,224.0,118.4,109.1,121.0,118.7,8,6,2,0.75,8,3,5,0.375,3,3,2,1,241.8,244.4,243.10000000000002
2018-11-02,1610612753,1610612746,2018,95.0,120.0,215.0,98.8,108.5,113.4,108.4,7,2,5,0.28600000000000003,8,4,4,0.5,1,1,3,1,208.4,216.8,212.60000000000002
2018-11-02,1610612751,1610612745,2018,111.0,119.0,230.0,105.84375,109.69583333333333,104.56363636363636,109.2,8,3,5,0.375,6,1,5,0.16699999999999998,2,1,0,1,217.02958333333333,215.4,216.21479166666666
2018-11-02,1610612764,1610612760,2018,111.0,134.0,245.0,110.21,115.52,110.72653061224487,109.27142857142857,7,1,6,0.14300000000000002,7,3,4,0.429,0,1,2,1,214.6167924528302,229.2,221.9083962264151
2018-11-02,1610612741,1610612754,2018,105.0,107.0,212.0,107.6,115.5,106.94255319148935,103.78936170212765,8,2,6,0.25,8,5,3,0.625,1,1,2,3,227.0,208.6810377006346,217.8405188503173
2018-11-02,1610612742,1610612752,2018,106.0,118.0,224.0,112.3,117.6,107.9,110.5,8,2,6,0.25,8,2,6,0.25,2,0,2,0,238.4,216.8,227.60000000000002
2018-11-02,1610612762,1610612763,2018,100.0,110.0,210.0,111.4,103.65,103.5,105.8,7,4,3,0.5710000000000001,6,4,2,0.667,0,4,3,1,206.0017857142857,220.0,213.00089285714284
2018-11-02,1610612756,1610612761,2018,98.0,107.0,205.0,100.2,116.4,114.56792452830187,106.5811320754717,7,1,6,0.14300000000000002,8,7,1,0.875,1,0,6,1,218.2,225.6,221.89999999999998
2018-11-02,1610612744,1610612750,2018,116.0,99.0,215.0,123.0,112.6,115.0,121.9,9,8,1,0.889,8,4,4,0.5,4,4,4,0,235.2,232.6,233.89999999999998
2018-11-01,1610612766,1610612760,2018,107.0,111.0,218.0,115.6,109.3,110.67083333333332,109.25208333333332,8,4,4,0.5,6,2,4,0.333,2,2,2,0,230.6,229.2,229.89999999999998
2018-11-01,1610612739,1610612743,2018,91.0,110.0,201.0,108.84482758620688,114.18275862068968,108.68478260869566,105.39782608695651,7,1,6,0.14300000000000002,7,6,1,0.857,1,0,4,2,229.4,217.92683946488296,223.66341973244147
2018-11-01,1610612755,1610612746,2018,122.0,113.0,235.0,113.2,113.7,111.02391304347826,106.61521739130436,8,4,4,0.5,7,4,3,0.5710000000000001,4,0,3,1,221.2,216.8,219.0
2018-11-01,1610612737,1610612758,2018,115.0,146.0,261.0,108.75744680851065,115.81702127659572,110.62553191489364,113.84893617021277,7,2,5,0.28600000000000003,8,5,3,0.625,1,1,2,3,213.05523731587562,207.1855791962175,210.12040825604657
2018-11-01,1610612738,1610612749,2018,117.0,113.0,230.0,102.9,101.0,113.45490196078433,106.2,7,5,2,0.7140000000000001,7,7,0,1.0,2,3,5,2,202.4,224.8,213.60000000000002
2018-11-01,1610612757,1610612740,2018,132.0,119.0,251.0,116.8,105.5,120.3,122.4,7,5,2,0.7140000000000001,7,4,3,0.5710000000000001,2,3,3,1,231.4,246.2,238.8
2018-10-31,1610612751,1610612765,2018,120.0,119.0,239.0,105.70212765957449,109.58723404255319,107.4,108.8,7,2,5,0.28600000000000003,6,4,2,0.667,1,1,3,1,216.77936170212766,215.6,216.18968085106383
2018-10-31,1610612752,1610612754,2018,101.0,107.0,208.0,108.5,111.1,105.14255319148936,104.08936170212765,7,2,5,0.28600000000000003,7,4,3,0.5710000000000001,2,0,2,2,219.2,208.67477203647417,213.93738601823708
2018-10-31,1610612741,1610612743,2018,107.0,108.0,215.0,107.3,113.6,109.18478260869566,105.79782608695652,7,2,5,0.28600000000000003,6,5,1,0.833,1,1,4,1,222.6,217.9688832054561,220.28444160272807
2018-10-31,1610612750,1610612762,2018,128.0,125.0,253.0,112.9,121.9,112.1,100.15,7,3,4,0.429,6,4,2,0.667,3,0,0,4,228.4,205.61363636363637,217.00681818181818
2018-10-31,1610612744,1610612740,2018,131.0,121.0,252.0,120.8,112.2,118.4,120.9,8,7,1,0.875,6,4,2,0.667,3,4,3,1,230.0,246.2,238.1
2018-10-31,1610612747,1610612742,2018,114.0,113.0,227.0,118.3,117.7,112.5,117.4,7,2,5,0.28600000000000003,7,2,5,0.28600000000000003,1,1,2,0,237.0,238.4,237.7
2018-10-31,1610612756,1610612759,2018,90.0,120.0,210.0,100.05531914893619,115.97659574468085,103.03,106.29,6,1,5,0.16699999999999998,6,4,2,0.667,1,0,3,1,217.4094659140252,214.0,215.7047329570126
2018-10-30,1610612766,1610612748,2018,125.0,113.0,238.0,113.5,107.7,111.5,111.0,7,3,4,0.429,6,3,3,0.5,1,2,2,1,223.2,224.2,223.7
2018-10-30,1610612739,1610612737,2018,136.0,114.0,250.0,105.44482758620691,113.88275862068966,108.65744680851064,114.11702127659576,6,0,6,0.0,6,2,4,0.333,0,0,1,1,222.0,212.69211514392993,217.34605757196496
2018-10-30,1610612753,1610612758,2018,99.0,107.0,206.0,99.1,106.4,111.42553191489358,115.74893617021276,6,2,4,0.333,7,4,3,0.5710000000000001,1,1,2,2,204.8,207.19710959454034,205.99855479727017
2018-10-30,1610612738,1610612765,2018,108.0,105.0,213.0,104.15172413793104,100.73793103448277,104.34893617021277,107.48297872340427,6,4,2,0.667,5,4,1,0.8,1,3,3,1,203.77737447065942,215.6,209.68868723532972
2018-10-30,1610612761,1610612755,2018,129.0,112.0,241.0,113.26792452830186,105.7811320754717,111.6653846153846,107.58846153846152,7,6,1,0.857,7,4,3,0.5710000000000001,5,1,4,0,221.4,221.2,221.3
2018-10-30,1610612745,1610612757,2018,85.0,104.0,189.0,109.16363636363636,110.3,116.8,109.2,5,1,4,0.2,6,4,2,0.667,0,1,2,2,226.8,231.4,229.10000000000002
2018-10-30,1610612763,1610612764,2018,107.0,95.0,202.0,104.8,107.3,110.91,114.52,5,3,2,0.6,6,1,5,0.16699999999999998,2,1,0,1,225.6,214.73961538461538,220.1698076923077
2018-10-30,1610612760,1610612746,2018,128.0,110.0,238.0,109.17083333333332,107.65208333333334,111.01111111111112,106.41111111111113,5,1,4,0.2,6,4,2,0.667,1,0,3,1,223.0,216.8,219.9
2018-10-29,1610612754,1610612757,2018,93.0,103.0,196.0,105.29565217391306,104.08913043478262,113.79,107.5,6,4,2,0.667,5,3,2,0.6,2,2,2,1,208.8276397515528,231.4,220.11381987577641
2018-10-29,1610612755,1610612737,2018,113.0,92.0,205.0,112.3653846153846,109.78846153846158,108.85744680851064,114.11702127659576,6,3,3,0.5,5,2,3,0.4,3,0,1,1,227.0,212.7644680851064,219.8822340425532
2018-10-29,1610612748,1610612758,2018,113.0,123.0,236.0,114.2,111.5,108.52553191489363,116.64893617021276,5,3,2,0.6,6,3,3,0.5,2,1,2,1,230.6,206.92062193126023,218.7603109656301
2018-10-29,1610612752,1610612751,2018,115.0,96.0,211.0,106.8,112.5,107.40212765957445,108.7872340425532,6,1,5,0.16699999999999998,6,2,4,0.333,1,0,1,1,218.6,216.85670864090315,217.72835432045156
2018-10-29,1610612741,1610612744,2018,124.0,149.0,273.0,107.7,110.3,117.2,112.1,6,2,4,0.333,7,6,1,0.857,1,1,3,3,216.8,230.0,223.4
2018-10-29,1610612749,1610612761,2018,124.0,109.0,233.0,115.35490196078432,107.4,113.275,105.61730769230768,6,6,0,1.0,6,6,0,1.0,4,2,5,1,231.0,221.4,226.2
2018-10-29,1610612750,1610612747,2018,124.0,120.0,244.0,110.6,121.2,113.88695652173914,116.27608695652174,6,2,4,0.333,6,2,4,0.333,2,0,1,1,222.4,237.0,229.7
2018-10-29,1610612759,1610612742,2018,113.0,108.0,221.0,103.43,104.79,109.64166666666668,113.80833333333334,5,3,2,0.6,6,2,4,0.333,2,1,2,0,211.8,238.4,225.10000000000002
2018-10-29,1610612743,1610612740,2018,116.0,111.0,227.0,109.13333333333333,105.73333333333332,118.9,122.1,5,4,1,0.8,5,4,1,0.8,3,1,3,1,217.8529411764706,246.2,232.0264705882353
2018-10-28,1610612751,1610612744,2018,114.0,120.0,234.0,107.3195652173913,108.66304347826087,115.38214285714285,110.23392857142859,5,2,3,0.4,6,5,1,0.833,1,1,3,2,216.64995563442767,230.0,223.32497781721383
2018-10-28,1610612742,1610612762,2018,104.0,113.0,217.0,103.32291666666666,105.98958333333334,113.1,100.95,5,2,3,0.4,5,3,2,0.6,2,0,0,3,209.3125,205.54444444444442,207.4284722222222
2018-10-28,1610612760,1610612756,2018,117.0,110.0,227.0,106.57083333333333,106.35208333333333,100.75531914893615,115.17659574468084,4,0,4,0.0,5,1,4,0.2,0,0,1,0,215.2,217.31316489361703,216.25658244680852
2018-10-28,1610612746,1610612764,2018,136.0,104.0,240.0,110.21111111111112,106.11111111111113,111.51,110.72,5,3,2,0.6,5,1,4,0.2,2,1,0,1,214.6,214.49470588235295,214.54735294117648
2018-10-27,1610612765,1610612738,2018,89.0,109.0,198.0,106.24893617021276,107.58297872340427,102.95172413793102,102.23793103448277,4,4,0,1.0,5,3,2,0.6,3,1,1,2,219.6,203.82358374384236,211.71179187192118
2018-10-27,1610612740,1610612762,2018,111.0,132.0,243.0,114.88,116.5,104.76981132075471,100.4575471698113,4,4,0,1.0,4,2,2,0.5,3,1,0,2,223.49851851851852,205.22735849056602,214.36293850454229
2018-10-27,1610612737,1610612741,2018,85.0,97.0,182.0,109.07391304347826,114.2391304347826,106.2,113.4,4,2,2,0.5,5,1,4,0.2,1,1,1,0,213.10304347826087,216.8,214.95152173913044
2018-10-27,1610612739,1610612754,2018,107.0,119.0,226.0,106.0448275862069,112.18275862068968,104.49565217391304,103.58913043478262,5,0,5,0.0,5,3,2,0.6,0,0,2,1,219.8,208.65750988142292,214.22875494071147
2018-10-27,1610612755,1610612766,2018,105.0,103.0,208.0,110.01632801161102,106.24129172714079,115.5,109.0,5,2,3,0.4,6,3,3,0.5,2,0,1,2,216.25761973875183,223.2,219.7288098693759
2018-10-27,1610612748,1610612757,2018,120.0,111.0,231.0,111.2,109.3,113.74081632653063,107.3469387755102,4,2,2,0.5,4,3,1,0.75,1,1,2,1,220.2,231.4,225.8
2018-10-27,1610612763,1610612756,2018,117.0,96.0,213.0,97.78958333333333,104.15625,103.89361702127658,113.46808510638296,4,2,2,0.5,4,1,3,0.25,1,1,1,0,205.23958333333331,217.36170212765958,211.30064273049646
2018-10-27,1610612749,1610612753,2018,113.0,91.0,204.0,115.65490196078431,106.5,100.15,107.44791666666666,5,5,0,1.0,5,2,3,0.4,3,2,1,1,229.8,204.8,217.3
2018-10-27,1610612759,1610612747,2018,110.0,106.0,216.0,102.83,104.19,113.93333333333334,116.31111111111113,4,2,2,0.5,5,2,3,0.4,1,1,1,1,209.4,237.0,223.2
2018-10-26,1610612766,1610612741,2018,135.0,106.0,241.0,112.15744680851064,109.5191489361702,106.33125,109.1625,5,2,3,0.4,4,1,3,0.25,0,2,1,0,216.29659574468084,216.8,216.5482978723404
2018-10-26,1610612752,1610612744,2018,100.0,128.0,228.0,107.4,109.7,115.24545454545456,110.30909090909093,5,1,4,0.2,5,4,1,0.8,1,0,3,1,214.2,230.0,222.1
2018-10-26,1610612761,1610612742,2018,116.0,107.0,223.0,113.475,104.0173076923077,103.25997340425532,105.89827127659576,5,5,0,1.0,4,2,2,0.5,4,1,2,0,218.6,209.15824468085106,213.8791223404255
2018-10-26,1610612745,1610612746,2018,113.0,133.0,246.0,110.91363636363636,103.95357142857141,109.93636363636364,106.0681818181818,4,1,3,0.25,4,2,2,0.5,0,1,2,0,214.8672077922078,214.6,214.7336038961039
2018-10-26,1610612750,1610612749,2018,95.0,125.0,220.0,112.725,117.1875,115.47,106.63,5,2,3,0.4,4,4,0,1.0,2,0,3,1,218.25480769230768,229.8,224.02740384615385
2018-10-26,1610612740,1610612751,2018,117.0,115.0,232.0,114.8530612244898,116.47551020408164,104.9195652173913,108.76304347826088,3,3,0,1.0,4,2,2,0.5,2,1,1,1,223.44708994708995,216.51177536231884,219.9794326547044
2018-10-26,1610612758,1610612764,2018,116.0,112.0,228.0,108.3608695652174,116.58695652173913,107.42,106.94,5,2,3,0.4,4,1,3,0.25,1,1,0,1,206.69397993311037,214.36,210.5269899665552
2018-10-25,1610612765,1610612739,2018,110.0,103.0,213.0,104.23226950354609,104.38297872340424,106.08596491228072,112.17368421052632,3,3,0,1.0,4,0,4,0.0,2,1,0,0,208.61524822695037,219.8,214.2076241134752
2018-10-25,1610612753,1610612757,2018,114.0,128.0,242.0,102.69791666666666,107.0625,113.5125,107.25,4,2,2,0.5,3,2,1,0.667,1,1,2,0,209.76041666666669,231.4,220.58020833333336
2018-10-25,1610612760,1610612738,2018,95.0,101.0,196.0,107.05083333333334,104.42208333333332,103.38808777429466,100.50156739811915,3,0,3,0.0,4,2,2,0.5,0,0,1,1,211.47291666666666,203.8896551724138,207.68128591954024
2018-10-25,1610612747,1610612743,2018,121.0,114.0,235.0,114.63333333333333,117.21111111111112,110.13333333333333,104.33333333333331,4,1,3,0.25,4,4,0,1.0,0,1,3,1,240.2,217.69666666666666,228.94833333333332
2018-10-24,1610612737,1610612742,2018,111.0,104.0,215.0,109.01111111111112,114.28888888888888,103.22690217391305,105.85733695652176,3,1,2,0.333,3,2,1,0.667,0,1,2,0,213.09,209.08423913043478,211.0871195652174
2018-10-24,1610612739,1610612751,2018,86.0,102.0,188.0,108.41138864109422,108.83809099018734,105.7195652173913,110.96304347826086,3,0,3,0.0,3,1,2,0.333,0,0,1,0,217.2494796312816,216.83580018501388,217.04263990814775
2018-10-24,1610612748,1610612752,2018,110.0,87.0,197.0,106.93,108.24,105.06595744680851,108.59787234042555,3,1,2,0.333,4,1,3,0.25,0,1,1,0,208.2796153846154,214.2,211.2398076923077
2018-10-24,1610612761,1610612750,2018,112.0,105.0,217.0,114.475,103.9173076923077,113.625,116.9875,4,4,0,1.0,4,2,2,0.5,3,1,2,0,220.4,218.26348039215685,219.33174019607844
2018-10-24,1610612741,1610612766,2018,112.0,110.0,222.0,103.01041666666666,110.01041666666666,112.35744680851064,109.81914893617022,3,0,3,0.0,4,2,2,0.5,0,0,0,2,213.02083333333331,216.22557533651758,214.62320433492545
2018-10-24,1610612745,1610612762,2018,89.0,100.0,189.0,111.12727272727273,104.0,104.82115384615385,100.59615384615385,3,1,2,0.333,3,1,2,0.333,0,1,0,1,215.12727272727273,205.4173076923077,210.2722902097902
2018-10-24,1610612759,1610612754,2018,96.0,116.0,212.0,103.47,100.97,103.29565217391306,104.8891304347826,3,2,1,0.667,4,2,2,0.5,1,1,2,0,204.44,208.61070853462158,206.52535426731077
2018-10-24,1610612749,1610612755,2018,123.0,108.0,231.0,106.96,106.55,110.02349241583427,106.09988901220864,3,3,0,1.0,4,2,2,0.5,2,1,2,0,213.51,216.12338142804293,214.81669071402146
2018-10-24,1610612756,1610612747,2018,113.0,131.0,244.0,103.79047178538391,113.27844588344125,114.39772727272728,117.21363636363635,3,1,2,0.333,3,0,3,0.0,1,0,0,0,217.06891766882518,240.2,228.63445883441258
2018-10-24,1610612758,1610612763,2018,97.0,92.0,189.0,108.4,116.74444444444444,100.03213652482272,105.37965425531914,4,1,3,0.25,3,2,1,0.667,0,1,1,1,206.8905982905983,205.41179078014184,206.15119453537005
2018-10-24,1610612744,1610612764,2018,144.0,122.0,266.0,113.04545454545456,107.5090909090909,107.25693877551019,106.5751020408163,4,3,1,0.75,3,1,2,0.333,2,1,0,1,220.0,213.83204081632653,216.91602040816326
2018-10-23,1610612765,1610612755,2018,133.0,132.0,265.0,103.94680851063829,104.07446808510642,109.79094339622642,105.85283018867923,2,2,0,1.0,3,2,1,0.667,1,1,2,0,208.02127659574467,215.64377358490566,211.83252509032516
2018-10-23,1610612740,1610612746,2018,116.0,109.0,225.0,114.83541666666667,116.5125,109.9279069767442,105.98837209302326,2,2,0,1.0,3,2,1,0.667,1,1,2,0,223.4664351851852,214.6,219.0332175925926
2018-10-23,1610612743,1610612758,2018,126.0,112.0,238.0,109.9659090909091,104.25454545454544,109.5,116.94444444444444,3,3,0,1.0,3,1,2,0.333,2,1,0,1,217.45045454545453,206.58366013071895,212.01705733808674
2018-10-22,1610612738,1610612753,2018,90.0,93.0,183.0,103.52057416267942,100.55661881977673,102.79898049645391,107.25288120567377,3,2,1,0.667,3,1,2,0.333,1,1,1,0,204.07719298245615,210.05186170212767,207.0645273422919
2018-10-22,1610612761,1610612766,2018,127.0,106.0,233.0,111.40384615384615,104.68269230769229,108.41578014184398,107.62123226950355,3,3,0,1.0,3,2,1,0.667,2,1,0,2,216.08653846153845,216.03701241134752,216.06177543644299
2018-10-22,1610612749,1610612752,2018,124.0,113.0,237.0,106.79448979591835,106.46673469387757,104.95217391304348,108.45217391304348,2,2,0,1.0,3,1,2,0.333,1,1,1,0,213.26122448979592,214.2,213.73061224489794
2018-10-22,1610612750,1610612754,2018,101.0,91.0,192.0,113.73404255319149,117.16170212765957,105.19565217391305,104.7891304347826,3,1,2,0.333,3,2,1,0.667,1,0,2,0,218.54672507300793,208.7508203445447,213.64877270877633
2018-10-22,1610612742,1610612741,2018,115.0,109.0,224.0,103.12650323774284,105.8101295097132,102.93661347517728,109.97983156028369,2,1,1,0.5,2,0,2,0.0,1,0,0,0,208.93663274745606,212.91644503546098,210.9265388914585
2018-10-22,1610612762,1610612763,2018,84.0,92.0,176.0,105.02727629513343,100.65227629513343,100.09827898550724,105.63451086956522,2,1,1,0.5,2,1,1,0.5,0,1,1,0,205.6795525902669,205.73278985507244,205.70617122266967
2018-10-22,1610612757,1610612764,2018,124.0,125.0,249.0,112.3125,107.05,107.05583333333334,106.40333333333334,2,2,0,1.0,2,0,2,0.0,2,0,0,0,228.6,213.45916666666668,221.02958333333333
2018-10-22,1610612744,1610612756,2018,123.0,103.0,226.0,111.74545454545456,108.60909090909092,103.80434782608695,113.17391304347828,3,2,1,0.667,2,1,1,0.5,1,1,1,0,219.6,216.97826086956522,218.2891304347826
2018-10-22,1610612747,1610612759,2018,142.0,143.0,285.0,111.29772727272729,114.21363636363635,103.04408163265309,100.57591836734692,2,0,2,0.0,2,1,1,0.5,0,0,1,0,228.0,203.62,215.81
2018-10-21,1610612739,1610612737,2018,111.0,133.0,244.0,108.39458560193589,108.6288566243194,106.71111111111112,115.18888888888891,2,0,2,0.0,2,0,2,0.0,0,0,0,0,217.02344222625527,212.76734693877552,214.8953945825154
2018-10-21,1610612760,1610612758,2018,120.0,131.0,251.0,106.93409863945578,104.14392006802721,107.0,115.14444444444445,2,0,2,0.0,2,0,2,0.0,0,0,0,0,211.078018707483,206.13444444444445,208.60623157596373
2018-10-21,1610612743,1610612744,2018,100.0,98.0,198.0,110.09302325581396,104.33488372093024,111.88148148148147,108.68703703703704,2,2,0,1.0,2,2,0,1.0,1,1,1,1,217.6579069767442,219.6,218.62895348837208
2018-10-21,1610612746,1610612745,2018,115.0,112.0,227.0,108.75035595633602,108.31490270526815,111.10252525252524,103.88703703703705,2,1,1,0.5,2,1,1,0.5,1,0,0,1,217.06525866160416,214.9895622895623,216.02741047558322
2018-10-20,1610612754,1610612751,2018,132.0,112.0,244.0,104.92222222222222,104.68888888888887,106.70652173913044,109.8586956521739,2,1,1,0.5,2,1,1,0.5,1,0,1,0,208.37714884696015,216.56521739130434,212.47118311913226
2018-10-20,1610612764,1610612761,2018,113.0,117.0,230.0,107.01318027210884,106.2874149659864,111.3327677224736,104.62028657616892,1,0,1,0.0,2,2,0,1.0,0,0,2,0,213.30059523809524,215.95305429864254,214.6268247683689
2018-10-20,1610612752,1610612738,2018,101.0,103.0,204.0,104.49592391304348,108.35009057971014,103.50828460038986,100.56335282651071,2,1,1,0.5,2,1,1,0.5,1,0,1,0,212.84601449275362,204.07163742690057,208.4588259598271
2018-10-20,1610612755,1610612753,2018,116.0,115.0,231.0,109.74576923076923,105.74615384615385,102.6653079710145,107.16893115942028,2,1,1,0.5,2,1,1,0.5,1,0,1,0,215.4919230769231,209.83423913043478,212.66308110367893
2018-10-20,1610612748,1610612766,2018,112.0,113.0,225.0,106.86530612244896,108.1469387755102,108.35106382978724,107.57446808510642,2,1,1,0.5,2,1,1,0.5,0,1,0,1,208.12186028257457,215.9255319148936,212.0236960987341
2018-10-20,1610612741,1610612765,2018,116.0,118.0,234.0,102.80851063829788,109.87234042553192,103.77613320999077,103.96322849213689,1,0,1,0.0,1,1,0,1.0,0,0,1,0,212.68085106382978,207.73936170212767,210.21010638297872
2018-10-20,1610612742,1610612750,2018,140.0,136.0,276.0,102.75,105.46739130434784,109.34404255319149,108.62170212765957,1,0,1,0.0,2,1,1,0.5,0,0,1,0,208.2173913043478,217.96574468085106,213.09156799259944
2018-10-20,1610612743,1610612756,2018,119.0,91.0,210.0,110.0,104.50238095238096,103.95217391304348,113.10917874396135,1,1,0,1.0,1,1,0,1.0,0,1,1,0,217.73238095238094,217.06135265700482,217.39686680469288
2018-10-20,1610612757,1610612759,2018,121.0,108.0,229.0,106.56760204081631,103.81122448979592,102.965,100.38416666666666,1,1,0,1.0,1,1,0,1.0,1,0,1,0,210.37882653061223,203.3491666666667,206.86399659863946
2018-10-20,1610612747,1610612745,2018,115.0,124.0,239.0,110.49772727272727,114.21363636363635,110.96363636363635,103.76981132075471,1,0,1,0.0,1,0,1,0.0,0,0,0,0,226.4,214.73344768439108,220.56672384219553
2018-10-19,1610612753,1610612766,2018,88.0,120.0,208.0,102.82377428307123,107.02243293246994,108.20744680851065,107.78654024051805,1,1,0,1.0,1,0,1,0.0,1,0,0,0,209.84620721554117,215.99398704902868,212.92009713228492
2018-10-19,1610612751,1610612752,2018,107.0,105.0,212.0,106.69806763285023,109.89565217391304,104.46597222222222,108.38680555555555,1,0,1,0.0,1,1,0,1.0,0,0,1,0,216.5937198067633,212.8527777777778,214.72324879227054
2018-10-19,1610612761,1610612738,2018,113.0,101.0,214.0,111.33333333333334,104.63725490196079,103.51439920556106,100.45713339953657,1,1,0,1.0,1,1,0,1.0,1,0,1,0,215.97058823529412,203.97153260509765,209.9710604201959
2018-10-19,1610612763,1610612737,2018,131.0,117.0,248.0,99.7895467160037,105.48889916743755,103.54861111111113,108.84097222222223,1,0,1,0.0,1,0,1,0.0,0,0,0,0,205.27844588344124,212.38958333333335,208.8340146083873
2018-10-19,1610612750,1610612739,2018,131.0,123.0,254.0,109.13173913043478,108.45565217391304,108.25862068965515,108.4319581280788,1,0,1,0.0,1,0,1,0.0,0,0,0,0,217.58739130434782,216.69057881773398,217.1389850610409
2018-10-19,1610612740,1610612758,2018,149.0,129.0,278.0,114.46595744680852,116.33829787234043,98.96326530612244,106.42811791383221,1,1,0,1.0,1,0,1,0.0,0,1,0,0,222.92277383766745,205.39138321995466,214.15707852881104
2018-10-19,1610612749,1610612754,2018,118.0,101.0,219.0,106.68458333333334,106.505,105.191452991453,103.0715811965812,1,1,0,1.0,1,1,0,1.0,0,1,1,0,213.18958333333333,208.2630341880342,210.72630876068376
2018-10-19,1610612762,1610612744,2018,123.0,124.0,247.0,104.8357371794872,100.37740384615385,111.77735849056604,108.55094339622643,1,1,0,1.0,1,1,0,1.0,0,1,1,0,205.21314102564102,219.6,212.4065705128205
2018-10-19,1610612746,1610612760,2018,108.0,92.0,200.0,108.76332364341083,108.4779554263566,107.07815892314372,104.11311333043855,1,0,1,0.0,1,0,1,0.0,0,0,0,0,217.24127906976744,211.19127225358227,214.21627566167484
2018-10-18,1610612755,1610612741,2018,127.0,108.0,235.0,109.59098039215687,105.70392156862744,102.74236817761332,109.7099907493062,1,0,1,0.0,0,0,0,0.0,0,0,0,0,215.29490196078433,212.45235892691952,213.87363044385194
2018-10-18,1610612764,1610612748,2018,112.0,113.0,225.0,106.97916666666669,106.20833333333334,103.72609043617449,104.21948779511807,0,0,0,0.0,1,0,1,0.0,0,0,0,0,213.1875,207.94557823129253,210.56653911564626
2018-10-18,1610612757,1610612747,2018,128.0,119.0,247.0,106.35416666666666,103.64583333333334,110.3906976744186,114.04186046511627,0,0,0,0.0,0,0,0,0.0,0,0,0,0,210.0,226.4,218.2
2018-10-17,1610612766,1610612749,2018,112.0,113.0,225.0,108.18478260869566,107.72826086956522,106.61458333333334,106.46683673469387,0,0,0,0.0,0,0,0,0.0,0,0,0,0,215.91304347826087,213.0814200680272,214.49723177314405
2018-10-17,1610612765,1610612751,2018,103.0,100.0,203.0,103.80434782608695,103.9891304347826,106.77777777777777,109.98888888888891,0,0,0,0.0,0,0,0,0.0,0,0,0,0,207.79347826086956,216.76666666666665,212.2800724637681
2018-10-17,1610612754,1610612763,2018,111.0,83.0,194.0,105.14423076923076,103.29632867132868,99.95862884160758,105.4550827423168,0,0,0,0.0,0,0,0,0.0,0,0,0,0,208.44055944055944,205.41371158392434,206.92713551224188
2018-10-17,1610612753,1610612748,2018,104.0,101.0,205.0,102.81521739130434,107.07608695652172,103.73530612244896,104.22693877551019,0,0,0,0.0,0,0,0,0.0,0,0,0,0,209.89130434782606,207.96224489795918,208.92677462289262
2018-10-17,1610612752,1610612737,2018,126.0,107.0,233.0,104.26052009456265,108.380378250591,103.49408983451536,108.6612293144208,0,0,0,0.0,0,0,0,0.0,0,0,0,0,212.6408983451537,212.15531914893617,212.39810874704494
2018-10-17,1610612761,1610612739,2018,116.0,104.0,220.0,111.30392156862746,104.62490196078431,108.29043887147336,108.364263322884,0,0,0,0.0,0,0,0,0.0,0,0,0,0,215.92882352941177,216.65470219435736,216.29176286188456
2018-10-17,1610612745,1610612740,2018,112.0,131.0,243.0,110.97222222222223,103.53092243186585,111.3791649939783,111.32697711762344,0,0,0,0.0,0,0,0,0.0,0,0,0,0,214.50314465408803,222.70614211160176,218.6046433828449
2018-10-17,1610612759,1610612750,2018,112.0,108.0,220.0,102.90051020408166,100.28784013605444,109.12377994676132,108.43034605146408,0,0,0,0.0,0,0,0,0.0,0,0,0,0,203.18835034013605,217.55412599822537,210.3712381691807
2018-10-17,1610612758,1610612762,2018,117.0,123.0,240.0,98.7769016697588,106.24049165120591,104.66360294117645,100.24693627450979,0,0,0,0.0,0,0,0,0.0,0,0,0,0,205.01739332096474,204.91053921568627,204.96396626832552
2018-10-17,1610612746,1610612743,2018,98.0,107.0,205.0,108.88322612568035,108.48837209302326,109.83673469387756,108.03911564625851,0,0,0,0.0,0,0,0,0.0,0,0,0,0,217.3715982187036,217.87585034013605,217.62372427941983
2018-10-17,1610612756,1610612742,2018,121.0,100.0,221.0,103.75555555555556,113.25555555555556,102.75990338164252,105.31352657004831,0,0,0,0.0,0,0,0,0.0,0,0,0,0,217.01111111111112,208.07342995169083,212.54227053140096
2018-10-16,1610612738,1610612755,2018,105.0,87.0,192.0,103.51768867924528,100.56772237196763,109.80812324929971,105.73249299719886,0,0,0,0.0,0,0,0,0.0,0,0,0,0,204.08541105121293,215.5406162464986,209.81301364885576
2018-10-16,1610612744,1610612760,2018,108.0,100.0,208.0,112.83498560921012,106.56619763351456,107.14152617568766,104.0809671694765,0,0,0,0.0,0,0,0,0.0,0,0,0,0,219.40118324272464,211.22249334516414,215.3118382939444
2018-10-12,1610612753,1610612759,2018,81.0,100.0,181.0,103.06183574879229,107.14323671497586,102.90316977854971,100.51346070343031,0,0,0,0.0,0,0,0,0.0,0,0,0,0,210.20507246376812,203.41663048198,206.81085147287405
2018-10-12,1610612742,1610612766,2018,118.0,123.0,241.0,102.61111111111113,105.1,108.00144927536232,107.61642512077293,0,0,0,0.0,0,0,0,0.0,0,0,0,0,207.7111111111111,215.61787439613528,211.6644927536232
2018-10-12,1610612739,1610612765,2018,110.0,129.0,239.0,108.28181818181818,108.18277511961722,103.50386473429951,103.93961352657006,0,0,0,0.0,0,0,0,0.0,0,0,0,0,216.4645933014354,207.44347826086957,211.95403578115247
2018-10-12,1610612752,1610612751,2018,107.0,113.0,220.0,104.25265700483091,108.30845410628021,106.71338383838385,110.0409090909091,0,0,0,0.0,0,0,0,0.0,0,0,0,0,212.56111111111113,216.75429292929294,214.65770202020204
2018-10-12,1610612748,1610612737,2018,119.0,113.0,232.0,103.595,104.13,103.3719806763285,108.54975845410627,0,0,0,0.0,0,0,0,0.0,0,0,0,0,207.725,211.9217391304348,209.82336956521738
2018-10-12,1610612741,1610612743,2018,93.0,98.0,191.0,102.8586956521739,109.81521739130434,109.94791666666666,108.22321428571428,0,0,0,0.0,0,0,0,0.0,0,0,0,0,212.67391304347825,218.17113095238096,215.4225219979296
2018-10-12,1610612763,1610612745,2018,103.0,121.0,224.0,99.94082125603865,105.2596618357488,110.85683760683762,103.52457264957266,0,0,0,0.0,0,0,0,0.0,0,0,0,0,205.20048309178745,214.38141025641025,209.79094667409885
2018-10-12,1610612749,1610612750,2018,143.0,121.0,264.0,106.23404255319149,106.29396439426834,108.98007246376812,108.08106884057972,0,0,0,0.0,0,0,0,0.0,0,0,0,0,212.52800694745983,217.0611413043478,214.7945741259038
2018-10-12,1610612757,1610612758,2018,118.0,115.0,233.0,106.23803191489358,103.51595744680851,98.59280303030305,106.1193181818182,0,0,0,0.0,0,0,0,0.0,0,0,0,0,209.7539893617021,204.71212121212122,207.23305528691168
2018-10-12,1610612744,1610612747,2018,105.0,119.0,224.0,112.90322055953156,106.44404684450228,110.27857142857144,114.13571428571429,0,0,0,0.0,0,0,0,0.0,0,0,0,0,219.34726740403383,224.4142857142857,221.88077655915976
2018-10-11,1610612740,1610612761,2018,119.0,134.0,253.0,111.31972928630026,111.0908531583265,111.06,104.5,0,0,0,0.0,0,0,0,0.0,0,0,0,0,222.41058244462675,215.56,218.98529122231338
2018-10-11,1610612758,1610612762,2018,93.0,132.0,225.0,98.67684108527132,105.81831395348836,104.39458333333334,100.35125,0,0,0,0.0,0,0,0,0.0,0,0,0,0,204.4951550387597,204.74583333333334,204.62049418604653
2018-10-10,1610612765,1610612764,2018,97.0,102.0,199.0,103.6,103.94444444444444,107.01418439716312,106.31648936170212,0,0,0,0.0,0,0,0,0.0,0,0,0,0,207.54444444444445,213.33067375886526,210.43755910165487
2018-10-10,1610612753,1610612763,2018,102.0,86.0,188.0,103.0810276679842,107.37252964426878,100.0834980237154,105.32658102766798,0,0,0,0.0,0,0,0,0.0,0,0,0,0,210.45355731225297,205.4100790513834,207.9318181818182
2018-10-10,1610612761,1610612751,2018,118.0,91.0,209.0,111.00897959183672,104.61979591836734,106.90180878552972,109.96744186046513,0,0,0,0.0,0,0,0,0.0,0,0,0,0,215.6287755102041,216.86925064599484,216.24901307809947
2018-10-10,1610612737,1610612759,2018,130.0,127.0,257.0,103.09041501976284,108.34041501976284,102.61246672582077,100.21628216503991,0,0,0,0.0,0,0,0,0.0,0,0,0,0,211.4308300395257,202.82874889086068,207.1297894651932
2018-10-10,1610612748,1610612740,2018,140.0,128.0,268.0,103.22531914893615,103.86936170212765,111.13921404682274,110.80602006688964,0,0,0,0.0,0,0,0,0.0,0,0,0,0,207.09468085106383,221.9452341137124,214.51995748238812
2018-10-10,1610612741,1610612754,2018,104.0,89.0,193.0,102.85797101449276,110.02512077294685,105.28676470588236,103.29010695187166,0,0,0,0.0,0,0,0,0.0,0,0,0,0,212.8830917874396,208.576871657754,210.7299817225968
2018-10-10,1610612757,1610612756,2018,116.0,83.0,199.0,106.13858695652176,103.72826086956522,104.00101010101014,113.2219696969697,0,0,0,0.0,0,0,0,0.0,0,0,0,0,209.86684782608694,217.2229797979798,213.54491381203337
2018-10-10,1610612747,1610612744,2018,123.0,113.0,236.0,107.64857142857143,109.77571428571429,112.90086206896551,106.30271883289127,0,0,0,0.0,0,0,0,0.0,0,0,0,0,217.4242857142857,219.20358090185675,218.31393330807123
2018-10-09,1610612760,1610612749,2018,119.0,115.0,234.0,107.03034420289856,103.9578804347826,106.14029255319149,106.18129432624113,0,0,0,0.0,0,0,0,0.0,0,0,0,0,210.98822463768116,212.32158687943263,211.65490575855688
2018-10-09,1610612746,1610612743,2018,109.0,103.0,212.0,108.88877654196158,108.5427199191102,110.01063829787232,108.24493414387031,0,0,0,0.0,0,0,0,0.0,0,0,0,0,217.4314964610718,218.25557244174266,217.8435344514072
2018-10-08,1610612755,1610612742,2018,112.0,115.0,227.0,109.79714285714287,105.61857142857143,102.4510101010101,105.04141414141417,0,0,0,0.0,0,0,0,0.0,0,0,0,0,215.41571428571427,207.49242424242425,211.45406926406926
2018-10-08,1610612766,1610612741,2018,110.0,104.0,214.0,108.0,107.65555555555555,102.83333333333334,110.04444444444445,0,0,0,0.0,0,0,0,0.0,0,0,0,0,215.65555555555557,212.8777777777778,214.26666666666668
2018-10-08,1610612739,1610612754,2018,102.0,111.0,213.0,108.34431818181818,108.15551948051949,105.215,103.30363636363636,0,0,0,0.0,0,0,0,0.0,0,0,0,0,216.49983766233765,208.51863636363635,212.509237012987
2018-10-08,1610612765,1610612751,2018,108.0,110.0,218.0,103.57550505050507,103.85858585858584,106.87301587301589,110.0095238095238,0,0,0,0.0,0,0,0,0.0,0,0,0,0,207.4340909090909,216.8825396825397,212.1583152958153
2018-10-08,1610612748,1610612753,2018,90.0,89.0,179.0,103.38304347826087,104.02130434782607,103.23030303030303,107.57373737373736,0,0,0,0.0,0,0,0,0.0,0,0,0,0,207.40434782608696,210.8040404040404,209.10419411506368
2018-10-08,1610612752,1610612764,2018,98.0,110.0,208.0,104.34444444444445,108.26666666666668,106.96376811594205,106.41847826086956,0,0,0,0.0,0,0,0,0.0,0,0,0,0,212.61111111111111,213.3822463768116,212.99667874396135
2018-10-08,1610612744,1610612756,2018,109.0,117.0,226.0,112.93640350877192,106.19382591093115,103.86253229974159,113.26821705426356,0,0,0,0.0,0,0,0,0.0,0,0,0,0,219.1302294197031,217.13074935400516,218.13048938685415
2018-10-07,1610612760,1610612737,2018,113.0,94.0,207.0,106.97826086956522,104.05296022201664,103.1739898989899,108.29065656565656,0,0,0,0.0,0,0,0,0.0,0,0,0,0,211.03122109158187,211.46464646464648,211.24793377811417
2018-10-07,1610612759,1610612745,2018,93.0,108.0,201.0,102.74320652173913,100.1159420289855,110.86437908496731,103.61601307189542,0,0,0,0.0,0,0,0,0.0,0,0,0,0,202.85914855072463,214.48039215686273,208.6697703537937
2018-10-07,1610612750,1610612749,2018,107.0,125.0,232.0,109.025,107.88541666666666,105.93617021276594,106.19148936170212,0,0,0,0.0,0,0,0,0.0,0,0,0,0,216.91041666666666,212.12765957446808,214.51903812056736
2018-10-07,1610612757,1610612762,2018,112.0,123.0,235.0,106.07916666666668,103.50555555555556,104.20642006802721,100.26594387755102,0,0,0,0.0,0,0,0,0.0,0,0,0,0,209.58472222222224,204.47236394557822,207.02854308390022
2018-10-06,1610612739,1610612738,2018,113.0,102.0,215.0,108.30909090909093,108.20909090909092,103.51442307692308,100.45741758241758,0,0,0,0.0,0,0,0,0.0,0,0,0,0,216.5181818181818,203.97184065934067,210.24501123876124
2018-10-06,1610612763,1610612754,2018,109.0,104.0,213.0,99.9982323232323,105.31136363636364,105.21173469387756,103.24628942486086,0,0,0,0.0,0,0,0,0.0,0,0,0,0,205.30959595959598,208.45802411873842,206.8838100391672
2018-10-06,1610612747,1610612746,2018,87.0,103.0,190.0,107.84183673469387,109.81122448979592,108.95134575569357,108.80434782608695,0,0,0,0.0,0,0,0,0.0,0,0,0,0,217.6530612244898,217.75569358178052,217.70437740313514
2018-10-05,1610612742,1610612755,2018,114.0,120.0,234.0,102.3409090909091,104.85227272727272,109.67958333333334,105.55458333333334,0,0,0,0.0,0,0,0,0.0,0,0,0,0,207.1931818181818,215.23416666666668,211.21367424242425
2018-10-05,1610612764,1610612748,2018,121.0,114.0,235.0,106.83256244218315,106.3253931544866,103.25998225377107,103.8555900621118,0,0,0,0.0,0,0,0,0.0,0,0,0,0,213.15795559666975,207.11557231588287,210.1367639562763
2018-10-05,1610612752,1610612740,2018,106.0,100.0,206.0,104.34949494949495,108.33661616161615,111.2261295822677,110.8433503836317,0,0,0,0.0,0,0,0,0.0,0,0,0,0,212.68611111111113,222.0694799658994,217.37779553850527
2018-10-05,1610612763,1610612737,2018,120.0,110.0,230.0,99.7840909090909,105.22727272727272,103.07954545454544,108.1590909090909,0,0,0,0.0,0,0,0,0.0,0,0,0,0,205.01136363636363,211.23863636363637,208.125
2018-10-05,1610612750,1610612760,2018,101.0,113.0,214.0,109.14015151515152,107.81723484848484,106.9,104.09716312056736,0,0,0,0.0,0,0,0,0.0,0,0,0,0,216.95738636363637,210.9971631205674,213.97727474210188
2018-10-05,1610612759,1610612765,2018,117.0,93.0,210.0,102.62419056429232,100.17090656799259,103.67045454545456,103.72727272727272,0,0,0,0.0,0,0,0,0.0,0,0,0,0,202.79509713228492,207.39772727272725,205.0964122025061
2018-10-05,1610612756,1610612757,2018,93.0,115.0,208.0,103.97515856236788,113.25079281183932,105.97943262411349,103.62789598108749,0,0,0,0.0,0,0,0,0.0,0,0,0,0,217.22595137420717,209.60732860520096,213.41663998970407
2018-10-05,1610612744,1610612758,2018,122.0,94.0,216.0,112.85714285714286,106.28640109890112,98.708312716477,105.64943097476495,0,0,0,0.0,0,0,0,0.0,0,0,0,0,219.14354395604397,204.35774369124195,211.75064382364297
2018-10-04,1610612745,1610612754,2018,100.0,110.0,210.0,110.9864964853866,103.56622271550128,105.14583333333334,103.28030303030305,0,0,0,0.0,0,0,0,0.0,0,0,0,0,214.5527192008879,208.42613636363637,211.48942778226214
2018-10-04,1610612747,1610612758,2018,128.0,123.0,251.0,107.61607142857143,109.63988095238096,98.42593528816988,105.40798786653185,0,0,0,0.0,0,0,0,0.0,0,0,0,0,217.25595238095238,203.83392315470172,210.54493776782704
2018-10-03,1610612751,1610612752,2018,102.0,107.0,209.0,106.9209956709957,110.02543290043292,104.29545454545456,108.4318181818182,0,0,0,0.0,0,0,0,0.0,0,0,0,0,216.94642857142856,212.72727272727275,214.83685064935065
2018-10-03,1610612749,1610612741,2018,116.0,82.0,198.0,105.83256244218315,106.43501387604071,103.05757575757576,109.99646464646466,0,0,0,0.0,0,0,0,0.0,0,0,0,0,212.26757631822386,213.0540404040404,212.66080836113213
2018-10-03,1610612760,1610612765,2018,91.0,97.0,188.0,107.08478260869565,104.16376811594202,103.7233086680761,103.89217758985201,0,0,0,0.0,0,0,0,0.0,0,0,0,0,211.24855072463768,207.61548625792813,209.43201849128292
2018-10-03,1610612746,1610612750,2018,128.0,101.0,229.0,108.74603174603176,108.88333333333333,109.20309477756285,107.61266924564795,0,0,0,0.0,0,0,0,0.0,0,0,0,0,217.62936507936507,216.81576402321082,217.22256455128795
2018-10-02,1610612766,1610612748,2018,122.0,113.0,235.0,107.86212121212122,107.59419191919191,103.14221014492752,103.6725543478261,0,0,0,0.0,0,0,0,0.0,0,0,0,0,215.45631313131312,206.81476449275362,211.13553881203336
2018-10-02,1610612738,1610612739,2018,95.0,102.0,197.0,103.60874125874126,100.43566433566434,108.36060606060606,108.33333333333334,0,0,0,0.0,0,0,0,0.0,0,0,0,0,204.0444055944056,216.6939393939394,210.3691724941725
2018-10-02,1610612745,1610612763,2018,131.0,115.0,246.0,110.81523378582202,103.46644042232279,99.59619450317123,104.96009513742071,0,0,0,0.0,0,0,0,0.0,0,0,0,0,214.2816742081448,204.55628964059196,209.41898192436838
2018-10-02,1610612762,1610612761,2018,105.0,90.0,195.0,104.19821971341729,100.34107685627443,111.20408163265307,104.63265306122447,0,0,0,0.0,0,0,0,0.0,0,0,0,0,204.53929656969171,215.83673469387753,210.18801563178462
2018-10-02,1610612747,1610612743,2018,111.0,113.0,224.0,107.56155015197571,109.5676291793313,109.96739130434784,108.24585921325053,0,0,0,0.0,0,0,0,0.0,0,0,0,0,217.129179331307,218.21325051759834,217.67121492445267
2018-10-01,1610612755,1610612753,2018,120.0,114.0,234.0,109.58652210884355,105.44621598639456,103.10227272727272,107.4431818181818,0,0,0,0.0,0,0,0,0.0,0,0,0,0,215.0327380952381,210.54545454545456,212.78909632034635
2018-10-01,1610612764,1610612752,2018,121.0,124.0,245.0,106.69565217391305,106.11956521739133,104.04122621564484,108.31051797040169,0,0,0,0.0,0,0,0,0.0,0,0,0,0,212.81521739130437,212.35174418604652,212.58348078867544
2018-10-01,1610612737,1610612740,2018,116.0,102.0,218.0,102.94767441860463,108.23070824524315,111.29652173913044,110.78217391304348,0,0,0,0.0,0,0,0,0.0,0,0,0,0,211.1783826638478,222.0786956521739,216.62853915801085
2018-10-01,1610612756,1610612758,2018,102.0,106.0,208.0,103.98837209302326,113.33720930232559,98.31989664082687,105.44470284237728,0,0,0,0.0,0,0,0,0.0,0,0,0,0,217.32558139534882,203.76459948320414,210.54509043927646
2018-09-30,1610612759,1610612748,2018,104.0,100.0,204.0,102.6413043478261,100.15217391304348,103.15772432932471,103.6732192414431,0,0,0,0.0,0,0,0,0.0,0,0,0,0,202.79347826086956,206.8309435707678,204.8122109158187
2018-09-30,1610612738,1610612766,2018,115.0,112.0,227.0,103.52136752136751,100.3205128205128,107.79545454545456,107.51136363636364,0,0,0,0.0,0,0,0,0.0,0,0,0,0,203.84188034188034,215.3068181818182,209.57434926184925
2018-09-30,1610612741,1610612740,2018,128.0,116.0,244.0,102.7840909090909,109.9090909090909,111.22692990239572,110.59605146406388,0,0,0,0.0,0,0,0,0.0,0,0,0,0,212.6931818181818,221.8229813664596,217.2580815923207
2018-09-30,1610612747,1610612743,2018,107.0,124.0,231.0,107.54813664596271,109.37267080745342,109.8,108.29126984126984,0,0,0,0.0,0,0,0,0.0,0,0,0,0,216.92080745341616,218.09126984126982,217.506038647343
2018-09-29,1610612761,1610612757,2018,122.0,104.0,226.0,111.10926870748298,104.6220238095238,105.99492753623188,103.44033816425119,0,0,0,0.0,0,0,0,0.0,0,0,0,0,215.7312925170068,209.43526570048311,212.58327910874496
2018-09-29,1610612744,1610612750,2018,110.0,114.0,224.0,112.8840909090909,106.20052447552449,109.12747035573122,107.59486166007905,0,0,0,0.0,0,0,0,0.0,0,0,0,0,219.0846153846154,216.72233201581025,217.90347370021283
2018-09-28,1610612766,1610612738,2018,104.0,97.0,201.0,107.86046511627909,107.63319238900637,103.56699346405227,100.2941176470588,0,0,0,0.0,0,0,0,0.0,0,0,0,0,215.4936575052854,203.86111111111111,209.67738430819827
