GAME_DATE_EST,HOME_TEAM_ID,VISITOR_TEAM_ID,SEASON,PTS_home,PTS_away,point_total,point_average_last10,point_againts_average_last10,away_point_average_last10,away_point_againts_average_last10,cgp,wins,losses,winpercent,cgp_away,wins_away,losses_away,winpercen_away,hometeam-homewins,hometeam-awaywins,awayteam-homewins,awayteam-awaywins,avgpointtotal_home,avgpointtotal_away,meanpointtotal
2020-03-01,1610612766,1610612749,2019,85.0,93.0,178.0,98.55,108.05,122.2,107.5,59,21,38,0.35600000000000004,59,51,8,0.8640000000000001,9,12,27,24,205.64,222.4,214.01999999999998
2020-03-01,1610612750,1610612742,2019,91.0,111.0,202.0,116.1,123.15,115.45,112.9,58,17,41,0.293,60,36,24,0.6,7,10,16,20,224.64,223.64,224.14
2020-03-01,1610612746,1610612755,2019,136.0,130.0,266.0,116.65,109.3,107.55,107.9,59,40,19,0.6779999999999999,60,37,23,0.617,24,16,28,9,226.24,216.72,221.48000000000002
2020-03-01,1610612743,1610612761,2019,133.0,118.0,251.0,112.35,109.5,115.95,107.4,59,40,19,0.6779999999999999,59,42,17,0.7120000000000001,23,17,23,19,219.0,221.72,220.36
2020-03-01,1610612758,1610612765,2019,106.0,100.0,206.0,112.65,112.55,106.85,110.05,59,25,34,0.424,61,20,41,0.328,12,13,11,9,217.48,221.0,219.24
2020-03-01,1610612740,1610612747,2019,114.0,122.0,236.0,120.8,117.3,116.2,109.4,59,26,33,0.441,58,45,13,0.7759999999999999,12,14,21,24,227.04,224.28,225.66
2020-03-01,1610612744,1610612764,2019,110.0,124.0,234.0,108.0,118.3,116.3,120.55,60,13,47,0.217,58,21,37,0.362,7,6,14,7,220.32,220.76,220.54
2020-02-29,1610612752,1610612741,2019,125.0,115.0,240.0,105.4,110.2,108.5,113.5,59,17,42,0.28800000000000003,59,20,39,0.339,8,9,12,8,211.72,208.88,210.3
2020-02-29,1610612737,1610612757,2019,129.0,117.0,246.0,118.15,122.4,115.4,118.05,61,18,43,0.295,60,26,34,0.433,12,6,16,10,224.72,228.32,226.51999999999998
2020-02-29,1610612748,1610612751,2019,116.0,113.0,229.0,114.75,112.3,112.3,111.4,59,37,22,0.627,58,26,32,0.448,24,13,16,10,220.88,211.76,216.32
2020-02-29,1610612739,1610612754,2019,104.0,113.0,217.0,110.7,117.5,109.4,108.85,59,17,42,0.28800000000000003,59,35,24,0.593,9,8,21,14,221.12,209.56,215.34
2020-02-29,1610612763,1610612747,2019,105.0,88.0,193.0,113.4,112.75,118.05,109.65,59,28,31,0.475,57,45,12,0.789,16,12,21,24,217.48,224.28,220.88
2020-02-29,1610612738,1610612745,2019,110.0,111.0,221.0,116.7,109.25,117.65,114.7,58,41,17,0.7070000000000001,58,38,20,0.655,23,18,21,17,221.48,228.12,224.8
2020-02-29,1610612759,1610612753,2019,114.0,113.0,227.0,111.4,113.0,108.8,111.35,57,24,33,0.421,59,27,32,0.458,14,10,16,11,217.36,210.64,214.0
2020-02-29,1610612756,1610612744,2019,99.0,115.0,214.0,108.1,109.85,107.15,118.9,60,24,36,0.4,59,12,47,0.203,11,13,7,5,217.8,220.32,219.06
2020-02-28,1610612753,1610612750,2019,136.0,125.0,261.0,107.05,109.55,115.45,122.3,58,26,32,0.448,57,17,40,0.298,15,11,7,10,208.8,224.64,216.72
2020-02-28,1610612737,1610612751,2019,141.0,118.0,259.0,116.25,123.3,110.85,109.4,60,17,43,0.28300000000000003,57,26,31,0.456,11,6,16,10,222.44,211.76,217.1
2020-02-28,1610612761,1610612766,2019,96.0,99.0,195.0,118.15,108.0,98.2,108.25,58,42,16,0.7240000000000001,58,20,38,0.345,23,19,9,11,221.72,205.64,213.68
2020-02-28,1610612748,1610612742,2019,126.0,118.0,244.0,114.55,111.95,116.2,112.85,58,36,22,0.621,59,36,23,0.61,23,13,16,20,218.72,223.64,221.18
2020-02-28,1610612763,1610612758,2019,101.0,104.0,205.0,114.3,113.15,113.1,113.4,58,28,30,0.483,58,24,34,0.414,16,12,12,12,215.4,217.48,216.44
2020-02-28,1610612749,1610612760,2019,133.0,86.0,219.0,121.9,109.1,115.5,108.25,58,50,8,0.862,59,37,22,0.627,26,24,20,17,222.16,222.36,222.26
2020-02-28,1610612740,1610612739,2019,116.0,104.0,220.0,121.15,117.5,111.25,117.3,58,25,33,0.431,58,17,41,0.293,11,14,9,8,226.76,221.12,223.94
2020-02-28,1610612756,1610612765,2019,111.0,113.0,224.0,107.7,109.9,106.95,110.15,59,24,35,0.407,60,19,41,0.317,11,13,11,8,217.28,221.0,219.14
2020-02-28,1610612762,1610612764,2019,129.0,119.0,248.0,115.05,114.2,115.45,120.7,58,36,22,0.621,57,21,36,0.368,20,16,14,7,214.2,220.76,217.48
2020-02-28,1610612746,1610612743,2019,132.0,103.0,235.0,116.8,110.75,113.9,109.45,58,39,19,0.672,58,40,18,0.69,23,16,23,17,225.56,219.0,222.28
2020-02-27,1610612755,1610612752,2019,115.0,106.0,221.0,107.25,107.5,105.3,110.85,59,36,23,0.61,58,17,41,0.293,27,9,8,9,215.72,211.72,213.72
2020-02-27,1610612754,1610612757,2019,106.0,100.0,206.0,109.15,108.6,115.45,117.7,58,34,24,0.586,59,26,33,0.441,20,14,16,10,209.24,228.32,218.78
2020-02-27,1610612760,1610612758,2019,112.0,108.0,220.0,115.3,108.6,112.75,113.95,58,36,22,0.621,57,24,33,0.421,19,17,12,12,221.92,217.48,219.7
2020-02-27,1610612744,1610612747,2019,86.0,116.0,202.0,107.7,119.3,118.7,111.05,58,12,46,0.207,56,44,12,0.7859999999999999,7,5,21,23,220.2,224.28,222.24
2020-02-26,1610612766,1610612752,2019,107.0,101.0,208.0,97.95,108.4,104.6,111.35,57,19,38,0.333,57,17,40,0.298,8,11,8,9,206.04,211.72,208.88
2020-02-26,1610612739,1610612755,2019,108.0,94.0,202.0,110.15,117.9,107.1,107.55,57,16,41,0.281,58,36,22,0.621,8,8,27,9,219.68,215.72,217.7
2020-02-26,1610612764,1610612751,2019,110.0,106.0,216.0,115.75,121.75,111.1,110.05,56,20,36,0.35700000000000004,56,26,30,0.464,13,7,16,10,219.6,211.76,215.68
2020-02-26,1610612737,1610612753,2019,120.0,130.0,250.0,116.4,122.3,106.25,109.15,59,17,42,0.28800000000000003,57,25,32,0.439,11,6,15,10,220.32,208.8,214.56
2020-02-26,1610612748,1610612750,2019,126.0,129.0,255.0,112.45,109.3,114.9,121.15,57,36,21,0.632,56,16,40,0.28600000000000003,23,13,7,9,215.56,224.64,220.1
2020-02-26,1610612745,1610612763,2019,140.0,112.0,252.0,116.0,114.95,113.45,112.1,57,37,20,0.649,57,28,29,0.491,20,17,16,12,226.76,215.4,221.07999999999998
2020-02-26,1610612759,1610612742,2019,103.0,109.0,212.0,113.05,113.0,117.1,113.85,56,24,32,0.429,58,35,23,0.603,14,10,16,19,217.48,223.64,220.56
2020-02-26,1610612756,1610612746,2019,92.0,102.0,194.0,108.8,110.85,116.9,111.85,58,24,34,0.414,57,38,19,0.667,11,13,23,15,219.52,225.56,222.54000000000002
2020-02-26,1610612762,1610612738,2019,103.0,114.0,217.0,116.05,113.55,117.15,110.5,57,36,21,0.632,57,40,17,0.7020000000000001,20,16,23,17,212.64,221.48,217.06
2020-02-25,1610612754,1610612766,2019,119.0,80.0,199.0,108.6,110.7,98.55,107.9,57,33,24,0.579,56,19,37,0.339,19,14,8,11,208.16,206.04,207.1
2020-02-25,1610612761,1610612749,2019,97.0,108.0,205.0,118.5,107.85,121.85,109.15,57,42,15,0.737,57,49,8,0.86,23,19,26,23,220.76,222.16,221.45999999999998
2020-02-25,1610612741,1610612760,2019,122.0,124.0,246.0,107.65,113.1,115.15,107.8,58,20,38,0.345,57,35,22,0.614,12,8,19,16,207.2,221.92,214.56
2020-02-25,1610612743,1610612765,2019,115.0,98.0,213.0,113.3,110.1,107.0,109.7,57,39,18,0.684,59,19,40,0.322,22,17,11,8,219.88,221.0,220.44
2020-02-25,1610612747,1610612740,2019,118.0,109.0,227.0,118.1,110.55,121.85,117.15,55,43,12,0.782,57,25,32,0.439,20,23,11,14,224.16,226.76,225.45999999999998
2020-02-25,1610612757,1610612738,2019,106.0,118.0,224.0,115.9,117.4,116.15,110.65,58,26,32,0.448,56,39,17,0.696,16,10,23,16,229.08,221.48,225.28
2020-02-25,1610612744,1610612758,2019,94.0,112.0,206.0,107.9,119.05,112.85,114.4,57,12,45,0.211,56,23,33,0.411,7,5,12,11,221.24,217.48,219.36
2020-02-24,1610612739,1610612748,2019,125.0,119.0,244.0,109.55,117.7,112.55,109.25,56,15,41,0.268,56,36,20,0.643,7,8,23,13,218.0,215.56,216.78
2020-02-24,1610612755,1610612737,2019,129.0,112.0,241.0,106.65,107.6,115.85,121.4,57,35,22,0.614,58,17,41,0.293,26,9,11,6,213.28,220.32,216.8
2020-02-24,1610612764,1610612749,2019,134.0,137.0,271.0,114.6,119.95,120.2,108.75,55,20,35,0.364,56,48,8,0.857,13,7,26,22,216.64,222.16,219.39999999999998
2020-02-24,1610612751,1610612753,2019,113.0,115.0,228.0,110.85,108.6,105.2,108.4,55,26,29,0.473,56,24,32,0.429,16,10,15,9,210.04,208.8,209.42000000000002
2020-02-24,1610612745,1610612752,2019,123.0,112.0,235.0,116.8,114.8,105.6,111.95,56,36,20,0.643,56,17,39,0.304,19,17,8,9,226.36,211.72,219.04000000000002
2020-02-24,1610612742,1610612750,2019,139.0,123.0,262.0,115.45,113.05,113.95,119.5,57,34,23,0.596,55,16,39,0.29100000000000004,15,19,7,9,222.84,224.64,223.74
2020-02-24,1610612762,1610612756,2019,111.0,131.0,242.0,115.95,111.6,108.4,111.25,56,36,20,0.643,57,23,34,0.404,20,16,11,12,211.28,219.52,215.4
2020-02-24,1610612746,1610612763,2019,124.0,97.0,221.0,116.4,114.0,114.65,111.6,56,37,19,0.6609999999999999,56,28,28,0.5,22,15,16,12,225.04,215.4,220.22
2020-02-23,1610612747,1610612738,2019,114.0,112.0,226.0,118.55,110.6,115.25,109.9,54,42,12,0.778,55,39,16,0.7090000000000001,19,23,23,16,224.48,221.48,222.98
2020-02-23,1610612761,1610612754,2019,127.0,81.0,208.0,117.1,108.85,110.3,109.55,56,41,15,0.732,56,33,23,0.589,22,19,19,14,220.84,208.16,214.5
2020-02-23,1610612743,1610612750,2019,128.0,116.0,244.0,112.9,110.05,113.4,118.3,56,38,18,0.679,54,16,38,0.29600000000000004,21,17,7,9,218.4,224.64,221.51999999999998
2020-02-23,1610612741,1610612764,2019,126.0,117.0,243.0,106.55,112.8,114.8,119.4,57,19,38,0.333,54,20,34,0.37,11,8,13,7,205.16,216.64,210.89999999999998
2020-02-23,1610612760,1610612759,2019,131.0,103.0,234.0,114.65,109.15,113.9,112.35,56,34,22,0.607,55,24,31,0.436,18,16,14,10,221.08,217.48,219.28
2020-02-23,1610612744,1610612740,2019,101.0,115.0,216.0,108.05,118.85,121.95,117.85,56,12,44,0.214,56,24,32,0.429,7,5,11,13,219.44,226.76,223.1
2020-02-23,1610612757,1610612765,2019,107.0,104.0,211.0,115.6,118.3,107.35,109.55,57,25,32,0.439,58,19,39,0.328,15,10,11,8,230.12,221.0,225.56
2020-02-22,1610612746,1610612758,2019,103.0,112.0,215.0,117.55,114.0,113.0,115.25,55,37,18,0.6729999999999999,55,22,33,0.4,22,15,12,10,225.12,217.48,221.3
2020-02-22,1610612766,1610612751,2019,86.0,115.0,201.0,99.6,107.85,110.85,110.4,55,19,36,0.345,54,25,29,0.463,8,11,16,9,205.2,210.04,207.62
2020-02-22,1610612737,1610612742,2019,111.0,107.0,218.0,116.05,122.15,116.3,112.35,57,16,41,0.281,56,34,22,0.607,10,6,15,19,220.2,222.84,221.51999999999998
2020-02-22,1610612748,1610612739,2019,124.0,105.0,229.0,112.2,109.8,109.15,117.35,55,35,20,0.636,55,15,40,0.273,22,13,7,8,214.12,218.0,216.06
2020-02-22,1610612741,1610612756,2019,104.0,112.0,216.0,106.25,112.3,108.85,110.95,56,19,37,0.339,56,22,34,0.393,11,8,11,11,203.48,219.52,211.5
2020-02-22,1610612749,1610612755,2019,119.0,98.0,217.0,119.55,109.05,107.15,107.55,55,47,8,0.855,56,35,21,0.625,25,22,26,9,221.2,213.28,217.24
2020-02-22,1610612762,1610612745,2019,110.0,120.0,230.0,116.85,110.8,116.9,115.05,55,36,19,0.655,55,35,20,0.636,20,16,19,16,209.16,226.36,217.76
2020-02-21,1610612753,1610612742,2019,106.0,122.0,228.0,104.7,107.75,115.25,112.35,55,24,31,0.436,55,33,22,0.6,15,9,15,18,206.88,222.84,214.86
2020-02-21,1610612764,1610612739,2019,108.0,113.0,221.0,114.35,118.45,108.2,116.35,53,20,33,0.377,54,14,40,0.259,13,7,7,7,216.08,218.0,217.04000000000002
2020-02-21,1610612752,1610612754,2019,98.0,106.0,204.0,106.25,112.8,110.55,110.45,55,17,38,0.309,55,32,23,0.5820000000000001,8,9,19,13,211.12,208.16,209.64
2020-02-21,1610612761,1610612756,2019,118.0,101.0,219.0,117.05,108.65,109.3,111.2,55,40,15,0.727,55,22,33,0.4,21,19,11,11,220.4,219.52,219.96
2020-02-21,1610612750,1610612738,2019,117.0,127.0,244.0,112.75,117.8,114.45,109.25,53,16,37,0.302,54,38,16,0.7040000000000001,7,9,23,15,222.48,221.48,221.98
2020-02-21,1610612760,1610612743,2019,113.0,101.0,214.0,114.5,110.35,113.2,109.7,55,33,22,0.6,55,38,17,0.691,17,16,21,17,221.6,218.4,220.0
2020-02-21,1610612762,1610612759,2019,104.0,113.0,217.0,116.85,109.2,113.25,112.45,54,36,18,0.667,54,23,31,0.426,20,16,14,9,207.8,217.48,212.64
2020-02-21,1610612747,1610612763,2019,117.0,105.0,222.0,118.55,110.7,116.4,111.45,53,41,12,0.774,55,28,27,0.509,18,23,16,12,224.56,215.4,219.98000000000002
2020-02-21,1610612757,1610612740,2019,115.0,128.0,243.0,115.65,118.0,121.2,118.25,56,25,31,0.446,55,23,32,0.418,15,10,11,12,228.96,226.76,227.86
2020-02-20,1610612765,1610612749,2019,106.0,126.0,232.0,107.55,109.1,119.4,108.85,57,19,38,0.333,54,46,8,0.852,11,8,25,21,219.44,221.2,220.32
2020-02-20,1610612737,1610612748,2019,129.0,124.0,253.0,115.35,122.1,111.65,109.2,56,15,41,0.268,54,35,19,0.648,9,6,22,13,217.96,214.12,216.04000000000002
2020-02-20,1610612755,1610612751,2019,112.0,104.0,216.0,107.6,107.8,110.55,110.2,55,34,21,0.618,53,25,28,0.472,25,9,16,9,212.44,210.04,211.24
2020-02-20,1610612741,1610612766,2019,93.0,103.0,196.0,106.7,113.3,100.6,109.2,55,19,36,0.345,54,18,36,0.333,11,8,8,10,202.24,205.2,203.72
2020-02-20,1610612758,1610612763,2019,129.0,125.0,254.0,112.3,114.85,116.3,111.4,54,21,33,0.389,54,28,26,0.519,11,10,16,12,214.44,215.4,214.92000000000002
2020-02-20,1610612744,1610612745,2019,105.0,135.0,240.0,108.85,119.15,115.75,116.15,55,12,43,0.218,54,34,20,0.63,7,5,19,15,216.76,226.36,221.56
2020-02-13,1610612738,1610612746,2019,141.0,133.0,274.0,114.4,107.85,116.15,111.3,53,37,16,0.698,54,37,17,0.685,22,15,22,15,218.08,225.12,221.60000000000002
2020-02-13,1610612740,1610612760,2019,118.0,123.0,241.0,121.6,118.5,113.8,109.6,54,23,31,0.426,54,32,22,0.593,11,12,17,15,225.12,221.6,223.36
2020-02-12,1610612739,1610612737,2019,127.0,105.0,232.0,107.0,117.0,115.4,121.2,53,13,40,0.245,55,15,40,0.273,6,7,9,6,217.88,217.96,217.92000000000002
2020-02-12,1610612753,1610612765,2019,116.0,112.0,228.0,104.15,106.4,107.55,109.6,54,23,31,0.426,56,19,37,0.339,14,9,11,8,206.0,219.44,212.72
2020-02-12,1610612751,1610612761,2019,101.0,91.0,192.0,111.35,111.3,118.55,108.7,52,24,28,0.462,54,40,14,0.741,15,9,21,19,209.6,220.4,215.0
2020-02-12,1610612754,1610612749,2019,118.0,111.0,229.0,110.45,111.1,119.45,107.25,54,31,23,0.574,53,46,7,0.868,18,13,25,21,207.16,221.2,214.18
2020-02-12,1610612752,1610612764,2019,96.0,114.0,210.0,107.3,111.75,114.05,119.9,54,17,37,0.315,52,19,33,0.365,8,9,13,6,211.88,216.08,213.98000000000002
2020-02-12,1610612763,1610612757,2019,111.0,104.0,215.0,116.6,111.4,116.0,118.55,53,27,26,0.509,55,25,30,0.455,15,12,15,10,214.08,228.96,221.52
2020-02-12,1610612750,1610612766,2019,108.0,115.0,223.0,113.15,117.15,100.3,109.1,52,16,36,0.308,53,17,36,0.321,7,9,8,9,223.44,205.2,214.32
2020-02-12,1610612742,1610612758,2019,130.0,111.0,241.0,114.65,112.3,112.5,114.3,54,32,22,0.593,53,21,32,0.396,14,18,11,10,221.32,214.44,217.88
2020-02-12,1610612756,1610612744,2019,112.0,106.0,218.0,109.7,111.5,107.75,118.5,54,21,33,0.389,54,12,42,0.222,10,11,7,5,218.8,216.76,217.78
2020-02-12,1610612762,1610612748,2019,116.0,101.0,217.0,117.1,109.9,112.7,108.8,53,35,18,0.66,53,35,18,0.66,19,16,22,13,207.48,214.12,210.8
2020-02-12,1610612743,1610612747,2019,116.0,120.0,236.0,113.35,109.2,118.95,110.9,54,38,16,0.7040000000000001,52,40,12,0.769,21,17,18,22,218.04,224.56,221.3
2020-02-11,1610612755,1610612746,2019,110.0,103.0,213.0,108.35,108.05,116.55,111.1,54,33,21,0.611,53,37,16,0.698,24,9,22,15,212.44,225.12,218.78
2020-02-11,1610612764,1610612741,2019,126.0,114.0,240.0,114.15,119.9,106.4,113.15,51,18,33,0.353,54,19,35,0.35200000000000004,12,6,11,8,214.28,202.24,208.26
2020-02-11,1610612740,1610612757,2019,138.0,117.0,255.0,121.05,118.25,116.25,116.8,53,22,31,0.415,54,25,29,0.463,10,12,15,10,223.2,228.96,226.07999999999998
2020-02-11,1610612760,1610612759,2019,106.0,114.0,220.0,114.15,108.5,112.8,112.35,53,32,21,0.604,53,22,31,0.415,17,15,14,8,221.96,217.48,219.72
2020-02-11,1610612745,1610612738,2019,116.0,105.0,221.0,115.85,116.3,114.6,106.65,53,33,20,0.623,52,37,15,0.7120000000000001,18,15,22,15,226.24,218.08,222.16000000000003
2020-02-10,1610612765,1610612766,2019,76.0,87.0,163.0,108.7,110.65,101.15,111.15,55,19,36,0.345,52,16,36,0.308,11,8,8,8,221.56,205.2,213.38
2020-02-10,1610612754,1610612751,2019,105.0,106.0,211.0,110.95,110.65,111.3,111.95,53,31,22,0.585,51,23,28,0.451,18,13,15,8,206.16,209.6,207.88
2020-02-10,1610612753,1610612737,2019,135.0,126.0,261.0,102.05,105.15,114.15,119.1,53,22,31,0.415,54,15,39,0.278,13,9,9,6,204.84,217.96,211.4
2020-02-10,1610612761,1610612750,2019,137.0,126.0,263.0,116.55,107.3,112.05,115.95,53,39,14,0.736,51,16,35,0.314,20,19,7,9,219.44,223.44,221.44
2020-02-10,1610612749,1610612758,2019,123.0,111.0,234.0,118.85,106.7,112.2,114.1,52,45,7,0.865,52,21,31,0.404,24,21,11,10,219.96,214.44,217.2
2020-02-10,1610612742,1610612762,2019,119.0,123.0,242.0,114.7,112.3,116.4,108.75,53,32,21,0.604,52,34,18,0.654,14,18,19,15,220.12,207.48,213.8
2020-02-10,1610612743,1610612759,2019,127.0,120.0,247.0,112.0,108.8,112.85,112.7,53,37,16,0.698,52,22,30,0.423,20,17,14,8,216.56,217.48,217.01999999999998
2020-02-10,1610612744,1610612748,2019,101.0,113.0,214.0,107.95,117.65,111.3,109.0,53,12,41,0.226,52,34,18,0.654,7,5,22,12,215.92,214.12,215.01999999999998
2020-02-10,1610612747,1610612756,2019,125.0,100.0,225.0,118.1,110.65,110.05,111.1,51,39,12,0.765,53,21,32,0.396,17,22,10,11,225.0,218.8,221.9
2020-02-09,1610612760,1610612738,2019,111.0,112.0,223.0,113.9,107.95,114.9,106.2,52,32,20,0.615,51,36,15,0.706,17,15,22,14,221.0,218.08,219.54000000000002
2020-02-09,1610612737,1610612752,2019,140.0,135.0,275.0,112.95,117.9,106.15,110.75,53,14,39,0.264,53,17,36,0.321,8,6,8,9,214.88,211.88,213.38
2020-02-09,1610612755,1610612741,2019,118.0,111.0,229.0,107.35,108.35,106.35,113.15,53,32,21,0.604,53,19,34,0.358,23,9,11,8,211.12,202.24,206.68
2020-02-09,1610612764,1610612763,2019,99.0,106.0,205.0,114.35,120.7,116.8,112.4,50,18,32,0.36,52,26,26,0.5,12,6,15,11,213.36,214.08,213.72000000000003
2020-02-09,1610612745,1610612762,2019,113.0,114.0,227.0,116.7,115.8,115.8,108.0,52,33,19,0.635,51,33,18,0.647,18,15,19,14,226.56,207.48,217.01999999999998
2020-02-09,1610612739,1610612746,2019,92.0,133.0,225.0,107.7,116.4,115.5,112.4,52,13,39,0.25,52,36,16,0.6920000000000001,6,7,22,14,216.76,225.12,220.94
2020-02-09,1610612757,1610612748,2019,115.0,109.0,224.0,116.5,117.75,111.1,109.4,53,24,29,0.453,51,34,17,0.667,14,10,22,12,229.44,214.12,221.78
2020-02-08,1610612753,1610612749,2019,95.0,111.0,206.0,102.2,104.45,118.75,108.0,52,22,30,0.423,51,44,7,0.863,13,9,24,20,204.2,219.96,212.07999999999998
2020-02-08,1610612766,1610612742,2019,100.0,116.0,216.0,101.65,110.45,113.65,112.7,51,16,35,0.314,52,31,21,0.596,8,8,14,17,204.48,220.12,212.3
2020-02-08,1610612765,1610612752,2019,92.0,95.0,187.0,109.7,111.65,106.75,111.15,54,19,35,0.35200000000000004,52,16,36,0.308,11,8,8,8,221.6,211.88,216.74
2020-02-08,1610612754,1610612740,2019,117.0,124.0,241.0,111.1,110.2,120.45,117.4,52,31,21,0.596,52,21,31,0.404,18,13,10,11,204.28,223.2,213.74
2020-02-08,1610612761,1610612751,2019,119.0,118.0,237.0,115.7,107.3,110.8,111.05,52,38,14,0.731,50,23,27,0.46,19,19,15,8,217.8,209.6,213.7
2020-02-08,1610612750,1610612746,2019,142.0,115.0,257.0,109.9,114.4,116.45,110.75,50,15,35,0.3,51,36,15,0.706,6,9,22,14,221.4,225.12,223.26
2020-02-08,1610612744,1610612747,2019,120.0,125.0,245.0,107.75,116.6,117.05,110.2,52,12,40,0.231,50,38,12,0.76,7,5,17,21,213.68,225.0,219.34
2020-02-08,1610612756,1610612743,2019,108.0,117.0,225.0,110.2,110.9,112.3,109.15,52,21,31,0.404,52,36,16,0.6920000000000001,10,11,20,16,219.76,216.56,218.16
2020-02-08,1610612758,1610612759,2019,122.0,102.0,224.0,112.5,115.15,114.2,112.3,51,20,31,0.392,51,22,29,0.431,10,10,14,8,214.6,217.48,216.04
2020-02-07,1610612755,1610612763,2019,119.0,107.0,226.0,106.6,108.4,116.95,111.3,52,31,21,0.596,51,26,25,0.51,22,9,15,11,211.08,214.08,212.58
2020-02-07,1610612764,1610612742,2019,119.0,118.0,237.0,113.45,120.9,114.8,112.8,49,17,32,0.34700000000000003,51,31,20,0.608,11,6,14,17,210.84,220.12,215.48000000000002
2020-02-07,1610612738,1610612737,2019,112.0,107.0,219.0,115.0,107.3,111.65,118.1,50,35,15,0.7,52,14,38,0.269,21,14,8,6,217.2,214.88,216.04
2020-02-07,1610612754,1610612761,2019,106.0,115.0,221.0,111.75,109.7,113.75,106.2,51,31,20,0.608,51,37,14,0.725,18,13,19,18,203.4,217.8,210.60000000000002
2020-02-07,1610612760,1610612765,2019,108.0,101.0,209.0,113.35,108.4,108.7,111.45,51,31,20,0.608,53,19,34,0.358,16,15,11,8,221.28,221.6,221.44
2020-02-07,1610612756,1610612745,2019,127.0,91.0,218.0,110.1,113.3,117.35,115.25,51,20,31,0.392,51,33,18,0.647,9,11,18,15,219.84,226.56,223.2
2020-02-07,1610612758,1610612748,2019,105.0,97.0,202.0,111.6,115.55,111.65,109.35,50,19,31,0.38,50,34,16,0.68,9,10,22,12,213.92,214.12,214.01999999999998
2020-02-07,1610612762,1610612757,2019,117.0,114.0,231.0,115.4,107.4,115.45,117.75,50,32,18,0.64,52,24,28,0.462,18,14,14,10,207.12,229.44,218.28
2020-02-06,1610612752,1610612753,2019,105.0,103.0,208.0,107.25,112.05,103.15,104.25,51,15,36,0.294,51,22,29,0.431,7,8,13,9,212.28,204.2,208.24
2020-02-06,1610612741,1610612740,2019,119.0,125.0,244.0,106.2,110.95,119.3,116.15,52,19,33,0.365,51,20,31,0.392,11,8,10,10,199.12,223.2,211.16
2020-02-06,1610612749,1610612755,2019,112.0,101.0,213.0,119.0,107.4,106.4,108.55,50,43,7,0.86,51,31,20,0.608,23,20,22,9,220.28,211.08,215.68
2020-02-06,1610612757,1610612759,2019,125.0,117.0,242.0,113.9,117.0,114.25,112.4,51,23,28,0.451,50,22,28,0.44,13,10,14,8,227.72,217.48,222.6
2020-02-06,1610612747,1610612745,2019,111.0,121.0,232.0,116.8,109.7,116.95,114.9,49,38,11,0.7759999999999999,50,32,18,0.64,17,21,18,14,226.0,226.56,226.28
2020-02-05,1610612765,1610612756,2019,116.0,108.0,224.0,109.5,111.15,110.8,113.3,52,18,34,0.34600000000000003,50,20,30,0.4,10,8,9,11,220.6,219.84,220.22
2020-02-05,1610612738,1610612753,2019,116.0,100.0,216.0,114.65,107.6,103.15,104.0,49,34,15,0.6940000000000001,50,22,28,0.44,20,14,13,9,215.24,204.2,209.72
2020-02-05,1610612751,1610612744,2019,129.0,88.0,217.0,109.5,112.2,109.0,116.0,49,22,27,0.449,51,12,39,0.235,14,8,7,5,209.72,213.68,211.7
2020-02-05,1610612761,1610612754,2019,119.0,118.0,237.0,113.3,105.65,110.75,109.75,50,36,14,0.72,50,31,19,0.62,18,18,18,13,216.72,203.4,210.06
2020-02-05,1610612750,1610612737,2019,120.0,127.0,247.0,110.0,113.8,111.2,118.15,49,15,34,0.306,51,13,38,0.255,6,9,8,5,220.04,214.88,217.45999999999998
2020-02-05,1610612760,1610612739,2019,109.0,103.0,212.0,113.8,108.85,108.4,117.4,50,30,20,0.6,51,13,38,0.255,15,15,6,7,220.24,216.76,218.5
2020-02-05,1610612742,1610612763,2019,107.0,121.0,228.0,115.6,112.3,116.25,111.65,50,31,19,0.62,50,25,25,0.5,14,17,15,10,220.88,214.08,217.48000000000002
2020-02-05,1610612762,1610612743,2019,95.0,98.0,193.0,116.35,107.8,113.1,110.8,49,32,17,0.653,51,35,16,0.6859999999999999,18,14,20,15,207.2,216.56,211.88
2020-02-05,1610612746,1610612748,2019,128.0,111.0,239.0,115.4,111.2,111.65,108.85,50,35,15,0.7,49,34,15,0.6940000000000001,21,14,22,12,224.36,214.12,219.24
2020-02-04,1610612740,1610612749,2019,108.0,120.0,228.0,119.9,115.05,119.15,107.1,50,20,30,0.4,49,42,7,0.857,10,10,23,19,223.72,220.28,222.0
2020-02-04,1610612745,1610612766,2019,125.0,110.0,235.0,116.1,114.3,100.8,110.15,49,31,18,0.633,50,16,34,0.32,17,14,8,8,225.56,204.48,215.01999999999998
2020-02-04,1610612743,1610612757,2019,127.0,99.0,226.0,112.2,110.85,114.7,116.7,50,34,16,0.68,50,23,27,0.46,19,15,13,10,217.92,227.72,222.82
2020-02-04,1610612747,1610612759,2019,129.0,102.0,231.0,115.55,111.0,114.05,111.05,48,37,11,0.7709999999999999,49,22,27,0.449,16,21,14,8,226.68,217.48,222.07999999999998
2020-02-03,1610612766,1610612753,2019,100.0,112.0,212.0,101.5,109.9,102.7,104.9,49,16,33,0.327,49,21,28,0.429,8,8,13,8,204.12,204.2,204.16
2020-02-03,1610612739,1610612752,2019,134.0,139.0,273.0,107.0,115.9,105.0,109.45,50,13,37,0.26,50,14,36,0.28,6,7,7,7,213.68,212.28,212.98000000000002
2020-02-03,1610612754,1610612742,2019,103.0,112.0,215.0,110.85,109.25,115.35,112.65,49,31,18,0.633,49,30,19,0.612,18,13,14,16,202.6,220.88,211.74
2020-02-03,1610612764,1610612744,2019,117.0,125.0,242.0,113.75,119.9,108.35,116.25,48,17,31,0.354,50,11,39,0.22,11,6,7,4,209.56,213.68,211.62
2020-02-03,1610612737,1610612738,2019,115.0,123.0,238.0,109.75,117.6,113.95,107.0,50,13,37,0.26,48,33,15,0.688,8,5,20,13,212.76,215.24,214.0
2020-02-03,1610612751,1610612756,2019,119.0,97.0,216.0,108.65,113.4,111.55,112.85,48,21,27,0.43799999999999994,49,20,29,0.408,13,8,9,11,209.12,219.84,214.48000000000002
2020-02-03,1610612748,1610612755,2019,137.0,106.0,243.0,110.45,109.15,106.9,107.55,48,33,15,0.688,50,31,19,0.62,21,12,22,9,212.32,211.08,211.7
2020-02-03,1610612763,1610612765,2019,96.0,82.0,178.0,117.2,114.8,110.85,113.15,49,24,25,0.49,51,18,33,0.353,14,10,10,8,215.28,220.6,217.94
2020-02-03,1610612758,1610612750,2019,113.0,109.0,222.0,111.45,115.7,109.85,113.8,49,18,31,0.3670000000000001,48,15,33,0.313,8,10,6,9,213.24,220.04,216.64
2020-02-03,1610612746,1610612759,2019,108.0,105.0,213.0,115.85,112.05,116.05,111.4,49,34,15,0.6940000000000001,48,22,26,0.45799999999999996,20,14,14,8,224.0,217.48,220.74
2020-02-02,1610612765,1610612743,2019,128.0,123.0,251.0,109.9,113.25,112.25,110.25,50,17,33,0.34,49,34,15,0.6940000000000001,9,8,19,15,217.8,217.92,217.86
2020-02-02,1610612745,1610612740,2019,117.0,109.0,226.0,115.7,114.2,119.55,114.5,48,30,18,0.625,49,20,29,0.408,16,14,10,10,225.76,223.72,224.74
2020-02-02,1610612749,1610612756,2019,129.0,108.0,237.0,118.25,106.9,110.95,111.65,48,41,7,0.8540000000000001,48,20,28,0.41700000000000004,22,19,9,11,219.52,219.84,219.68
2020-02-02,1610612761,1610612741,2019,129.0,102.0,231.0,112.95,106.45,105.85,109.65,49,35,14,0.7140000000000001,51,19,32,0.373,17,18,11,8,215.8,199.12,207.46
2020-02-01,1610612746,1610612750,2019,118.0,106.0,224.0,115.95,111.7,109.55,113.35,48,33,15,0.688,47,15,32,0.319,19,14,6,9,223.64,220.04,221.83999999999997
2020-02-01,1610612754,1610612752,2019,85.0,92.0,177.0,111.95,108.9,106.1,111.65,48,31,17,0.6459999999999999,49,13,36,0.265,18,13,7,6,203.32,212.28,207.8
2020-02-01,1610612753,1610612748,2019,89.0,102.0,191.0,103.4,104.55,111.45,110.6,48,21,27,0.43799999999999994,47,32,15,0.6809999999999999,13,8,21,11,203.48,212.32,207.89999999999998
2020-02-01,1610612739,1610612744,2019,112.0,131.0,243.0,107.45,115.25,107.1,116.35,49,13,36,0.265,49,10,39,0.204,6,7,7,3,212.12,213.68,212.9
2020-02-01,1610612764,1610612751,2019,113.0,107.0,220.0,113.1,119.9,108.4,113.25,47,16,31,0.34,47,21,26,0.447,10,6,13,8,208.68,209.12,208.9
2020-02-01,1610612738,1610612755,2019,116.0,95.0,211.0,113.0,107.9,107.0,106.65,47,32,15,0.6809999999999999,49,31,18,0.633,19,13,22,9,215.12,211.08,213.10000000000002
2020-02-01,1610612742,1610612737,2019,123.0,100.0,223.0,114.3,112.55,110.35,117.55,48,29,19,0.604,49,13,36,0.265,13,16,8,5,220.4,212.76,216.57999999999998
2020-02-01,1610612759,1610612766,2019,114.0,90.0,204.0,115.8,113.6,101.9,109.2,47,21,26,0.447,48,16,32,0.33299999999999996,13,8,8,8,217.8,204.12,210.96
2020-02-01,1610612758,1610612747,2019,113.0,129.0,242.0,111.0,114.5,114.2,110.6,48,18,30,0.375,47,36,11,0.7659999999999999,8,10,16,20,212.84,226.68,219.76
2020-02-01,1610612757,1610612762,2019,124.0,107.0,231.0,114.15,116.65,117.0,106.95,49,22,27,0.449,48,32,16,0.667,12,10,18,14,226.24,207.2,216.72
2020-01-31,1610612765,1610612761,2019,92.0,105.0,197.0,110.65,113.95,113.35,106.7,49,17,32,0.34700000000000003,48,34,14,0.708,9,8,17,17,217.92,215.8,216.86
2020-01-31,1610612751,1610612741,2019,133.0,118.0,251.0,105.85,112.05,105.9,108.35,46,20,26,0.435,50,19,31,0.38,12,8,11,8,207.6,199.12,203.36
2020-01-31,1610612745,1610612742,2019,128.0,121.0,249.0,114.65,113.9,114.1,111.05,47,29,18,0.617,47,29,18,0.617,15,14,13,16,223.72,220.4,222.06
2020-01-31,1610612740,1610612763,2019,139.0,111.0,250.0,117.65,114.35,117.75,114.15,48,19,29,0.396,48,24,24,0.5,9,10,14,10,222.28,215.28,218.78
2020-01-31,1610612749,1610612743,2019,115.0,127.0,242.0,118.3,106.55,111.1,111.0,47,41,6,0.872,48,33,15,0.688,22,19,19,14,217.92,217.92,217.92
2020-01-31,1610612756,1610612760,2019,107.0,111.0,218.0,111.1,111.65,113.15,108.35,47,20,27,0.426,49,29,20,0.5920000000000001,9,11,15,14,219.56,220.24,219.9
2020-01-31,1610612747,1610612757,2019,119.0,127.0,246.0,115.35,110.5,113.35,116.2,46,36,10,0.7829999999999999,48,21,27,0.43799999999999994,16,20,12,9,225.24,226.24,225.74
2020-01-30,1610612739,1610612761,2019,109.0,115.0,224.0,107.7,114.85,113.35,107.25,48,13,35,0.271,47,33,14,0.7020000000000001,6,7,17,16,212.08,215.8,213.94
2020-01-30,1610612764,1610612766,2019,121.0,107.0,228.0,112.5,120.05,100.8,108.5,46,15,31,0.326,47,16,31,0.34,9,6,8,8,206.32,204.12,205.22
2020-01-30,1610612737,1610612755,2019,127.0,117.0,244.0,109.3,117.25,107.4,105.75,48,12,36,0.25,48,31,17,0.6459999999999999,7,5,22,9,210.88,211.08,210.98000000000002
2020-01-30,1610612738,1610612744,2019,119.0,104.0,223.0,113.5,108.55,106.9,115.3,46,31,15,0.674,48,10,38,0.20800000000000002,18,13,7,3,215.36,213.68,214.52
2020-01-30,1610612743,1610612762,2019,106.0,100.0,206.0,111.45,111.2,117.2,107.0,47,32,15,0.6809999999999999,47,32,15,0.6809999999999999,18,14,18,14,218.68,207.2,212.94
2020-01-30,1610612746,1610612758,2019,103.0,124.0,227.0,116.65,110.35,109.9,114.85,47,33,14,0.7020000000000001,47,17,30,0.36200000000000004,19,14,8,9,221.84,212.84,217.34
2020-01-29,1610612754,1610612741,2019,115.0,106.0,221.0,112.3,109.45,106.1,108.05,47,30,17,0.638,49,19,30,0.388,17,13,11,8,201.68,199.12,200.4
2020-01-29,1610612751,1610612765,2019,125.0,115.0,240.0,105.7,111.9,109.55,113.4,45,19,26,0.422,48,17,31,0.354,11,8,9,8,206.2,217.92,212.06
2020-01-29,1610612752,1610612763,2019,106.0,127.0,233.0,105.9,111.45,117.15,114.25,48,13,35,0.271,47,23,24,0.489,7,6,14,9,211.24,215.28,213.26
2020-01-29,1610612759,1610612762,2019,127.0,120.0,247.0,115.35,112.85,116.9,106.0,46,20,26,0.435,46,32,14,0.696,12,8,18,14,216.12,207.2,211.66
2020-01-29,1610612757,1610612745,2019,125.0,112.0,237.0,113.0,115.75,116.0,113.9,47,20,27,0.426,46,29,17,0.63,11,9,15,14,224.84,223.72,224.28
2020-01-29,1610612758,1610612760,2019,100.0,120.0,220.0,110.1,114.5,112.35,108.45,46,17,29,0.37,48,28,20,0.583,8,9,15,13,212.16,220.24,216.2
2020-01-28,1610612766,1610612752,2019,97.0,92.0,189.0,101.3,110.0,106.55,112.15,46,15,31,0.326,47,13,34,0.277,7,8,7,6,204.28,211.24,207.76
2020-01-28,1610612755,1610612744,2019,115.0,104.0,219.0,107.45,106.0,106.25,114.85,47,30,17,0.638,47,10,37,0.213,21,9,7,3,209.96,213.68,211.82
2020-01-28,1610612739,1610612740,2019,111.0,125.0,236.0,107.15,113.5,116.75,113.75,47,13,34,0.277,47,18,29,0.383,6,7,9,9,209.76,222.28,216.01999999999998
2020-01-28,1610612761,1610612737,2019,130.0,114.0,244.0,113.5,107.2,109.6,117.9,46,32,14,0.696,47,12,35,0.255,16,16,7,5,213.32,210.88,212.1
2020-01-28,1610612748,1610612738,2019,101.0,109.0,210.0,111.75,110.35,113.9,109.6,46,32,14,0.696,45,30,15,0.667,21,11,18,12,211.4,215.36,213.38
2020-01-28,1610612763,1610612743,2019,104.0,96.0,200.0,117.9,115.2,112.3,111.55,46,22,24,0.478,46,32,14,0.696,13,9,18,14,215.28,218.68,216.98000000000002
2020-01-28,1610612749,1610612764,2019,151.0,131.0,282.0,117.0,105.4,111.85,118.6,46,40,6,0.87,45,15,30,0.333,21,19,9,6,214.84,206.32,210.57999999999998
2020-01-28,1610612742,1610612756,2019,104.0,133.0,237.0,114.05,109.85,109.85,112.75,46,29,17,0.63,46,19,27,0.413,13,16,9,10,220.04,219.56,219.8
2020-01-27,1610612765,1610612739,2019,100.0,115.0,215.0,109.5,113.25,107.05,115.15,47,17,30,0.362,46,12,34,0.261,9,8,6,6,217.92,209.76,213.83999999999997
2020-01-27,1610612748,1610612753,2019,113.0,92.0,205.0,112.55,111.45,104.0,104.55,45,31,14,0.6890000000000001,47,21,26,0.447,20,11,13,8,210.68,203.48,207.07999999999998
2020-01-27,1610612741,1610612759,2019,110.0,109.0,219.0,106.05,107.9,115.25,112.8,48,18,30,0.375,45,20,25,0.444,10,8,12,8,197.24,216.12,206.68
2020-01-27,1610612750,1610612758,2019,129.0,133.0,262.0,107.5,111.4,108.45,112.0,46,15,31,0.326,45,16,29,0.35600000000000004,6,9,8,8,218.16,212.16,215.16
2020-01-27,1610612760,1610612742,2019,97.0,107.0,204.0,113.8,108.5,114.7,110.8,47,28,19,0.596,45,28,17,0.622,15,13,13,15,221.0,220.04,220.51999999999998
2020-01-27,1610612762,1610612745,2019,117.0,126.0,243.0,115.55,104.9,115.8,113.9,45,32,13,0.711,45,28,17,0.622,18,14,15,13,205.8,223.72,214.76
2020-01-26,1610612743,1610612745,2019,117.0,110.0,227.0,112.0,111.3,116.8,113.4,45,31,14,0.6890000000000001,44,28,16,0.636,17,14,15,13,220.0,223.72,221.86
2020-01-26,1610612759,1610612761,2019,106.0,110.0,216.0,115.4,113.15,113.6,106.85,44,20,24,0.455,45,31,14,0.6890000000000001,12,8,16,15,214.48,213.32,213.89999999999998
2020-01-26,1610612737,1610612764,2019,152.0,133.0,285.0,106.8,116.3,111.85,116.95,46,11,35,0.239,44,15,29,0.341,6,5,9,6,208.12,206.32,207.22
2020-01-26,1610612752,1610612751,2019,110.0,97.0,207.0,108.2,113.3,106.4,111.6,46,12,34,0.261,44,19,25,0.4320000000000001,6,6,11,8,211.24,206.2,208.72
2020-01-26,1610612753,1610612746,2019,97.0,112.0,209.0,104.5,105.45,116.35,110.95,46,21,25,0.457,46,32,14,0.696,13,8,19,13,205.12,221.84,213.48000000000002
2020-01-26,1610612763,1610612756,2019,114.0,109.0,223.0,118.1,115.3,109.35,113.05,45,21,24,0.467,45,19,26,0.422,12,9,9,10,214.6,219.56,217.07999999999998
2020-01-26,1610612740,1610612738,2019,123.0,108.0,231.0,116.55,114.85,113.9,109.1,46,17,29,0.37,44,30,14,0.682,8,9,18,12,220.16,215.36,217.76
2020-01-26,1610612757,1610612754,2019,139.0,129.0,268.0,112.15,114.9,111.45,108.15,46,19,27,0.413,46,30,16,0.652,10,9,17,13,222.24,201.68,211.96
2020-01-25,1610612762,1610612742,2019,112.0,107.0,219.0,116.25,105.15,115.45,110.75,44,31,13,0.705,44,28,16,0.636,17,14,13,15,206.04,220.04,213.04
2020-01-25,1610612765,1610612751,2019,111.0,121.0,232.0,109.9,113.85,106.85,111.95,46,17,29,0.37,43,18,25,0.419,9,8,11,7,217.52,206.2,211.86
2020-01-25,1610612739,1610612741,2019,106.0,118.0,224.0,107.25,115.05,105.45,108.05,45,12,33,0.267,47,17,30,0.362,6,6,10,7,208.48,197.24,202.86
2020-01-25,1610612750,1610612760,2019,104.0,113.0,217.0,107.25,111.1,113.25,108.8,45,15,30,0.333,46,27,19,0.5870000000000001,6,9,15,12,218.08,221.0,219.54000000000002
2020-01-25,1610612755,1610612747,2019,108.0,91.0,199.0,106.9,106.05,115.85,109.9,46,29,17,0.63,45,36,9,0.8,20,9,16,20,211.6,225.24,218.42000000000002
2020-01-24,1610612766,1610612749,2019,103.0,116.0,219.0,101.35,109.75,117.55,105.95,45,15,30,0.333,45,39,6,0.867,7,8,21,18,203.36,214.84,209.10000000000002
2020-01-24,1610612765,1610612763,2019,112.0,125.0,237.0,109.85,113.7,117.35,114.8,45,17,28,0.378,44,20,24,0.455,9,8,12,8,216.2,214.6,215.39999999999998
2020-01-24,1610612753,1610612738,2019,98.0,109.0,207.0,103.95,104.8,114.0,109.15,45,21,24,0.467,43,29,14,0.674,13,8,18,11,203.52,215.36,209.44
2020-01-24,1610612752,1610612761,2019,112.0,118.0,230.0,107.75,112.6,112.35,105.85,45,12,33,0.267,44,30,14,0.682,6,6,16,14,209.4,213.32,211.36
2020-01-24,1610612748,1610612746,2019,117.0,122.0,239.0,112.2,111.0,116.45,110.95,44,31,13,0.705,45,31,14,0.6890000000000001,20,11,19,12,208.48,221.84,215.16
2020-01-24,1610612741,1610612758,2019,81.0,98.0,179.0,105.05,107.3,109.5,113.85,46,17,29,0.37,44,15,29,0.341,10,7,8,7,197.36,212.16,204.76
2020-01-24,1610612750,1610612745,2019,124.0,131.0,255.0,106.9,110.75,116.05,112.7,44,15,29,0.341,43,27,16,0.628,6,9,15,12,216.84,223.72,220.28
2020-01-24,1610612740,1610612743,2019,106.0,113.0,219.0,116.4,114.45,112.75,111.2,45,17,28,0.378,44,30,14,0.682,8,9,17,13,220.12,220.0,220.06
2020-01-24,1610612760,1610612737,2019,140.0,111.0,251.0,112.55,109.35,106.35,116.1,45,26,19,0.578,45,11,34,0.244,14,12,6,5,219.36,208.12,213.74
2020-01-24,1610612759,1610612756,2019,99.0,103.0,202.0,115.7,113.2,109.65,113.85,43,20,23,0.465,44,18,26,0.409,12,8,9,9,214.92,219.56,217.24
2020-01-24,1610612744,1610612754,2019,118.0,129.0,247.0,106.0,113.6,109.45,108.1,46,10,36,0.217,45,29,16,0.644,7,3,17,12,212.8,201.68,207.24
2020-01-23,1610612739,1610612764,2019,112.0,124.0,236.0,106.0,113.5,111.2,117.75,44,12,32,0.273,43,14,29,0.326,6,6,9,5,206.2,206.32,206.26
2020-01-23,1610612751,1610612747,2019,113.0,128.0,241.0,106.65,110.0,115.1,109.75,42,18,24,0.429,44,35,9,0.795,11,7,16,19,205.04,225.24,215.14
2020-01-23,1610612757,1610612742,2019,125.0,133.0,258.0,111.65,112.6,114.7,109.35,45,19,26,0.422,43,27,16,0.628,10,9,13,14,220.68,220.04,220.36
2020-01-22,1610612765,1610612758,2019,127.0,106.0,233.0,108.9,113.45,109.7,112.8,44,16,28,0.364,43,15,28,0.349,8,8,8,7,214.16,212.16,213.16
2020-01-22,1610612753,1610612760,2019,114.0,120.0,234.0,104.65,104.5,111.2,108.35,44,21,23,0.477,44,25,19,0.568,13,8,14,11,201.56,219.36,210.46
2020-01-22,1610612761,1610612755,2019,107.0,95.0,202.0,112.5,106.2,106.6,106.15,43,29,14,0.674,45,29,16,0.644,15,14,20,9,214.72,211.6,213.16
2020-01-22,1610612737,1610612746,2019,102.0,95.0,197.0,106.25,116.85,117.3,110.45,44,10,34,0.227,44,31,13,0.705,5,5,19,12,209.48,221.84,215.66
2020-01-22,1610612738,1610612763,2019,119.0,95.0,214.0,114.0,109.05,118.2,115.15,42,28,14,0.667,43,20,23,0.465,17,11,12,8,213.8,214.6,214.2
2020-01-22,1610612748,1610612764,2019,134.0,129.0,263.0,112.25,110.6,110.1,116.75,43,30,13,0.698,42,14,28,0.333,19,11,9,5,204.96,206.32,205.64
2020-01-22,1610612752,1610612747,2019,92.0,100.0,192.0,107.75,114.05,114.9,109.5,44,12,32,0.273,43,34,9,0.7909999999999999,6,6,16,18,209.6,225.24,217.42000000000002
2020-01-22,1610612741,1610612750,2019,117.0,110.0,227.0,106.0,106.9,106.85,111.15,45,16,29,0.35600000000000004,43,15,28,0.349,9,7,6,9,195.52,216.84,206.18
2020-01-22,1610612745,1610612743,2019,121.0,105.0,226.0,115.9,113.4,112.1,110.0,42,26,16,0.619,43,30,13,0.698,14,12,17,13,223.04,220.0,221.51999999999998
2020-01-22,1610612756,1610612754,2019,87.0,112.0,199.0,111.25,114.3,109.35,108.75,43,18,25,0.419,44,28,16,0.636,9,9,17,11,220.68,201.68,211.18
2020-01-22,1610612740,1610612759,2019,117.0,121.0,238.0,117.15,115.35,115.7,113.3,44,17,27,0.386,42,19,23,0.452,8,9,12,7,219.24,214.92,217.07999999999998
2020-01-22,1610612744,1610612762,2019,96.0,129.0,225.0,106.5,112.25,115.35,105.65,45,10,35,0.222,43,30,13,0.698,7,3,17,13,211.48,206.04,208.76
2020-01-21,1610612742,1610612746,2019,107.0,110.0,217.0,115.25,109.95,117.3,110.05,42,27,15,0.643,43,30,13,0.698,13,14,19,11,221.16,221.84,221.5
2020-01-20,1610612764,1610612765,2019,106.0,100.0,206.0,110.75,118.5,109.65,113.5,41,13,28,0.317,43,16,27,0.3720000000000001,8,5,8,8,205.76,214.16,209.95999999999998
2020-01-20,1610612737,1610612761,2019,117.0,122.0,239.0,106.3,117.25,111.6,105.85,43,10,33,0.233,42,28,14,0.667,5,5,15,13,207.48,214.72,211.1
2020-01-20,1610612751,1610612755,2019,111.0,117.0,228.0,106.5,109.8,106.5,106.05,41,18,23,0.439,44,28,16,0.636,11,7,20,8,204.04,211.6,207.82
2020-01-20,1610612766,1610612753,2019,83.0,106.0,189.0,102.5,109.0,104.45,105.8,44,15,29,0.341,43,20,23,0.465,7,8,13,7,203.04,201.56,202.3
2020-01-20,1610612739,1610612752,2019,86.0,106.0,192.0,106.4,114.55,107.6,114.8,43,12,31,0.279,43,11,32,0.256,6,6,6,5,206.28,209.6,207.94
2020-01-20,1610612748,1610612758,2019,118.0,113.0,231.0,111.85,110.2,109.25,112.15,42,29,13,0.69,42,15,27,0.35700000000000004,18,11,8,7,203.44,212.16,207.8
2020-01-20,1610612745,1610612760,2019,107.0,112.0,219.0,116.3,113.25,110.8,107.5,41,26,15,0.634,43,24,19,0.5579999999999999,14,12,14,10,223.4,219.36,221.38
2020-01-20,1610612763,1610612740,2019,116.0,126.0,242.0,118.8,114.4,116.3,115.35,42,20,22,0.476,43,16,27,0.3720000000000001,12,8,8,8,213.36,219.24,216.3
2020-01-20,1610612749,1610612741,2019,111.0,98.0,209.0,118.35,106.65,106.35,106.85,44,38,6,0.8640000000000001,44,16,28,0.364,20,18,9,7,214.88,195.52,205.2
2020-01-20,1610612738,1610612747,2019,139.0,107.0,246.0,112.75,108.35,116.35,108.2,41,27,14,0.659,42,34,8,0.81,16,11,16,18,211.8,225.24,218.52
2020-01-20,1610612750,1610612743,2019,100.0,107.0,207.0,107.65,112.15,111.85,110.25,42,15,27,0.35700000000000004,42,29,13,0.69,6,9,17,12,216.36,220.0,218.18
2020-01-20,1610612756,1610612759,2019,118.0,120.0,238.0,110.75,114.05,115.05,111.7,42,18,24,0.429,41,18,23,0.439,9,9,12,6,218.8,214.92,216.86
2020-01-20,1610612762,1610612754,2019,118.0,88.0,206.0,114.25,107.3,110.15,108.0,42,29,13,0.69,43,28,15,0.6509999999999999,16,13,17,11,205.96,201.68,203.82
2020-01-20,1610612757,1610612744,2019,129.0,124.0,253.0,110.0,111.8,106.35,112.1,44,18,26,0.409,44,10,34,0.227,9,9,7,3,219.96,211.48,215.72
2020-01-19,1610612759,1610612748,2019,107.0,102.0,209.0,116.45,113.25,111.4,110.45,40,17,23,0.425,41,29,12,0.7070000000000001,11,6,18,11,215.2,203.44,209.32
2020-01-19,1610612743,1610612754,2019,107.0,115.0,222.0,112.0,109.6,109.45,108.05,41,29,12,0.7070000000000001,42,27,15,0.643,17,12,17,10,219.16,201.68,210.42000000000002
2020-01-18,1610612740,1610612746,2019,130.0,133.0,263.0,114.65,114.6,117.4,109.5,42,16,26,0.381,42,29,13,0.69,8,8,19,10,218.04,221.84,219.94
2020-01-18,1610612751,1610612749,2019,97.0,117.0,214.0,106.9,109.05,118.85,106.95,40,18,22,0.45,43,37,6,0.86,11,7,20,17,203.6,214.88,209.24
2020-01-18,1610612738,1610612756,2019,119.0,123.0,242.0,112.25,107.95,111.55,114.7,40,27,13,0.675,41,17,24,0.415,16,11,9,8,210.08,218.8,214.44
2020-01-18,1610612737,1610612765,2019,103.0,136.0,239.0,105.55,115.2,108.1,113.5,42,10,32,0.238,42,15,27,0.35700000000000004,5,5,8,7,205.88,214.16,210.01999999999998
2020-01-18,1610612752,1610612755,2019,87.0,90.0,177.0,108.0,114.9,107.65,107.65,42,11,31,0.262,43,27,16,0.628,6,5,20,7,210.64,211.6,211.12
2020-01-18,1610612741,1610612739,2019,118.0,116.0,234.0,105.05,105.7,106.0,114.9,43,15,28,0.349,42,12,30,0.28600000000000003,8,7,6,6,194.08,206.28,200.18
2020-01-18,1610612750,1610612761,2019,112.0,122.0,234.0,108.55,112.85,109.65,105.1,41,15,26,0.366,41,27,14,0.659,6,9,15,12,215.28,214.72,215.0
2020-01-18,1610612745,1610612747,2019,115.0,124.0,239.0,115.95,111.95,116.2,107.25,40,26,14,0.65,41,33,8,0.805,14,12,16,17,222.84,225.24,224.04000000000002
2020-01-18,1610612744,1610612753,2019,109.0,95.0,204.0,104.85,112.35,106.2,106.3,43,9,34,0.209,42,20,22,0.476,6,3,13,7,211.2,201.56,206.38
2020-01-18,1610612760,1610612757,2019,119.0,106.0,225.0,110.3,107.5,109.65,111.55,42,23,19,0.5479999999999999,43,18,25,0.419,13,10,9,9,218.36,219.96,219.16000000000003
2020-01-18,1610612762,1610612758,2019,123.0,101.0,224.0,113.3,108.2,110.0,112.35,41,28,13,0.6829999999999999,41,15,26,0.366,15,13,8,7,205.2,212.16,208.68
2020-01-17,1610612754,1610612750,2019,116.0,114.0,230.0,108.6,107.85,109.1,114.15,41,26,15,0.634,40,15,25,0.375,16,10,6,9,199.16,215.28,207.22
2020-01-17,1610612755,1610612741,2019,100.0,89.0,189.0,108.15,108.4,105.05,105.6,42,26,16,0.619,42,15,27,0.35700000000000004,19,7,8,7,213.48,194.08,203.78
2020-01-17,1610612761,1610612764,2019,140.0,111.0,251.0,107.25,105.15,110.35,117.1,40,26,14,0.65,40,13,27,0.325,14,12,8,5,214.04,205.76,209.89999999999998
2020-01-17,1610612763,1610612739,2019,113.0,109.0,222.0,118.85,115.3,106.4,114.7,41,19,22,0.463,41,12,29,0.293,11,8,6,6,212.4,206.28,209.34
2020-01-17,1610612760,1610612748,2019,108.0,115.0,223.0,111.85,108.1,111.7,110.55,41,23,18,0.561,40,28,12,0.7,13,10,18,10,217.92,203.44,210.68
2020-01-17,1610612759,1610612737,2019,120.0,121.0,241.0,115.65,111.55,105.55,115.95,39,17,22,0.436,41,9,32,0.22,11,6,5,4,213.72,205.88,209.8
2020-01-17,1610612742,1610612757,2019,120.0,112.0,232.0,114.55,109.85,108.9,111.4,41,26,15,0.634,42,18,24,0.429,12,14,9,9,219.2,219.96,219.57999999999998
2020-01-16,1610612752,1610612756,2019,98.0,121.0,219.0,108.1,113.3,111.2,116.2,41,11,30,0.268,40,16,24,0.4,6,5,9,7,209.96,218.8,214.38
2020-01-16,1610612749,1610612738,2019,128.0,123.0,251.0,117.95,105.85,110.95,106.8,42,36,6,0.857,39,27,12,0.6920000000000001,19,17,16,11,212.48,210.08,211.28
2020-01-16,1610612740,1610612762,2019,138.0,132.0,270.0,113.0,113.0,113.05,107.1,41,15,26,0.366,40,28,12,0.7,7,8,15,13,214.8,205.2,210.0
2020-01-16,1610612744,1610612743,2019,131.0,134.0,265.0,104.4,111.85,110.05,108.45,42,9,33,0.214,40,28,12,0.7,6,3,17,11,208.32,219.16,213.74
2020-01-16,1610612746,1610612753,2019,122.0,95.0,217.0,116.2,109.95,106.5,105.7,41,28,13,0.6829999999999999,41,20,21,0.488,18,10,13,7,221.52,201.56,211.54000000000002
2020-01-15,1610612738,1610612765,2019,103.0,116.0,219.0,111.3,105.4,108.65,113.05,38,27,11,0.711,41,14,27,0.341,16,11,8,6,210.08,214.16,212.12
2020-01-15,1610612755,1610612751,2019,117.0,106.0,223.0,109.35,107.8,106.3,108.0,41,25,16,0.61,39,18,21,0.462,18,7,11,7,212.52,203.6,208.06
2020-01-15,1610612748,1610612759,2019,106.0,100.0,206.0,112.0,110.7,116.2,110.85,39,27,12,0.6920000000000001,38,17,21,0.447,17,10,11,6,204.92,213.72,209.32
2020-01-15,1610612741,1610612764,2019,115.0,106.0,221.0,104.2,105.3,110.15,115.3,41,14,27,0.341,39,13,26,0.333,7,7,8,5,193.24,205.76,199.5
2020-01-15,1610612750,1610612754,2019,99.0,104.0,203.0,109.75,114.45,108.75,107.9,39,15,24,0.385,40,25,15,0.625,6,9,16,9,215.0,199.16,207.07999999999998
2020-01-15,1610612760,1610612761,2019,121.0,130.0,251.0,110.8,106.95,105.1,103.05,40,23,17,0.575,39,25,14,0.6409999999999999,13,10,14,11,214.88,214.04,214.45999999999998
2020-01-15,1610612743,1610612766,2019,100.0,86.0,186.0,110.75,109.1,102.35,107.65,39,27,12,0.6920000000000001,43,15,28,0.349,16,11,7,8,219.52,203.04,211.28
2020-01-15,1610612745,1610612757,2019,107.0,117.0,224.0,115.85,111.7,107.15,111.25,39,26,13,0.667,41,17,24,0.415,14,12,9,8,223.08,219.96,221.52
2020-01-15,1610612758,1610612742,2019,123.0,127.0,250.0,108.9,111.15,113.0,109.65,40,15,25,0.375,40,25,15,0.625,8,7,12,13,209.88,219.2,214.54
2020-01-15,1610612747,1610612753,2019,118.0,119.0,237.0,114.8,106.4,105.2,104.15,40,33,7,0.825,40,19,21,0.475,16,17,13,6,223.48,201.56,212.51999999999998
2020-01-14,1610612737,1610612756,2019,123.0,110.0,233.0,103.8,115.0,110.9,115.0,40,8,32,0.2,39,16,23,0.41,4,4,9,7,204.96,218.8,211.88
2020-01-14,1610612751,1610612762,2019,107.0,118.0,225.0,105.75,107.2,113.95,108.25,38,18,20,0.474,39,27,12,0.6920000000000001,11,7,15,12,202.52,205.2,203.86
2020-01-14,1610612763,1610612745,2019,121.0,110.0,231.0,117.0,115.0,116.3,111.1,40,18,22,0.45,38,26,12,0.684,10,8,14,12,210.8,223.08,216.94
2020-01-14,1610612749,1610612752,2019,128.0,102.0,230.0,117.5,105.3,109.2,113.0,41,35,6,0.8540000000000001,40,11,29,0.275,18,17,6,5,211.44,209.96,210.7
2020-01-14,1610612744,1610612742,2019,97.0,124.0,221.0,104.65,111.15,111.95,110.25,41,9,32,0.22,39,24,15,0.615,6,3,12,12,208.28,219.2,213.74
2020-01-14,1610612746,1610612739,2019,128.0,103.0,231.0,114.85,109.75,105.65,113.8,40,27,13,0.675,40,12,28,0.3,17,10,6,6,220.96,206.28,213.62
2020-01-13,1610612765,1610612740,2019,110.0,117.0,227.0,108.3,113.55,112.75,113.85,40,14,26,0.35,40,14,26,0.35,8,6,7,7,213.44,214.8,214.12
2020-01-13,1610612754,1610612755,2019,101.0,95.0,196.0,108.35,107.65,109.6,107.1,39,24,15,0.615,40,25,15,0.625,15,9,18,7,198.12,212.52,205.32
2020-01-13,1610612738,1610612741,2019,113.0,101.0,214.0,111.05,105.1,104.15,104.5,37,26,11,0.703,40,14,26,0.35,15,11,7,7,209.36,193.24,201.3
2020-01-13,1610612750,1610612760,2019,104.0,117.0,221.0,108.9,113.7,110.35,106.55,38,15,23,0.395,39,22,17,0.564,6,9,13,9,215.24,214.88,215.06
2020-01-13,1610612757,1610612766,2019,115.0,112.0,227.0,107.05,112.45,102.4,107.3,40,16,24,0.4,42,15,27,0.35700000000000004,8,8,7,8,219.88,203.04,211.45999999999998
2020-01-13,1610612758,1610612753,2019,112.0,114.0,226.0,108.0,110.1,105.85,104.55,39,15,24,0.385,39,18,21,0.462,8,7,13,5,209.24,201.56,205.4
2020-01-13,1610612747,1610612739,2019,128.0,99.0,227.0,113.15,107.05,105.4,114.45,39,32,7,0.821,39,12,27,0.308,15,17,6,6,224.08,206.28,215.18
2020-01-12,1610612752,1610612748,2019,124.0,121.0,245.0,107.45,111.45,110.3,109.7,39,10,29,0.256,38,27,11,0.711,5,5,17,10,208.68,204.92,206.8
2020-01-12,1610612764,1610612762,2019,116.0,127.0,243.0,110.3,114.6,112.3,107.5,38,13,25,0.342,38,26,12,0.684,8,5,15,11,203.84,205.2,204.51999999999998
2020-01-12,1610612751,1610612737,2019,108.0,86.0,194.0,105.55,107.4,105.6,114.95,37,17,20,0.459,39,8,31,0.205,10,7,4,4,202.48,204.96,203.72
2020-01-12,1610612761,1610612759,2019,104.0,105.0,209.0,105.35,103.75,116.55,111.0,38,25,13,0.6579999999999999,37,16,21,0.4320000000000001,14,11,11,5,213.08,213.72,213.4
2020-01-12,1610612763,1610612744,2019,122.0,102.0,224.0,115.35,114.5,104.7,110.7,39,17,22,0.436,40,9,31,0.225,9,8,6,3,209.08,208.28,208.68
2020-01-12,1610612743,1610612746,2019,114.0,104.0,218.0,109.85,109.15,114.2,110.0,38,26,12,0.684,39,27,12,0.6920000000000001,15,11,17,10,218.96,220.96,219.96
2020-01-12,1610612756,1610612766,2019,100.0,92.0,192.0,112.15,115.85,102.65,107.35,38,15,23,0.395,41,15,26,0.366,8,7,7,8,218.88,203.04,210.95999999999998
2020-01-11,1610612745,1610612750,2019,139.0,109.0,248.0,115.35,111.75,109.8,113.7,37,25,12,0.6759999999999999,37,15,22,0.405,13,12,6,9,221.08,215.24,218.16000000000003
2020-01-11,1610612738,1610612740,2019,140.0,105.0,245.0,109.65,104.5,111.7,113.35,36,25,11,0.6940000000000001,39,14,25,0.359,14,11,7,7,207.28,214.8,211.04000000000002
2020-01-11,1610612765,1610612741,2019,99.0,108.0,207.0,108.7,113.95,103.05,104.1,39,14,25,0.359,39,13,26,0.333,8,6,7,6,214.56,193.24,203.9
2020-01-11,1610612760,1610612747,2019,110.0,125.0,235.0,110.2,105.9,112.15,106.35,38,22,16,0.579,38,31,7,0.816,13,9,15,16,214.0,224.08,219.04000000000002
2020-01-11,1610612742,1610612755,2019,109.0,91.0,200.0,113.0,109.9,110.3,107.2,38,23,15,0.605,39,25,14,0.6409999999999999,11,12,18,7,219.16,212.52,215.84
2020-01-11,1610612743,1610612739,2019,103.0,111.0,214.0,110.3,109.4,105.65,115.25,37,26,11,0.703,38,11,27,0.289,15,11,6,5,219.16,206.28,212.72
2020-01-11,1610612757,1610612749,2019,101.0,122.0,223.0,108.35,112.15,116.4,105.75,39,16,23,0.41,40,34,6,0.85,8,8,18,16,218.16,211.44,214.8
2020-01-10,1610612764,1610612737,2019,111.0,101.0,212.0,110.75,115.9,104.55,114.0,37,12,25,0.324,38,8,30,0.211,7,5,4,4,202.68,204.96,203.82
2020-01-10,1610612752,1610612740,2019,111.0,123.0,234.0,107.4,109.35,110.75,113.35,38,10,28,0.263,38,13,25,0.342,5,5,7,6,208.16,214.8,211.48000000000002
2020-01-10,1610612751,1610612748,2019,117.0,113.0,230.0,104.55,105.9,109.55,108.65,36,16,20,0.444,37,27,10,0.73,9,7,17,10,201.16,204.92,203.04
2020-01-10,1610612741,1610612754,2019,105.0,116.0,221.0,103.1,103.25,107.15,108.25,38,13,25,0.342,38,23,15,0.605,7,6,15,8,191.72,198.12,194.92000000000002
2020-01-10,1610612763,1610612759,2019,134.0,121.0,255.0,113.55,113.2,115.1,109.55,38,16,22,0.421,36,16,20,0.444,8,8,11,5,207.12,213.72,210.42000000000002
2020-01-10,1610612756,1610612753,2019,98.0,94.0,192.0,111.8,116.0,105.9,105.05,37,14,23,0.378,38,18,20,0.474,7,7,13,5,219.2,201.56,210.38
2020-01-10,1610612762,1610612766,2019,109.0,92.0,201.0,111.8,108.45,102.45,106.85,37,25,12,0.6759999999999999,40,15,25,0.375,14,11,7,8,204.48,203.04,203.76
2020-01-10,1610612742,1610612747,2019,114.0,129.0,243.0,113.35,109.15,111.35,105.65,37,23,14,0.622,37,30,7,0.8109999999999999,11,12,15,15,217.48,224.08,220.78
2020-01-10,1610612758,1610612749,2019,106.0,127.0,233.0,107.65,108.95,114.6,105.65,38,15,23,0.395,39,33,6,0.846,8,7,18,15,206.68,211.44,209.06
2020-01-10,1610612746,1610612744,2019,109.0,100.0,209.0,114.35,110.9,104.6,112.15,38,26,12,0.684,39,9,30,0.231,16,10,6,3,221.28,208.28,214.78
2020-01-09,1610612765,1610612739,2019,112.0,115.0,227.0,108.85,113.75,104.8,115.5,38,14,24,0.368,37,10,27,0.27,8,6,6,4,213.72,206.28,210.0
2020-01-09,1610612755,1610612738,2019,109.0,98.0,207.0,110.5,107.7,110.3,104.8,38,24,14,0.632,35,25,10,0.7140000000000001,17,7,14,11,212.64,207.28,209.95999999999998
2020-01-09,1610612750,1610612757,2019,116.0,102.0,218.0,109.5,113.15,108.1,112.05,36,14,22,0.389,38,16,22,0.421,5,9,8,8,214.84,218.16,216.5
2020-01-09,1610612760,1610612745,2019,113.0,92.0,205.0,109.8,105.9,117.4,112.85,37,21,16,0.568,36,25,11,0.6940000000000001,12,9,13,12,213.6,221.08,217.34
2020-01-08,1610612738,1610612759,2019,114.0,129.0,243.0,109.7,104.25,113.5,109.15,34,25,9,0.735,35,15,20,0.429,14,11,11,4,205.08,213.72,209.4
2020-01-08,1610612766,1610612761,2019,110.0,112.0,222.0,101.85,106.7,104.65,103.35,39,15,24,0.385,37,24,13,0.649,7,8,14,10,201.24,213.08,207.16000000000003
2020-01-08,1610612754,1610612748,2019,108.0,122.0,230.0,105.9,106.5,108.2,108.75,37,23,14,0.622,36,26,10,0.722,15,8,17,9,196.48,204.92,200.7
2020-01-08,1610612753,1610612764,2019,123.0,89.0,212.0,104.05,105.65,110.4,114.05,37,17,20,0.459,36,12,24,0.333,12,5,7,5,201.28,202.68,201.98000000000002
2020-01-08,1610612737,1610612745,2019,115.0,122.0,237.0,103.7,112.15,116.2,112.05,37,8,29,0.21600000000000005,35,24,11,0.6859999999999999,4,4,13,11,203.68,221.08,212.38
2020-01-08,1610612742,1610612743,2019,106.0,107.0,213.0,113.7,109.35,111.4,108.7,36,23,13,0.639,36,25,11,0.6940000000000001,11,12,15,10,216.6,219.16,217.88
2020-01-08,1610612740,1610612741,2019,123.0,108.0,231.0,109.65,112.4,102.15,102.1,37,12,25,0.324,37,13,24,0.35100000000000003,6,6,7,6,213.12,191.72,202.42000000000002
2020-01-08,1610612762,1610612752,2019,128.0,104.0,232.0,109.55,108.0,106.55,108.7,36,24,12,0.667,37,10,27,0.27,13,11,5,5,202.12,208.16,205.14
2020-01-08,1610612744,1610612749,2019,98.0,107.0,205.0,104.7,111.75,113.75,105.85,38,9,29,0.237,38,32,6,0.8420000000000001,6,3,18,14,208.4,211.44,209.92000000000002
2020-01-07,1610612739,1610612765,2019,113.0,115.0,228.0,104.85,114.0,108.65,113.7,36,10,26,0.278,37,13,24,0.35100000000000003,6,4,8,5,205.48,213.72,209.6
2020-01-07,1610612761,1610612757,2019,99.0,101.0,200.0,105.2,104.35,107.65,112.9,36,24,12,0.667,37,15,22,0.405,14,10,8,7,212.6,218.16,215.38
2020-01-07,1610612751,1610612760,2019,103.0,111.0,214.0,103.35,104.7,108.7,106.6,35,16,19,0.457,36,20,16,0.556,9,7,12,8,199.64,213.6,206.62
2020-01-07,1610612763,1610612750,2019,119.0,112.0,231.0,112.9,112.85,109.6,113.25,37,15,22,0.405,35,14,21,0.4,7,8,5,9,205.44,214.84,210.14
2020-01-07,1610612756,1610612758,2019,103.0,114.0,217.0,112.75,116.05,107.0,109.65,36,14,22,0.389,37,14,23,0.378,7,7,8,6,219.76,206.68,213.22
2020-01-07,1610612747,1610612752,2019,117.0,87.0,204.0,112.0,108.55,107.65,107.75,36,29,7,0.8059999999999999,36,10,26,0.278,14,15,5,5,224.32,208.16,216.24
2020-01-06,1610612766,1610612754,2019,104.0,115.0,219.0,100.9,105.85,104.65,106.4,38,15,23,0.395,36,22,14,0.611,7,8,15,7,201.04,196.48,198.76
2020-01-06,1610612753,1610612751,2019,101.0,89.0,190.0,103.3,106.0,103.0,104.35,36,16,20,0.444,34,16,18,0.471,11,5,9,7,202.08,199.64,200.86
2020-01-06,1610612755,1610612760,2019,120.0,113.0,233.0,109.55,107.3,106.9,106.2,37,23,14,0.622,35,20,15,0.5710000000000001,16,7,12,8,212.2,213.6,212.89999999999998
2020-01-06,1610612764,1610612738,2019,99.0,94.0,193.0,109.45,114.0,109.6,105.2,35,11,24,0.314,33,25,8,0.758,6,5,14,11,202.76,205.08,203.92000000000002
2020-01-06,1610612737,1610612743,2019,115.0,123.0,238.0,102.6,110.75,110.5,108.8,36,8,28,0.222,35,24,11,0.6859999999999999,4,4,15,9,202.6,219.16,210.88
2020-01-06,1610612740,1610612762,2019,126.0,128.0,254.0,107.75,110.7,108.25,108.2,36,12,24,0.333,35,23,12,0.657,6,6,13,10,211.16,202.12,206.64
2020-01-06,1610612742,1610612741,2019,118.0,110.0,228.0,112.25,108.5,101.75,100.55,35,22,13,0.629,36,13,23,0.361,10,12,7,6,215.36,191.72,203.54000000000002
2020-01-06,1610612759,1610612749,2019,126.0,104.0,230.0,112.0,108.85,112.4,104.35,34,14,20,0.412,37,32,5,0.865,10,4,18,14,212.56,211.44,212.0
2020-01-06,1610612758,1610612744,2019,111.0,98.0,209.0,106.75,109.9,105.25,111.45,36,13,23,0.361,37,9,28,0.243,7,6,6,3,205.84,208.4,207.12
2020-01-05,1610612746,1610612752,2019,135.0,132.0,267.0,113.9,110.35,106.45,106.0,37,25,12,0.6759999999999999,35,10,25,0.28600000000000003,15,10,5,5,217.96,208.16,213.06
2020-01-05,1610612748,1610612757,2019,122.0,111.0,233.0,106.4,108.55,107.0,112.2,35,25,10,0.7140000000000001,36,15,21,0.417,16,9,8,7,202.52,218.16,210.34
2020-01-05,1610612739,1610612750,2019,103.0,118.0,221.0,104.65,113.65,109.7,114.6,35,10,25,0.28600000000000003,34,13,21,0.382,6,4,5,8,203.6,214.84,209.22
2020-01-05,1610612756,1610612763,2019,114.0,121.0,235.0,112.45,115.6,111.8,112.45,35,14,21,0.4,36,14,22,0.389,7,7,7,7,218.08,205.44,211.76
2020-01-05,1610612747,1610612765,2019,106.0,99.0,205.0,111.45,108.95,108.6,113.7,35,28,7,0.8,36,13,23,0.361,13,15,8,5,223.12,213.72,218.42000000000002
2020-01-04,1610612746,1610612763,2019,114.0,140.0,254.0,113.85,108.5,110.25,112.75,36,25,11,0.6940000000000001,35,13,22,0.371,15,10,7,6,215.56,205.44,210.5
2020-01-04,1610612751,1610612761,2019,102.0,121.0,223.0,103.0,103.2,103.75,104.0,33,16,17,0.485,35,23,12,0.657,9,7,14,9,198.48,212.6,205.54
2020-01-04,1610612753,1610612762,2019,96.0,109.0,205.0,104.25,106.1,107.6,109.2,35,16,19,0.457,34,22,12,0.647,11,5,13,9,202.48,202.12,202.3
2020-01-04,1610612737,1610612754,2019,116.0,111.0,227.0,101.7,109.45,103.45,105.55,35,7,28,0.2,35,22,13,0.629,3,4,15,7,199.72,196.48,198.1
2020-01-04,1610612739,1610612760,2019,106.0,121.0,227.0,105.45,112.6,106.1,107.0,34,10,24,0.294,34,19,15,0.5589999999999999,6,4,12,7,203.6,213.6,208.6
2020-01-04,1610612764,1610612743,2019,128.0,114.0,242.0,107.65,113.05,109.8,107.35,34,10,24,0.294,34,24,10,0.706,5,5,15,9,201.64,219.16,210.39999999999998
2020-01-04,1610612741,1610612738,2019,104.0,111.0,215.0,100.0,98.75,108.05,104.7,35,13,22,0.371,32,24,8,0.75,7,6,14,10,189.6,205.08,197.34
2020-01-04,1610612742,1610612766,2019,120.0,123.0,243.0,111.7,107.75,99.5,104.5,34,22,12,0.647,37,14,23,0.378,10,12,7,7,214.56,201.04,207.8
2020-01-04,1610612749,1610612759,2019,127.0,118.0,245.0,111.2,104.0,110.7,107.65,36,31,5,0.861,33,14,19,0.424,17,14,10,4,209.64,212.56,211.1
2020-01-04,1610612744,1610612765,2019,104.0,111.0,215.0,105.95,110.75,108.05,114.6,36,9,27,0.25,35,12,23,0.343,6,3,8,4,206.96,213.72,210.34
2020-01-04,1610612758,1610612740,2019,115.0,117.0,232.0,105.6,109.4,106.6,110.75,35,13,22,0.371,35,11,24,0.314,7,6,6,5,206.24,211.16,208.7
2020-01-03,1610612738,1610612737,2019,109.0,106.0,215.0,107.9,104.55,101.75,108.85,31,23,8,0.742,34,7,27,0.206,13,10,3,4,203.88,199.72,201.8
2020-01-03,1610612753,1610612748,2019,105.0,85.0,190.0,104.0,106.45,106.65,107.95,34,15,19,0.441,34,25,9,0.735,10,5,16,9,203.64,202.52,203.07999999999998
2020-01-03,1610612764,1610612757,2019,103.0,122.0,225.0,105.65,111.2,106.5,112.3,33,10,23,0.303,35,14,21,0.4,5,5,8,6,201.48,218.16,209.82
2020-01-03,1610612745,1610612755,2019,118.0,108.0,226.0,115.5,111.55,108.9,107.25,34,23,11,0.6759999999999999,36,23,13,0.639,12,11,16,7,219.52,212.2,215.86
2020-01-03,1610612756,1610612752,2019,120.0,112.0,232.0,112.05,114.4,105.4,105.1,34,13,21,0.382,34,10,24,0.294,6,7,5,5,216.8,208.16,212.48000000000002
2020-01-03,1610612747,1610612740,2019,123.0,113.0,236.0,110.9,109.5,105.65,109.6,34,27,7,0.794,34,11,23,0.324,12,15,6,5,220.8,211.16,215.98000000000002
2020-01-02,1610612739,1610612766,2019,106.0,109.0,215.0,104.85,111.95,99.2,104.5,33,10,23,0.303,36,13,23,0.361,6,4,7,6,202.56,201.04,201.8
2020-01-02,1610612754,1610612743,2019,116.0,124.0,240.0,103.0,104.15,109.85,108.05,34,22,12,0.647,33,23,10,0.6970000000000001,15,7,15,8,193.96,219.16,206.56
2020-01-02,1610612748,1610612761,2019,84.0,76.0,160.0,107.05,109.7,105.75,105.15,33,24,9,0.727,34,23,11,0.6759999999999999,15,9,14,9,203.16,212.6,207.88
2020-01-02,1610612741,1610612762,2019,98.0,102.0,200.0,100.05,98.7,107.25,109.4,34,13,21,0.382,33,21,12,0.636,7,6,13,8,189.56,202.12,195.84
2020-01-02,1610612750,1610612744,2019,99.0,84.0,183.0,109.85,114.8,107.55,111.4,33,12,21,0.364,35,9,26,0.257,4,8,6,3,214.88,206.96,210.92000000000002
2020-01-02,1610612742,1610612751,2019,123.0,111.0,234.0,110.6,107.1,101.75,102.4,33,21,12,0.636,32,16,16,0.5,9,12,9,7,212.56,198.48,205.51999999999998
2020-01-02,1610612759,1610612760,2019,103.0,109.0,212.0,111.05,106.95,105.85,106.75,32,14,18,0.43799999999999994,33,18,15,0.545,10,4,12,6,211.12,213.6,212.36
2020-01-02,1610612758,1610612763,2019,128.0,123.0,251.0,103.75,107.9,109.1,111.3,34,12,22,0.353,34,13,21,0.382,6,6,7,6,205.28,205.44,205.36
2020-01-02,1610612746,1610612765,2019,126.0,112.0,238.0,114.45,107.8,107.55,113.05,35,24,11,0.6859999999999999,34,12,22,0.353,14,10,8,4,214.68,213.72,214.2
2020-01-01,1610612764,1610612753,2019,101.0,122.0,223.0,105.5,109.55,102.3,106.25,32,10,22,0.313,33,14,19,0.424,5,5,10,4,200.04,203.64,201.83999999999997
2020-01-01,1610612752,1610612757,2019,117.0,93.0,210.0,104.55,105.75,107.95,112.45,33,9,24,0.273,34,14,20,0.41200000000000003,4,5,8,6,208.4,218.16,213.28
2020-01-01,1610612749,1610612750,2019,106.0,104.0,210.0,111.85,104.6,109.8,114.8,35,30,5,0.857,32,12,20,0.375,16,14,4,8,208.76,214.88,211.82
2020-01-01,1610612747,1610612756,2019,117.0,107.0,224.0,110.8,109.1,111.6,113.6,33,26,7,0.7879999999999999,33,13,20,0.39399999999999996,11,15,6,7,220.24,216.8,218.52
2019-12-31,1610612766,1610612738,2019,92.0,109.0,201.0,99.15,103.35,107.6,105.2,35,13,22,0.371,30,22,8,0.733,7,6,13,9,201.12,203.88,202.5
2019-12-31,1610612754,1610612755,2019,115.0,97.0,212.0,101.2,104.4,109.75,107.75,33,21,12,0.636,35,23,12,0.657,14,7,16,7,193.24,212.2,202.72
2019-12-31,1610612758,1610612746,2019,87.0,105.0,192.0,104.75,107.75,114.4,108.7,33,12,21,0.364,34,23,11,0.6759999999999999,6,6,14,9,205.76,214.68,210.22
2019-12-31,1610612761,1610612739,2019,117.0,97.0,214.0,105.05,105.5,105.95,111.0,33,22,11,0.667,32,10,22,0.313,13,9,6,4,211.48,202.56,207.01999999999998
2019-12-31,1610612745,1610612743,2019,130.0,104.0,234.0,114.55,111.55,109.25,106.55,33,22,11,0.667,32,23,9,0.7190000000000001,11,11,15,8,217.16,219.16,218.16
2019-12-31,1610612759,1610612744,2019,117.0,113.0,230.0,111.05,105.75,107.75,111.5,31,13,18,0.419,34,9,25,0.265,9,4,6,3,210.36,206.96,208.66000000000003
2019-12-31,1610612760,1610612742,2019,106.0,101.0,207.0,105.85,106.55,111.2,106.4,32,17,15,0.531,32,21,11,0.6559999999999999,11,6,9,12,214.64,212.56,213.6
2019-12-30,1610612753,1610612737,2019,93.0,101.0,194.0,102.55,107.15,100.95,109.25,32,14,18,0.438,33,6,27,0.182,10,4,3,3,204.72,199.72,202.22
2019-12-30,1610612764,1610612748,2019,123.0,105.0,228.0,104.2,109.3,106.15,107.7,31,9,22,0.29,32,24,8,0.75,4,5,15,9,198.76,203.16,200.95999999999998
2019-12-30,1610612741,1610612749,2019,102.0,123.0,225.0,99.6,97.65,111.25,105.3,33,13,20,0.394,34,29,5,0.853,7,6,16,13,188.0,208.76,198.38
2019-12-30,1610612750,1610612751,2019,122.0,115.0,237.0,108.9,114.75,101.2,101.45,31,11,20,0.355,31,16,15,0.516,3,8,9,7,212.0,198.48,205.24
2019-12-30,1610612762,1610612765,2019,104.0,81.0,185.0,107.05,110.15,108.7,113.65,32,20,12,0.625,33,12,21,0.364,12,8,8,4,202.12,213.72,207.92000000000002
2019-12-30,1610612757,1610612756,2019,116.0,122.0,238.0,107.3,110.95,110.7,113.4,33,14,19,0.424,32,12,20,0.375,8,6,6,6,217.16,216.8,216.98000000000002
2019-12-29,1610612761,1610612760,2019,97.0,98.0,195.0,105.95,106.25,105.9,106.75,32,22,10,0.688,31,16,15,0.516,13,9,11,5,211.76,214.64,213.2
2019-12-29,1610612763,1610612766,2019,117.0,104.0,221.0,109.1,110.85,98.65,101.9,33,12,21,0.364,34,13,21,0.382,6,6,7,6,203.8,201.12,202.46
2019-12-29,1610612740,1610612745,2019,127.0,112.0,239.0,104.15,109.1,114.95,111.35,33,10,23,0.303,32,22,10,0.688,5,5,11,11,209.48,217.16,213.32
2019-12-29,1610612743,1610612758,2019,120.0,115.0,235.0,108.3,105.5,103.95,106.75,31,22,9,0.71,32,12,20,0.375,14,8,6,6,218.16,205.76,211.95999999999998
2019-12-29,1610612747,1610612742,2019,108.0,95.0,203.0,111.75,109.15,110.7,105.5,32,25,7,0.7809999999999999,31,21,10,0.677,10,15,9,12,219.96,212.56,216.26
2019-12-28,1610612743,1610612763,2019,119.0,110.0,229.0,108.5,105.8,109.15,110.15,30,21,9,0.7,32,12,20,0.375,13,8,6,6,218.24,203.8,211.02
2019-12-28,1610612738,1610612761,2019,97.0,113.0,210.0,107.85,105.1,105.4,106.3,29,22,7,0.759,31,21,10,0.677,13,9,13,8,203.04,211.76,207.39999999999998
2019-12-28,1610612740,1610612754,2019,120.0,98.0,218.0,103.25,108.95,100.95,102.4,32,9,23,0.281,32,21,11,0.6559999999999999,4,5,14,7,207.44,193.24,200.34
2019-12-28,1610612748,1610612755,2019,117.0,116.0,233.0,106.15,106.5,109.5,107.0,31,23,8,0.742,34,23,11,0.6759999999999999,14,9,16,7,201.2,212.2,206.7
2019-12-28,1610612764,1610612752,2019,100.0,107.0,207.0,104.9,108.6,103.8,104.9,30,9,21,0.3,32,8,24,0.25,4,5,4,4,197.56,208.4,202.98000000000002
2019-12-28,1610612741,1610612737,2019,116.0,81.0,197.0,99.2,98.35,101.95,108.1,32,12,20,0.375,32,6,26,0.188,6,6,3,3,188.36,199.72,194.04000000000002
2019-12-28,1610612745,1610612751,2019,108.0,98.0,206.0,116.05,112.7,101.95,101.8,31,21,10,0.677,30,16,14,0.5329999999999999,10,11,9,7,217.6,198.48,208.04
2019-12-28,1610612750,1610612739,2019,88.0,94.0,182.0,111.65,115.4,106.1,112.0,30,11,19,0.3670000000000001,31,9,22,0.29,3,8,6,3,211.52,202.56,207.04000000000002
2019-12-28,1610612749,1610612753,2019,111.0,100.0,211.0,110.8,105.5,101.55,106.15,33,28,5,0.848,31,14,17,0.452,15,13,10,4,208.16,204.72,206.44
2019-12-28,1610612759,1610612765,2019,136.0,109.0,245.0,109.85,104.15,107.95,111.9,30,12,18,0.4,32,12,20,0.375,8,4,8,4,208.72,213.72,211.22
2019-12-28,1610612744,1610612742,2019,121.0,141.0,262.0,106.5,109.35,108.9,104.75,33,9,24,0.273,30,20,10,0.667,6,3,9,11,204.52,212.56,208.54000000000002
2019-12-28,1610612758,1610612756,2019,110.0,112.0,222.0,103.4,106.5,109.8,112.3,31,12,19,0.387,31,11,20,0.355,6,6,6,5,204.32,216.8,210.56
2019-12-28,1610612757,1610612747,2019,120.0,128.0,248.0,106.45,110.45,111.3,108.35,32,14,18,0.438,31,24,7,0.774,8,6,10,14,215.16,219.96,217.56
2019-12-28,1610612746,1610612762,2019,107.0,120.0,227.0,114.3,108.15,105.35,109.6,33,23,10,0.6970000000000001,31,19,12,0.613,14,9,12,7,215.16,202.12,208.64
2019-12-27,1610612738,1610612739,2019,129.0,117.0,246.0,106.5,104.6,105.1,110.35,28,21,7,0.75,30,9,21,0.3,12,9,6,3,199.76,202.56,201.16
2019-12-27,1610612766,1610612760,2019,102.0,104.0,206.0,99.1,101.95,106.6,107.25,33,13,20,0.394,30,15,15,0.5,7,6,11,4,201.04,214.64,207.83999999999997
2019-12-27,1610612753,1610612755,2019,98.0,97.0,195.0,101.3,106.2,109.4,107.25,30,13,17,0.433,33,23,10,0.6970000000000001,9,4,16,7,204.28,212.2,208.24
2019-12-27,1610612737,1610612749,2019,86.0,112.0,198.0,102.9,107.35,110.1,106.5,31,6,25,0.194,32,27,5,0.8440000000000001,3,3,15,12,198.76,208.16,203.45999999999998
2019-12-27,1610612748,1610612754,2019,113.0,112.0,225.0,105.6,105.4,100.1,101.35,30,22,8,0.733,31,21,10,0.677,13,9,14,7,199.28,193.24,196.26
2019-12-27,1610612744,1610612756,2019,105.0,96.0,201.0,107.75,110.55,110.45,111.7,32,8,24,0.25,30,11,19,0.3670000000000001,5,3,6,5,205.32,216.8,211.06
2019-12-26,1610612765,1610612764,2019,132.0,102.0,234.0,107.15,112.35,104.9,106.8,31,11,20,0.355,29,9,20,0.31,7,4,4,5,212.72,197.56,205.14
2019-12-26,1610612751,1610612752,2019,82.0,94.0,176.0,102.75,102.55,103.55,105.0,29,16,13,0.552,31,7,24,0.226,9,7,4,3,198.4,208.4,203.4
2019-12-26,1610612760,1610612763,2019,97.0,110.0,207.0,107.0,106.95,107.95,110.3,29,15,14,0.517,31,11,20,0.355,11,4,6,5,214.52,203.8,209.16000000000003
2019-12-26,1610612742,1610612759,2019,102.0,98.0,200.0,108.8,105.3,110.85,104.2,29,19,10,0.655,29,12,17,0.414,8,11,8,4,213.8,208.72,211.26
2019-12-26,1610612758,1610612750,2019,104.0,105.0,209.0,104.4,106.6,111.0,115.2,30,12,18,0.4,29,10,19,0.345,6,6,3,7,205.64,211.52,208.57999999999998
2019-12-26,1610612762,1610612757,2019,121.0,115.0,236.0,103.45,108.45,106.25,109.35,30,18,12,0.6,31,14,17,0.452,11,7,8,6,200.88,215.16,208.01999999999998
2019-12-25,1610612761,1610612738,2019,102.0,118.0,220.0,105.3,105.15,105.5,105.2,30,21,9,0.7,27,20,7,0.741,13,8,12,8,213.48,199.76,206.62
2019-12-25,1610612755,1610612749,2019,121.0,109.0,230.0,108.0,107.95,110.0,106.65,32,22,10,0.688,31,27,4,0.871,15,7,15,12,211.96,208.16,210.06
2019-12-25,1610612744,1610612745,2019,116.0,104.0,220.0,106.9,110.35,116.9,112.7,31,7,24,0.226,30,21,9,0.7,4,3,10,11,204.64,217.6,211.12
2019-12-25,1610612747,1610612746,2019,106.0,111.0,217.0,111.15,107.5,113.8,108.45,30,24,6,0.8,32,22,10,0.688,10,14,14,8,220.8,215.16,217.98000000000002
2019-12-25,1610612743,1610612740,2019,100.0,112.0,212.0,110.35,105.55,102.45,108.95,29,21,8,0.7240000000000001,31,8,23,0.258,13,8,4,4,217.36,207.44,212.4
2019-12-23,1610612739,1610612737,2019,121.0,118.0,239.0,103.55,108.25,102.55,106.45,29,8,21,0.276,30,6,24,0.2,5,3,3,3,200.56,198.76,199.66
2019-12-23,1610612765,1610612755,2019,109.0,125.0,234.0,105.6,111.6,106.65,108.5,30,11,19,0.3670000000000001,31,21,10,0.677,7,4,15,6,210.96,211.96,211.46
2019-12-23,1610612754,1610612761,2019,120.0,115.0,235.0,98.4,99.7,103.7,103.8,30,20,10,0.667,29,21,8,0.7240000000000001,13,7,13,8,191.24,213.48,202.36
2019-12-23,1610612752,1610612764,2019,115.0,121.0,236.0,102.4,103.25,102.6,104.5,30,7,23,0.233,28,8,20,0.28600000000000003,4,3,4,4,206.28,197.56,201.92000000000002
2019-12-23,1610612753,1610612741,2019,103.0,95.0,198.0,101.65,106.7,99.25,97.1,29,12,17,0.414,31,12,19,0.387,8,4,6,6,204.84,188.36,196.60000000000002
2019-12-23,1610612748,1610612762,2019,107.0,104.0,211.0,105.2,104.55,102.55,109.3,29,21,8,0.7240000000000001,29,18,11,0.621,12,9,11,7,199.52,200.88,200.2
2019-12-23,1610612763,1610612759,2019,115.0,145.0,260.0,107.55,108.15,109.15,104.1,30,11,19,0.3670000000000001,28,11,17,0.393,6,5,8,3,200.88,208.72,204.8
2019-12-23,1610612756,1610612743,2019,111.0,113.0,224.0,109.8,110.65,109.85,105.4,29,11,18,0.379,28,20,8,0.7140000000000001,6,5,13,7,215.68,217.36,216.52
2019-12-23,1610612757,1610612740,2019,94.0,102.0,196.0,106.5,109.15,102.7,111.1,30,14,16,0.467,30,7,23,0.233,8,6,4,3,215.48,207.44,211.45999999999998
2019-12-23,1610612758,1610612745,2019,104.0,113.0,217.0,103.15,105.9,116.25,112.75,29,12,17,0.414,29,20,9,0.69,6,6,10,10,205.6,217.6,211.6
2019-12-23,1610612744,1610612750,2019,113.0,104.0,217.0,107.75,110.25,111.9,115.6,30,6,24,0.2,28,10,18,0.35700000000000004,3,3,3,7,203.52,211.52,207.52
2019-12-22,1610612761,1610612742,2019,110.0,107.0,217.0,102.55,103.15,108.2,103.95,28,20,8,0.7140000000000001,28,19,9,0.679,12,8,8,11,212.6,213.8,213.2
2019-12-22,1610612738,1610612766,2019,119.0,93.0,212.0,104.05,105.5,99.25,100.7,26,19,7,0.731,32,13,19,0.406,11,8,7,6,198.64,201.04,199.83999999999997
2019-12-22,1610612749,1610612754,2019,117.0,89.0,206.0,109.05,107.3,98.2,97.0,30,26,4,0.867,29,20,9,0.69,14,12,13,7,207.88,191.24,199.56
2019-12-22,1610612760,1610612746,2019,118.0,112.0,230.0,106.7,106.4,114.3,107.8,28,14,14,0.5,31,22,9,0.71,10,4,14,8,214.0,215.16,214.57999999999998
2019-12-22,1610612747,1610612743,2019,104.0,128.0,232.0,111.3,106.95,108.25,106.05,29,24,5,0.828,27,19,8,0.7040000000000001,10,14,13,6,221.6,217.36,219.48000000000002
2019-12-21,1610612766,1610612762,2019,107.0,114.0,221.0,98.45,99.0,102.05,110.05,31,13,18,0.419,28,17,11,0.607,7,6,11,6,199.24,200.88,200.06
2019-12-21,1610612751,1610612737,2019,122.0,112.0,234.0,101.5,101.35,101.6,104.75,28,15,13,0.536,29,6,23,0.207,8,7,3,3,196.72,198.76,197.74
2019-12-21,1610612765,1610612741,2019,107.0,119.0,226.0,105.05,110.5,98.55,96.35,29,11,18,0.379,30,11,19,0.3670000000000001,7,4,6,5,210.08,188.36,199.22000000000003
2019-12-21,1610612755,1610612764,2019,125.0,108.0,233.0,106.55,108.0,102.25,103.2,30,20,10,0.667,27,8,19,0.29600000000000004,14,6,4,4,212.12,197.56,204.84
2019-12-21,1610612752,1610612749,2019,102.0,123.0,225.0,103.05,101.8,108.4,107.95,29,7,22,0.241,29,25,4,0.862,4,3,14,11,205.44,207.88,206.66
2019-12-21,1610612763,1610612758,2019,119.0,115.0,234.0,106.6,107.0,100.85,105.05,29,10,19,0.345,28,12,16,0.429,5,5,6,6,198.76,205.6,202.18
2019-12-21,1610612759,1610612746,2019,109.0,134.0,243.0,109.8,102.65,112.55,107.35,27,11,16,0.407,30,21,9,0.7,8,3,14,7,208.04,215.16,211.6
2019-12-21,1610612756,1610612745,2019,125.0,139.0,264.0,109.0,108.35,114.8,112.1,28,11,17,0.393,28,19,9,0.679,6,5,10,9,214.08,217.6,215.84
2019-12-21,1610612757,1610612750,2019,113.0,106.0,219.0,107.0,109.85,111.55,115.65,29,13,16,0.448,27,10,17,0.37,7,6,3,7,214.92,211.52,213.22
2019-12-20,1610612739,1610612763,2019,114.0,107.0,221.0,102.95,107.9,106.1,105.85,28,7,21,0.25,28,10,18,0.35700000000000004,4,3,5,5,198.56,198.76,198.66
2019-12-20,1610612754,1610612758,2019,119.0,105.0,224.0,97.05,96.85,100.7,103.95,28,19,9,0.679,27,12,15,0.444,12,7,6,6,190.16,205.6,197.88
2019-12-20,1610612738,1610612765,2019,114.0,93.0,207.0,103.4,105.65,105.3,110.95,25,18,7,0.72,28,11,17,0.393,10,8,7,4,198.8,210.08,204.44
2019-12-20,1610612761,1610612764,2019,122.0,118.0,240.0,101.95,102.25,101.45,101.75,27,19,8,0.7040000000000001,26,8,18,0.308,11,8,4,4,210.56,197.56,204.06
2019-12-20,1610612748,1610612752,2019,129.0,114.0,243.0,103.55,103.55,101.75,100.95,28,20,8,0.7140000000000001,28,7,21,0.25,11,9,4,3,198.52,205.44,201.98000000000002
2019-12-20,1610612755,1610612742,2019,98.0,117.0,215.0,106.25,106.8,107.0,103.6,29,20,9,0.69,27,18,9,0.667,14,6,8,10,211.28,213.8,212.54000000000002
2019-12-20,1610612760,1610612756,2019,126.0,108.0,234.0,105.65,107.1,108.55,107.8,27,13,14,0.481,27,11,16,0.407,9,4,6,5,213.24,214.08,213.66000000000003
2019-12-20,1610612743,1610612750,2019,109.0,100.0,209.0,107.4,105.75,111.15,115.65,26,18,8,0.6920000000000001,26,10,16,0.385,12,6,3,7,216.96,211.52,214.24
2019-12-20,1610612757,1610612753,2019,118.0,103.0,221.0,106.9,110.75,101.2,105.95,28,12,16,0.429,28,12,16,0.429,6,6,8,4,213.92,204.84,209.38
2019-12-20,1610612744,1610612740,2019,106.0,102.0,208.0,107.55,108.6,101.6,110.6,29,5,24,0.172,29,7,22,0.241,2,3,4,3,201.84,207.44,204.64
2019-12-19,1610612737,1610612762,2019,106.0,111.0,217.0,101.05,104.3,101.7,109.35,28,6,22,0.214,27,16,11,0.593,3,3,11,5,199.4,200.88,200.14
2019-12-19,1610612749,1610612747,2019,111.0,104.0,215.0,106.2,107.15,110.95,107.4,28,24,4,0.857,28,24,4,0.857,13,11,10,14,209.0,221.6,215.3
2019-12-19,1610612759,1610612751,2019,118.0,105.0,223.0,109.1,101.5,101.0,100.45,26,10,16,0.385,27,15,12,0.556,7,3,8,7,207.28,196.72,202.0
2019-12-19,1610612746,1610612745,2019,117.0,122.0,239.0,112.55,106.5,114.5,112.4,29,21,8,0.7240000000000001,27,18,9,0.667,14,7,10,8,213.64,217.6,215.62
2019-12-18,1610612739,1610612766,2019,100.0,98.0,198.0,103.5,108.9,99.7,98.65,27,6,21,0.222,30,13,17,0.433,3,3,7,6,198.04,199.24,198.64
2019-12-18,1610612765,1610612761,2019,99.0,112.0,211.0,105.55,110.95,101.25,101.95,27,11,16,0.407,26,18,8,0.6920000000000001,7,4,11,7,210.24,210.56,210.4
2019-12-18,1610612764,1610612741,2019,109.0,110.0,219.0,101.2,100.8,98.4,96.0,25,8,17,0.32,29,10,19,0.345,4,4,6,4,197.92,188.36,193.14
2019-12-18,1610612755,1610612748,2019,104.0,108.0,212.0,105.75,106.5,102.95,103.7,28,20,8,0.7140000000000001,27,19,8,0.7040000000000001,14,6,11,8,210.76,198.52,204.64
2019-12-18,1610612750,1610612740,2019,99.0,107.0,206.0,111.55,114.45,101.8,110.9,25,10,15,0.4,28,6,22,0.214,3,7,4,2,212.04,207.44,209.74
2019-12-18,1610612760,1610612763,2019,126.0,122.0,248.0,105.35,106.45,105.1,104.05,26,12,14,0.462,27,10,17,0.37,8,4,5,5,212.12,198.76,205.44
2019-12-18,1610612743,1610612753,2019,113.0,104.0,217.0,106.85,107.2,100.4,104.75,25,17,8,0.68,27,12,15,0.444,11,6,8,4,216.48,204.84,210.66
2019-12-18,1610612742,1610612738,2019,103.0,109.0,212.0,107.85,104.25,102.4,105.2,26,18,8,0.6920000000000001,24,17,7,0.708,8,10,10,7,213.72,198.8,206.26
2019-12-18,1610612757,1610612744,2019,122.0,112.0,234.0,106.3,110.35,107.55,107.25,27,11,16,0.407,28,5,23,0.179,5,6,2,3,213.36,201.84,207.60000000000002
2019-12-17,1610612766,1610612758,2019,110.0,102.0,212.0,99.2,98.25,100.6,103.6,29,12,17,0.414,26,12,14,0.462,6,6,6,6,198.2,205.6,201.89999999999998
2019-12-17,1610612754,1610612747,2019,105.0,102.0,207.0,96.4,95.75,110.95,107.5,27,18,9,0.667,27,24,3,0.889,11,7,10,14,190.52,221.6,206.06
2019-12-17,1610612752,1610612737,2019,143.0,120.0,263.0,100.75,100.45,100.4,101.55,27,6,21,0.222,27,6,21,0.222,3,3,3,3,202.68,199.4,201.04000000000002
2019-12-17,1610612740,1610612751,2019,101.0,108.0,209.0,101.65,110.3,100.3,99.75,27,6,21,0.222,26,14,12,0.5379999999999999,4,2,8,6,206.76,196.72,201.74
2019-12-17,1610612762,1610612753,2019,109.0,102.0,211.0,100.6,108.8,99.95,104.75,26,15,11,0.5770000000000001,26,12,14,0.462,10,5,8,4,200.64,204.84,202.74
2019-12-17,1610612746,1610612756,2019,120.0,99.0,219.0,112.4,106.6,108.55,106.45,28,20,8,0.7140000000000001,26,11,15,0.423,13,7,6,5,213.8,214.08,213.94
2019-12-16,1610612765,1610612764,2019,119.0,133.0,252.0,104.55,108.75,100.45,99.95,26,11,15,0.423,24,7,17,0.292,7,4,4,3,208.12,197.92,203.01999999999998
2019-12-16,1610612761,1610612739,2019,133.0,113.0,246.0,99.6,101.7,103.15,107.25,25,17,8,0.68,26,6,20,0.231,10,7,3,3,208.16,198.04,203.1
2019-12-16,1610612745,1610612759,2019,109.0,107.0,216.0,114.6,112.4,108.4,100.5,26,17,9,0.654,25,10,15,0.4,9,8,7,3,218.52,207.28,212.9
2019-12-16,1610612763,1610612748,2019,118.0,111.0,229.0,104.65,103.1,102.5,102.6,26,9,17,0.34600000000000003,26,19,7,0.731,4,5,11,8,196.68,198.52,197.60000000000002
2019-12-16,1610612749,1610612742,2019,116.0,120.0,236.0,105.8,106.4,107.2,103.2,27,24,3,0.889,25,17,8,0.68,13,11,8,9,207.56,213.72,210.64
2019-12-16,1610612760,1610612741,2019,109.0,106.0,215.0,104.85,106.15,97.05,95.1,25,11,14,0.44,28,10,18,0.35700000000000004,7,4,6,4,212.24,188.36,200.3
2019-12-16,1610612756,1610612757,2019,110.0,111.0,221.0,108.1,106.4,106.95,110.45,25,11,14,0.44,26,10,16,0.385,6,5,5,5,214.04,213.36,213.7
2019-12-15,1610612740,1610612753,2019,119.0,130.0,249.0,101.15,109.0,97.9,103.95,26,6,20,0.231,25,11,14,0.44,4,2,8,3,205.24,204.84,205.04000000000002
2019-12-15,1610612754,1610612766,2019,107.0,85.0,192.0,95.9,96.85,100.2,98.4,26,17,9,0.654,28,12,16,0.429,10,7,6,6,191.08,198.2,194.64
2019-12-15,1610612737,1610612747,2019,96.0,101.0,197.0,101.45,101.4,111.25,109.85,26,6,20,0.231,26,23,3,0.885,3,3,10,13,198.88,221.6,210.24
2019-12-15,1610612751,1610612755,2019,109.0,89.0,198.0,99.25,99.95,105.85,106.7,25,13,12,0.52,27,20,7,0.741,7,6,14,6,197.2,210.76,203.98
2019-12-15,1610612743,1610612752,2019,111.0,105.0,216.0,106.55,107.05,100.85,99.85,24,16,8,0.667,26,6,20,0.231,10,6,3,3,216.88,202.68,209.78
2019-12-15,1610612744,1610612758,2019,79.0,100.0,179.0,107.8,106.7,99.65,104.35,27,5,22,0.185,25,11,14,0.44,2,3,6,5,202.8,205.6,204.2
2019-12-14,1610612756,1610612759,2019,119.0,121.0,240.0,108.55,106.45,107.75,100.0,24,11,13,0.458,24,9,15,0.375,6,5,7,2,213.12,207.28,210.2
2019-12-14,1610612761,1610612751,2019,110.0,102.0,212.0,100.35,102.3,98.4,100.15,24,16,8,0.667,24,13,11,0.542,9,7,7,6,207.16,197.2,202.18
2019-12-14,1610612741,1610612746,2019,109.0,106.0,215.0,96.9,94.7,111.95,107.05,27,9,18,0.333,27,20,7,0.741,5,4,13,7,186.48,213.8,200.14
2019-12-14,1610612763,1610612764,2019,128.0,111.0,239.0,102.35,101.1,99.7,97.85,25,8,17,0.32,23,7,16,0.304,3,5,4,3,195.48,197.92,196.7
2019-12-14,1610612742,1610612748,2019,118.0,122.0,240.0,106.45,102.1,100.9,101.9,24,17,7,0.708,25,18,7,0.72,8,9,11,7,213.4,198.52,205.96
2019-12-14,1610612749,1610612739,2019,125.0,108.0,233.0,104.15,106.05,101.75,106.1,26,23,3,0.885,25,6,19,0.24,12,11,3,3,206.2,198.04,202.12
2019-12-14,1610612745,1610612765,2019,107.0,115.0,222.0,114.6,112.55,104.5,108.1,25,17,8,0.68,25,10,15,0.4,9,8,7,3,218.36,208.12,213.24
2019-12-14,1610612743,1610612760,2019,110.0,102.0,212.0,106.95,107.4,104.95,104.85,23,15,8,0.652,24,11,13,0.458,9,6,7,4,216.96,212.24,214.60000000000002
2019-12-13,1610612753,1610612745,2019,107.0,130.0,237.0,97.3,101.7,115.35,113.7,24,11,13,0.458,24,16,8,0.667,8,3,9,7,205.48,218.36,211.92000000000002
2019-12-13,1610612755,1610612740,2019,116.0,109.0,225.0,103.9,106.4,102.3,109.45,26,19,7,0.731,25,6,19,0.24,13,6,4,2,209.24,205.24,207.24
2019-12-13,1610612748,1610612747,2019,110.0,113.0,223.0,100.1,100.35,110.85,109.75,24,18,6,0.75,25,22,3,0.88,11,7,10,12,197.24,221.6,209.42000000000002
2019-12-13,1610612737,1610612754,2019,100.0,110.0,210.0,101.05,101.15,95.15,96.25,25,6,19,0.24,25,16,9,0.64,3,3,10,6,199.88,191.08,195.48000000000002
2019-12-13,1610612741,1610612766,2019,73.0,83.0,156.0,98.35,95.05,101.0,99.95,26,9,17,0.34600000000000003,27,11,16,0.407,5,4,6,5,187.64,198.2,192.92
2019-12-13,1610612763,1610612749,2019,114.0,127.0,241.0,101.45,99.05,103.55,106.35,24,8,16,0.333,25,22,3,0.88,3,5,12,10,193.96,206.2,200.07999999999998
2019-12-13,1610612762,1610612744,2019,114.0,106.0,220.0,99.6,109.2,107.0,106.55,25,14,11,0.56,26,5,21,0.192,9,5,2,3,200.2,202.8,201.5
2019-12-13,1610612750,1610612746,2019,117.0,124.0,241.0,111.7,114.6,110.65,106.0,24,10,14,0.417,26,19,7,0.731,3,7,13,6,210.84,213.8,212.32
2019-12-13,1610612758,1610612752,2019,101.0,103.0,204.0,100.45,104.75,100.5,101.15,24,11,13,0.458,25,5,20,0.2,6,5,3,2,206.12,202.68,204.4
2019-12-12,1610612738,1610612755,2019,109.0,115.0,224.0,100.95,103.8,102.2,105.5,23,17,6,0.7390000000000001,25,18,7,0.72,10,7,13,5,196.68,209.24,202.96
2019-12-12,1610612759,1610612739,2019,109.0,117.0,226.0,108.0,99.0,101.05,105.35,23,9,14,0.391,24,5,19,0.208,7,2,3,2,205.96,198.04,202.0
2019-12-12,1610612765,1610612742,2019,111.0,122.0,233.0,103.65,107.25,106.0,101.9,24,10,14,0.417,23,16,7,0.696,7,3,8,8,207.52,213.4,210.46
2019-12-12,1610612743,1610612757,2019,114.0,99.0,213.0,106.75,107.45,106.55,108.45,22,14,8,0.636,25,10,15,0.4,8,6,5,5,216.0,213.36,214.68
2019-12-11,1610612739,1610612745,2019,110.0,116.0,226.0,100.3,104.65,114.7,113.55,23,5,18,0.217,23,15,8,0.652,3,2,9,6,196.96,218.36,207.66000000000003
2019-12-11,1610612754,1610612738,2019,122.0,117.0,239.0,94.1,94.65,101.1,103.75,24,15,9,0.625,22,17,5,0.773,9,6,10,7,187.68,196.68,192.18
2019-12-11,1610612753,1610612747,2019,87.0,96.0,183.0,98.0,102.15,110.3,111.35,23,11,12,0.478,24,21,3,0.875,8,3,10,11,206.32,221.6,213.95999999999998
2019-12-11,1610612761,1610612746,2019,92.0,112.0,204.0,100.85,101.4,110.25,106.9,23,16,7,0.696,25,18,7,0.72,9,7,13,5,207.36,213.8,210.58
2019-12-11,1610612751,1610612766,2019,108.0,113.0,221.0,98.8,99.7,100.4,99.15,23,13,10,0.565,26,10,16,0.385,7,6,6,4,196.96,198.2,197.57999999999998
2019-12-11,1610612741,1610612737,2019,136.0,102.0,238.0,96.25,93.95,100.8,99.4,25,8,17,0.32,24,6,18,0.25,4,4,3,3,185.36,199.88,192.62
2019-12-11,1610612750,1610612762,2019,116.0,127.0,243.0,111.1,113.35,97.3,108.8,23,10,13,0.435,24,13,11,0.542,3,7,9,4,209.4,200.2,204.8
2019-12-11,1610612756,1610612763,2019,108.0,115.0,223.0,107.95,105.9,100.3,99.25,23,11,12,0.478,23,7,16,0.304,6,5,3,4,213.6,193.96,203.78
2019-12-11,1610612749,1610612740,2019,127.0,112.0,239.0,102.45,105.65,101.15,107.9,24,21,3,0.875,24,6,18,0.25,11,10,4,2,204.84,205.24,205.04000000000002
2019-12-11,1610612758,1610612760,2019,94.0,93.0,187.0,100.55,104.55,104.9,104.6,23,10,13,0.435,23,11,12,0.478,5,5,7,4,207.08,212.24,209.66000000000003
2019-12-11,1610612744,1610612752,2019,122.0,124.0,246.0,105.9,105.0,98.95,99.65,25,5,20,0.2,24,4,20,0.16699999999999998,2,3,3,1,199.88,202.68,201.28
2019-12-10,1610612766,1610612764,2019,114.0,107.0,221.0,100.5,99.35,98.85,96.6,25,9,16,0.36,22,7,15,0.318,5,4,4,3,197.16,197.92,197.54
2019-12-10,1610612755,1610612743,2019,97.0,92.0,189.0,102.05,105.95,107.45,108.7,24,17,7,0.708,21,14,7,0.667,12,5,8,6,209.16,216.0,212.57999999999998
2019-12-10,1610612748,1610612737,2019,135.0,121.0,256.0,98.7,98.6,98.9,98.0,23,17,6,0.7390000000000001,23,6,17,0.261,10,7,3,3,194.56,199.88,197.22
2019-12-10,1610612757,1610612752,2019,115.0,87.0,202.0,106.75,109.95,100.4,98.5,24,9,15,0.375,23,4,19,0.174,4,5,3,1,213.0,202.68,207.84
2019-12-09,1610612754,1610612746,2019,99.0,110.0,209.0,93.8,94.2,110.35,107.35,23,15,8,0.652,24,17,7,0.708,9,6,13,4,187.28,213.8,200.54000000000002
2019-12-09,1610612738,1610612739,2019,110.0,88.0,198.0,100.2,105.15,101.4,104.2,21,16,5,0.762,22,5,17,0.227,9,7,3,2,196.6,196.96,196.78
2019-12-09,1610612741,1610612761,2019,92.0,93.0,185.0,95.35,93.85,101.15,101.3,24,8,16,0.333,22,15,7,0.682,4,4,9,6,186.24,207.36,196.8
2019-12-09,1610612745,1610612758,2019,118.0,119.0,237.0,114.8,112.5,99.7,103.85,22,15,7,0.682,22,9,13,0.409,9,6,5,4,216.72,207.08,211.9
2019-12-09,1610612749,1610612753,2019,110.0,101.0,211.0,102.3,106.3,97.85,101.9,23,20,3,0.87,22,11,11,0.5,10,10,8,3,202.76,206.32,204.54
2019-12-09,1610612740,1610612765,2019,103.0,105.0,208.0,101.25,107.4,103.55,107.7,23,6,17,0.261,23,9,14,0.391,4,2,7,2,204.28,207.52,205.9
2019-12-09,1610612756,1610612750,2019,125.0,109.0,234.0,108.15,106.45,110.95,113.55,22,10,12,0.455,22,10,12,0.455,5,5,3,7,212.88,209.4,211.14
2019-12-09,1610612762,1610612760,2019,90.0,104.0,194.0,97.25,108.0,104.45,105.0,23,13,10,0.565,22,10,12,0.455,9,4,7,3,201.28,212.24,206.76
2019-12-09,1610612744,1610612763,2019,102.0,110.0,212.0,105.3,104.45,99.2,99.25,24,5,19,0.208,22,6,16,0.273,2,3,3,3,199.04,193.96,196.5
2019-12-08,1610612751,1610612743,2019,105.0,102.0,207.0,98.8,99.4,106.95,108.3,22,12,10,0.545,20,14,6,0.7,6,6,8,6,196.96,216.0,206.48000000000002
2019-12-08,1610612766,1610612737,2019,107.0,122.0,229.0,99.6,98.25,97.1,97.45,24,9,15,0.375,22,5,17,0.227,5,4,3,2,196.0,199.88,197.94
2019-12-08,1610612748,1610612741,2019,110.0,105.0,215.0,98.25,98.2,95.2,93.05,22,16,6,0.727,23,8,15,0.348,9,7,4,4,195.2,186.24,190.72
2019-12-08,1610612755,1610612761,2019,110.0,104.0,214.0,101.45,106.5,100.95,100.9,23,16,7,0.696,21,15,6,0.7140000000000001,11,5,9,6,208.36,207.36,207.86
2019-12-08,1610612764,1610612746,2019,119.0,135.0,254.0,97.3,94.55,109.3,106.6,21,7,14,0.333,23,16,7,0.696,4,3,13,3,197.48,213.8,205.64
2019-12-08,1610612742,1610612758,2019,106.0,110.0,216.0,105.85,101.85,98.55,103.25,22,16,6,0.727,21,8,13,0.381,8,8,5,3,213.64,207.08,210.36
2019-12-08,1610612757,1610612760,2019,96.0,108.0,204.0,106.95,109.5,103.5,105.25,23,9,14,0.391,21,9,12,0.429,4,5,7,2,213.2,212.24,212.72
2019-12-08,1610612747,1610612750,2019,142.0,125.0,267.0,108.65,111.35,110.85,112.55,23,20,3,0.87,21,10,11,0.476,9,11,3,7,219.28,209.4,214.34
2019-12-07,1610612742,1610612740,2019,130.0,84.0,214.0,105.75,103.6,100.85,106.3,21,15,6,0.7140000000000001,22,6,16,0.273,7,8,4,2,214.6,204.28,209.44
2019-12-07,1610612752,1610612754,2019,103.0,104.0,207.0,100.65,97.35,93.15,93.45,22,4,18,0.182,22,14,8,0.636,3,1,9,5,202.16,187.28,194.72
2019-12-07,1610612755,1610612739,2019,141.0,94.0,235.0,99.0,107.0,101.3,102.2,22,15,7,0.682,21,5,16,0.238,10,5,3,2,207.68,196.96,202.32
2019-12-07,1610612745,1610612756,2019,115.0,109.0,224.0,115.5,112.35,107.8,105.45,21,14,7,0.667,21,10,11,0.476,8,6,5,5,216.24,212.88,214.56
2019-12-07,1610612762,1610612763,2019,126.0,112.0,238.0,95.3,107.2,98.3,97.55,22,12,10,0.545,21,6,15,0.28600000000000003,8,4,3,3,200.36,193.96,197.16000000000003
2019-12-06,1610612766,1610612751,2019,104.0,111.0,215.0,100.6,97.4,98.8,99.95,23,9,14,0.391,21,11,10,0.524,5,4,6,5,195.64,196.96,196.3
2019-12-06,1610612739,1610612753,2019,87.0,93.0,180.0,101.75,102.55,98.8,103.6,20,5,15,0.25,21,10,11,0.476,3,2,8,2,197.92,206.32,202.12
2019-12-06,1610612765,1610612754,2019,108.0,101.0,209.0,102.95,106.9,92.35,92.95,22,8,14,0.364,21,14,7,0.667,6,2,9,5,207.0,187.28,197.14
2019-12-06,1610612738,1610612743,2019,108.0,95.0,203.0,100.7,105.95,107.75,108.25,20,15,5,0.75,19,14,5,0.737,8,7,8,6,195.96,216.0,205.98000000000002
2019-12-06,1610612748,1610612764,2019,112.0,103.0,215.0,97.6,97.45,96.85,93.95,21,15,6,0.7140000000000001,20,7,13,0.35,8,7,4,3,195.0,197.48,196.24
2019-12-06,1610612741,1610612744,2019,98.0,100.0,198.0,94.75,91.9,106.4,105.55,22,8,14,0.364,23,4,19,0.174,4,4,2,2,186.4,199.04,192.72
2019-12-06,1610612760,1610612750,2019,139.0,127.0,266.0,101.8,104.45,109.15,110.85,20,8,12,0.4,20,10,10,0.5,6,2,3,7,211.28,209.4,210.34
2019-12-06,1610612749,1610612746,2019,119.0,91.0,210.0,101.45,107.55,110.65,106.0,22,19,3,0.8640000000000001,22,16,6,0.727,9,10,13,3,200.48,213.8,207.14
2019-12-06,1610612759,1610612758,2019,105.0,104.0,209.0,108.55,98.4,99.1,102.9,22,8,14,0.364,20,8,12,0.4,6,2,5,3,206.92,207.08,207.0
2019-12-06,1610612757,1610612747,2019,113.0,136.0,249.0,106.3,107.4,106.95,112.25,22,9,13,0.409,22,19,3,0.8640000000000001,4,5,9,10,210.4,219.28,214.84
2019-12-05,1610612764,1610612755,2019,119.0,113.0,232.0,94.8,93.1,97.85,106.0,19,6,13,0.316,21,15,6,0.7140000000000001,3,3,10,5,195.8,207.68,201.74
2019-12-05,1610612752,1610612743,2019,92.0,129.0,221.0,101.2,97.2,107.3,109.25,21,4,17,0.19,18,13,5,0.722,3,1,8,5,200.28,216.0,208.14
2019-12-05,1610612761,1610612745,2019,109.0,119.0,228.0,100.85,100.1,114.35,112.15,20,15,5,0.75,20,13,7,0.65,9,6,8,5,205.48,216.24,210.86
2019-12-05,1610612740,1610612756,2019,132.0,139.0,271.0,99.25,104.7,107.2,104.85,21,6,15,0.28600000000000003,20,9,11,0.45,4,2,5,4,201.56,212.88,207.22
2019-12-04,1610612766,1610612744,2019,106.0,91.0,197.0,99.45,97.7,107.5,105.85,22,8,14,0.364,22,4,18,0.182,4,4,2,2,194.96,199.04,197.0
2019-12-04,1610612765,1610612749,2019,103.0,127.0,230.0,102.6,105.75,99.8,108.15,21,8,13,0.381,21,18,3,0.857,6,2,9,9,206.0,200.48,203.24
2019-12-04,1610612753,1610612756,2019,128.0,114.0,242.0,98.0,103.9,106.25,103.85,20,9,11,0.45,19,9,10,0.474,7,2,5,4,203.64,212.88,208.26
2019-12-04,1610612737,1610612751,2019,118.0,130.0,248.0,96.35,95.7,96.7,98.4,21,5,16,0.238,20,10,10,0.5,3,2,6,4,199.44,196.96,198.2
2019-12-04,1610612738,1610612748,2019,112.0,93.0,205.0,99.65,105.5,98.4,96.75,19,14,5,0.737,20,15,5,0.75,7,7,8,7,195.08,195.0,195.04000000000002
2019-12-04,1610612741,1610612763,2019,106.0,99.0,205.0,94.0,91.0,98.25,97.5,21,7,14,0.333,20,6,14,0.3,3,4,3,3,185.44,193.96,189.7
2019-12-04,1610612760,1610612754,2019,100.0,107.0,207.0,101.8,103.4,92.05,92.25,19,8,11,0.421,20,13,7,0.65,6,2,9,4,210.36,187.28,198.82
2019-12-04,1610612742,1610612750,2019,121.0,114.0,235.0,104.9,103.25,110.05,111.2,20,14,6,0.7,19,10,9,0.526,6,8,3,7,213.0,209.4,211.2
2019-12-04,1610612762,1610612747,2019,96.0,121.0,217.0,95.55,106.55,107.2,114.15,21,12,9,0.5710000000000001,21,18,3,0.857,8,4,9,9,200.2,219.28,209.74
2019-12-04,1610612757,1610612758,2019,127.0,116.0,243.0,104.6,107.05,97.75,101.5,21,8,13,0.381,19,8,11,0.421,3,5,5,3,209.44,207.08,208.26
2019-12-03,1610612739,1610612765,2019,94.0,127.0,221.0,101.9,101.55,100.85,105.95,19,5,14,0.263,20,7,13,0.35,3,2,6,1,195.48,206.0,200.74
2019-12-03,1610612764,1610612753,2019,120.0,127.0,247.0,94.7,91.35,96.55,103.5,18,6,12,0.333,19,8,11,0.421,3,3,7,1,193.0,203.64,198.32
2019-12-03,1610612761,1610612748,2019,110.0,121.0,231.0,100.6,99.2,97.25,95.5,19,15,4,0.789,19,14,5,0.737,9,6,8,6,206.0,195.0,200.5
2019-12-03,1610612740,1610612742,2019,97.0,118.0,215.0,100.45,104.8,104.45,102.7,20,6,14,0.3,19,13,6,0.684,4,2,6,7,200.8,213.0,206.9
2019-12-03,1610612759,1610612745,2019,135.0,133.0,268.0,107.75,96.55,112.7,109.85,21,7,14,0.333,19,13,6,0.684,5,2,8,5,204.12,216.24,210.18
2019-12-03,1610612743,1610612747,2019,96.0,105.0,201.0,109.2,110.3,107.3,114.65,17,13,4,0.765,20,17,3,0.85,8,5,9,8,217.04,219.28,218.16
2019-12-03,1610612746,1610612757,2019,117.0,97.0,214.0,109.85,106.5,104.75,105.45,21,15,6,0.7140000000000001,20,8,12,0.4,12,3,3,5,214.36,209.44,211.9
2014-06-15,1610612759,1610612748,2013,104.0,87.0,191.0,108.0,97.35,97.55,96.0,82,62,20,0.7559999999999999,82,54,28,0.659,32,30,32,22,205.2,195.0,200.1
2014-06-12,1610612748,1610612759,2013,86.0,107.0,193.0,97.6,95.65,107.55,98.25,82,54,28,0.659,82,62,20,0.7559999999999999,32,22,32,30,194.88,205.2,200.04
2014-06-10,1610612748,1610612759,2013,92.0,111.0,203.0,97.9,94.4,107.45,98.65,82,54,28,0.659,82,62,20,0.7559999999999999,32,22,32,30,193.64,205.2,199.42
2014-06-08,1610612759,1610612748,2013,96.0,98.0,194.0,107.25,99.4,97.25,94.5,82,62,20,0.7559999999999999,82,54,28,0.659,32,30,32,22,204.4,193.64,199.01999999999998
2014-06-05,1610612759,1610612748,2013,110.0,95.0,205.0,106.25,98.9,97.6,94.35,82,62,20,0.7559999999999999,82,54,28,0.659,32,30,32,22,205.4,193.64,199.51999999999998
2014-05-31,1610612760,1610612759,2013,107.0,112.0,219.0,102.05,103.35,105.2,99.05,82,59,23,0.72,82,62,20,0.7559999999999999,34,25,32,30,210.08,205.4,207.74
2014-05-30,1610612748,1610612754,2013,117.0,92.0,209.0,96.1,94.15,91.75,91.3,82,54,28,0.659,82,56,26,0.6829999999999999,32,22,35,21,193.2,187.28,190.24
2014-05-29,1610612759,1610612760,2013,117.0,89.0,206.0,104.35,100.25,102.45,102.6,82,62,20,0.7559999999999999,82,59,23,0.72,32,30,34,25,204.68,210.08,207.38
2014-05-28,1610612754,1610612748,2013,93.0,90.0,183.0,92.2,91.65,96.0,92.85,82,56,26,0.6829999999999999,82,54,28,0.659,35,21,32,22,189.2,193.2,191.2
2014-05-27,1610612760,1610612759,2013,105.0,92.0,197.0,103.0,102.7,104.45,100.3,82,59,23,0.72,82,62,20,0.7559999999999999,34,25,32,30,210.32,204.68,207.5
2014-05-26,1610612748,1610612754,2013,102.0,90.0,192.0,96.0,92.9,92.9,91.65,82,54,28,0.659,82,56,26,0.6829999999999999,32,22,35,21,193.8,189.2,191.5
2014-05-25,1610612760,1610612759,2013,106.0,97.0,203.0,103.0,102.55,104.75,98.85,82,59,23,0.72,82,62,20,0.7559999999999999,34,25,32,30,208.72,204.68,206.7
2014-05-24,1610612748,1610612754,2013,99.0,87.0,186.0,97.1,94.65,93.25,91.8,82,54,28,0.659,82,56,26,0.6829999999999999,32,22,35,21,194.92,189.2,192.06
2014-05-21,1610612759,1610612760,2013,112.0,77.0,189.0,104.75,100.2,104.5,102.0,82,62,20,0.7559999999999999,82,59,23,0.72,32,30,34,25,204.4,208.72,206.56
2014-05-20,1610612754,1610612748,2013,83.0,87.0,170.0,93.5,92.8,98.25,94.4,82,56,26,0.6829999999999999,82,54,28,0.659,35,21,32,22,189.48,194.92,192.2
2014-05-19,1610612759,1610612760,2013,122.0,105.0,227.0,104.25,99.55,104.6,100.5,82,62,20,0.7559999999999999,82,59,23,0.72,32,30,34,25,203.96,208.72,206.34
2014-05-18,1610612754,1610612748,2013,107.0,96.0,203.0,93.2,92.7,97.6,93.25,82,56,26,0.6829999999999999,82,54,28,0.659,35,21,32,22,189.08,194.92,192.0
2014-05-15,1610612764,1610612754,2013,80.0,93.0,173.0,95.75,91.55,92.35,93.2,82,44,38,0.537,82,56,26,0.6829999999999999,22,22,35,21,195.04,189.08,192.06
2014-05-15,1610612746,1610612760,2013,98.0,104.0,202.0,110.95,106.15,105.15,101.7,82,57,25,0.695,82,59,23,0.72,34,23,34,25,213.84,208.72,211.28
2014-05-14,1610612748,1610612751,2013,96.0,94.0,190.0,97.6,92.4,97.25,98.65,82,54,28,0.659,82,44,38,0.537,32,22,28,16,195.76,196.96,196.36
2014-05-14,1610612759,1610612757,2013,104.0,82.0,186.0,104.6,99.95,104.9,105.0,82,62,20,0.7559999999999999,82,54,28,0.659,32,30,31,23,204.2,209.44,206.82
2014-05-13,1610612754,1610612764,2013,79.0,102.0,181.0,92.25,93.25,95.75,92.85,82,56,26,0.6829999999999999,82,44,38,0.537,35,21,22,22,189.68,195.04,192.36
2014-05-13,1610612760,1610612746,2013,105.0,104.0,209.0,105.7,101.3,111.2,106.05,82,59,23,0.72,82,57,25,0.695,34,25,34,23,209.16,213.84,211.5
2014-05-12,1610612751,1610612748,2013,96.0,102.0,198.0,98.15,98.5,97.25,92.85,82,44,38,0.537,82,54,28,0.659,28,16,32,22,197.56,195.76,196.66
2014-05-12,1610612757,1610612759,2013,103.0,92.0,195.0,105.0,105.3,106.65,99.9,82,54,28,0.659,82,62,20,0.7559999999999999,31,23,32,30,210.24,204.2,207.22
2014-05-11,1610612746,1610612760,2013,101.0,99.0,200.0,111.5,106.75,106.1,101.8,82,57,25,0.695,82,59,23,0.72,34,23,34,25,214.36,209.16,211.76
2014-05-11,1610612764,1610612754,2013,92.0,95.0,187.0,95.7,92.0,91.4,93.2,82,44,38,0.537,82,56,26,0.6829999999999999,22,22,35,21,195.8,189.68,192.74
2014-05-10,1610612751,1610612748,2013,104.0,90.0,194.0,98.35,98.85,97.55,92.7,82,44,38,0.537,82,54,28,0.659,28,16,32,22,197.44,195.76,196.6
2014-05-10,1610612757,1610612759,2013,103.0,118.0,221.0,105.65,104.55,105.7,99.25,82,54,28,0.659,82,62,20,0.7559999999999999,31,23,32,30,209.56,204.2,206.88
2014-05-09,1610612764,1610612754,2013,63.0,85.0,148.0,97.2,92.7,91.0,94.5,82,44,38,0.537,82,56,26,0.6829999999999999,22,22,35,21,197.96,189.68,193.82
2014-05-09,1610612746,1610612760,2013,112.0,118.0,230.0,111.2,105.75,106.15,102.6,82,57,25,0.695,82,59,23,0.72,34,23,34,25,215.4,209.16,212.28
2014-05-08,1610612748,1610612751,2013,94.0,82.0,176.0,97.5,92.75,98.3,99.65,82,54,28,0.659,82,44,38,0.537,32,22,28,16,195.88,197.44,196.66
2014-05-08,1610612759,1610612757,2013,114.0,97.0,211.0,104.8,98.4,105.35,103.5,82,62,20,0.7559999999999999,82,54,28,0.659,32,30,31,23,204.12,209.56,206.84
2014-05-07,1610612754,1610612764,2013,86.0,82.0,168.0,90.9,94.55,98.95,93.75,82,56,26,0.6829999999999999,82,44,38,0.537,35,21,22,22,190.88,197.96,194.42000000000002
2014-05-07,1610612760,1610612746,2013,112.0,101.0,213.0,105.25,101.6,110.95,105.05,82,59,23,0.72,82,57,25,0.695,34,25,34,23,208.72,215.4,212.06
2014-05-06,1610612748,1610612751,2013,107.0,86.0,193.0,96.8,93.0,99.55,100.1,82,54,28,0.659,82,44,38,0.537,32,22,28,16,195.96,197.44,196.7
2014-05-06,1610612759,1610612757,2013,116.0,92.0,208.0,104.4,98.95,105.45,103.9,82,62,20,0.7559999999999999,82,54,28,0.659,32,30,31,23,204.36,209.56,206.96
2014-05-05,1610612754,1610612764,2013,96.0,102.0,198.0,90.65,93.4,99.0,94.75,82,56,26,0.6829999999999999,82,44,38,0.537,35,21,22,22,191.2,197.96,194.57999999999998
2014-05-05,1610612760,1610612746,2013,105.0,122.0,227.0,105.85,100.3,109.85,105.3,82,59,23,0.72,82,57,25,0.695,34,25,34,23,207.68,215.4,211.54000000000002
2014-05-04,1610612761,1610612751,2013,103.0,104.0,207.0,100.25,98.3,99.55,100.4,82,48,34,0.585,82,44,38,0.537,26,22,28,16,204.84,197.44,201.14
2014-05-04,1610612759,1610612742,2013,119.0,96.0,215.0,104.1,98.7,105.05,101.8,82,62,20,0.7559999999999999,82,49,33,0.598,32,30,26,23,203.36,213.0,208.18
2014-05-03,1610612754,1610612737,2013,92.0,80.0,172.0,91.0,93.9,97.2,95.25,82,56,26,0.6829999999999999,82,38,44,0.463,35,21,24,14,192.64,199.44,196.04
2014-05-03,1610612760,1610612763,2013,120.0,109.0,229.0,104.15,100.3,97.45,96.5,82,59,23,0.72,82,50,32,0.61,34,25,27,23,208.44,193.96,201.2
2014-05-03,1610612746,1610612744,2013,126.0,121.0,247.0,109.15,104.4,106.35,105.1,82,57,25,0.695,82,51,31,0.622,34,23,27,24,213.92,199.04,206.48
2014-05-02,1610612751,1610612761,2013,97.0,83.0,180.0,100.4,101.15,101.45,98.45,82,44,38,0.537,82,48,34,0.585,28,16,26,22,198.2,204.84,201.51999999999998
2014-05-02,1610612742,1610612759,2013,113.0,111.0,224.0,105.5,101.55,103.5,97.0,82,49,33,0.598,82,62,20,0.7559999999999999,26,23,32,30,212.72,203.36,208.04000000000002
2014-05-02,1610612757,1610612745,2013,99.0,98.0,197.0,106.5,104.75,113.7,110.45,82,54,28,0.659,82,54,28,0.659,31,23,33,21,210.32,216.24,213.28
2014-05-01,1610612737,1610612754,2013,88.0,95.0,183.0,97.05,95.5,89.8,93.6,82,38,44,0.463,82,56,26,0.6829999999999999,24,14,35,21,198.64,192.64,195.64
2014-05-01,1610612763,1610612760,2013,84.0,104.0,188.0,98.7,96.25,104.9,102.0,82,50,32,0.61,82,59,23,0.72,27,23,34,25,195.16,208.44,201.8
2014-05-01,1610612744,1610612746,2013,100.0,99.0,199.0,107.1,105.65,109.0,103.75,82,51,31,0.622,82,57,25,0.695,27,24,34,23,200.72,213.92,207.32
2014-04-30,1610612759,1610612742,2013,109.0,103.0,212.0,104.15,97.05,104.6,101.5,82,62,20,0.7559999999999999,82,49,33,0.598,32,30,26,23,202.96,212.72,207.84
2014-04-30,1610612761,1610612751,2013,115.0,113.0,228.0,101.6,98.75,100.1,100.6,82,48,34,0.585,82,44,38,0.537,26,22,28,16,204.44,198.2,201.32
2014-04-30,1610612745,1610612757,2013,108.0,98.0,206.0,114.5,109.85,107.15,104.5,82,54,28,0.659,82,54,28,0.659,33,21,31,23,216.08,210.32,213.2
2014-04-29,1610612741,1610612764,2013,69.0,75.0,144.0,94.8,92.1,100.8,97.15,82,48,34,0.585,82,44,38,0.537,27,21,22,22,187.28,197.96,192.62
2014-04-29,1610612760,1610612763,2013,99.0,100.0,199.0,106.5,102.1,98.25,95.65,82,59,23,0.72,82,50,32,0.61,34,25,27,23,207.92,195.16,201.54
2014-04-29,1610612746,1610612744,2013,113.0,103.0,216.0,108.45,102.6,107.35,104.4,82,57,25,0.695,82,51,31,0.622,34,23,27,24,213.92,200.72,207.32
2014-04-28,1610612766,1610612748,2013,98.0,109.0,207.0,99.8,96.9,96.35,92.9,82,43,39,0.524,82,54,28,0.659,25,18,32,22,193.64,195.96,194.8
2014-04-28,1610612754,1610612737,2013,97.0,107.0,204.0,89.65,92.4,97.3,96.15,82,56,26,0.6829999999999999,82,38,44,0.463,35,21,24,14,190.84,198.64,194.74
2014-04-28,1610612742,1610612759,2013,89.0,93.0,182.0,106.25,103.0,105.75,98.05,82,49,33,0.598,82,62,20,0.7559999999999999,26,23,32,30,213.72,202.96,208.34
2014-04-27,1610612764,1610612741,2013,98.0,89.0,187.0,100.95,97.4,95.6,91.9,82,44,38,0.537,82,48,34,0.585,22,22,27,21,198.04,187.28,192.66
2014-04-27,1610612744,1610612746,2013,118.0,97.0,215.0,106.6,104.0,110.7,101.4,82,51,31,0.622,82,57,25,0.695,27,24,34,23,199.96,213.92,206.94
2014-04-27,1610612751,1610612761,2013,79.0,87.0,166.0,101.35,101.2,102.9,100.7,82,44,38,0.537,82,48,34,0.585,28,16,26,22,199.56,204.44,202.0
2014-04-27,1610612757,1610612745,2013,123.0,120.0,243.0,106.6,104.15,113.7,109.35,82,54,28,0.659,82,54,28,0.659,31,23,33,21,208.76,216.08,212.42000000000002
2014-04-26,1610612737,1610612754,2013,88.0,91.0,179.0,97.65,96.7,89.4,92.6,82,38,44,0.463,82,56,26,0.6829999999999999,24,14,35,21,198.84,190.84,194.84
2014-04-26,1610612742,1610612759,2013,109.0,108.0,217.0,105.5,102.05,105.55,97.4,82,49,33,0.598,82,62,20,0.7559999999999999,26,23,32,30,211.92,202.96,207.44
2014-04-26,1610612766,1610612748,2013,85.0,98.0,183.0,100.8,96.9,95.85,93.4,82,43,39,0.524,82,54,28,0.659,25,18,32,22,195.16,195.96,195.56
2014-04-26,1610612763,1610612760,2013,89.0,92.0,181.0,99.35,95.5,107.0,102.4,82,50,32,0.61,82,59,23,0.72,27,23,34,25,195.36,207.92,201.64
2014-04-25,1610612751,1610612761,2013,102.0,98.0,200.0,101.65,101.05,102.85,100.65,82,44,38,0.537,82,48,34,0.585,28,16,26,22,198.64,204.44,201.54
2014-04-25,1610612764,1610612741,2013,97.0,100.0,197.0,100.35,97.3,94.6,91.85,82,44,38,0.537,82,48,34,0.585,22,22,27,21,198.6,187.28,192.94
2014-04-25,1610612757,1610612745,2013,116.0,121.0,237.0,105.9,102.0,112.0,109.1,82,54,28,0.659,82,54,28,0.659,31,23,33,21,207.28,216.08,211.68
2014-04-24,1610612737,1610612754,2013,98.0,85.0,183.0,98.0,98.0,90.75,92.9,82,38,44,0.463,82,56,26,0.6829999999999999,24,14,35,21,199.56,190.84,195.2
2014-04-24,1610612763,1610612760,2013,98.0,95.0,193.0,99.95,95.55,107.1,101.75,82,50,32,0.61,82,59,23,0.72,27,23,34,25,196.4,207.92,202.16
2014-04-24,1610612744,1610612746,2013,96.0,98.0,194.0,106.5,104.25,111.0,101.4,82,51,31,0.622,82,57,25,0.695,27,24,34,23,201.76,213.92,207.83999999999997
2014-04-23,1610612748,1610612766,2013,101.0,97.0,198.0,95.35,92.85,100.85,96.1,82,54,28,0.659,82,43,39,0.524,32,22,25,18,196.0,195.16,195.57999999999998
2014-04-23,1610612759,1610612742,2013,92.0,113.0,205.0,106.9,96.0,105.35,103.2,82,62,20,0.7559999999999999,82,49,33,0.598,32,30,26,23,203.08,211.92,207.5
2014-04-23,1610612745,1610612757,2013,105.0,112.0,217.0,112.65,109.15,104.8,101.9,82,54,28,0.659,82,54,28,0.659,33,21,31,23,216.04,207.28,211.66
2014-04-22,1610612754,1610612737,2013,101.0,85.0,186.0,90.5,93.55,99.15,98.4,82,56,26,0.6829999999999999,82,38,44,0.463,35,21,24,14,190.0,199.56,194.78
2014-04-22,1610612761,1610612751,2013,100.0,95.0,195.0,103.5,101.95,101.6,101.1,82,48,34,0.585,82,44,38,0.537,26,22,28,16,203.96,198.64,201.3
2014-04-22,1610612741,1610612764,2013,99.0,101.0,200.0,94.35,91.15,100.55,97.4,82,48,34,0.585,82,44,38,0.537,27,21,22,22,187.28,198.6,192.94
2014-04-21,1610612760,1610612763,2013,105.0,111.0,216.0,107.15,101.1,98.7,94.85,82,59,23,0.72,82,50,32,0.61,34,25,27,23,207.88,196.4,202.14
2014-04-21,1610612746,1610612744,2013,138.0,98.0,236.0,109.65,101.4,106.5,102.15,82,57,25,0.695,82,51,31,0.622,34,23,27,24,211.76,201.76,206.76
2014-04-20,1610612759,1610612742,2013,90.0,85.0,175.0,107.55,96.25,106.4,104.3,82,62,20,0.7559999999999999,82,49,33,0.598,32,30,26,23,204.32,211.92,208.12
2014-04-20,1610612748,1610612766,2013,99.0,88.0,187.0,96.05,93.65,100.9,96.7,82,54,28,0.659,82,43,39,0.524,32,22,25,18,198.0,195.16,196.57999999999998
2014-04-20,1610612741,1610612764,2013,93.0,102.0,195.0,95.25,90.4,99.95,97.7,82,48,34,0.585,82,44,38,0.537,27,21,22,22,186.64,198.6,192.62
2014-04-20,1610612745,1610612757,2013,120.0,122.0,242.0,112.25,107.35,103.65,101.35,82,54,28,0.659,82,54,28,0.659,33,21,31,23,214.56,207.28,210.92000000000002
2014-04-19,1610612761,1610612751,2013,87.0,94.0,181.0,104.1,101.55,101.7,101.5,82,48,34,0.585,82,44,38,0.537,26,22,28,16,205.12,198.64,201.88
2014-04-19,1610612746,1610612744,2013,105.0,109.0,214.0,110.0,101.2,105.95,102.1,82,57,25,0.695,82,51,31,0.622,34,23,27,24,211.08,201.76,206.42000000000002
2014-04-19,1610612754,1610612737,2013,93.0,101.0,194.0,90.55,93.05,98.95,99.3,82,56,26,0.6829999999999999,82,38,44,0.463,35,21,24,14,189.48,199.56,194.51999999999998
2014-04-19,1610612760,1610612763,2013,100.0,86.0,186.0,108.4,101.4,99.55,93.7,82,59,23,0.72,82,50,32,0.61,34,25,27,23,207.96,196.4,202.18
2014-04-16,1610612766,1610612741,2013,91.0,86.0,177.0,101.4,97.0,95.95,90.4,81,42,39,0.519,81,48,33,0.593,24,18,27,21,195.0,186.64,190.82
2014-04-16,1610612753,1610612754,2013,86.0,101.0,187.0,96.7,103.5,90.55,93.45,81,23,58,0.284,81,55,26,0.679,19,4,35,20,204.6,189.48,197.04
2014-04-16,1610612763,1610612742,2013,106.0,105.0,211.0,99.65,93.6,106.65,104.4,81,49,32,0.605,81,49,32,0.605,26,23,26,23,195.88,211.92,203.89999999999998
2014-04-16,1610612749,1610612737,2013,103.0,111.0,214.0,100.35,107.0,97.3,99.25,81,15,66,0.185,81,37,44,0.457,10,5,24,13,199.16,199.56,199.36
2014-04-16,1610612750,1610612762,2013,130.0,136.0,266.0,109.15,109.45,93.3,105.25,81,40,41,0.494,81,24,57,0.29600000000000004,24,16,16,8,207.8,200.2,204.0
2014-04-16,1610612740,1610612745,2013,105.0,100.0,205.0,100.35,105.35,112.15,107.4,81,33,48,0.407,81,54,27,0.667,21,12,33,21,200.48,214.56,207.51999999999998
2014-04-16,1610612760,1610612765,2013,112.0,111.0,223.0,108.6,100.8,100.75,106.25,81,58,23,0.716,81,29,52,0.358,33,25,17,12,206.72,206.0,206.36
2014-04-16,1610612759,1610612747,2013,100.0,113.0,213.0,108.6,96.2,106.8,115.05,81,62,19,0.765,81,26,55,0.321,32,30,14,12,204.0,219.28,211.64
2014-04-16,1610612738,1610612764,2013,102.0,118.0,220.0,98.95,105.0,99.75,97.95,81,25,56,0.309,81,43,38,0.531,16,9,22,21,194.4,198.6,196.5
2014-04-16,1610612739,1610612751,2013,114.0,85.0,199.0,101.25,103.4,101.65,100.35,81,32,49,0.395,81,44,37,0.5429999999999999,18,14,28,16,194.24,198.64,196.44
2014-04-16,1610612748,1610612755,2013,87.0,100.0,187.0,97.05,94.2,98.35,107.8,81,54,27,0.667,81,18,63,0.222,32,22,10,8,200.12,207.68,203.9
2014-04-16,1610612752,1610612761,2013,95.0,92.0,187.0,101.85,98.1,105.05,102.0,81,36,45,0.444,81,48,33,0.593,18,18,26,22,199.92,205.12,202.51999999999998
2014-04-16,1610612757,1610612746,2013,110.0,104.0,214.0,103.45,101.5,110.95,101.2,81,53,28,0.654,81,57,24,0.7040000000000001,30,23,34,23,208.24,211.08,209.66000000000003
2014-04-16,1610612758,1610612756,2013,99.0,104.0,203.0,97.65,101.7,107.1,104.55,81,28,53,0.34600000000000003,81,47,34,0.58,17,11,26,21,207.48,212.88,210.18
2014-04-16,1610612743,1610612744,2013,112.0,116.0,228.0,109.35,110.0,106.45,101.65,81,36,45,0.444,81,50,31,0.617,22,14,27,23,216.68,201.76,209.22
2014-04-15,1610612751,1610612752,2013,98.0,109.0,207.0,101.8,99.75,101.75,98.05,80,44,36,0.55,80,35,45,0.438,28,16,18,17,197.2,199.92,198.56
2014-04-15,1610612746,1610612743,2013,117.0,105.0,222.0,110.55,101.35,109.0,109.4,80,56,24,0.7,80,36,44,0.45,33,23,22,14,210.0,216.68,213.34
2014-04-14,1610612755,1610612738,2013,113.0,108.0,221.0,97.85,108.5,97.7,104.05,80,17,63,0.213,80,25,55,0.313,9,8,16,9,207.68,194.4,201.04000000000002
2014-04-14,1610612761,1610612749,2013,110.0,100.0,210.0,104.6,101.35,100.2,106.6,80,47,33,0.588,80,15,65,0.188,25,22,10,5,203.76,199.16,201.45999999999998
2014-04-14,1610612764,1610612748,2013,114.0,93.0,207.0,99.25,97.85,96.75,94.05,80,42,38,0.525,80,54,26,0.675,21,21,32,22,199.16,200.12,199.64
2014-04-14,1610612737,1610612766,2013,93.0,95.0,188.0,98.55,100.15,102.0,98.55,80,37,43,0.463,80,41,39,0.513,24,13,24,17,201.4,195.0,198.2
2014-04-14,1610612741,1610612753,2013,108.0,95.0,203.0,95.35,90.85,97.0,102.6,80,47,33,0.588,80,23,57,0.28800000000000003,26,21,19,4,185.52,204.6,195.06
2014-04-14,1610612745,1610612759,2013,104.0,98.0,202.0,112.25,107.65,109.8,96.05,80,53,27,0.6629999999999999,80,62,18,0.775,32,21,32,30,214.16,204.0,209.07999999999998
2014-04-14,1610612740,1610612760,2013,101.0,89.0,190.0,99.7,105.4,109.65,101.45,80,32,48,0.4,80,58,22,0.725,20,12,33,25,200.8,206.72,203.76
2014-04-14,1610612762,1610612747,2013,104.0,119.0,223.0,93.6,104.9,105.75,115.75,80,24,56,0.3,80,25,55,0.313,16,8,14,11,198.6,219.28,208.94
2014-04-14,1610612756,1610612763,2013,91.0,97.0,188.0,108.35,104.9,99.1,94.0,80,47,33,0.588,80,48,32,0.6,26,21,26,22,212.96,195.88,204.42000000000002
2014-04-14,1610612744,1610612750,2013,130.0,120.0,250.0,105.35,99.9,108.55,107.8,80,49,31,0.613,80,40,40,0.5,26,23,24,16,199.6,207.8,203.7
2014-04-13,1610612754,1610612760,2013,102.0,97.0,199.0,90.5,93.4,110.9,102.75,80,54,26,0.675,79,58,21,0.7340000000000001,34,20,33,25,188.2,206.72,197.45999999999998
2014-04-13,1610612765,1610612761,2013,107.0,116.0,223.0,100.5,106.1,103.75,100.65,80,29,51,0.363,79,46,33,0.5820000000000001,17,12,25,21,205.52,203.76,204.64
2014-04-13,1610612751,1610612753,2013,97.0,88.0,185.0,102.15,99.8,97.9,103.5,79,43,36,0.544,79,23,56,0.29100000000000004,27,16,19,4,197.68,204.6,201.14
2014-04-13,1610612752,1610612741,2013,100.0,89.0,189.0,101.8,98.9,96.25,91.0,79,34,45,0.43,79,47,32,0.595,17,17,26,21,201.04,185.52,193.28
2014-04-13,1610612757,1610612744,2013,119.0,117.0,236.0,102.6,100.45,103.65,99.1,80,52,28,0.65,79,49,30,0.62,29,23,26,23,207.4,199.6,203.5
2014-04-13,1610612758,1610612750,2013,106.0,103.0,209.0,97.5,103.0,108.9,107.55,80,27,53,0.338,79,40,39,0.506,16,11,24,16,207.0,207.8,207.4
2014-04-13,1610612747,1610612763,2013,90.0,102.0,192.0,106.95,116.15,98.5,93.9,79,25,54,0.316,79,47,32,0.595,14,11,26,21,218.52,195.88,207.2
2014-04-12,1610612746,1610612758,2013,117.0,101.0,218.0,110.1,100.1,96.9,102.35,79,55,24,0.696,79,27,52,0.342,32,23,16,11,208.8,207.0,207.9
2014-04-12,1610612766,1610612755,2013,111.0,105.0,216.0,101.9,97.65,97.2,109.2,79,40,39,0.506,79,17,62,0.215,23,17,9,8,193.64,207.68,200.66
2014-04-12,1610612764,1610612749,2013,104.0,91.0,195.0,99.25,98.8,100.7,107.0,79,41,38,0.519,79,15,64,0.19,20,21,10,5,199.68,199.16,199.42000000000002
2014-04-12,1610612737,1610612748,2013,98.0,85.0,183.0,98.5,100.5,97.65,94.45,79,36,43,0.456,79,54,25,0.684,23,13,32,22,202.2,200.12,201.16
2014-04-12,1610612739,1610612738,2013,99.0,111.0,210.0,101.25,101.8,97.05,104.6,80,32,48,0.4,79,24,55,0.304,18,14,16,8,194.32,194.4,194.36
2014-04-12,1610612745,1610612740,2013,111.0,104.0,215.0,112.6,107.95,99.7,105.65,79,52,27,0.6579999999999999,79,32,47,0.405,31,21,20,12,214.16,200.8,207.48000000000002
2014-04-12,1610612742,1610612756,2013,101.0,98.0,199.0,106.85,104.2,107.8,103.85,80,48,32,0.6,79,47,32,0.595,25,23,26,21,213.2,212.96,213.07999999999998
2014-04-12,1610612743,1610612762,2013,101.0,94.0,195.0,110.35,111.3,93.3,105.55,79,35,44,0.443,79,24,55,0.304,21,14,16,8,217.52,198.6,208.06
2014-04-11,1610612753,1610612764,2013,86.0,96.0,182.0,98.2,102.75,100.55,99.65,78,23,55,0.295,78,40,38,0.513,19,4,20,20,205.36,199.68,202.52
2014-04-11,1610612761,1610612752,2013,100.0,108.0,208.0,103.7,99.6,102.3,99.2,78,46,32,0.59,78,33,45,0.423,25,21,17,16,203.56,201.04,202.3
2014-04-11,1610612738,1610612766,2013,106.0,103.0,209.0,96.6,104.55,101.7,98.15,78,23,55,0.295,78,40,38,0.513,15,8,23,17,194.24,193.64,193.94
2014-04-11,1610612751,1610612737,2013,88.0,93.0,181.0,102.9,99.85,99.85,102.55,78,43,35,0.551,78,35,43,0.449,27,16,23,12,197.36,202.2,199.78
2014-04-11,1610612748,1610612754,2013,98.0,86.0,184.0,97.5,94.95,90.9,93.75,78,53,25,0.679,79,54,25,0.684,31,22,34,20,201.76,188.2,194.98
2014-04-11,1610612741,1610612765,2013,106.0,98.0,204.0,95.7,90.5,99.95,105.85,78,46,32,0.59,79,29,50,0.3670000000000001,25,21,17,12,184.4,205.52,194.96
2014-04-11,1610612763,1610612755,2013,117.0,95.0,212.0,97.75,93.95,96.5,107.95,78,46,32,0.59,78,17,61,0.218,25,21,9,8,194.92,207.68,201.3
2014-04-11,1610612750,1610612745,2013,112.0,110.0,222.0,108.5,107.6,112.15,106.8,78,39,39,0.5,78,52,26,0.667,23,16,31,21,208.36,214.16,211.26
2014-04-11,1610612760,1610612740,2013,116.0,94.0,210.0,110.75,103.4,99.45,105.25,78,57,21,0.731,78,32,46,0.41,32,25,20,12,206.44,200.8,203.62
2014-04-11,1610612749,1610612739,2013,119.0,116.0,235.0,99.65,106.55,100.25,101.35,78,14,64,0.179,79,32,47,0.405,9,5,18,14,198.24,194.32,196.28
2014-04-11,1610612759,1610612756,2013,112.0,104.0,216.0,109.75,95.2,107.85,103.85,79,61,18,0.772,78,47,31,0.603,31,30,26,21,204.0,212.96,208.48000000000002
2014-04-11,1610612762,1610612757,2013,99.0,111.0,210.0,93.8,104.3,102.7,101.4,78,24,54,0.308,79,51,28,0.6459999999999999,16,8,29,22,196.72,207.4,202.06
2014-04-11,1610612747,1610612744,2013,95.0,112.0,207.0,106.9,117.65,103.25,99.15,78,25,53,0.321,78,48,30,0.615,14,11,26,22,218.84,199.6,209.22
2014-04-10,1610612742,1610612759,2013,100.0,109.0,209.0,107.0,103.65,108.55,95.5,79,48,31,0.608,78,60,18,0.769,25,23,31,29,213.76,204.0,208.88
2014-04-10,1610612744,1610612743,2013,99.0,100.0,199.0,103.95,99.5,110.7,111.9,77,48,29,0.623,78,34,44,0.436,26,22,21,13,199.68,217.52,208.60000000000002
2014-04-09,1610612739,1610612765,2013,122.0,100.0,222.0,98.8,101.3,100.5,105.65,78,31,47,0.397,78,29,49,0.3720000000000001,17,14,17,12,195.52,205.52,200.52
2014-04-09,1610612753,1610612751,2013,115.0,111.0,226.0,98.9,103.25,102.7,99.0,77,22,55,0.28600000000000003,77,43,34,0.5579999999999999,18,4,27,16,204.36,197.36,200.86
2014-04-09,1610612761,1610612755,2013,125.0,114.0,239.0,102.65,98.8,95.8,106.95,77,45,32,0.584,77,17,60,0.221,24,21,9,8,201.08,207.68,204.38
2014-04-09,1610612764,1610612766,2013,88.0,94.0,182.0,101.9,100.25,101.1,98.35,77,40,37,0.519,77,39,38,0.506,20,20,23,16,199.96,193.64,196.8
2014-04-09,1610612737,1610612738,2013,105.0,97.0,202.0,99.7,102.55,96.65,104.55,77,34,43,0.442,77,23,54,0.299,22,12,15,8,203.36,194.24,198.8
2014-04-09,1610612763,1610612748,2013,107.0,102.0,209.0,97.3,93.5,97.55,93.65,77,45,32,0.584,77,53,24,0.688,24,21,31,22,194.32,201.76,198.04
2014-04-09,1610612749,1610612754,2013,102.0,104.0,206.0,99.55,106.85,90.0,94.25,77,14,63,0.182,78,53,25,0.679,9,5,34,19,198.88,188.2,193.54
2014-04-09,1610612750,1610612741,2013,87.0,102.0,189.0,109.85,107.55,94.55,90.8,77,39,38,0.506,77,45,32,0.584,23,16,25,20,208.72,184.4,196.56
2014-04-09,1610612740,1610612756,2013,88.0,94.0,182.0,100.6,105.9,108.5,105.1,77,32,45,0.416,77,46,31,0.597,20,12,26,20,202.24,212.96,207.60000000000002
2014-04-09,1610612743,1610612745,2013,123.0,116.0,239.0,109.0,111.7,111.0,105.7,77,33,44,0.429,77,52,25,0.675,20,13,31,21,215.6,214.16,214.88
2014-04-09,1610612757,1610612758,2013,100.0,99.0,199.0,103.9,100.45,96.3,102.3,78,50,28,0.6409999999999999,78,27,51,0.34600000000000003,28,22,16,11,208.56,207.0,207.78
2014-04-09,1610612746,1610612760,2013,101.0,107.0,208.0,110.1,99.4,110.75,103.5,78,55,23,0.705,77,56,21,0.727,32,23,32,24,209.92,206.44,208.18
2014-04-08,1610612737,1610612765,2013,95.0,102.0,197.0,100.1,102.8,100.45,106.6,76,34,42,0.447,77,28,49,0.364,22,12,17,11,204.04,205.52,204.78
2014-04-08,1610612750,1610612759,2013,110.0,91.0,201.0,109.65,108.9,109.55,95.45,76,38,38,0.5,77,60,17,0.779,22,16,31,29,209.4,204.0,206.7
2014-04-08,1610612748,1610612751,2013,87.0,88.0,175.0,98.15,93.75,103.9,99.1,76,53,23,0.6970000000000001,76,42,34,0.5529999999999999,31,22,27,15,202.4,197.36,199.88
2014-04-08,1610612762,1610612742,2013,83.0,95.0,178.0,95.15,104.45,107.9,104.6,77,24,53,0.312,78,47,31,0.603,16,8,25,22,197.92,213.76,205.83999999999997
2014-04-08,1610612758,1610612760,2013,92.0,107.0,199.0,96.95,101.85,110.3,103.65,77,27,50,0.35100000000000003,76,55,21,0.7240000000000001,16,11,32,23,207.96,206.44,207.2
2014-04-08,1610612747,1610612745,2013,130.0,145.0,275.0,106.65,117.0,110.2,104.35,77,25,52,0.325,76,51,25,0.6709999999999999,14,11,31,20,215.68,214.16,214.92000000000002
2014-04-06,1610612748,1610612752,2013,102.0,91.0,193.0,99.25,94.55,102.0,98.9,75,52,23,0.693,77,33,44,0.429,30,22,17,16,203.12,201.04,202.07999999999998
2014-04-06,1610612746,1610612747,2013,120.0,97.0,217.0,109.25,100.2,107.4,115.9,77,54,23,0.701,76,25,51,0.329,31,23,14,11,209.36,215.68,212.52
2014-04-06,1610612758,1610612742,2013,91.0,93.0,184.0,97.0,102.25,109.45,105.65,76,27,49,0.355,77,46,31,0.597,16,11,25,21,208.96,213.76,211.36
2014-04-06,1610612754,1610612737,2013,88.0,107.0,195.0,91.5,93.8,99.95,104.15,77,53,24,0.688,75,33,42,0.44,34,19,22,11,188.24,204.04,196.14
2014-04-06,1610612745,1610612743,2013,130.0,125.0,255.0,109.35,103.7,107.55,110.3,75,50,25,0.667,76,33,43,0.434,30,20,20,13,212.08,215.6,213.84
2014-04-06,1610612759,1610612763,2013,112.0,92.0,204.0,109.55,96.15,96.95,91.75,76,59,17,0.7759999999999999,76,45,31,0.5920000000000001,30,29,24,21,204.2,194.32,199.26
2014-04-06,1610612744,1610612762,2013,130.0,102.0,232.0,103.0,99.25,94.6,102.65,76,47,29,0.618,76,24,52,0.316,25,22,16,8,198.72,197.92,198.32
2014-04-06,1610612756,1610612760,2013,122.0,115.0,237.0,107.45,104.85,109.65,102.7,76,45,31,0.5920000000000001,75,55,20,0.733,25,20,32,23,212.12,206.44,209.28
2014-04-06,1610612757,1610612740,2013,100.0,94.0,194.0,104.3,100.6,100.55,105.6,77,49,28,0.636,76,32,44,0.421,27,22,20,12,209.48,202.24,205.86
2014-04-05,1610612753,1610612750,2013,100.0,92.0,192.0,97.95,102.95,109.9,109.3,76,21,55,0.276,75,38,37,0.507,17,4,22,16,204.88,209.4,207.14
2014-04-05,1610612764,1610612741,2013,78.0,96.0,174.0,102.7,100.1,94.45,91.5,76,40,36,0.526,76,44,32,0.579,20,20,25,19,199.6,184.4,192.0
2014-04-05,1610612739,1610612766,2013,94.0,96.0,190.0,98.25,101.3,101.7,98.45,77,31,46,0.403,76,38,38,0.5,17,14,23,15,196.2,193.64,194.92
2014-04-05,1610612765,1610612738,2013,115.0,111.0,226.0,100.45,106.4,95.7,103.85,76,27,49,0.355,76,23,53,0.303,16,11,15,8,205.36,194.24,199.8
2014-04-05,1610612755,1610612751,2013,101.0,105.0,206.0,95.25,106.75,102.65,100.25,76,17,59,0.224,75,41,34,0.547,9,8,27,14,209.08,197.36,203.22000000000003
2014-04-05,1610612749,1610612761,2013,98.0,102.0,200.0,99.15,106.8,102.7,98.55,76,14,62,0.184,76,44,32,0.579,9,5,24,20,199.2,201.08,200.14
2014-04-04,1610612763,1610612743,2013,100.0,92.0,192.0,96.55,91.6,107.4,111.15,75,44,31,0.5870000000000001,75,33,42,0.44,23,21,20,13,195.28,215.6,205.44
2014-04-04,1610612766,1610612753,2013,91.0,80.0,171.0,101.75,98.9,98.45,103.65,75,37,38,0.493,75,21,54,0.28,22,15,17,4,193.72,204.88,199.3
2014-04-04,1610612761,1610612754,2013,102.0,94.0,196.0,104.05,100.55,91.15,94.15,75,43,32,0.573,76,53,23,0.6970000000000001,23,20,34,19,201.84,188.24,195.04000000000002
2014-04-04,1610612737,1610612739,2013,117.0,98.0,215.0,99.45,104.15,99.05,100.65,74,32,42,0.4320000000000001,76,31,45,0.408,21,11,17,14,203.44,196.2,199.82
2014-04-04,1610612738,1610612755,2013,102.0,111.0,213.0,96.35,103.5,93.7,107.8,75,23,52,0.307,75,16,59,0.213,15,8,9,7,194.24,209.08,201.66000000000003
2014-04-04,1610612751,1610612765,2013,116.0,104.0,220.0,101.65,99.05,100.75,106.5,74,40,34,0.541,75,27,48,0.36,26,14,16,11,196.12,205.36,200.74
2014-04-04,1610612748,1610612750,2013,121.0,122.0,243.0,98.8,93.35,109.85,108.45,74,52,22,0.703,74,37,37,0.5,30,22,22,15,202.24,209.4,205.82
2014-04-04,1610612752,1610612764,2013,89.0,90.0,179.0,103.4,98.9,104.9,102.1,76,33,43,0.434,75,39,36,0.52,17,16,20,19,201.16,199.6,200.38
2014-04-04,1610612741,1610612749,2013,102.0,90.0,192.0,93.2,91.25,99.85,107.3,75,43,32,0.573,75,14,61,0.187,24,19,9,5,183.28,199.2,191.24
2014-04-04,1610612762,1610612740,2013,100.0,96.0,196.0,94.8,103.9,100.1,105.1,75,23,52,0.307,75,32,43,0.4270000000000001,15,8,20,12,197.44,202.24,199.84
2014-04-04,1610612745,1610612760,2013,111.0,107.0,218.0,109.9,103.75,108.35,101.95,74,49,25,0.662,74,55,19,0.743,29,20,32,23,210.8,206.44,208.62
2014-04-04,1610612757,1610612756,2013,93.0,109.0,202.0,104.75,99.85,106.3,105.65,76,49,27,0.645,75,44,31,0.5870000000000001,27,22,25,19,210.0,212.12,211.06
2014-04-04,1610612744,1610612758,2013,102.0,69.0,171.0,102.55,100.1,99.35,102.25,75,46,29,0.613,75,27,48,0.36,24,22,16,11,199.28,208.96,204.12
2014-04-04,1610612747,1610612742,2013,95.0,107.0,202.0,108.95,116.65,108.15,104.55,75,25,50,0.333,76,45,31,0.5920000000000001,14,11,25,20,215.4,213.76,214.57999999999998
2014-04-03,1610612760,1610612759,2013,106.0,94.0,200.0,108.25,102.95,110.5,96.0,73,54,19,0.74,75,59,16,0.787,31,23,30,29,206.52,204.2,205.36
2014-04-03,1610612746,1610612742,2013,107.0,113.0,220.0,110.0,100.4,106.95,104.9,76,54,22,0.711,75,44,31,0.5870000000000001,31,23,25,19,208.68,213.76,211.22
2014-04-02,1610612754,1610612765,2013,101.0,94.0,195.0,91.5,94.35,101.55,107.45,75,52,23,0.693,74,27,47,0.365,33,19,16,11,187.84,205.36,196.60000000000002
2014-04-02,1610612752,1610612751,2013,110.0,81.0,191.0,102.4,99.55,103.0,98.65,75,32,43,0.4270000000000001,73,40,33,0.5479999999999999,16,16,26,14,201.64,196.12,198.88
2014-04-02,1610612753,1610612739,2013,98.0,119.0,217.0,98.2,102.3,97.65,100.65,74,21,53,0.284,75,30,45,0.4,17,4,17,13,202.92,196.2,199.56
2014-04-02,1610612755,1610612766,2013,93.0,123.0,216.0,94.55,108.15,100.05,99.5,74,16,58,0.21600000000000005,74,36,38,0.486,9,7,22,14,210.2,193.72,201.95999999999998
2014-04-02,1610612761,1610612745,2013,107.0,103.0,210.0,103.95,99.9,110.5,104.0,74,42,32,0.568,73,49,24,0.6709999999999999,22,20,29,20,201.68,210.8,206.24
2014-04-02,1610612764,1610612738,2013,118.0,92.0,210.0,103.65,102.65,96.45,102.6,74,38,36,0.514,74,23,51,0.311,19,19,15,8,198.72,194.24,196.48000000000002
2014-04-02,1610612737,1610612741,2013,92.0,105.0,197.0,99.7,104.6,92.55,90.95,73,32,41,0.438,74,42,32,0.568,21,11,24,18,203.28,183.28,193.28
2014-04-02,1610612748,1610612749,2013,96.0,77.0,173.0,99.4,93.6,100.8,107.55,73,51,22,0.6990000000000001,74,14,60,0.189,29,22,9,5,203.48,199.2,201.33999999999997
2014-04-02,1610612750,1610612763,2013,102.0,88.0,190.0,109.95,108.6,96.85,91.65,73,36,37,0.493,74,44,30,0.595,21,15,23,21,210.96,195.28,203.12
2014-04-02,1610612759,1610612744,2013,111.0,90.0,201.0,109.55,95.6,103.1,99.15,74,58,16,0.784,74,46,28,0.622,29,29,24,22,204.6,199.28,201.94
2014-04-02,1610612743,1610612740,2013,137.0,107.0,244.0,105.3,110.8,99.85,103.15,74,32,42,0.4320000000000001,74,32,42,0.4320000000000001,19,13,20,12,212.64,202.24,207.44
2014-04-02,1610612756,1610612746,2013,108.0,112.0,220.0,106.5,105.8,110.65,100.85,74,44,30,0.595,75,53,22,0.7070000000000001,25,19,31,22,211.6,208.68,210.14
2014-04-02,1610612758,1610612747,2013,107.0,102.0,209.0,99.45,102.2,109.8,116.7,74,26,48,0.35100000000000003,74,25,49,0.338,15,11,14,11,208.84,215.4,212.12
2014-04-01,1610612751,1610612745,2013,105.0,96.0,201.0,103.0,98.3,110.65,103.85,72,39,33,0.542,72,49,23,0.6809999999999999,25,14,29,20,196.88,210.8,203.84
2014-04-01,1610612742,1610612744,2013,120.0,122.0,242.0,105.5,103.8,102.45,99.25,74,44,30,0.595,73,45,28,0.616,25,19,24,21,212.76,199.28,206.01999999999998
2014-04-01,1610612747,1610612757,2013,112.0,124.0,236.0,109.3,115.9,103.45,99.4,73,25,48,0.342,75,48,27,0.64,14,11,27,21,214.84,210.0,212.42000000000002
2014-03-31,1610612766,1610612764,2013,100.0,94.0,194.0,99.55,99.15,103.75,101.8,73,35,38,0.479,73,38,35,0.521,21,14,19,19,192.96,198.72,195.84
2014-03-31,1610612754,1610612759,2013,77.0,103.0,180.0,91.3,93.25,109.6,96.35,74,52,22,0.703,73,57,16,0.7809999999999999,33,19,29,28,188.44,204.6,196.51999999999998
2014-03-31,1610612737,1610612755,2013,103.0,95.0,198.0,98.35,103.8,93.7,109.15,72,31,41,0.431,73,16,57,0.219,20,11,9,7,203.24,210.2,206.72
2014-03-31,1610612765,1610612749,2013,116.0,111.0,227.0,100.55,107.3,101.75,107.25,73,26,47,0.35600000000000004,73,14,59,0.192,15,11,9,5,205.08,199.2,202.14
2014-03-31,1610612748,1610612761,2013,93.0,83.0,176.0,99.4,93.4,105.05,101.15,72,50,22,0.6940000000000001,73,42,31,0.575,28,22,22,20,204.32,201.68,203.0
2014-03-31,1610612741,1610612738,2013,94.0,80.0,174.0,93.3,91.45,97.55,102.2,73,41,32,0.562,73,23,50,0.315,23,18,15,8,183.84,194.24,189.04000000000002
2014-03-31,1610612750,1610612746,2013,104.0,114.0,218.0,110.6,107.4,109.75,100.75,72,36,36,0.5,74,52,22,0.703,21,15,31,21,210.44,208.68,209.56
2014-03-31,1610612740,1610612758,2013,97.0,102.0,199.0,100.6,103.25,100.45,103.65,73,32,41,0.438,73,25,48,0.342,20,12,15,10,202.04,208.84,205.44
2014-03-31,1610612743,1610612763,2013,92.0,94.0,186.0,105.45,111.55,97.65,92.25,73,32,41,0.438,73,43,30,0.589,19,13,23,20,213.28,195.28,204.28
2014-03-31,1610612762,1610612752,2013,83.0,92.0,175.0,95.6,104.55,102.3,100.85,74,23,51,0.311,74,31,43,0.419,15,8,16,15,198.4,201.64,200.01999999999998
2014-03-30,1610612760,1610612762,2013,116.0,96.0,212.0,108.3,104.4,94.75,103.7,72,53,19,0.736,73,23,50,0.315,30,23,15,8,206.12,198.4,202.26
2014-03-30,1610612739,1610612754,2013,90.0,76.0,166.0,98.2,101.5,92.6,93.6,74,29,45,0.392,73,52,21,0.7120000000000001,16,13,33,19,198.56,188.44,193.5
2014-03-30,1610612751,1610612750,2013,114.0,99.0,213.0,101.95,97.4,110.2,106.6,71,38,33,0.535,71,36,35,0.507,24,14,21,15,197.32,210.44,203.88
2014-03-30,1610612753,1610612761,2013,93.0,98.0,191.0,98.7,102.5,105.2,101.95,73,21,52,0.28800000000000003,72,41,31,0.569,17,4,22,19,203.64,201.68,202.66
2014-03-30,1610612738,1610612741,2013,102.0,107.0,209.0,97.05,102.05,92.3,91.45,72,23,49,0.319,72,40,32,0.556,15,8,23,17,193.8,183.84,188.82
2014-03-30,1610612744,1610612752,2013,84.0,89.0,173.0,103.35,99.75,101.95,102.05,72,45,27,0.625,73,30,43,0.411,24,21,16,14,200.6,201.64,201.12
2014-03-30,1610612757,1610612763,2013,105.0,98.0,203.0,103.65,100.05,98.1,92.65,74,47,27,0.635,72,43,29,0.597,26,21,23,20,210.44,195.28,202.86
2014-03-30,1610612747,1610612756,2013,115.0,99.0,214.0,108.6,115.55,107.15,105.4,72,24,48,0.333,73,44,29,0.603,13,11,25,19,214.28,211.6,212.94
2014-03-29,1610612755,1610612765,2013,123.0,98.0,221.0,93.15,110.45,100.55,106.95,72,15,57,0.208,72,26,46,0.361,8,7,15,11,208.44,205.08,206.76
2014-03-29,1610612745,1610612746,2013,107.0,118.0,225.0,110.6,102.55,109.6,101.2,71,49,22,0.69,73,51,22,0.6990000000000001,29,20,31,20,209.32,208.68,209.0
2014-03-29,1610612764,1610612737,2013,101.0,97.0,198.0,103.35,101.15,98.85,104.5,72,37,35,0.514,71,31,40,0.4370000000000001,18,19,20,11,199.2,203.24,201.22
2014-03-29,1610612742,1610612758,2013,103.0,100.0,203.0,105.75,103.25,100.9,103.25,73,43,30,0.589,72,25,47,0.34700000000000003,24,19,15,10,212.48,208.84,210.66
2014-03-29,1610612749,1610612748,2013,67.0,88.0,155.0,103.6,107.85,100.85,95.35,72,14,58,0.194,71,49,22,0.69,9,5,28,21,200.24,204.32,202.28
2014-03-29,1610612759,1610612740,2013,96.0,80.0,176.0,110.8,97.85,101.65,103.85,72,56,16,0.778,72,32,40,0.444,28,28,20,12,206.08,202.04,204.06
2014-03-28,1610612753,1610612766,2013,110.0,105.0,215.0,98.8,102.15,98.85,97.4,72,20,52,0.278,72,35,37,0.486,16,4,21,14,203.04,192.96,198.0
2014-03-28,1610612761,1610612738,2013,105.0,103.0,208.0,104.85,101.35,97.6,102.2,71,40,31,0.563,71,23,48,0.324,21,19,15,8,201.68,193.8,197.74
2014-03-28,1610612764,1610612754,2013,91.0,78.0,169.0,104.45,103.0,94.2,94.05,71,36,35,0.507,72,52,20,0.722,17,19,33,19,198.4,188.44,193.42000000000002
2014-03-28,1610612751,1610612739,2013,108.0,97.0,205.0,101.7,97.0,99.05,100.35,70,37,33,0.529,73,29,44,0.397,23,14,16,13,196.92,198.56,197.74
2014-03-28,1610612765,1610612748,2013,78.0,110.0,188.0,101.1,106.1,100.9,96.95,71,26,45,0.366,70,48,22,0.6859999999999999,15,11,28,20,205.64,204.32,204.98
2014-03-28,1610612741,1610612757,2013,74.0,91.0,165.0,93.75,91.05,104.1,101.1,71,40,31,0.563,73,46,27,0.63,23,17,26,20,184.6,210.44,197.51999999999998
2014-03-28,1610612750,1610612747,2013,143.0,107.0,250.0,107.5,106.6,108.2,113.85,70,35,35,0.5,71,24,47,0.338,20,15,13,11,207.84,214.28,211.06
2014-03-28,1610612740,1610612762,2013,102.0,95.0,197.0,102.05,105.25,94.7,103.7,71,31,40,0.4370000000000001,72,23,49,0.319,19,12,15,8,202.24,198.4,200.32
2014-03-28,1610612760,1610612758,2013,94.0,81.0,175.0,107.65,105.5,102.15,103.6,71,52,19,0.732,71,25,46,0.35200000000000004,29,23,15,10,207.08,208.84,207.96
2014-03-28,1610612743,1610612759,2013,102.0,133.0,235.0,105.7,110.5,109.15,98.2,72,32,40,0.444,71,55,16,0.775,19,13,28,27,211.8,206.08,208.94
2014-03-28,1610612756,1610612752,2013,112.0,88.0,200.0,106.85,105.25,102.45,101.8,72,43,29,0.597,72,30,42,0.417,24,19,16,14,212.84,201.64,207.24
2014-03-28,1610612744,1610612763,2013,100.0,93.0,193.0,103.85,100.65,97.9,92.25,71,44,27,0.62,71,43,28,0.606,23,21,23,20,200.76,195.28,198.01999999999998
2014-03-27,1610612737,1610612757,2013,85.0,100.0,185.0,98.85,103.95,104.95,102.95,70,31,39,0.443,72,45,27,0.625,20,11,26,19,204.0,210.44,207.22
2014-03-27,1610612745,1610612755,2013,120.0,98.0,218.0,109.45,102.15,93.35,109.85,70,48,22,0.6859999999999999,71,15,56,0.211,28,20,8,7,208.0,208.44,208.22
2014-03-27,1610612749,1610612747,2013,108.0,105.0,213.0,103.1,107.7,108.1,113.95,71,13,58,0.183,70,24,46,0.343,8,5,13,11,199.16,214.28,206.72
2014-03-27,1610612742,1610612746,2013,103.0,109.0,212.0,105.9,103.65,108.75,101.6,72,43,29,0.597,72,50,22,0.6940000000000001,24,19,31,19,211.96,208.68,210.32
2014-03-26,1610612766,1610612751,2013,116.0,111.0,227.0,98.85,96.75,100.45,95.85,71,34,37,0.479,69,37,32,0.536,20,14,23,14,192.92,196.92,194.92
2014-03-26,1610612764,1610612756,2013,93.0,99.0,192.0,105.7,104.3,107.3,106.7,70,36,34,0.514,71,42,29,0.5920000000000001,17,19,24,18,199.28,212.84,206.06
2014-03-26,1610612738,1610612761,2013,90.0,99.0,189.0,97.65,102.35,104.6,100.8,70,23,47,0.329,70,39,31,0.557,15,8,21,18,193.28,201.68,197.48000000000002
2014-03-26,1610612765,1610612739,2013,96.0,97.0,193.0,101.75,106.25,98.85,100.0,70,26,44,0.371,72,28,44,0.389,15,11,16,12,206.52,198.56,202.54000000000002
2014-03-26,1610612750,1610612737,2013,107.0,83.0,190.0,107.65,108.3,99.6,104.0,69,34,35,0.493,69,31,38,0.449,19,15,20,11,209.32,204.0,206.66
2014-03-26,1610612740,1610612746,2013,98.0,96.0,194.0,101.7,105.35,109.65,101.0,70,30,40,0.429,71,50,21,0.7040000000000001,18,12,31,19,203.16,208.68,205.92000000000002
2014-03-26,1610612754,1610612748,2013,84.0,83.0,167.0,95.95,93.9,101.9,97.6,71,51,20,0.718,69,48,21,0.696,32,19,28,20,189.64,204.32,196.98
2014-03-26,1610612759,1610612743,2013,108.0,103.0,211.0,108.5,97.7,105.6,109.6,70,54,16,0.7709999999999999,71,32,39,0.451,27,27,19,13,206.72,211.8,209.26
2014-03-26,1610612758,1610612752,2013,99.0,107.0,206.0,102.15,101.75,103.15,103.3,70,25,45,0.35700000000000004,71,29,42,0.408,15,10,16,13,208.28,201.64,204.95999999999998
2014-03-26,1610612762,1610612763,2013,87.0,91.0,178.0,95.6,104.15,97.65,91.95,71,23,48,0.324,70,42,28,0.6,15,8,23,19,199.84,195.28,197.56
2014-03-25,1610612739,1610612761,2013,102.0,100.0,202.0,99.2,99.95,104.75,101.0,71,27,44,0.38,69,39,30,0.565,15,12,21,18,199.88,201.68,200.78
2014-03-25,1610612753,1610612757,2013,95.0,85.0,180.0,99.7,103.0,106.55,103.7,71,19,52,0.268,71,45,26,0.634,15,4,26,19,203.8,210.44,207.12
2014-03-25,1610612742,1610612760,2013,128.0,119.0,247.0,104.65,101.75,107.7,103.85,71,42,29,0.5920000000000001,70,52,18,0.743,23,19,29,23,208.92,207.08,208.0
2014-03-25,1610612747,1610612752,2013,127.0,96.0,223.0,107.15,115.85,103.25,101.5,69,23,46,0.333,70,29,41,0.414,12,11,16,13,214.24,201.64,207.94
2014-03-24,1610612766,1610612745,2013,89.0,100.0,189.0,100.1,96.2,111.15,103.1,70,34,36,0.486,69,47,22,0.6809999999999999,20,14,28,19,193.08,208.0,200.54000000000002
2014-03-24,1610612737,1610612756,2013,95.0,102.0,197.0,100.85,104.55,107.3,106.65,68,31,37,0.456,70,41,29,0.586,20,11,24,17,203.12,212.84,207.98000000000002
2014-03-24,1610612748,1610612757,2013,93.0,91.0,184.0,102.35,97.85,107.65,104.95,68,47,21,0.691,70,45,25,0.643,27,20,26,19,204.92,210.44,207.68
2014-03-24,1610612741,1610612754,2013,89.0,77.0,166.0,95.15,91.65,96.65,94.65,70,39,31,0.557,70,51,19,0.7290000000000001,22,17,32,19,184.56,189.64,187.1
2014-03-24,1610612763,1610612750,2013,109.0,92.0,201.0,97.0,92.85,107.9,108.15,69,41,28,0.594,68,34,34,0.5,22,19,19,15,194.4,209.32,201.86
2014-03-24,1610612740,1610612751,2013,109.0,104.0,213.0,101.15,104.7,100.5,95.35,69,29,40,0.42,68,37,31,0.544,17,12,23,14,202.8,196.92,199.86
2014-03-24,1610612760,1610612743,2013,117.0,96.0,213.0,107.45,104.05,105.3,109.6,69,51,18,0.7390000000000001,70,32,38,0.457,28,23,19,13,207.32,211.8,209.56
2014-03-24,1610612759,1610612755,2013,113.0,91.0,204.0,107.15,97.95,93.6,109.85,69,53,16,0.768,70,15,55,0.214,26,27,8,7,207.0,208.44,207.72
2014-03-24,1610612762,1610612765,2013,94.0,114.0,208.0,95.6,102.9,100.95,107.15,70,23,47,0.329,69,25,44,0.362,15,8,15,10,198.76,206.52,202.64
2014-03-24,1610612746,1610612749,2013,106.0,98.0,204.0,110.5,100.0,103.2,107.9,70,49,21,0.7,70,13,57,0.18600000000000005,30,19,8,5,208.8,199.16,203.98000000000002
2014-03-23,1610612761,1610612737,2013,96.0,86.0,182.0,104.55,101.4,100.7,104.95,68,38,30,0.5589999999999999,67,31,36,0.463,20,18,20,11,203.16,203.12,203.14
2014-03-23,1610612750,1610612756,2013,120.0,127.0,247.0,107.35,106.75,107.25,106.5,67,34,33,0.507,69,40,29,0.58,19,15,24,16,207.12,212.84,209.98000000000002
2014-03-23,1610612743,1610612764,2013,105.0,102.0,207.0,105.55,109.5,106.3,103.9,69,31,38,0.449,69,36,33,0.522,18,13,17,19,211.32,199.28,205.3
2014-03-23,1610612758,1610612749,2013,124.0,107.0,231.0,100.4,101.35,102.35,106.65,69,24,45,0.348,69,13,56,0.188,14,10,8,5,208.16,199.16,203.66
2014-03-23,1610612742,1610612751,2013,104.0,107.0,211.0,105.65,101.75,98.95,94.75,70,42,28,0.6,67,36,31,0.537,23,19,23,13,209.2,196.92,203.06
2014-03-23,1610612752,1610612739,2013,100.0,106.0,206.0,102.8,101.5,99.65,100.6,69,29,40,0.42,70,26,44,0.371,16,13,15,11,202.08,199.88,200.98000000000002
2014-03-23,1610612747,1610612753,2013,103.0,94.0,197.0,107.15,116.5,99.65,102.9,68,22,46,0.324,70,19,51,0.271,11,11,15,4,213.8,203.8,208.8
2014-03-22,1610612766,1610612757,2013,124.0,94.0,218.0,98.9,96.7,107.65,103.25,69,33,36,0.478,69,45,24,0.652,19,14,26,19,191.08,210.44,200.76
2014-03-22,1610612739,1610612745,2013,111.0,118.0,229.0,98.65,98.85,110.6,102.0,69,26,43,0.377,68,46,22,0.6759999999999999,15,11,28,18,198.84,208.0,203.42000000000002
2014-03-22,1610612741,1610612755,2013,91.0,81.0,172.0,95.2,91.4,94.3,110.0,69,38,31,0.551,69,15,54,0.217,21,17,8,7,184.72,208.44,196.57999999999998
2014-03-22,1610612763,1610612754,2013,82.0,71.0,153.0,97.85,93.8,97.7,95.2,68,40,28,0.588,69,51,18,0.7390000000000001,21,19,32,19,195.88,189.64,192.76
2014-03-22,1610612740,1610612748,2013,105.0,95.0,200.0,101.15,104.95,102.05,97.3,68,28,40,0.412,67,47,20,0.701,16,12,27,20,202.68,204.92,203.8
2014-03-22,1610612762,1610612753,2013,89.0,88.0,177.0,95.1,103.2,100.25,103.65,69,22,47,0.319,69,19,50,0.275,14,8,15,4,200.16,203.8,201.98000000000002
2014-03-22,1610612744,1610612759,2013,90.0,99.0,189.0,105.5,99.7,107.4,98.45,70,44,26,0.629,68,52,16,0.765,23,21,26,26,202.32,207.0,204.66
2014-03-22,1610612746,1610612765,2013,112.0,103.0,215.0,110.8,100.1,100.6,106.65,69,48,21,0.696,68,25,43,0.368,29,19,15,10,208.4,206.52,207.46
2014-03-21,1610612754,1610612741,2013,91.0,79.0,170.0,99.05,96.9,96.3,91.45,68,50,18,0.735,68,38,30,0.5589999999999999,31,19,21,17,190.56,184.72,187.64
2014-03-21,1610612755,1610612752,2013,92.0,93.0,185.0,93.95,111.05,102.8,101.8,68,15,53,0.221,68,28,40,0.412,8,7,16,12,208.84,202.08,205.46
2014-03-21,1610612761,1610612760,2013,118.0,119.0,237.0,103.85,99.6,107.1,102.9,67,38,29,0.5670000000000001,68,50,18,0.735,20,18,28,22,202.08,207.32,204.7
2014-03-21,1610612737,1610612740,2013,105.0,111.0,216.0,99.4,104.65,99.65,104.35,66,31,35,0.47,67,27,40,0.403,20,11,16,11,202.52,202.68,202.60000000000002
2014-03-21,1610612751,1610612738,2013,114.0,98.0,212.0,98.65,94.95,97.15,102.35,66,35,31,0.53,69,23,46,0.333,22,13,15,8,196.44,193.28,194.86
2014-03-21,1610612748,1610612763,2013,91.0,86.0,177.0,102.25,98.6,97.7,93.8,66,46,20,0.6970000000000001,67,40,27,0.597,26,20,21,19,205.84,195.88,200.86
2014-03-21,1610612742,1610612743,2013,122.0,106.0,228.0,104.9,101.6,104.25,109.35,69,41,28,0.594,68,31,37,0.456,22,19,18,13,208.16,211.32,209.74
2014-03-21,1610612756,1610612765,2013,98.0,92.0,190.0,107.35,106.6,101.3,107.55,68,39,29,0.574,67,25,42,0.373,23,16,15,10,213.6,206.52,210.06
2014-03-21,1610612758,1610612759,2013,79.0,99.0,178.0,102.3,102.65,106.9,99.65,68,24,44,0.353,67,51,16,0.7609999999999999,14,10,26,25,209.12,207.0,208.06
2014-03-21,1610612747,1610612764,2013,107.0,117.0,224.0,105.75,115.45,106.05,104.2,67,22,45,0.328,68,35,33,0.515,11,11,17,18,212.72,199.28,206.0
2014-03-20,1610612739,1610612760,2013,95.0,102.0,197.0,99.3,99.7,107.15,102.7,68,26,42,0.382,67,49,18,0.731,15,11,28,21,197.76,207.32,202.54
2014-03-20,1610612745,1610612750,2013,129.0,106.0,235.0,108.5,101.1,107.7,106.3,67,45,22,0.672,66,34,32,0.515,27,18,19,15,206.96,207.12,207.04000000000002
2014-03-20,1610612757,1610612764,2013,116.0,103.0,219.0,106.6,103.0,105.35,103.0,68,44,24,0.647,67,35,32,0.522,25,19,17,18,210.8,199.28,205.04000000000002
2014-03-20,1610612744,1610612749,2013,115.0,110.0,225.0,104.85,98.55,101.95,106.55,69,43,26,0.623,68,13,55,0.191,22,21,8,5,200.84,199.16,200.0
2014-03-19,1610612755,1610612741,2013,94.0,102.0,196.0,94.15,111.55,94.7,91.7,67,15,52,0.224,67,37,30,0.552,8,7,21,16,211.04,184.72,197.88
2014-03-19,1610612738,1610612748,2013,101.0,96.0,197.0,97.05,102.0,103.25,99.15,68,22,46,0.324,65,46,19,0.708,14,8,26,20,192.76,205.84,199.3
2014-03-19,1610612751,1610612766,2013,104.0,99.0,203.0,98.2,96.0,98.7,96.75,65,34,31,0.523,68,33,35,0.485,21,13,19,14,196.16,191.08,193.62
2014-03-19,1610612763,1610612762,2013,96.0,86.0,182.0,97.85,93.55,95.6,102.35,66,39,27,0.591,68,22,46,0.324,20,19,14,8,195.88,200.16,198.01999999999998
2014-03-19,1610612740,1610612761,2013,100.0,107.0,207.0,99.4,104.1,103.5,99.1,66,27,39,0.409,66,37,29,0.561,16,11,20,17,202.52,202.08,202.3
2014-03-19,1610612752,1610612754,2013,92.0,86.0,178.0,104.05,101.8,99.2,96.55,67,27,40,0.403,67,50,17,0.746,15,12,31,19,201.4,190.56,195.98000000000002
2014-03-19,1610612742,1610612750,2013,122.0,123.0,245.0,104.55,101.3,106.3,104.5,68,41,27,0.603,65,33,32,0.508,22,19,19,14,206.6,207.12,206.86
2014-03-19,1610612743,1610612765,2013,118.0,109.0,227.0,104.15,109.65,100.9,106.85,67,30,37,0.448,66,25,41,0.379,17,13,15,10,210.08,206.52,208.3
2014-03-19,1610612756,1610612753,2013,109.0,93.0,202.0,106.75,107.1,99.55,103.1,67,38,29,0.5670000000000001,68,19,49,0.279,22,16,15,4,213.84,203.8,208.82
2014-03-19,1610612747,1610612759,2013,109.0,125.0,234.0,104.6,113.8,106.9,100.1,66,22,44,0.333,66,50,16,0.758,11,11,26,24,211.88,207.0,209.44
2014-03-18,1610612739,1610612748,2013,96.0,100.0,196.0,98.95,99.7,103.55,98.9,67,26,41,0.388,64,45,19,0.703,15,11,26,19,197.36,205.84,201.60000000000002
2014-03-18,1610612737,1610612761,2013,118.0,113.0,231.0,99.55,104.7,103.05,98.35,65,30,35,0.462,65,37,28,0.569,19,11,20,17,200.52,202.08,201.3
2014-03-18,1610612757,1610612749,2013,120.0,115.0,235.0,105.9,102.4,100.1,105.2,67,43,24,0.642,67,13,54,0.194,24,19,8,5,210.0,199.16,204.57999999999998
2014-03-18,1610612758,1610612764,2013,117.0,111.0,228.0,102.0,102.9,104.95,102.65,67,23,44,0.343,66,35,31,0.53,13,10,17,18,208.44,199.28,203.86
2014-03-18,1610612744,1610612753,2013,103.0,89.0,192.0,103.45,98.65,99.55,102.75,68,42,26,0.618,67,19,48,0.284,21,21,15,4,201.76,203.8,202.78
2014-03-17,1610612766,1610612737,2013,83.0,97.0,180.0,98.9,96.35,98.95,105.55,67,33,34,0.493,64,29,35,0.453,19,14,19,10,190.8,200.52,195.66000000000003
2014-03-17,1610612754,1610612755,2013,99.0,90.0,189.0,99.15,96.0,95.15,111.9,66,49,17,0.742,66,15,51,0.227,30,19,8,7,189.96,211.04,200.5
2014-03-17,1610612751,1610612756,2013,108.0,95.0,203.0,97.95,96.45,108.2,107.35,64,33,31,0.516,66,38,28,0.5760000000000001,20,13,22,16,195.96,213.84,204.9
2014-03-17,1610612741,1610612760,2013,85.0,97.0,182.0,95.45,91.1,107.35,102.6,66,37,29,0.561,66,48,18,0.727,21,16,28,20,183.52,207.32,195.42000000000002
2014-03-17,1610612745,1610612762,2013,124.0,86.0,210.0,108.25,101.7,95.35,101.3,66,44,22,0.667,67,22,45,0.328,26,18,14,8,206.44,200.16,203.3
2014-03-17,1610612742,1610612738,2013,94.0,89.0,183.0,105.65,102.15,98.25,102.85,67,40,27,0.597,67,22,45,0.328,21,19,14,8,207.12,192.76,199.94
2014-03-17,1610612743,1610612746,2013,110.0,100.0,210.0,103.15,109.65,112.1,100.5,66,29,37,0.439,68,48,20,0.706,16,13,29,19,209.36,208.4,208.88
2014-03-16,1610612749,1610612766,2013,92.0,101.0,193.0,99.8,105.25,99.35,96.75,66,13,53,0.197,66,32,34,0.485,8,5,19,13,198.32,190.8,194.56
2014-03-16,1610612761,1610612756,2013,113.0,121.0,234.0,102.8,97.35,107.1,106.2,64,37,27,0.578,65,37,28,0.569,20,17,22,15,199.64,213.84,206.74
2014-03-16,1610612748,1610612745,2013,113.0,104.0,217.0,103.55,98.75,108.1,100.8,63,44,19,0.698,65,44,21,0.677,25,19,26,18,204.84,206.44,205.64
2014-03-16,1610612740,1610612738,2013,121.0,120.0,241.0,97.75,102.05,96.55,101.45,65,26,39,0.4,66,22,44,0.333,15,11,14,8,201.04,192.76,196.89999999999998
2014-03-16,1610612750,1610612758,2013,104.0,102.0,206.0,105.6,104.1,101.85,103.15,64,32,32,0.5,66,23,43,0.348,18,14,13,10,206.88,208.44,207.66
2014-03-16,1610612760,1610612742,2013,86.0,109.0,195.0,108.35,102.0,105.3,102.4,65,48,17,0.738,66,39,27,0.591,28,20,21,18,208.0,207.12,207.56
2014-03-16,1610612759,1610612762,2013,122.0,104.0,226.0,106.05,100.45,94.5,100.3,65,49,16,0.754,66,22,44,0.333,25,24,14,8,206.04,200.16,203.1
2014-03-16,1610612757,1610612744,2013,112.0,113.0,225.0,104.35,101.65,102.55,97.55,66,43,23,0.652,67,41,26,0.612,24,19,21,20,209.32,201.76,205.54
2014-03-16,1610612746,1610612739,2013,102.0,80.0,182.0,112.6,102.3,100.3,100.8,67,47,20,0.701,66,26,40,0.394,28,19,15,11,208.04,197.36,202.7
2014-03-15,1610612752,1610612749,2013,115.0,94.0,209.0,104.0,101.5,99.2,105.0,66,26,40,0.394,65,13,52,0.2,14,12,8,5,200.52,198.32,199.42000000000002
2014-03-15,1610612764,1610612751,2013,101.0,94.0,195.0,104.9,102.45,98.0,96.95,65,34,31,0.523,63,33,30,0.524,16,18,20,13,198.6,195.96,197.28
2014-03-15,1610612737,1610612743,2013,97.0,92.0,189.0,99.6,107.3,104.0,111.1,63,28,35,0.444,65,29,36,0.446,18,10,16,13,200.08,209.36,204.72000000000003
2014-03-15,1610612765,1610612754,2013,104.0,112.0,216.0,102.0,106.7,98.75,95.4,65,25,40,0.385,65,48,17,0.738,15,10,30,18,206.08,189.96,198.02
2014-03-15,1610612755,1610612763,2013,77.0,103.0,180.0,96.7,112.45,96.65,93.5,65,15,50,0.231,65,38,27,0.585,8,7,20,18,212.88,195.88,204.38
2014-03-15,1610612741,1610612758,2013,94.0,87.0,181.0,95.05,91.5,101.7,103.1,65,36,29,0.5539999999999999,65,23,42,0.354,20,16,13,10,182.96,208.44,195.7
2014-03-14,1610612766,1610612750,2013,105.0,93.0,198.0,98.85,96.65,106.15,104.6,65,31,34,0.477,63,32,31,0.508,18,13,18,14,190.16,206.88,198.51999999999998
2014-03-14,1610612753,1610612764,2013,101.0,105.0,206.0,100.2,102.75,104.05,101.65,66,19,47,0.28800000000000003,64,33,31,0.516,15,4,16,17,203.56,198.6,201.07999999999998
2014-03-14,1610612755,1610612754,2013,94.0,101.0,195.0,96.95,113.65,98.5,96.15,64,15,49,0.234,64,47,17,0.7340000000000001,8,7,30,17,213.96,189.96,201.96
2014-03-14,1610612761,1610612763,2013,99.0,86.0,185.0,102.75,97.2,96.2,92.85,63,36,27,0.5710000000000001,64,38,26,0.594,19,17,20,18,200.32,195.88,198.1
2014-03-14,1610612738,1610612756,2013,80.0,87.0,167.0,97.35,101.55,107.55,107.1,65,22,43,0.338,64,36,28,0.563,14,8,22,14,194.24,213.84,204.04000000000002
2014-03-14,1610612748,1610612743,2013,107.0,111.0,218.0,103.65,98.3,102.95,111.6,62,44,18,0.71,64,28,36,0.438,25,19,16,12,204.68,209.36,207.02
2014-03-14,1610612740,1610612757,2013,103.0,111.0,214.0,97.6,101.1,103.3,101.5,64,26,38,0.406,65,42,23,0.6459999999999999,15,11,24,18,200.6,209.32,204.95999999999998
2014-03-14,1610612759,1610612747,2013,119.0,85.0,204.0,105.6,100.3,105.6,113.55,64,48,16,0.75,65,22,43,0.338,24,24,11,11,206.6,211.88,209.24
2014-03-14,1610612762,1610612746,2013,87.0,96.0,183.0,94.65,100.25,113.4,102.7,65,22,43,0.338,66,46,20,0.6970000000000001,14,8,28,18,201.36,208.04,204.7
2014-03-14,1610612744,1610612739,2013,94.0,103.0,197.0,103.4,97.0,99.75,101.4,66,41,25,0.621,65,25,40,0.385,21,20,15,10,202.44,197.36,199.9
2014-03-13,1610612741,1610612745,2013,111.0,87.0,198.0,94.25,92.75,109.6,101.0,64,35,29,0.547,64,44,20,0.688,19,16,26,18,182.8,206.44,194.62
2014-03-13,1610612737,1610612749,2013,102.0,97.0,199.0,98.65,106.45,99.55,105.6,62,27,35,0.435,64,13,51,0.203,17,10,8,5,200.76,198.32,199.54
2014-03-13,1610612760,1610612747,2013,131.0,102.0,233.0,106.1,100.75,105.6,112.45,64,47,17,0.7340000000000001,64,22,42,0.344,27,20,11,11,207.32,211.88,209.6
2014-03-12,1610612748,1610612751,2013,95.0,96.0,191.0,103.55,97.8,98.0,97.05,61,44,17,0.721,62,32,30,0.516,25,19,20,12,205.56,195.96,200.76
2014-03-12,1610612753,1610612743,2013,112.0,120.0,232.0,100.05,102.35,103.2,111.85,65,19,46,0.292,63,27,36,0.429,15,4,16,11,202.76,209.36,206.06
2014-03-12,1610612755,1610612758,2013,98.0,115.0,213.0,97.7,114.1,100.4,103.15,63,15,48,0.238,64,22,42,0.344,8,7,13,9,213.68,208.44,211.06
2014-03-12,1610612761,1610612765,2013,101.0,87.0,188.0,103.6,99.15,102.85,106.55,62,35,27,0.565,64,25,39,0.391,18,17,15,10,200.16,206.08,203.12
2014-03-12,1610612764,1610612766,2013,85.0,98.0,183.0,104.6,100.8,99.0,97.3,63,33,30,0.524,64,30,34,0.469,16,17,18,12,199.64,190.16,194.89999999999998
2014-03-12,1610612738,1610612752,2013,92.0,116.0,208.0,97.45,100.5,103.2,102.5,64,22,42,0.344,65,25,40,0.385,14,8,14,11,194.24,200.52,197.38
2014-03-12,1610612740,1610612763,2013,88.0,90.0,178.0,98.05,102.3,96.4,92.95,63,26,37,0.413,63,37,26,0.5870000000000001,15,11,20,17,202.8,195.88,199.34
2014-03-12,1610612762,1610612742,2013,101.0,108.0,209.0,94.9,99.8,105.4,102.15,64,22,42,0.344,65,38,27,0.585,14,8,21,17,199.88,207.12,203.5
2014-03-12,1610612759,1610612757,2013,103.0,90.0,193.0,105.45,101.25,103.2,101.5,63,47,16,0.746,64,42,22,0.6559999999999999,23,24,24,18,207.08,209.32,208.2
2014-03-12,1610612756,1610612739,2013,101.0,110.0,211.0,108.6,107.05,98.55,102.2,63,36,27,0.5710000000000001,64,24,40,0.375,22,14,15,9,214.32,197.36,205.84
2014-03-12,1610612746,1610612744,2013,111.0,98.0,209.0,112.95,102.15,103.35,95.8,65,45,20,0.6920000000000001,65,41,24,0.631,27,18,21,20,207.8,202.44,205.12
2014-03-11,1610612754,1610612738,2013,94.0,83.0,177.0,98.65,96.8,97.85,100.45,63,46,17,0.73,63,22,41,0.349,29,17,14,8,189.52,194.24,191.88
2014-03-11,1610612765,1610612758,2013,99.0,89.0,188.0,103.45,106.85,100.6,102.95,63,24,39,0.381,63,22,41,0.349,14,10,13,9,207.16,208.44,207.8
2014-03-11,1610612741,1610612759,2013,96.0,104.0,200.0,94.55,92.55,105.35,101.2,63,35,28,0.556,62,46,16,0.742,19,16,23,23,185.16,207.08,196.12
2014-03-11,1610612763,1610612757,2013,109.0,99.0,208.0,95.55,92.75,103.1,101.3,62,36,26,0.581,63,42,21,0.667,19,17,24,18,195.6,209.32,202.45999999999998
2014-03-11,1610612750,1610612749,2013,112.0,101.0,213.0,104.95,103.4,99.2,105.8,62,31,31,0.5,63,13,50,0.206,17,14,8,5,206.12,198.32,202.22
2014-03-11,1610612760,1610612745,2013,106.0,98.0,204.0,106.35,101.3,108.75,100.65,63,46,17,0.73,63,44,19,0.698,26,20,26,18,208.16,206.44,207.3
2014-03-11,1610612744,1610612742,2013,108.0,85.0,193.0,102.2,95.95,106.45,102.1,64,40,24,0.625,64,38,26,0.594,20,20,21,17,201.48,207.12,204.3
2014-03-10,1610612766,1610612743,2013,105.0,98.0,203.0,98.75,97.15,103.55,112.1,63,29,34,0.46,62,27,35,0.435,17,12,16,11,189.6,209.36,199.48000000000002
2014-03-10,1610612751,1610612761,2013,101.0,97.0,198.0,98.3,97.5,103.95,98.85,61,31,30,0.508,61,35,26,0.574,19,12,18,17,195.76,200.16,197.95999999999998
2014-03-10,1610612748,1610612764,2013,99.0,90.0,189.0,103.95,97.7,105.15,101.05,60,43,17,0.7170000000000001,62,33,29,0.532,24,19,16,17,206.84,199.64,203.24
2014-03-10,1610612752,1610612755,2013,123.0,110.0,233.0,102.55,102.15,97.15,113.3,64,24,40,0.375,62,15,47,0.242,13,11,8,7,199.36,213.68,206.52
2014-03-10,1610612749,1610612753,2013,105.0,98.0,203.0,98.7,105.95,99.3,102.0,62,12,50,0.194,64,19,45,0.297,7,5,15,4,198.32,202.76,200.54
2014-03-10,1610612762,1610612737,2013,110.0,112.0,222.0,94.6,99.25,98.05,106.2,63,22,41,0.349,61,26,35,0.426,14,8,17,9,198.4,200.76,199.57999999999998
2014-03-10,1610612746,1610612756,2013,112.0,105.0,217.0,112.85,102.05,108.75,106.95,64,44,20,0.688,62,36,26,0.581,26,18,22,14,207.32,214.32,210.82
2014-03-09,1610612741,1610612748,2013,95.0,88.0,183.0,94.95,92.05,105.25,99.0,62,34,28,0.5479999999999999,59,43,16,0.7290000000000001,18,16,24,19,184.52,206.84,195.68
2014-03-09,1610612747,1610612760,2013,114.0,110.0,224.0,104.9,112.45,106.4,100.85,63,21,42,0.333,62,46,16,0.742,10,11,26,20,209.92,208.16,209.04
2014-03-09,1610612740,1610612743,2013,111.0,107.0,218.0,96.85,101.8,103.35,112.4,62,25,37,0.403,61,27,34,0.443,14,11,16,11,201.32,209.36,205.34
2014-03-09,1610612738,1610612765,2013,118.0,111.0,229.0,95.9,99.15,103.6,106.15,62,21,41,0.339,62,24,38,0.387,13,8,14,10,192.64,207.16,199.89999999999998
2014-03-09,1610612751,1610612758,2013,104.0,89.0,193.0,98.15,97.55,101.3,103.1,60,30,30,0.5,62,22,40,0.355,18,12,13,9,196.28,208.44,202.36
2014-03-09,1610612745,1610612757,2013,118.0,113.0,231.0,109.15,100.65,103.1,101.7,62,43,19,0.6940000000000001,62,42,20,0.677,25,18,24,18,205.72,209.32,207.51999999999998
2014-03-09,1610612750,1610612761,2013,104.0,111.0,215.0,104.65,101.45,103.15,98.65,61,31,30,0.508,60,34,26,0.5670000000000001,17,14,18,16,206.28,200.16,203.22
2014-03-09,1610612742,1610612754,2013,105.0,94.0,199.0,106.75,103.75,99.75,97.1,63,37,26,0.5870000000000001,62,46,16,0.742,20,17,29,17,208.88,189.52,199.2
2014-03-09,1610612744,1610612756,2013,113.0,107.0,220.0,101.7,95.0,108.35,106.5,63,39,24,0.619,61,36,25,0.59,19,20,22,14,200.28,214.32,207.3
2014-03-08,1610612739,1610612752,2013,97.0,107.0,204.0,98.2,101.8,102.1,102.35,63,24,39,0.381,63,23,40,0.365,15,9,13,10,196.8,199.36,198.08
2014-03-08,1610612755,1610612762,2013,92.0,104.0,196.0,97.1,113.25,93.0,99.55,61,15,46,0.246,62,21,41,0.339,8,7,14,7,215.44,198.4,206.92000000000002
2014-03-08,1610612763,1610612766,2013,111.0,89.0,200.0,94.55,92.8,99.1,97.85,61,35,26,0.574,62,29,33,0.468,18,17,17,12,195.0,189.6,192.3
2014-03-08,1610612759,1610612753,2013,121.0,112.0,233.0,104.75,100.85,98.05,101.1,61,45,16,0.738,63,19,44,0.302,22,23,15,4,206.64,202.76,204.7
2014-03-08,1610612749,1610612764,2013,107.0,114.0,221.0,98.4,105.15,104.5,100.45,61,12,49,0.197,61,32,29,0.525,7,5,16,16,196.56,199.64,198.1
2014-03-08,1610612746,1610612737,2013,109.0,108.0,217.0,113.85,103.0,98.9,105.7,63,43,20,0.6829999999999999,60,26,34,0.433,25,18,17,9,206.96,200.76,203.86
2014-03-07,1610612741,1610612763,2013,77.0,85.0,162.0,95.5,92.9,95.25,93.4,61,34,27,0.557,60,34,26,0.5670000000000001,18,16,18,16,186.2,195.0,190.6
2014-03-07,1610612766,1610612739,2013,101.0,92.0,193.0,98.85,98.45,99.45,102.2,61,28,33,0.459,62,24,38,0.387,16,12,15,9,189.32,196.8,193.06
2014-03-07,1610612761,1610612758,2013,99.0,87.0,186.0,102.85,98.55,101.9,103.45,59,33,26,0.5589999999999999,61,22,39,0.361,17,16,13,9,201.84,208.44,205.14
2014-03-07,1610612738,1610612751,2013,91.0,84.0,175.0,95.5,100.0,98.2,96.95,61,20,41,0.328,59,30,29,0.508,12,8,18,12,193.36,196.28,194.82
2014-03-07,1610612752,1610612762,2013,108.0,81.0,189.0,102.95,103.1,94.45,98.6,62,22,40,0.355,61,21,40,0.344,12,10,14,7,199.88,198.4,199.14
2014-03-07,1610612750,1610612765,2013,114.0,101.0,215.0,104.35,101.95,103.1,106.05,60,30,30,0.5,61,24,37,0.393,16,14,14,10,206.64,207.16,206.89999999999998
2014-03-07,1610612740,1610612749,2013,112.0,104.0,216.0,96.25,101.75,97.45,104.6,61,24,37,0.393,60,12,48,0.2,13,11,7,5,200.76,196.56,198.66
2014-03-07,1610612742,1610612757,2013,103.0,98.0,201.0,106.95,103.25,104.55,102.1,62,36,26,0.581,61,42,19,0.6890000000000001,19,17,24,18,208.48,209.32,208.89999999999998
2014-03-07,1610612743,1610612747,2013,134.0,126.0,260.0,101.55,111.15,103.6,110.85,60,26,34,0.433,62,21,41,0.339,15,11,10,11,207.04,209.92,208.48
2014-03-07,1610612745,1610612754,2013,112.0,86.0,198.0,109.25,101.55,100.45,97.7,61,42,19,0.6890000000000001,61,46,15,0.754,24,18,29,17,205.56,189.52,197.54000000000002
2014-03-07,1610612744,1610612737,2013,111.0,97.0,208.0,102.15,96.2,99.5,105.7,62,38,24,0.613,59,26,33,0.441,18,20,17,9,201.2,200.76,200.98
2014-03-06,1610612759,1610612748,2013,111.0,87.0,198.0,104.4,100.8,106.1,98.25,60,44,16,0.733,58,43,15,0.741,21,23,24,19,206.6,206.84,206.72
2014-03-06,1610612756,1610612760,2013,128.0,122.0,250.0,106.55,105.45,105.5,99.05,60,35,25,0.583,61,46,15,0.754,21,14,26,20,212.44,208.16,210.3
2014-03-06,1610612747,1610612746,2013,94.0,142.0,236.0,103.5,108.95,111.3,103.05,61,21,40,0.344,62,42,20,0.677,10,11,25,17,208.92,206.96,207.94
2014-03-05,1610612766,1610612754,2013,109.0,87.0,196.0,98.8,99.0,101.2,96.95,60,27,33,0.45,60,46,14,0.767,15,12,29,17,188.6,189.52,189.06
2014-03-05,1610612753,1610612745,2013,89.0,101.0,190.0,98.25,100.6,109.35,102.1,62,19,43,0.306,60,41,19,0.6829999999999999,15,4,24,17,203.48,205.56,204.51999999999998
2014-03-05,1610612764,1610612762,2013,104.0,91.0,195.0,104.85,101.55,95.15,98.85,60,31,29,0.517,60,21,39,0.35,15,16,14,7,200.92,198.4,199.66
2014-03-05,1610612738,1610612744,2013,88.0,108.0,196.0,96.3,99.95,102.8,98.15,60,20,40,0.333,61,37,24,0.607,12,8,18,19,192.68,201.2,196.94
2014-03-05,1610612751,1610612763,2013,103.0,94.0,197.0,98.25,97.0,95.45,92.3,58,29,29,0.5,59,34,25,0.5760000000000001,17,12,18,16,196.64,195.0,195.82
2014-03-05,1610612765,1610612741,2013,94.0,105.0,199.0,104.05,105.6,94.2,92.6,60,24,36,0.4,60,33,27,0.55,14,10,18,15,207.52,186.2,196.86
2014-03-05,1610612749,1610612758,2013,102.0,116.0,218.0,98.2,105.1,101.0,104.3,59,12,47,0.203,60,21,39,0.35,7,5,13,8,195.52,208.44,201.98000000000002
2014-03-05,1610612750,1610612752,2013,106.0,118.0,224.0,105.0,100.65,101.5,103.65,59,30,29,0.508,61,21,40,0.344,16,14,12,9,205.64,199.88,202.76
2014-03-05,1610612743,1610612742,2013,115.0,110.0,225.0,101.25,110.45,105.7,102.15,59,25,34,0.424,61,36,25,0.59,14,11,19,17,205.4,208.48,206.94
2014-03-05,1610612757,1610612737,2013,102.0,78.0,180.0,105.2,103.4,101.2,104.95,60,41,19,0.6829999999999999,58,26,32,0.448,23,18,17,9,209.84,200.76,205.3
2014-03-04,1610612739,1610612759,2013,101.0,122.0,223.0,99.05,100.0,102.8,100.6,61,24,37,0.393,59,43,16,0.7290000000000001,15,9,21,22,195.04,206.6,200.82
2014-03-04,1610612754,1610612744,2013,96.0,98.0,194.0,101.1,97.15,102.8,98.45,59,46,13,0.78,60,36,24,0.6,29,17,18,18,189.04,201.2,195.12
2014-03-04,1610612745,1610612748,2013,106.0,103.0,209.0,108.65,102.15,106.0,97.25,59,40,19,0.6779999999999999,57,43,14,0.754,23,17,24,19,206.52,206.84,206.68
2014-03-04,1610612760,1610612755,2013,125.0,92.0,217.0,104.5,99.3,96.4,112.15,60,45,15,0.75,60,15,45,0.25,25,20,8,7,206.76,215.44,211.1
2014-03-04,1610612756,1610612746,2013,96.0,104.0,200.0,107.0,105.0,111.7,103.4,59,35,24,0.593,61,41,20,0.672,21,14,25,16,213.08,206.96,210.02
2014-03-04,1610612747,1610612740,2013,125.0,132.0,257.0,103.15,108.35,93.5,99.9,60,21,39,0.35,60,23,37,0.383,10,11,13,10,206.76,200.76,203.76
2014-03-03,1610612764,1610612763,2013,104.0,110.0,214.0,105.0,101.0,94.35,91.45,59,31,28,0.525,58,33,25,0.569,15,16,18,15,199.84,195.0,197.42000000000002
2014-03-03,1610612751,1610612741,2013,96.0,80.0,176.0,98.55,97.9,95.0,92.1,57,28,29,0.491,59,33,26,0.5589999999999999,16,12,18,15,197.08,186.2,191.64
2014-03-03,1610612765,1610612752,2013,96.0,85.0,181.0,104.4,105.7,102.15,104.25,59,23,36,0.39,60,21,39,0.35,13,10,12,9,207.4,199.88,203.64
2014-03-03,1610612748,1610612766,2013,124.0,107.0,231.0,104.9,96.75,99.0,97.85,56,42,14,0.75,59,27,32,0.458,23,19,15,12,205.56,188.6,197.07999999999998
2014-03-03,1610612749,1610612762,2013,114.0,88.0,202.0,96.8,106.4,95.7,98.65,58,11,47,0.19,59,21,38,0.35600000000000004,6,5,14,7,194.16,198.4,196.28
2014-03-03,1610612743,1610612750,2013,128.0,132.0,260.0,100.3,109.7,104.45,100.25,58,25,33,0.431,58,29,29,0.5,14,11,16,13,204.2,205.64,204.92
2014-03-03,1610612757,1610612747,2013,106.0,107.0,213.0,105.4,103.3,103.4,108.35,59,41,18,0.695,59,20,39,0.339,23,18,10,10,209.04,206.76,207.89999999999998
2014-03-03,1610612758,1610612740,2013,96.0,89.0,185.0,102.4,103.85,94.05,99.55,59,20,39,0.339,59,23,36,0.39,12,8,13,10,208.36,200.76,204.56
2014-03-02,1610612741,1610612752,2013,109.0,90.0,199.0,94.7,92.45,102.75,103.4,58,32,26,0.552,59,21,38,0.35600000000000004,17,15,12,9,185.32,199.88,192.6
2014-03-02,1610612761,1610612744,2013,104.0,98.0,202.0,102.95,99.25,102.95,97.25,58,32,26,0.552,59,36,23,0.61,16,16,18,18,200.8,201.2,201.0
2014-03-02,1610612754,1610612762,2013,94.0,91.0,185.0,101.7,97.2,95.65,98.85,58,45,13,0.7759999999999999,58,21,37,0.362,28,17,14,7,189.8,198.4,194.10000000000002
2014-03-02,1610612753,1610612755,2013,92.0,81.0,173.0,98.7,102.1,97.0,113.1,61,18,43,0.295,59,15,44,0.254,14,4,8,7,203.96,215.44,209.7
2014-03-02,1610612760,1610612766,2013,116.0,99.0,215.0,104.1,99.0,98.65,96.8,59,44,15,0.746,58,27,31,0.466,24,20,15,12,204.88,188.6,196.74
2014-03-02,1610612759,1610612742,2013,112.0,106.0,218.0,102.8,99.8,105.5,101.4,58,42,16,0.7240000000000001,60,36,24,0.6,20,22,19,17,204.72,208.48,206.6
2014-03-02,1610612756,1610612737,2013,129.0,120.0,249.0,105.3,104.05,100.8,103.95,58,34,24,0.586,57,26,31,0.456,20,14,17,9,212.16,200.76,206.45999999999998
2014-03-01,1610612748,1610612753,2013,112.0,98.0,210.0,105.0,98.0,98.4,101.5,55,41,14,0.745,60,18,42,0.3,22,19,14,4,205.0,203.96,204.48000000000002
2014-03-01,1610612755,1610612764,2013,103.0,122.0,225.0,96.6,112.2,104.0,100.25,58,15,43,0.259,58,30,28,0.517,8,7,15,15,214.2,199.84,207.01999999999998
2014-03-01,1610612745,1610612765,2013,118.0,110.0,228.0,108.4,101.6,103.15,104.25,58,39,19,0.672,58,23,35,0.397,22,17,13,10,205.96,207.4,206.68
2014-03-01,1610612738,1610612754,2013,97.0,102.0,199.0,95.85,99.0,100.95,97.2,59,20,39,0.339,57,44,13,0.772,12,8,28,16,192.92,189.8,191.36
2014-03-01,1610612749,1610612751,2013,98.0,107.0,205.0,96.25,106.65,98.35,97.0,57,11,46,0.193,56,27,29,0.482,6,5,16,11,192.88,197.08,194.98000000000002
2014-03-01,1610612763,1610612739,2013,110.0,96.0,206.0,93.35,91.0,99.05,99.9,57,32,25,0.561,60,24,36,0.4,17,15,15,9,193.92,195.04,194.48
2014-03-01,1610612757,1610612743,2013,102.0,96.0,198.0,105.7,103.3,101.65,110.4,58,40,18,0.69,57,25,32,0.439,22,18,14,11,208.28,204.2,206.24
2014-03-01,1610612758,1610612750,2013,97.0,108.0,205.0,102.7,102.6,104.65,100.25,58,20,38,0.345,57,28,29,0.491,12,8,16,12,207.64,205.64,206.64
2014-03-01,1610612746,1610612740,2013,108.0,76.0,184.0,112.45,103.95,95.4,99.2,60,40,20,0.667,58,23,35,0.397,24,16,13,10,208.12,200.76,204.44
2014-02-28,1610612739,1610612762,2013,99.0,79.0,178.0,98.45,100.85,96.4,99.1,59,23,36,0.39,57,21,36,0.368,14,9,14,7,195.48,198.4,196.94
2014-02-28,1610612760,1610612763,2013,113.0,107.0,220.0,104.8,99.7,92.1,89.2,58,43,15,0.741,56,32,24,0.5710000000000001,23,20,17,15,203.92,193.92,198.92
2014-02-28,1610612752,1610612744,2013,103.0,126.0,229.0,102.9,102.6,102.25,96.9,58,21,37,0.362,58,35,23,0.603,12,9,18,17,198.68,201.2,199.94
2014-02-28,1610612742,1610612741,2013,91.0,100.0,191.0,106.45,101.75,94.15,92.25,59,36,23,0.61,57,31,26,0.544,19,17,17,14,208.84,185.32,197.07999999999998
2014-02-28,1610612759,1610612766,2013,92.0,82.0,174.0,104.0,100.3,99.4,97.35,57,41,16,0.7190000000000001,57,27,30,0.474,19,22,15,12,203.76,188.6,196.18
2014-02-28,1610612747,1610612758,2013,126.0,122.0,248.0,102.85,109.1,102.3,101.15,58,19,39,0.328,57,20,37,0.35100000000000003,9,10,12,8,205.16,207.64,206.39999999999998
2014-02-28,1610612756,1610612740,2013,116.0,104.0,220.0,105.7,103.85,94.95,98.0,57,33,24,0.579,57,23,34,0.404,19,14,13,10,212.12,200.76,206.44
2014-02-27,1610612754,1610612749,2013,101.0,96.0,197.0,101.75,96.85,96.45,107.4,56,43,13,0.768,56,11,45,0.196,27,16,6,5,189.16,192.88,191.01999999999998
2014-02-27,1610612761,1610612764,2013,129.0,134.0,263.0,101.2,97.0,100.6,98.45,57,32,25,0.561,57,29,28,0.509,16,16,15,14,198.52,199.84,199.18
2014-02-27,1610612748,1610612752,2013,108.0,82.0,190.0,105.65,99.85,103.4,101.2,54,40,14,0.741,57,21,36,0.368,21,19,12,9,205.48,198.68,202.07999999999998
2014-02-27,1610612743,1610612751,2013,89.0,112.0,201.0,103.2,109.5,99.1,98.05,56,25,31,0.446,55,26,29,0.473,14,11,16,10,204.56,197.08,200.82
2014-02-26,1610612755,1610612753,2013,90.0,101.0,191.0,96.4,112.2,97.85,102.05,57,15,42,0.263,59,17,42,0.28800000000000003,8,7,14,3,213.48,203.96,208.72
2014-02-26,1610612738,1610612737,2013,115.0,104.0,219.0,94.7,99.0,100.65,103.6,58,19,39,0.328,56,26,30,0.464,11,8,17,9,191.04,200.76,195.89999999999998
2014-02-26,1610612741,1610612744,2013,103.0,83.0,186.0,93.6,92.45,103.15,96.75,56,30,26,0.536,57,35,22,0.614,16,14,18,17,184.68,201.2,192.94
2014-02-26,1610612742,1610612740,2013,108.0,89.0,197.0,106.55,102.15,95.85,98.1,58,35,23,0.603,56,23,33,0.411,18,17,13,10,210.04,200.76,205.39999999999998
2014-02-26,1610612763,1610612747,2013,108.0,103.0,211.0,92.1,89.1,103.05,108.9,55,31,24,0.564,57,19,38,0.333,16,15,9,10,193.0,205.16,199.07999999999998
2014-02-26,1610612760,1610612739,2013,104.0,114.0,218.0,104.65,98.25,98.75,101.55,57,43,14,0.754,58,22,36,0.379,23,20,14,8,204.32,195.48,199.89999999999998
2014-02-26,1610612759,1610612765,2013,120.0,110.0,230.0,103.05,100.05,101.75,103.55,56,40,16,0.7140000000000001,57,23,34,0.404,18,22,13,10,202.36,207.4,204.88
2014-02-26,1610612762,1610612756,2013,109.0,86.0,195.0,95.8,100.4,106.6,103.55,56,20,36,0.35700000000000004,56,33,23,0.589,13,7,19,14,197.52,212.12,204.82
2014-02-26,1610612757,1610612751,2013,124.0,80.0,204.0,105.1,104.5,99.1,96.65,57,39,18,0.684,54,26,28,0.481,21,18,16,10,208.6,197.08,202.84
2014-02-26,1610612746,1610612745,2013,101.0,93.0,194.0,112.95,104.55,108.95,101.15,59,39,20,0.6609999999999999,57,39,18,0.684,23,16,22,17,208.92,205.96,207.44
2014-02-25,1610612739,1610612761,2013,93.0,99.0,192.0,98.95,101.7,100.4,96.75,57,22,35,0.386,56,31,25,0.5539999999999999,14,8,16,15,194.44,198.52,196.48000000000002
2014-02-25,1610612754,1610612747,2013,118.0,98.0,216.0,101.65,96.55,103.85,109.05,55,42,13,0.764,56,19,37,0.339,26,16,9,10,187.48,205.16,196.32
2014-02-25,1610612764,1610612753,2013,115.0,106.0,221.0,99.75,98.35,96.95,101.65,56,28,28,0.5,58,17,41,0.293,14,14,14,3,199.16,203.96,201.56
2014-02-25,1610612737,1610612741,2013,103.0,107.0,210.0,100.35,102.6,93.15,91.65,55,26,29,0.473,55,29,26,0.527,17,9,16,13,199.8,184.68,192.24
2014-02-25,1610612743,1610612757,2013,95.0,100.0,195.0,103.5,108.9,105.55,104.75,55,25,30,0.455,56,38,18,0.679,14,11,21,17,205.4,208.6,207.0
2014-02-25,1610612756,1610612750,2013,101.0,110.0,211.0,107.4,103.2,103.6,99.9,55,33,22,0.6,56,27,29,0.482,19,14,16,11,211.6,205.64,208.62
2014-02-25,1610612758,1610612745,2013,103.0,129.0,232.0,103.3,100.65,108.2,101.35,56,20,36,0.35700000000000004,56,38,18,0.679,12,8,22,16,206.08,205.96,206.02
2014-02-24,1610612755,1610612749,2013,110.0,130.0,240.0,95.65,110.3,94.3,106.7,56,15,41,0.268,55,10,45,0.182,8,7,6,4,212.6,192.88,202.74
2014-02-24,1610612765,1610612744,2013,96.0,104.0,200.0,102.0,103.5,104.1,97.65,56,23,33,0.411,56,34,22,0.607,13,10,18,16,207.68,201.2,204.44
2014-02-24,1610612752,1610612742,2013,108.0,110.0,218.0,102.0,100.85,106.55,102.1,56,21,35,0.375,57,34,23,0.596,12,9,18,16,197.96,210.04,204.0
2014-02-24,1610612740,1610612746,2013,110.0,123.0,233.0,95.1,97.0,111.4,104.35,55,23,32,0.418,58,38,20,0.655,13,10,23,15,199.0,208.92,203.95999999999998
2014-02-24,1610612762,1610612738,2013,110.0,98.0,208.0,96.2,100.65,95.0,99.1,55,19,36,0.345,57,19,38,0.333,12,7,11,8,197.84,191.04,194.44
2014-02-23,1610612760,1610612746,2013,117.0,125.0,242.0,104.75,96.8,110.6,103.25,56,43,13,0.768,57,37,20,0.649,23,20,23,14,203.08,208.92,206.0
2014-02-23,1610612748,1610612741,2013,93.0,79.0,172.0,107.1,101.05,93.85,91.8,53,39,14,0.736,54,29,25,0.537,20,19,16,13,206.4,184.68,195.54000000000002
2014-02-23,1610612739,1610612764,2013,83.0,96.0,179.0,100.35,101.55,100.05,99.0,56,22,34,0.393,55,27,28,0.491,14,8,14,13,197.36,199.16,198.26
2014-02-23,1610612761,1610612753,2013,105.0,90.0,195.0,100.95,96.95,97.15,102.4,55,30,25,0.545,57,17,40,0.298,15,15,14,3,198.68,203.96,201.32
2014-02-23,1610612743,1610612758,2013,95.0,109.0,204.0,105.2,108.35,102.5,101.3,54,25,29,0.463,55,19,36,0.345,14,11,12,7,205.08,206.08,205.58
2014-02-23,1610612756,1610612745,2013,112.0,115.0,227.0,107.15,102.95,106.45,99.9,54,33,21,0.611,55,37,18,0.6729999999999999,19,14,22,15,210.32,205.96,208.14
2014-02-23,1610612747,1610612751,2013,102.0,108.0,210.0,104.25,108.6,98.45,96.2,55,19,36,0.345,53,25,28,0.472,9,10,16,9,203.8,197.08,200.44
2014-02-23,1610612757,1610612750,2013,108.0,97.0,205.0,105.65,104.6,103.05,99.7,55,37,18,0.6729999999999999,55,27,28,0.491,20,17,16,11,208.2,205.64,206.92
2014-02-22,1610612766,1610612763,2013,92.0,89.0,181.0,98.95,97.75,93.25,88.7,56,26,30,0.464,54,31,23,0.574,14,12,16,15,189.24,193.0,191.12
2014-02-22,1610612764,1610612740,2013,94.0,93.0,187.0,100.15,99.0,94.85,97.65,54,26,28,0.481,54,23,31,0.426,13,13,13,10,199.64,199.0,199.32
2014-02-22,1610612737,1610612752,2013,107.0,98.0,205.0,100.0,102.75,102.1,100.6,54,25,29,0.463,55,21,34,0.382,16,9,12,9,199.52,197.96,198.74
2014-02-22,1610612765,1610612742,2013,102.0,113.0,215.0,102.05,103.45,107.25,103.45,55,23,32,0.418,56,33,23,0.589,13,10,18,15,206.48,210.04,208.26
2014-02-22,1610612749,1610612754,2013,100.0,110.0,210.0,94.5,106.25,100.25,95.45,54,10,44,0.185,54,41,13,0.759,6,4,26,15,191.32,187.48,189.39999999999998
2014-02-22,1610612762,1610612750,2013,104.0,121.0,225.0,96.1,100.25,103.3,99.25,54,19,35,0.35200000000000004,54,26,28,0.481,12,7,16,10,196.08,205.64,200.86
2014-02-22,1610612758,1610612738,2013,105.0,98.0,203.0,102.4,102.05,94.95,98.8,54,18,36,0.333,56,19,37,0.339,11,7,11,8,205.2,191.04,198.12
2014-02-22,1610612744,1610612751,2013,93.0,86.0,179.0,104.15,98.45,98.75,97.2,55,33,22,0.6,52,25,27,0.481,17,16,16,9,202.36,197.08,199.72000000000003
2014-02-21,1610612766,1610612740,2013,90.0,87.0,177.0,98.7,97.85,94.6,98.1,55,25,30,0.455,53,23,30,0.434,13,12,13,10,189.84,199.0,194.42000000000002
2014-02-21,1610612753,1610612752,2013,129.0,121.0,250.0,96.95,102.75,101.3,99.2,56,16,40,0.28600000000000003,54,21,33,0.389,13,3,12,9,201.16,197.96,199.56
2014-02-21,1610612755,1610612742,2013,112.0,124.0,236.0,94.65,109.2,106.4,102.35,55,15,40,0.273,55,32,23,0.5820000000000001,8,7,18,14,211.16,210.04,210.6
2014-02-21,1610612761,1610612739,2013,98.0,91.0,189.0,100.85,96.4,99.8,102.85,54,29,25,0.537,55,22,33,0.4,14,15,14,8,198.32,197.36,197.84
2014-02-21,1610612765,1610612737,2013,115.0,107.0,222.0,100.75,103.6,98.95,101.55,54,22,32,0.407,53,25,28,0.472,12,10,16,9,204.72,199.52,202.12
2014-02-21,1610612741,1610612743,2013,117.0,89.0,206.0,92.55,91.55,105.9,108.4,53,28,25,0.528,53,25,28,0.472,15,13,14,11,182.96,205.08,194.02
2014-02-21,1610612763,1610612746,2013,102.0,96.0,198.0,93.35,88.85,110.4,103.95,53,30,23,0.5660000000000001,56,37,19,0.6609999999999999,15,15,23,14,192.68,208.92,200.8
2014-02-21,1610612756,1610612759,2013,106.0,85.0,191.0,107.9,104.4,103.85,100.4,53,32,21,0.604,55,40,15,0.727,18,14,18,22,211.36,202.36,206.86
2014-02-21,1610612757,1610612762,2013,102.0,94.0,196.0,105.5,104.95,95.8,99.4,54,36,18,0.667,53,19,34,0.358,19,17,12,7,209.04,196.08,202.56
2014-02-21,1610612747,1610612738,2013,101.0,92.0,193.0,103.15,108.7,95.6,99.3,54,18,36,0.333,55,19,36,0.345,8,10,11,8,204.84,191.04,197.94
2014-02-20,1610612749,1610612743,2013,90.0,101.0,191.0,93.85,105.3,107.7,109.65,53,10,43,0.189,52,24,28,0.462,6,4,14,10,190.64,205.08,197.86
2014-02-20,1610612760,1610612748,2013,81.0,103.0,184.0,105.35,96.4,106.8,102.7,55,43,12,0.782,52,38,14,0.731,23,20,20,18,203.72,206.4,205.06
2014-02-20,1610612744,1610612745,2013,102.0,99.0,201.0,104.85,99.65,105.8,100.65,54,32,22,0.593,54,37,17,0.685,16,16,22,15,201.72,205.96,203.84
2014-02-19,1610612766,1610612765,2013,116.0,98.0,214.0,98.45,98.45,100.45,103.25,54,24,30,0.444,53,22,31,0.415,12,12,12,10,188.56,204.72,196.64
2014-02-19,1610612739,1610612753,2013,101.0,93.0,194.0,98.65,102.3,96.45,102.85,54,21,33,0.389,55,16,39,0.29100000000000004,13,8,13,3,197.0,201.16,199.07999999999998
2014-02-19,1610612761,1610612741,2013,92.0,94.0,186.0,101.85,96.25,94.25,93.2,53,29,24,0.547,52,27,25,0.519,14,15,15,12,198.08,182.96,190.52
2014-02-19,1610612737,1610612764,2013,97.0,114.0,211.0,100.0,101.65,99.3,98.3,52,25,27,0.481,53,25,28,0.472,16,9,13,12,198.96,199.64,199.3
2014-02-19,1610612750,1610612754,2013,104.0,91.0,195.0,103.25,99.9,99.8,95.0,53,25,28,0.472,53,41,12,0.774,15,10,26,15,205.08,187.48,196.28
2014-02-19,1610612740,1610612752,2013,91.0,98.0,189.0,94.55,98.55,101.4,100.4,52,23,29,0.442,53,20,33,0.377,13,10,12,8,198.84,197.96,198.4
2014-02-19,1610612756,1610612738,2013,100.0,94.0,194.0,108.7,104.7,95.8,100.75,52,31,21,0.596,54,19,35,0.35200000000000004,17,14,11,8,210.44,191.04,200.74
2014-02-19,1610612762,1610612751,2013,99.0,105.0,204.0,96.45,99.2,98.05,97.5,52,19,33,0.365,51,24,27,0.471,12,7,16,8,195.8,197.08,196.44
2014-02-19,1610612757,1610612759,2013,109.0,111.0,220.0,106.75,104.6,103.55,98.9,53,36,17,0.679,54,39,15,0.722,19,17,18,21,209.04,202.36,205.7
2014-02-19,1610612758,1610612744,2013,92.0,101.0,193.0,103.0,102.65,104.5,99.1,53,18,35,0.34,53,31,22,0.585,11,7,16,15,205.68,201.72,203.7
2014-02-19,1610612747,1610612745,2013,108.0,134.0,242.0,102.95,107.55,104.65,100.15,53,18,35,0.34,53,36,17,0.679,8,10,22,14,203.84,205.96,204.9
2014-02-18,1610612754,1610612737,2013,108.0,98.0,206.0,99.05,93.4,99.3,100.8,52,40,12,0.769,51,25,26,0.49,25,15,16,9,186.24,198.96,192.60000000000002
2014-02-18,1610612755,1610612739,2013,85.0,114.0,199.0,95.6,109.2,98.6,103.15,54,15,39,0.278,53,20,33,0.377,8,7,13,7,211.64,197.0,204.32
2014-02-18,1610612764,1610612761,2013,93.0,103.0,196.0,100.35,98.0,100.65,95.9,52,25,27,0.481,52,28,24,0.5379999999999999,13,12,14,14,200.6,198.08,199.34
2014-02-18,1610612765,1610612766,2013,96.0,108.0,204.0,101.15,103.25,97.65,99.6,52,22,30,0.423,53,23,30,0.434,12,10,12,11,205.72,188.56,197.14
2014-02-18,1610612763,1610612752,2013,98.0,93.0,191.0,93.85,89.7,101.9,100.4,52,29,23,0.5579999999999999,52,20,32,0.385,14,15,12,8,192.96,197.96,195.46
2014-02-18,1610612749,1610612753,2013,104.0,100.0,204.0,92.25,104.35,96.15,103.15,52,9,43,0.173,54,16,38,0.29600000000000004,5,4,13,3,191.0,201.16,196.07999999999998
2014-02-18,1610612742,1610612748,2013,106.0,117.0,223.0,105.1,101.1,105.7,102.6,54,32,22,0.593,51,37,14,0.725,18,14,20,17,209.52,206.4,207.96
2014-02-18,1610612743,1610612756,2013,107.0,112.0,219.0,107.9,109.45,107.45,103.95,51,24,27,0.471,51,30,21,0.588,14,10,17,13,204.76,210.44,207.6
2014-02-18,1610612746,1610612759,2013,103.0,113.0,216.0,110.3,102.35,102.95,98.5,55,37,18,0.6729999999999999,53,38,15,0.7170000000000001,23,14,18,20,208.92,202.36,205.64
2014-02-13,1610612741,1610612751,2013,92.0,76.0,168.0,94.35,93.5,100.25,98.95,51,26,25,0.51,50,24,26,0.48,14,12,16,8,183.56,197.08,190.32
2014-02-13,1610612747,1610612760,2013,103.0,107.0,210.0,102.55,107.25,104.35,95.75,52,18,34,0.34600000000000003,54,42,12,0.778,8,10,23,19,203.52,203.72,203.62
2014-02-12,1610612754,1610612742,2013,73.0,81.0,154.0,99.7,93.3,105.55,103.05,51,40,11,0.784,53,31,22,0.585,25,15,18,13,187.16,209.52,198.34
2014-02-12,1610612753,1610612763,2013,81.0,86.0,167.0,96.8,104.35,94.95,91.2,53,16,37,0.302,51,28,23,0.5489999999999999,13,3,14,14,202.0,192.96,197.48000000000002
2014-02-12,1610612761,1610612737,2013,104.0,83.0,187.0,100.2,95.85,99.75,100.15,51,27,24,0.529,50,25,25,0.5,13,14,16,9,200.32,198.96,199.64
2014-02-12,1610612738,1610612759,2013,92.0,104.0,196.0,95.8,100.3,103.25,99.3,53,19,34,0.358,52,37,15,0.7120000000000001,11,8,18,19,192.2,202.36,197.28
2014-02-12,1610612751,1610612766,2013,105.0,89.0,194.0,99.55,98.8,98.85,99.5,49,23,26,0.469,52,23,29,0.442,15,8,12,11,197.0,188.56,192.78
2014-02-12,1610612765,1610612739,2013,89.0,93.0,182.0,100.9,104.2,98.05,103.15,51,22,29,0.431,52,19,33,0.365,12,10,13,6,206.04,197.0,201.51999999999998
2014-02-12,1610612752,1610612758,2013,101.0,106.0,207.0,101.6,100.55,102.2,102.15,51,20,31,0.392,52,17,35,0.327,12,8,11,6,198.28,205.68,201.98000000000002
2014-02-12,1610612745,1610612764,2013,113.0,112.0,225.0,104.1,99.55,100.05,97.3,52,35,17,0.6729999999999999,51,25,26,0.49,21,14,13,12,205.0,200.6,202.8
2014-02-12,1610612749,1610612740,2013,98.0,102.0,200.0,91.35,104.3,94.2,98.25,51,9,42,0.17600000000000002,51,22,29,0.431,5,4,13,9,190.48,198.84,194.66
2014-02-12,1610612750,1610612743,2013,117.0,90.0,207.0,102.95,101.15,108.35,109.6,52,24,28,0.462,50,24,26,0.48,14,10,14,10,206.2,204.76,205.48
2014-02-12,1610612762,1610612755,2013,105.0,100.0,205.0,96.0,98.55,95.65,108.9,51,18,33,0.353,53,15,38,0.28300000000000003,11,7,8,7,195.56,211.64,203.6
2014-02-12,1610612744,1610612748,2013,110.0,111.0,221.0,103.95,98.4,104.75,102.2,52,31,21,0.596,50,36,14,0.72,16,15,20,16,201.64,206.4,204.01999999999998
2014-02-12,1610612746,1610612757,2013,122.0,117.0,239.0,109.8,100.75,106.85,104.65,54,36,18,0.667,52,36,16,0.6920000000000001,22,14,19,17,209.56,209.04,209.3
2014-02-11,1610612766,1610612742,2013,114.0,89.0,203.0,97.4,99.45,105.45,101.25,51,22,29,0.431,52,31,21,0.596,11,11,18,13,187.4,209.52,198.46
2014-02-11,1610612739,1610612758,2013,109.0,99.0,208.0,96.95,102.25,102.8,102.1,51,18,33,0.353,51,17,34,0.333,12,6,11,6,196.36,205.68,201.02
2014-02-11,1610612741,1610612737,2013,100.0,85.0,185.0,93.3,93.5,100.6,100.6,50,25,25,0.5,49,25,24,0.51,13,12,16,9,183.72,198.96,191.34
2014-02-11,1610612763,1610612764,2013,92.0,89.0,181.0,94.9,91.5,100.5,98.7,50,27,23,0.54,50,25,25,0.5,13,14,13,12,193.04,200.6,196.82
2014-02-11,1610612756,1610612748,2013,97.0,103.0,200.0,107.15,103.75,105.1,102.05,50,30,20,0.6,49,35,14,0.7140000000000001,17,13,20,15,210.24,206.4,208.32
2014-02-11,1610612757,1610612760,2013,95.0,98.0,193.0,107.45,105.15,103.85,96.05,51,36,15,0.706,53,41,12,0.774,19,17,23,18,209.88,203.72,206.8
2014-02-11,1610612747,1610612762,2013,79.0,96.0,175.0,103.8,107.0,95.45,100.5,51,18,33,0.353,50,17,33,0.34,8,10,11,6,204.32,195.56,199.94
2014-02-10,1610612754,1610612743,2013,119.0,80.0,199.0,98.7,93.4,108.8,108.9,50,39,11,0.78,49,24,25,0.49,24,15,14,10,185.72,204.76,195.24
2014-02-10,1610612761,1610612740,2013,108.0,101.0,209.0,100.55,95.8,94.75,99.05,50,26,24,0.52,50,22,28,0.44,12,14,13,9,199.8,198.84,199.32
2014-02-10,1610612765,1610612759,2013,109.0,100.0,209.0,100.4,104.5,104.05,99.2,50,21,29,0.42,51,37,14,0.725,11,10,18,19,204.24,202.36,203.3
2014-02-10,1610612749,1610612738,2013,86.0,102.0,188.0,91.8,105.05,95.5,101.95,50,9,41,0.18,52,18,34,0.34600000000000003,5,4,11,7,190.96,192.2,191.57999999999998
2014-02-10,1610612750,1610612745,2013,89.0,107.0,196.0,104.7,101.4,104.45,99.95,51,24,27,0.471,51,34,17,0.667,14,10,21,13,206.08,205.0,205.54000000000002
2014-02-10,1610612744,1610612755,2013,123.0,80.0,203.0,103.55,98.7,97.3,107.95,51,30,21,0.588,52,15,37,0.28800000000000003,15,15,8,7,200.08,211.64,205.86
2014-02-09,1610612760,1610612752,2013,112.0,100.0,212.0,102.95,95.95,101.95,100.0,52,40,12,0.769,50,20,30,0.4,22,18,12,8,203.2,198.28,200.74
2014-02-09,1610612747,1610612741,2013,86.0,92.0,178.0,104.9,108.1,92.75,92.8,50,18,32,0.36,49,24,25,0.49,8,10,13,11,204.8,183.72,194.26
2014-02-09,1610612738,1610612742,2013,91.0,102.0,193.0,95.5,101.45,105.35,101.6,51,18,33,0.353,51,30,21,0.588,11,7,18,12,191.84,209.52,200.68
2014-02-09,1610612751,1610612740,2013,93.0,81.0,174.0,99.35,98.85,95.6,99.75,48,22,26,0.458,49,22,27,0.449,14,8,13,9,198.08,198.84,198.46
2014-02-09,1610612739,1610612763,2013,91.0,83.0,174.0,97.6,103.5,95.7,91.5,50,17,33,0.34,49,27,22,0.551,11,6,13,14,196.72,193.04,194.88
2014-02-09,1610612753,1610612754,2013,93.0,92.0,185.0,96.2,104.45,99.25,93.05,52,15,37,0.28800000000000003,49,39,10,0.7959999999999999,12,3,24,15,202.32,185.72,194.01999999999998
2014-02-09,1610612764,1610612758,2013,93.0,84.0,177.0,101.2,100.2,103.2,103.25,49,24,25,0.49,50,17,33,0.34,12,12,11,6,201.96,205.68,203.82
2014-02-09,1610612746,1610612755,2013,123.0,78.0,201.0,108.05,102.2,99.1,106.9,53,35,18,0.66,51,15,36,0.294,21,14,8,7,211.16,211.64,211.39999999999998
2014-02-08,1610612766,1610612759,2013,100.0,104.0,204.0,97.15,98.6,104.05,99.3,50,22,28,0.44,50,36,14,0.72,11,11,18,18,187.12,202.36,194.74
2014-02-08,1610612737,1610612763,2013,76.0,79.0,155.0,102.7,100.9,96.35,92.7,48,25,23,0.521,48,26,22,0.542,16,9,13,13,200.6,193.04,196.82
2014-02-08,1610612765,1610612743,2013,126.0,109.0,235.0,98.95,104.75,107.9,108.2,49,20,29,0.408,48,24,24,0.5,10,10,14,10,203.44,204.76,204.1
2014-02-08,1610612750,1610612757,2013,110.0,117.0,227.0,104.1,100.55,106.5,104.35,50,24,26,0.48,50,35,15,0.7,14,10,19,16,205.04,209.88,207.45999999999998
2014-02-08,1610612749,1610612745,2013,95.0,101.0,196.0,92.85,105.3,103.45,100.9,49,9,40,0.184,50,33,17,0.66,5,4,21,12,189.48,205.0,197.24
2014-02-08,1610612756,1610612744,2013,122.0,109.0,231.0,106.8,103.35,103.5,97.8,49,29,20,0.5920000000000001,50,30,20,0.6,16,13,15,15,207.56,200.08,203.82
2014-02-08,1610612762,1610612748,2013,94.0,89.0,183.0,94.9,100.05,105.5,102.05,49,16,33,0.327,48,35,13,0.7290000000000001,10,6,20,15,195.88,206.4,201.14
2014-02-07,1610612754,1610612757,2013,118.0,113.0,231.0,97.9,91.2,106.25,103.95,48,38,10,0.792,49,35,14,0.7140000000000001,23,15,19,16,183.84,209.88,196.86
2014-02-07,1610612753,1610612760,2013,103.0,102.0,205.0,96.5,104.45,102.9,96.4,51,14,37,0.275,51,40,11,0.784,11,3,22,18,202.12,203.2,202.66
2014-02-07,1610612755,1610612747,2013,98.0,112.0,210.0,98.95,107.6,103.65,109.35,50,15,35,0.3,49,17,32,0.34700000000000003,8,7,8,9,212.2,204.8,208.5
2014-02-07,1610612764,1610612739,2013,113.0,115.0,228.0,100.35,100.05,95.65,102.4,48,24,24,0.5,49,16,33,0.327,12,12,11,5,200.32,196.72,198.51999999999998
2014-02-07,1610612738,1610612758,2013,99.0,89.0,188.0,95.7,102.0,104.25,103.6,50,17,33,0.34,49,17,32,0.34700000000000003,10,7,11,6,192.44,205.68,199.06
2014-02-07,1610612765,1610612751,2013,111.0,95.0,206.0,98.7,105.8,99.55,98.45,48,19,29,0.396,47,22,25,0.468,9,10,14,8,203.08,198.08,200.58
2014-02-07,1610612752,1610612743,2013,117.0,90.0,207.0,101.0,100.3,107.15,106.05,49,19,30,0.388,47,24,23,0.511,11,8,14,10,198.36,204.76,201.56
2014-02-07,1610612742,1610612762,2013,103.0,81.0,184.0,105.8,103.5,95.15,99.0,50,29,21,0.58,48,16,32,0.333,17,12,10,6,211.24,195.88,203.56
2014-02-07,1610612740,1610612750,2013,98.0,91.0,189.0,95.5,100.3,105.4,100.4,48,21,27,0.438,49,24,25,0.49,12,9,14,10,199.4,205.04,202.22
2014-02-07,1610612746,1610612761,2013,118.0,105.0,223.0,107.05,101.45,100.15,95.0,52,34,18,0.654,49,26,23,0.531,20,14,12,14,210.64,199.8,205.22
2014-02-06,1610612751,1610612759,2013,103.0,89.0,192.0,99.6,98.65,105.0,99.2,46,21,25,0.457,49,36,13,0.735,13,8,18,18,196.32,202.36,199.34
2014-02-06,1610612744,1610612741,2013,102.0,87.0,189.0,103.65,98.6,93.15,92.25,49,29,20,0.5920000000000001,48,24,24,0.5,14,15,13,11,200.68,183.72,192.2
2014-02-05,1610612739,1610612747,2013,108.0,119.0,227.0,96.5,102.8,102.65,109.6,48,16,32,0.333,48,16,32,0.333,11,5,8,8,195.52,204.8,200.16000000000003
2014-02-05,1610612755,1610612738,2013,108.0,114.0,222.0,99.6,107.9,94.1,101.3,49,15,34,0.306,49,16,33,0.327,8,7,10,6,212.4,192.44,202.42000000000002
2014-02-05,1610612764,1610612759,2013,118.0,125.0,243.0,98.85,98.85,103.35,99.05,47,24,23,0.511,48,35,13,0.7290000000000001,12,12,18,17,197.88,202.36,200.12
2014-02-05,1610612753,1610612765,2013,112.0,98.0,210.0,96.35,104.15,99.55,104.8,50,13,37,0.26,47,19,28,0.404,10,3,9,10,201.04,203.08,202.06
2014-02-05,1610612752,1610612757,2013,90.0,94.0,184.0,101.6,100.2,107.0,105.45,48,19,29,0.396,48,34,14,0.708,11,8,19,15,198.96,209.88,204.42000000000002
2014-02-05,1610612745,1610612756,2013,122.0,108.0,230.0,102.65,101.0,106.75,101.65,49,32,17,0.653,48,29,19,0.604,20,12,16,13,203.68,207.56,205.62
2014-02-05,1610612763,1610612742,2013,96.0,110.0,206.0,97.55,92.15,105.55,102.85,47,26,21,0.5529999999999999,49,28,21,0.5710000000000001,13,13,17,11,192.12,211.24,201.68
2014-02-05,1610612740,1610612737,2013,105.0,100.0,205.0,95.75,100.7,104.05,101.9,47,20,27,0.426,47,25,22,0.532,11,9,16,9,198.48,200.6,199.54
2014-02-05,1610612760,1610612750,2013,106.0,97.0,203.0,103.45,95.85,106.35,101.1,50,39,11,0.78,48,24,24,0.5,21,18,14,10,203.04,205.04,204.04
2014-02-05,1610612743,1610612749,2013,110.0,100.0,210.0,106.75,106.75,92.55,103.75,46,23,23,0.5,48,9,39,0.188,13,10,5,4,203.44,189.48,196.45999999999998
2014-02-05,1610612758,1610612761,2013,109.0,101.0,210.0,104.2,103.7,100.15,93.95,48,16,32,0.333,48,26,22,0.542,10,6,12,14,205.72,199.8,202.76
2014-02-05,1610612746,1610612748,2013,112.0,116.0,228.0,107.45,101.45,105.1,101.8,51,34,17,0.667,47,34,13,0.723,20,14,20,14,209.6,206.4,208.0
2014-02-04,1610612737,1610612754,2013,85.0,89.0,174.0,106.0,102.8,98.15,91.8,46,25,21,0.5429999999999999,47,37,10,0.787,16,9,23,14,200.52,183.84,192.18
2014-02-04,1610612750,1610612747,2013,109.0,99.0,208.0,106.9,101.05,102.55,109.65,47,23,24,0.489,47,16,31,0.34,13,10,8,8,204.2,204.8,204.5
2014-02-04,1610612756,1610612741,2013,92.0,101.0,193.0,108.0,101.1,92.85,91.55,47,29,18,0.617,47,23,24,0.489,16,13,13,10,207.76,183.72,195.74
2014-02-04,1610612744,1610612766,2013,75.0,91.0,166.0,105.0,98.2,97.8,101.55,48,29,19,0.604,49,21,28,0.429,14,15,11,10,201.04,187.12,194.07999999999998
2014-02-03,1610612754,1610612753,2013,98.0,79.0,177.0,98.5,92.4,96.45,104.3,46,36,10,0.7829999999999999,49,13,36,0.265,22,14,10,3,183.84,201.04,192.44
2014-02-03,1610612764,1610612757,2013,100.0,90.0,190.0,97.75,98.7,108.45,106.25,46,23,23,0.5,47,34,13,0.723,11,12,19,15,196.84,209.88,203.36
2014-02-03,1610612751,1610612755,2013,108.0,102.0,210.0,98.1,98.3,100.05,107.7,45,20,25,0.444,48,15,33,0.313,12,8,8,7,194.4,212.4,203.4
2014-02-03,1610612748,1610612765,2013,102.0,96.0,198.0,104.85,101.7,100.1,105.0,46,33,13,0.7170000000000001,46,19,27,0.413,19,14,9,10,207.16,203.08,205.12
2014-02-03,1610612749,1610612752,2013,101.0,98.0,199.0,92.55,104.2,101.0,99.65,47,8,39,0.17,47,19,28,0.404,4,4,11,8,188.12,198.96,193.54000000000002
2014-02-03,1610612740,1610612759,2013,95.0,102.0,197.0,96.25,100.05,103.25,98.5,46,20,26,0.435,47,34,13,0.723,11,9,18,16,197.72,202.36,200.04000000000002
2014-02-03,1610612760,1610612763,2013,86.0,77.0,163.0,104.05,97.2,98.45,92.2,49,38,11,0.7759999999999999,46,26,20,0.565,20,18,13,13,203.32,192.12,197.72
2014-02-03,1610612742,1610612739,2013,124.0,107.0,231.0,104.7,103.3,96.15,101.75,48,27,21,0.563,47,16,31,0.34,16,11,11,5,209.0,195.52,202.26
2014-02-03,1610612743,1610612746,2013,116.0,115.0,231.0,105.65,105.85,107.65,101.25,45,22,23,0.489,50,34,16,0.68,12,10,20,14,201.88,209.6,205.74
2014-02-03,1610612762,1610612761,2013,79.0,94.0,173.0,96.45,99.45,99.7,93.95,47,16,31,0.34,47,25,22,0.532,10,6,12,13,196.16,199.8,197.98000000000002
2014-02-03,1610612758,1610612741,2013,99.0,70.0,169.0,104.25,105.85,94.1,91.95,47,15,32,0.319,46,23,23,0.5,9,6,13,10,206.08,183.72,194.9
2014-02-02,1610612738,1610612753,2013,96.0,89.0,185.0,94.25,102.15,96.05,103.85,48,15,33,0.313,48,13,35,0.271,9,6,10,3,192.96,201.04,197.0
2014-02-01,1610612754,1610612751,2013,97.0,96.0,193.0,98.95,91.55,97.8,97.55,45,35,10,0.778,44,20,24,0.455,21,14,12,8,184.6,194.4,189.5
2014-02-01,1610612764,1610612760,2013,96.0,81.0,177.0,98.25,98.75,105.75,97.95,45,22,23,0.489,48,38,10,0.792,10,12,20,18,198.44,203.32,200.88
2014-02-01,1610612737,1610612750,2013,120.0,113.0,233.0,105.7,102.15,105.8,100.25,45,24,21,0.5329999999999999,46,23,23,0.5,15,9,13,10,199.6,204.2,201.89999999999998
2014-02-01,1610612765,1610612755,2013,113.0,96.0,209.0,99.9,105.75,100.3,107.8,45,18,27,0.4,47,15,32,0.319,8,10,8,7,202.52,212.4,207.46
2014-02-01,1610612745,1610612739,2013,106.0,92.0,198.0,102.7,101.3,95.75,101.45,48,31,17,0.6459999999999999,46,16,30,0.348,19,12,11,5,204.48,195.52,200.0
2014-02-01,1610612763,1610612749,2013,99.0,90.0,189.0,98.7,92.4,92.7,104.45,45,25,20,0.556,46,8,38,0.174,12,13,4,4,193.32,188.12,190.72
2014-02-01,1610612740,1610612741,2013,88.0,79.0,167.0,97.05,101.0,94.85,93.0,45,19,26,0.422,45,23,22,0.511,10,9,13,10,198.88,183.72,191.3
2014-02-01,1610612759,1610612758,2013,95.0,93.0,188.0,104.15,98.45,104.8,106.7,46,33,13,0.7170000000000001,46,15,31,0.326,17,16,9,6,202.64,206.08,204.36
2014-02-01,1610612752,1610612748,2013,91.0,106.0,197.0,100.9,98.6,104.7,102.55,46,19,27,0.413,45,32,13,0.711,11,8,19,13,199.44,207.16,203.3
2014-02-01,1610612756,1610612766,2013,105.0,95.0,200.0,108.9,101.75,97.3,101.9,46,28,18,0.609,48,21,27,0.438,15,13,11,10,209.0,187.12,198.06
2014-02-01,1610612757,1610612761,2013,106.0,103.0,209.0,108.95,106.7,99.3,92.8,46,33,13,0.7170000000000001,46,25,21,0.5429999999999999,18,15,12,13,208.8,199.8,204.3
2014-02-01,1610612746,1610612762,2013,102.0,87.0,189.0,108.15,101.45,96.8,100.2,49,33,16,0.6729999999999999,46,16,30,0.348,19,14,10,6,211.2,196.16,203.68
2014-01-31,1610612753,1610612749,2013,113.0,102.0,215.0,95.3,103.9,93.1,104.35,47,12,35,0.255,45,8,37,0.17800000000000002,9,3,4,4,199.36,188.12,193.74
2014-01-31,1610612755,1610612737,2013,99.0,125.0,224.0,100.6,108.5,105.4,103.25,46,15,31,0.326,44,23,21,0.523,8,7,15,8,212.4,199.6,206.0
2014-01-31,1610612750,1610612763,2013,90.0,94.0,184.0,107.3,101.0,98.55,93.15,45,23,22,0.511,44,24,20,0.545,13,10,12,12,203.88,193.32,198.6
2014-01-31,1610612751,1610612760,2013,95.0,120.0,215.0,97.35,96.7,104.2,97.45,43,20,23,0.465,47,37,10,0.787,12,8,20,17,193.28,203.32,198.3
2014-01-31,1610612742,1610612758,2013,107.0,103.0,210.0,104.75,103.6,104.9,106.35,47,26,21,0.5529999999999999,45,15,30,0.333,15,11,9,6,208.04,206.08,207.06
2014-01-31,1610612743,1610612761,2013,90.0,100.0,190.0,105.2,105.3,99.25,93.9,44,22,22,0.5,45,24,21,0.5329999999999999,12,10,12,12,202.56,199.8,201.18
2014-01-31,1610612747,1610612766,2013,100.0,110.0,210.0,102.25,109.45,95.8,101.05,46,16,30,0.348,47,20,27,0.426,8,8,11,9,203.52,187.12,195.32
2014-01-31,1610612762,1610612744,2013,90.0,95.0,185.0,96.5,100.45,104.7,97.75,45,16,29,0.35600000000000004,47,28,19,0.596,10,6,14,14,195.92,201.04,198.48
2014-01-30,1610612754,1610612756,2013,94.0,102.0,196.0,99.95,90.5,108.1,102.8,44,35,9,0.795,45,27,18,0.6,21,14,15,12,183.08,209.0,196.04000000000002
2014-01-30,1610612752,1610612739,2013,117.0,86.0,203.0,99.2,99.05,96.8,101.3,45,18,27,0.4,45,16,29,0.35600000000000004,10,8,11,5,198.24,195.52,196.88
2014-01-30,1610612744,1610612746,2013,111.0,92.0,203.0,104.25,98.35,109.15,101.7,46,27,19,0.5870000000000001,48,33,15,0.688,13,14,19,14,199.96,211.2,205.57999999999998
2014-01-29,1610612748,1610612760,2013,95.0,112.0,207.0,105.8,101.65,104.75,97.4,44,32,12,0.727,46,36,10,0.7829999999999999,19,13,20,16,205.32,203.32,204.32
2014-01-29,1610612761,1610612753,2013,98.0,83.0,181.0,99.45,94.95,95.3,103.1,44,23,21,0.523,46,12,34,0.261,11,12,9,3,200.2,199.36,199.78
2014-01-29,1610612738,1610612755,2013,94.0,95.0,189.0,94.85,102.75,101.15,109.6,47,15,32,0.319,45,14,31,0.311,9,6,8,6,193.08,212.4,202.74
2014-01-29,1610612749,1610612756,2013,117.0,126.0,243.0,91.75,102.6,106.95,101.9,44,8,36,0.182,44,26,18,0.591,4,4,15,11,186.2,209.0,197.6
2014-01-29,1610612750,1610612740,2013,88.0,77.0,165.0,108.2,102.1,98.85,101.6,44,22,22,0.5,44,19,25,0.4320000000000001,12,10,10,9,205.2,198.88,202.04
2014-01-29,1610612742,1610612745,2013,115.0,117.0,232.0,104.25,102.3,101.4,100.85,46,26,20,0.565,47,30,17,0.638,15,11,19,11,206.6,204.48,205.54
2014-01-29,1610612743,1610612766,2013,98.0,101.0,199.0,105.25,105.4,96.55,102.05,43,22,21,0.512,46,19,27,0.413,12,10,11,8,204.52,187.12,195.82
2014-01-29,1610612759,1610612741,2013,86.0,96.0,182.0,105.45,98.85,94.6,93.2,45,33,12,0.733,44,22,22,0.5,17,16,13,9,203.4,183.72,193.56
2014-01-29,1610612758,1610612763,2013,89.0,99.0,188.0,105.75,105.95,98.5,93.9,44,15,29,0.341,43,23,20,0.535,9,6,12,11,205.8,193.32,199.56
2014-01-29,1610612746,1610612764,2013,110.0,103.0,213.0,109.05,101.3,98.4,98.2,47,32,15,0.6809999999999999,44,22,22,0.5,18,14,10,12,209.8,198.44,204.12
2014-01-28,1610612739,1610612740,2013,89.0,100.0,189.0,96.95,102.05,99.2,102.65,44,16,28,0.364,43,18,25,0.419,11,5,10,8,195.2,198.88,197.04
2014-01-28,1610612765,1610612753,2013,103.0,87.0,190.0,99.9,106.35,95.85,103.0,44,17,27,0.386,45,12,33,0.267,7,10,9,3,203.68,199.36,201.52
2014-01-28,1610612752,1610612738,2013,114.0,88.0,202.0,98.2,100.8,94.4,102.35,44,17,27,0.386,46,15,31,0.326,9,8,9,6,196.88,193.08,194.98000000000002
2014-01-28,1610612745,1610612759,2013,97.0,90.0,187.0,101.55,100.95,106.4,97.85,46,29,17,0.63,44,33,11,0.75,18,11,17,16,204.16,203.4,203.78
2014-01-28,1610612757,1610612763,2013,81.0,98.0,179.0,110.4,107.15,98.6,94.5,45,33,12,0.733,42,22,20,0.524,18,15,12,10,209.72,193.32,201.51999999999998
2014-01-28,1610612744,1610612764,2013,85.0,88.0,173.0,105.2,98.6,99.65,99.3,45,27,18,0.6,43,21,22,0.488,13,14,10,11,200.4,198.44,199.42000000000002
2014-01-28,1610612747,1610612754,2013,92.0,104.0,196.0,103.05,109.95,99.45,91.8,45,16,29,0.35600000000000004,43,34,9,0.7909999999999999,8,8,21,13,203.08,183.08,193.08
2014-01-27,1610612755,1610612756,2013,113.0,124.0,237.0,99.65,108.1,106.45,101.65,44,14,30,0.318,43,25,18,0.581,8,6,15,10,210.2,209.0,209.6
2014-01-27,1610612751,1610612761,2013,103.0,104.0,207.0,97.55,97.15,99.45,94.7,42,20,22,0.476,43,22,21,0.512,12,8,11,11,192.68,200.2,196.44
2014-01-27,1610612741,1610612750,2013,86.0,95.0,181.0,94.45,93.7,108.3,102.85,43,22,21,0.512,43,21,22,0.488,13,9,12,9,184.52,205.2,194.86
2014-01-27,1610612749,1610612746,2013,86.0,114.0,200.0,91.3,102.35,108.5,102.25,43,8,35,0.18600000000000005,46,31,15,0.674,4,4,18,13,187.12,209.8,198.46
2014-01-27,1610612760,1610612737,2013,111.0,109.0,220.0,104.55,96.7,105.25,103.25,45,35,10,0.778,43,23,20,0.535,19,16,15,8,202.8,199.6,201.2
2014-01-27,1610612762,1610612758,2013,106.0,99.0,205.0,95.9,100.75,105.95,106.75,44,15,29,0.341,43,15,28,0.349,9,6,9,6,196.0,205.8,200.9
2014-01-26,1610612748,1610612759,2013,113.0,101.0,214.0,105.85,101.95,107.15,97.35,43,31,12,0.721,43,33,10,0.767,18,13,17,16,203.92,203.4,203.66
2014-01-26,1610612752,1610612747,2013,110.0,103.0,213.0,97.05,100.4,103.05,109.7,43,16,27,0.3720000000000001,44,16,28,0.364,8,8,8,8,194.76,203.08,198.92000000000002
2014-01-26,1610612740,1610612753,2013,100.0,92.0,192.0,99.75,103.35,95.85,102.15,42,17,25,0.405,44,12,32,0.273,9,8,9,3,198.76,199.36,199.06
2014-01-26,1610612739,1610612756,2013,90.0,99.0,189.0,98.15,102.65,106.35,101.55,43,16,27,0.3720000000000001,42,24,18,0.5710000000000001,11,5,15,9,194.84,209.0,201.92000000000002
2014-01-26,1610612738,1610612751,2013,79.0,85.0,164.0,95.5,102.95,98.15,97.6,45,15,30,0.333,41,19,22,0.463,9,6,12,7,194.72,192.68,193.7
2014-01-26,1610612742,1610612765,2013,116.0,106.0,222.0,103.75,101.65,99.65,105.35,45,25,20,0.556,43,17,26,0.395,14,11,7,10,205.16,203.68,204.42000000000002
2014-01-26,1610612744,1610612757,2013,103.0,88.0,191.0,105.65,100.0,111.55,107.45,44,26,18,0.591,44,33,11,0.75,12,14,18,15,200.52,209.72,205.12
2014-01-26,1610612758,1610612743,2013,117.0,125.0,242.0,105.15,106.6,104.15,104.15,42,15,27,0.35700000000000004,42,21,21,0.5,9,6,12,9,204.0,204.52,204.26
2014-01-25,1610612766,1610612741,2013,87.0,89.0,176.0,96.45,102.0,93.9,93.5,45,19,26,0.422,42,21,21,0.5,11,8,13,8,186.96,184.52,185.74
2014-01-25,1610612761,1610612746,2013,118.0,126.0,244.0,98.95,93.4,107.85,101.2,42,22,20,0.524,45,30,15,0.667,11,11,18,12,198.04,209.8,203.92000000000002
2014-01-25,1610612755,1610612760,2013,91.0,103.0,194.0,99.7,108.1,105.05,97.15,43,14,29,0.326,44,34,10,0.773,8,6,19,15,210.52,202.8,206.66000000000003
2014-01-25,1610612763,1610612745,2013,99.0,81.0,180.0,98.25,95.25,103.3,101.6,41,21,20,0.512,45,29,16,0.644,11,10,18,11,192.72,204.16,198.44
2014-01-25,1610612749,1610612737,2013,87.0,112.0,199.0,91.05,101.25,104.65,104.0,42,8,34,0.19,42,22,20,0.524,4,4,15,7,186.48,199.6,193.04
2014-01-25,1610612743,1610612754,2013,109.0,96.0,205.0,103.35,104.6,100.2,91.35,41,20,21,0.488,42,34,8,0.81,11,9,21,13,204.0,183.08,193.54000000000002
2014-01-25,1610612762,1610612764,2013,104.0,101.0,205.0,95.8,101.3,99.7,99.15,43,14,29,0.326,42,21,21,0.5,8,6,10,11,194.6,198.44,196.51999999999998
2014-01-25,1610612757,1610612750,2013,115.0,104.0,219.0,111.35,107.45,108.15,101.75,43,32,11,0.7440000000000001,42,21,21,0.5,17,15,12,9,207.76,205.2,206.48
2014-01-24,1610612753,1610612747,2013,114.0,105.0,219.0,95.15,102.15,102.3,109.85,43,11,32,0.256,43,16,27,0.3720000000000001,8,3,8,8,198.12,203.08,200.60000000000002
2014-01-24,1610612755,1610612761,2013,95.0,104.0,199.0,101.25,109.15,99.2,94.05,42,14,28,0.333,41,21,20,0.512,8,6,11,10,209.28,198.04,203.66
2014-01-24,1610612737,1610612759,2013,79.0,105.0,184.0,105.75,103.7,107.35,97.95,41,22,19,0.537,42,32,10,0.762,15,7,17,15,198.4,203.4,200.9
2014-01-24,1610612738,1610612760,2013,83.0,101.0,184.0,95.85,102.2,105.25,97.65,44,15,29,0.341,43,33,10,0.767,9,6,19,14,194.8,202.8,198.8
2014-01-24,1610612751,1610612742,2013,107.0,106.0,213.0,99.3,97.0,104.0,101.5,40,18,22,0.45,44,25,19,0.568,11,7,14,11,192.2,205.16,198.68
2014-01-24,1610612739,1610612749,2013,93.0,78.0,171.0,99.3,104.7,92.7,102.3,42,15,27,0.35700000000000004,41,8,33,0.195,10,5,4,4,194.64,186.48,190.56
2014-01-24,1610612765,1610612740,2013,101.0,103.0,204.0,99.3,106.25,99.35,103.7,42,17,25,0.405,41,16,25,0.39,7,10,9,7,203.92,198.76,201.33999999999997
2014-01-24,1610612752,1610612766,2013,125.0,96.0,221.0,95.85,100.7,97.45,101.05,42,15,27,0.35700000000000004,44,19,25,0.4320000000000001,7,8,11,8,193.28,186.96,190.12
2014-01-24,1610612741,1610612746,2013,95.0,112.0,207.0,94.15,92.1,106.9,101.55,41,21,20,0.512,44,29,15,0.659,13,8,18,11,183.32,209.8,196.56
2014-01-24,1610612745,1610612763,2013,87.0,88.0,175.0,104.15,102.75,98.25,94.95,44,29,15,0.659,40,20,20,0.5,18,11,11,9,204.96,192.72,198.84
2014-01-24,1610612756,1610612764,2013,95.0,101.0,196.0,106.65,101.9,99.6,99.45,41,24,17,0.585,41,20,21,0.488,15,9,10,10,208.64,198.44,203.54
2014-01-24,1610612758,1610612754,2013,111.0,116.0,227.0,105.2,105.65,99.15,90.1,41,15,26,0.366,41,33,8,0.805,9,6,21,12,202.4,183.08,192.74
2014-01-24,1610612744,1610612750,2013,120.0,121.0,241.0,104.4,98.6,107.6,101.6,43,26,17,0.605,41,20,21,0.488,12,14,12,8,198.08,205.2,201.64
2014-01-23,1610612748,1610612747,2013,109.0,102.0,211.0,105.25,102.2,101.35,109.5,42,30,12,0.7140000000000001,42,16,26,0.381,17,13,8,8,202.8,203.08,202.94
2014-01-23,1610612757,1610612743,2013,110.0,105.0,215.0,111.15,107.6,103.0,104.4,42,31,11,0.738,40,20,20,0.5,16,15,11,9,206.64,204.0,205.32
2014-01-22,1610612766,1610612746,2013,95.0,91.0,186.0,96.85,101.1,107.15,101.2,43,18,25,0.419,43,29,14,0.674,10,8,18,11,187.28,209.8,198.54000000000002
2014-01-22,1610612739,1610612741,2013,87.0,98.0,185.0,100.4,104.5,93.9,92.6,41,15,26,0.366,40,20,20,0.5,10,5,13,7,194.68,183.32,189.0
2014-01-22,1610612753,1610612737,2013,109.0,112.0,221.0,93.8,100.85,105.2,103.65,42,11,31,0.262,40,21,19,0.525,8,3,15,6,197.88,198.4,198.14
2014-01-22,1610612761,1610612742,2013,93.0,85.0,178.0,99.7,95.6,105.15,103.0,40,20,20,0.5,43,25,18,0.581,10,10,14,11,199.08,205.16,202.12
2014-01-22,1610612764,1610612738,2013,111.0,113.0,224.0,98.9,99.45,95.0,101.85,40,20,20,0.5,43,14,29,0.326,10,10,9,5,196.8,194.8,195.8
2014-01-22,1610612752,1610612755,2013,106.0,110.0,216.0,96.1,100.5,100.45,110.35,41,15,26,0.366,41,13,28,0.317,7,8,8,5,192.52,209.28,200.9
2014-01-22,1610612745,1610612758,2013,119.0,98.0,217.0,103.65,102.55,105.65,105.9,43,28,15,0.6509999999999999,40,15,25,0.375,17,11,9,6,204.76,202.4,203.57999999999998
2014-01-22,1610612749,1610612765,2013,104.0,101.0,205.0,92.4,102.5,99.55,106.6,40,7,33,0.175,41,17,24,0.415,3,4,7,10,186.48,203.92,195.2
2014-01-22,1610612759,1610612760,2013,105.0,111.0,216.0,107.0,97.95,105.5,97.4,41,32,9,0.78,42,32,10,0.762,17,15,19,13,203.72,202.8,203.26
2014-01-22,1610612756,1610612754,2013,124.0,100.0,224.0,105.75,102.0,99.25,89.2,40,23,17,0.575,40,33,7,0.825,14,9,21,12,208.4,183.08,195.74
2014-01-21,1610612751,1610612753,2013,101.0,90.0,191.0,99.35,97.15,93.55,100.5,39,17,22,0.436,41,11,30,0.268,10,7,8,3,191.44,197.88,194.66
2014-01-21,1610612748,1610612738,2013,93.0,86.0,179.0,105.55,102.8,96.4,100.85,41,29,12,0.7070000000000001,42,14,28,0.333,16,13,9,5,203.76,194.8,199.28
2014-01-21,1610612740,1610612758,2013,97.0,114.0,211.0,99.25,103.45,104.3,105.8,40,16,24,0.4,39,14,25,0.359,9,7,9,5,198.48,202.4,200.44
2014-01-21,1610612760,1610612757,2013,105.0,97.0,202.0,105.3,97.45,113.25,107.6,41,31,10,0.7559999999999999,41,31,10,0.7559999999999999,18,13,16,15,202.32,206.64,204.48
2014-01-21,1610612762,1610612750,2013,97.0,112.0,209.0,95.25,100.45,108.05,101.45,42,14,28,0.333,40,19,21,0.475,8,6,12,7,193.36,205.2,199.28
2014-01-20,1610612739,1610612742,2013,97.0,102.0,199.0,99.95,103.5,104.7,102.9,40,15,25,0.375,42,24,18,0.5710000000000001,10,5,14,10,194.36,205.16,199.76
2014-01-20,1610612765,1610612746,2013,103.0,112.0,215.0,99.15,106.5,106.25,100.2,40,17,23,0.425,42,28,14,0.667,7,10,18,10,203.56,209.8,206.68
2014-01-20,1610612766,1610612761,2013,100.0,95.0,195.0,97.6,101.9,99.9,94.45,42,17,25,0.405,39,20,19,0.513,9,8,10,10,186.36,199.08,192.72000000000003
2014-01-20,1610612764,1610612755,2013,107.0,99.0,206.0,97.25,98.25,100.5,110.4,39,19,20,0.487,40,13,27,0.325,9,10,8,5,196.6,209.28,202.94
2014-01-20,1610612752,1610612751,2013,80.0,103.0,183.0,96.25,99.25,98.95,98.85,40,15,25,0.375,38,16,22,0.421,7,8,10,6,192.32,191.44,191.88
2014-01-20,1610612763,1610612740,2013,92.0,95.0,187.0,98.3,95.25,99.15,104.05,39,20,19,0.513,39,15,24,0.385,11,9,9,6,193.28,198.48,195.88
2014-01-20,1610612737,1610612748,2013,121.0,114.0,235.0,103.75,103.0,104.9,101.5,39,20,19,0.513,40,29,11,0.725,14,6,16,13,196.72,203.76,200.24
2014-01-20,1610612741,1610612747,2013,102.0,100.0,202.0,92.9,91.75,101.15,109.0,39,19,20,0.487,41,16,25,0.39,12,7,8,8,182.96,203.08,193.02
2014-01-20,1610612745,1610612757,2013,126.0,113.0,239.0,102.25,101.3,112.85,106.0,42,27,15,0.643,40,31,9,0.775,16,11,16,15,203.4,206.64,205.01999999999998
2014-01-20,1610612744,1610612754,2013,94.0,102.0,196.0,105.3,98.65,99.4,89.5,42,26,16,0.619,39,32,7,0.821,12,14,21,11,198.88,183.08,190.98000000000002
2014-01-19,1610612761,1610612747,2013,106.0,112.0,218.0,99.5,94.45,100.55,109.4,38,20,18,0.526,40,15,25,0.375,10,10,8,7,197.56,203.08,200.32
2014-01-19,1610612753,1610612738,2013,93.0,91.0,184.0,93.9,101.4,96.1,100.8,40,10,30,0.25,41,14,27,0.341,7,3,9,5,198.28,194.8,196.54000000000002
2014-01-19,1610612760,1610612758,2013,108.0,93.0,201.0,106.0,97.65,105.0,106.2,40,30,10,0.75,38,14,24,0.368,17,13,9,5,201.16,202.4,201.78
2014-01-19,1610612759,1610612749,2013,110.0,82.0,192.0,107.1,98.8,92.95,102.3,40,31,9,0.775,39,7,32,0.179,16,15,3,4,204.24,186.48,195.36
2014-01-19,1610612756,1610612743,2013,117.0,103.0,220.0,105.7,102.2,102.25,103.45,39,22,17,0.564,39,20,19,0.513,13,9,11,9,208.24,204.0,206.12
2014-01-18,1610612754,1610612746,2013,106.0,92.0,198.0,98.9,89.94999999999997,105.75,99.3,38,31,7,0.816,41,28,13,0.6829999999999999,20,11,18,10,181.88,209.8,195.84
2014-01-18,1610612764,1610612765,2013,98.0,104.0,202.0,97.6,98.5,98.55,105.35,38,19,19,0.5,39,16,23,0.41,9,10,7,9,196.08,203.56,199.82
2014-01-18,1610612766,1610612748,2013,96.0,104.0,200.0,98.05,101.1,103.9,101.2,41,17,24,0.415,39,28,11,0.718,9,8,16,12,186.48,203.76,195.12
2014-01-18,1610612741,1610612755,2013,103.0,78.0,181.0,91.6,92.8,101.55,110.55,38,18,20,0.474,39,13,26,0.333,11,7,8,5,181.84,209.28,195.56
2014-01-18,1610612745,1610612749,2013,114.0,104.0,218.0,101.8,100.25,91.65,100.3,41,26,15,0.634,38,7,31,0.184,15,11,3,4,203.92,186.48,195.2
2014-01-18,1610612750,1610612762,2013,98.0,72.0,170.0,107.25,103.0,96.8,100.2,39,18,21,0.462,41,14,27,0.341,11,7,8,6,206.72,193.36,200.04000000000002
2014-01-18,1610612740,1610612744,2013,87.0,97.0,184.0,99.65,104.2,105.55,99.6,38,15,23,0.395,41,25,16,0.61,9,6,12,13,199.0,198.88,198.94
2014-01-18,1610612742,1610612757,2013,111.0,127.0,238.0,103.6,100.65,112.2,105.85,41,24,17,0.585,39,30,9,0.769,14,10,16,14,203.08,206.64,204.86
2014-01-17,1610612752,1610612746,2013,95.0,109.0,204.0,95.15,99.5,105.35,98.6,39,15,24,0.385,40,27,13,0.675,7,8,18,9,190.48,209.8,200.14
2014-01-17,1610612753,1610612766,2013,101.0,111.0,212.0,93.4,101.3,97.7,101.15,39,10,29,0.256,40,16,24,0.4,7,3,9,7,197.24,186.48,191.86
2014-01-17,1610612755,1610612748,2013,86.0,101.0,187.0,102.5,111.55,104.35,101.65,38,13,25,0.342,38,27,11,0.711,8,5,16,11,210.8,203.76,207.28
2014-01-17,1610612761,1610612750,2013,94.0,89.0,183.0,98.95,94.5,107.95,103.95,37,19,18,0.514,38,18,20,0.474,9,10,11,7,197.64,206.72,202.18
2014-01-17,1610612764,1610612741,2013,96.0,93.0,189.0,97.7,97.85,91.9,91.95,37,18,19,0.486,37,18,19,0.486,8,10,11,7,195.56,181.84,188.7
2014-01-17,1610612738,1610612747,2013,104.0,107.0,211.0,95.3,100.25,99.6,108.45,40,14,26,0.35,39,14,25,0.359,9,5,8,6,193.08,203.08,198.08
2014-01-17,1610612765,1610612762,2013,89.0,110.0,199.0,99.85,104.85,97.4,100.8,38,16,22,0.421,40,13,27,0.325,7,9,8,5,202.96,193.36,198.16000000000003
2014-01-17,1610612763,1610612758,2013,91.0,90.0,181.0,98.75,96.55,106.1,106.75,38,19,19,0.5,37,14,23,0.378,10,9,9,5,193.44,202.4,197.92000000000002
2014-01-17,1610612759,1610612757,2013,100.0,109.0,209.0,107.1,99.0,112.05,106.85,39,31,8,0.795,38,29,9,0.763,16,15,16,13,204.6,206.64,205.62
2014-01-17,1610612743,1610612739,2013,109.0,117.0,226.0,101.9,102.25,99.55,103.05,38,20,18,0.526,39,14,25,0.359,11,9,10,4,203.6,194.36,198.98000000000002
2014-01-17,1610612756,1610612742,2013,107.0,110.0,217.0,105.65,101.55,102.95,100.9,38,22,16,0.579,40,23,17,0.575,13,9,14,9,208.36,203.08,205.72000000000003
2014-01-17,1610612760,1610612744,2013,127.0,121.0,248.0,105.55,96.3,105.05,99.0,39,29,10,0.7440000000000001,40,25,15,0.625,16,13,12,13,198.92,198.88,198.89999999999998
2014-01-16,1610612737,1610612751,2013,110.0,127.0,237.0,103.65,101.1,97.7,98.35,38,20,18,0.526,37,15,22,0.405,14,6,10,5,193.6,191.44,192.51999999999998
2014-01-16,1610612754,1610612752,2013,117.0,89.0,206.0,98.0,90.2,95.4,99.1,37,30,7,0.8109999999999999,38,15,23,0.395,19,11,7,8,181.28,190.48,185.88
2014-01-16,1610612745,1610612760,2013,92.0,104.0,196.0,101.6,99.9,105.4,96.3,40,26,14,0.65,38,28,10,0.737,15,11,16,12,203.96,198.92,201.44
2014-01-15,1610612753,1610612741,2013,125.0,128.0,253.0,92.4,99.6,89.65,90.15,38,10,28,0.263,36,17,19,0.472,7,3,11,6,195.44,181.84,188.64
2014-01-15,1610612755,1610612766,2013,95.0,92.0,187.0,103.5,112.3,97.8,101.35,37,12,25,0.324,39,16,23,0.41,7,5,9,7,211.0,186.48,198.74
2014-01-15,1610612764,1610612748,2013,114.0,97.0,211.0,97.4,98.05,104.65,100.05,36,17,19,0.472,37,27,10,0.73,7,10,16,11,195.16,203.76,199.45999999999998
2014-01-15,1610612738,1610612761,2013,88.0,83.0,171.0,96.2,101.0,100.1,94.8,39,13,26,0.333,36,19,17,0.528,8,5,9,10,193.72,197.64,195.68
2014-01-15,1610612749,1610612763,2013,77.0,82.0,159.0,92.4,100.45,99.95,97.8,37,7,30,0.189,37,18,19,0.486,3,4,10,8,189.44,193.44,191.44
2014-01-15,1610612750,1610612758,2013,108.0,111.0,219.0,108.05,104.25,104.85,106.35,37,18,19,0.486,36,13,23,0.361,11,7,9,4,205.48,202.4,203.94
2014-01-15,1610612740,1610612745,2013,100.0,103.0,203.0,99.7,104.15,101.65,100.45,37,15,22,0.405,39,25,14,0.6409999999999999,9,6,15,10,198.72,203.96,201.34
2014-01-15,1610612759,1610612762,2013,109.0,105.0,214.0,107.5,99.25,97.05,101.85,38,30,8,0.789,39,13,26,0.333,15,15,8,5,204.12,193.36,198.74
2014-01-15,1610612756,1610612747,2013,121.0,114.0,235.0,104.8,101.45,98.75,108.5,37,21,16,0.568,38,14,24,0.368,12,9,8,6,207.04,203.08,205.06
2014-01-15,1610612757,1610612739,2013,108.0,96.0,204.0,113.15,106.95,99.2,103.05,37,28,9,0.757,38,14,24,0.368,15,13,10,4,206.32,194.36,200.34
2014-01-15,1610612744,1610612743,2013,116.0,123.0,239.0,104.3,98.5,101.3,100.8,39,25,14,0.6409999999999999,37,19,18,0.514,12,13,11,8,198.04,203.6,200.82
2014-01-15,1610612746,1610612742,2013,129.0,127.0,256.0,104.65,96.85,102.0,99.75,39,26,13,0.667,39,23,16,0.59,17,9,14,9,207.4,203.08,205.24
2014-01-14,1610612766,1610612752,2013,108.0,98.0,206.0,97.0,100.25,96.15,97.85,38,15,23,0.395,37,15,22,0.405,8,7,7,8,186.28,190.48,188.38
2014-01-14,1610612754,1610612758,2013,116.0,92.0,208.0,96.7,89.8,105.35,105.7,36,29,7,0.8059999999999999,35,13,22,0.371,18,11,9,4,181.36,202.4,191.88
2014-01-14,1610612763,1610612760,2013,90.0,87.0,177.0,100.15,97.7,106.5,96.55,36,17,19,0.472,37,28,9,0.757,9,8,16,12,193.52,198.92,196.22
2014-01-14,1610612747,1610612739,2013,118.0,120.0,238.0,97.85,106.8,97.5,102.3,37,14,23,0.378,37,13,24,0.35100000000000003,8,6,10,3,201.52,194.36,197.94
2014-01-13,1610612761,1610612749,2013,116.0,94.0,210.0,99.3,95.2,93.15,99.9,35,18,17,0.514,36,7,29,0.194,8,10,3,4,195.88,189.44,192.66
2014-01-13,1610612738,1610612745,2013,92.0,104.0,196.0,97.0,100.8,101.6,101.3,38,13,25,0.342,38,24,14,0.632,8,5,15,9,192.52,203.96,198.24
2014-01-13,1610612752,1610612756,2013,98.0,96.0,194.0,97.3,97.2,104.55,102.05,36,14,22,0.389,36,21,15,0.583,6,8,12,9,189.24,207.04,198.14
2014-01-13,1610612741,1610612764,2013,88.0,102.0,190.0,88.95,88.95,95.95,98.3,35,17,18,0.486,35,16,19,0.457,11,6,7,9,182.16,195.16,188.66
2014-01-13,1610612740,1610612759,2013,95.0,101.0,196.0,100.15,104.1,106.85,99.2,36,15,21,0.417,37,29,8,0.784,9,6,15,14,198.72,204.12,201.42000000000002
2014-01-13,1610612742,1610612753,2013,107.0,88.0,195.0,101.95,100.95,92.4,99.15,38,22,16,0.579,37,10,27,0.27,13,9,7,3,203.28,195.44,199.36
2014-01-13,1610612762,1610612743,2013,118.0,103.0,221.0,96.6,101.85,101.75,99.8,38,12,26,0.316,36,19,17,0.528,7,5,11,8,192.88,203.6,198.24
2014-01-12,1610612758,1610612739,2013,124.0,80.0,204.0,104.15,107.0,98.3,102.4,34,12,22,0.353,36,13,23,0.361,8,4,10,3,203.04,194.36,198.7
2014-01-12,1610612763,1610612737,2013,108.0,101.0,209.0,98.85,98.05,102.8,101.35,35,16,19,0.457,37,20,17,0.541,8,8,14,6,193.04,193.6,193.32
2014-01-12,1610612759,1610612750,2013,104.0,86.0,190.0,106.65,100.45,109.35,104.35,36,28,8,0.778,36,18,18,0.5,14,14,11,7,204.12,205.48,204.8
2014-01-11,1610612761,1610612751,2013,96.0,80.0,176.0,99.3,95.6,97.75,99.1,34,17,17,0.5,36,15,21,0.417,7,10,10,5,197.08,191.44,194.26
2014-01-11,1610612764,1610612745,2013,107.0,114.0,221.0,96.4,98.15,101.5,101.25,34,16,18,0.471,37,23,14,0.622,7,9,15,8,194.36,203.96,199.16000000000003
2014-01-11,1610612765,1610612756,2013,110.0,108.0,218.0,99.45,104.75,104.75,101.6,37,15,22,0.405,35,21,14,0.6,6,9,12,9,201.48,207.04,204.26
2014-01-11,1610612755,1610612752,2013,92.0,102.0,194.0,103.8,112.6,96.95,97.45,36,12,24,0.333,35,13,22,0.371,7,5,6,7,210.92,189.24,200.07999999999998
2014-01-11,1610612741,1610612766,2013,103.0,97.0,200.0,87.55000000000003,88.7,96.25,99.55,34,16,18,0.471,37,15,22,0.405,10,6,8,7,181.64,186.28,183.95999999999998
2014-01-11,1610612760,1610612749,2013,101.0,85.0,186.0,107.1,97.45,93.9,100.25,36,27,9,0.75,35,7,28,0.2,15,12,3,4,198.84,189.44,194.14
2014-01-11,1610612742,1610612740,2013,110.0,107.0,217.0,101.6,100.55,99.45,103.7,37,21,16,0.568,35,15,20,0.429,12,9,9,6,203.12,198.72,200.92000000000002
2014-01-11,1610612743,1610612753,2013,120.0,94.0,214.0,100.4,100.25,91.85,99.2,35,18,17,0.514,36,10,26,0.278,10,8,7,3,204.12,195.44,199.78
2014-01-11,1610612757,1610612738,2013,112.0,104.0,216.0,113.1,106.95,96.6,99.5,36,27,9,0.75,37,13,24,0.35100000000000003,14,13,8,5,206.44,192.52,199.48000000000002
2014-01-10,1610612754,1610612764,2013,93.0,66.0,159.0,96.7,90.15,98.1,98.1,35,28,7,0.8,33,16,17,0.485,17,11,7,9,183.2,194.36,188.78
2014-01-10,1610612755,1610612765,2013,104.0,114.0,218.0,104.75,112.75,99.0,104.45,35,12,23,0.343,36,14,22,0.389,7,5,6,8,210.24,201.48,205.86
2014-01-10,1610612737,1610612745,2013,83.0,80.0,163.0,104.0,102.2,102.15,101.4,36,19,17,0.528,36,23,13,0.639,13,6,15,8,195.44,203.96,199.7
2014-01-10,1610612763,1610612756,2013,104.0,99.0,203.0,97.7,98.15,104.4,101.75,34,15,19,0.441,34,21,13,0.618,7,8,12,9,192.92,207.04,199.98
2014-01-10,1610612750,1610612766,2013,119.0,92.0,211.0,108.95,103.8,96.55,98.55,35,17,18,0.486,36,15,21,0.417,10,7,8,7,205.44,186.28,195.86
2014-01-10,1610612740,1610612742,2013,90.0,107.0,197.0,100.2,103.25,101.25,100.9,34,15,19,0.441,36,20,16,0.556,9,6,12,8,197.76,203.12,200.44
2014-01-10,1610612751,1610612748,2013,104.0,95.0,199.0,97.75,99.15,104.25,100.2,35,14,21,0.4,36,27,9,0.75,9,5,16,11,191.28,203.76,197.51999999999998
2014-01-10,1610612749,1610612741,2013,72.0,81.0,153.0,94.9,101.2,87.6,91.15,34,7,27,0.206,33,15,18,0.455,3,4,10,5,191.64,181.64,186.64
2014-01-10,1610612762,1610612739,2013,102.0,113.0,215.0,96.55,101.8,97.65,102.5,37,12,25,0.324,35,12,23,0.343,7,5,10,2,192.84,194.36,193.60000000000002
2014-01-10,1610612758,1610612753,2013,103.0,83.0,186.0,103.75,107.7,93.95,100.35,33,11,22,0.333,35,10,25,0.28600000000000003,7,4,7,3,204.84,195.44,200.14
2014-01-10,1610612744,1610612738,2013,99.0,97.0,196.0,103.4,98.05,96.45,98.9,38,24,14,0.632,36,13,23,0.361,11,13,8,5,199.08,192.52,195.8
2014-01-10,1610612746,1610612747,2013,123.0,87.0,210.0,103.5,97.75,98.8,105.65,38,25,13,0.6579999999999999,36,14,22,0.389,16,9,8,6,206.36,201.52,203.94
2014-01-09,1610612752,1610612748,2013,102.0,92.0,194.0,96.8,98.0,104.15,99.25,34,12,22,0.353,35,27,8,0.7709999999999999,5,7,16,11,189.08,203.76,196.42000000000002
2014-01-09,1610612743,1610612760,2013,101.0,88.0,189.0,100.2,100.6,107.9,97.95,34,17,17,0.5,35,27,8,0.7709999999999999,9,8,15,12,203.84,198.84,201.34
2014-01-08,1610612759,1610612742,2013,112.0,90.0,202.0,106.15,100.95,101.1,99.7,35,27,8,0.7709999999999999,35,20,15,0.5710000000000001,13,14,12,8,203.32,203.12,203.22
2014-01-08,1610612761,1610612765,2013,112.0,91.0,203.0,99.2,96.95,99.8,103.7,33,16,17,0.485,35,14,21,0.4,6,10,6,8,196.76,201.48,199.12
2014-01-08,1610612737,1610612754,2013,97.0,87.0,184.0,103.55,102.2,97.3,89.0,35,18,17,0.514,34,28,6,0.8240000000000001,12,6,17,11,196.6,183.2,189.89999999999998
2014-01-08,1610612751,1610612744,2013,102.0,98.0,200.0,96.8,99.9,103.9,97.05,34,13,21,0.382,37,24,13,0.649,8,5,11,13,191.36,199.08,195.22000000000003
2014-01-08,1610612740,1610612764,2013,96.0,102.0,198.0,102.15,103.05,97.4,98.1,33,15,18,0.455,32,15,17,0.469,9,6,7,8,196.76,194.36,195.56
2014-01-08,1610612745,1610612747,2013,113.0,99.0,212.0,102.2,101.2,99.15,105.1,35,22,13,0.629,35,14,21,0.4,14,8,8,6,203.8,201.52,202.66000000000003
2014-01-08,1610612750,1610612756,2013,103.0,104.0,207.0,108.7,103.7,104.4,101.4,34,17,17,0.5,33,20,13,0.606,10,7,12,8,204.56,207.04,205.8
2014-01-08,1610612757,1610612753,2013,110.0,94.0,204.0,112.9,107.35,93.25,99.75,35,26,9,0.743,34,10,24,0.294,13,13,7,3,205.76,195.44,200.6
2014-01-08,1610612746,1610612738,2013,111.0,105.0,216.0,102.6,96.5,95.85,98.55,37,24,13,0.649,35,13,22,0.371,15,9,8,5,205.84,192.52,199.18
2014-01-07,1610612766,1610612764,2013,83.0,97.0,180.0,96.1,98.65,97.45,98.5,35,15,20,0.429,31,14,17,0.452,8,7,7,7,186.28,194.36,190.32
2014-01-07,1610612739,1610612755,2013,111.0,93.0,204.0,97.0,102.25,104.5,112.45,34,11,23,0.324,34,12,22,0.353,9,2,7,5,193.88,210.24,202.06
2014-01-07,1610612754,1610612761,2013,86.0,79.0,165.0,97.9,89.25,100.1,97.95,33,27,6,0.818,32,16,16,0.5,16,11,6,10,183.6,196.76,190.18
2014-01-07,1610612748,1610612740,2013,107.0,88.0,195.0,104.15,99.45,104.3,104.1,34,26,8,0.765,32,15,17,0.469,15,11,9,6,203.44,196.76,200.1
2014-01-07,1610612752,1610612765,2013,89.0,85.0,174.0,97.15,98.9,101.0,104.1,33,11,22,0.333,34,14,20,0.412,4,7,6,8,188.92,201.48,195.2
2014-01-07,1610612741,1610612756,2013,92.0,87.0,179.0,88.35,91.15,104.95,101.35,32,14,18,0.438,32,20,12,0.625,9,5,12,8,185.52,207.04,196.28
2014-01-07,1610612763,1610612759,2013,108.0,110.0,218.0,97.8,97.2,105.75,99.85,33,15,18,0.455,34,26,8,0.765,7,8,13,13,190.92,203.32,197.12
2014-01-07,1610612749,1610612744,2013,80.0,101.0,181.0,94.5,100.95,103.0,98.3,33,7,26,0.212,36,23,13,0.639,3,4,11,12,193.04,199.08,196.06
2014-01-07,1610612742,1610612747,2013,110.0,97.0,207.0,100.4,100.35,99.25,104.3,34,19,15,0.5589999999999999,34,14,20,0.412,11,8,8,6,202.56,201.52,202.04000000000002
2014-01-07,1610612743,1610612738,2013,129.0,98.0,227.0,98.85,100.7,95.2,97.55,33,16,17,0.485,34,13,21,0.382,8,8,8,5,204.6,192.52,198.56
2014-01-07,1610612762,1610612760,2013,112.0,101.0,213.0,95.4,100.9,107.7,97.1,36,11,25,0.306,34,27,7,0.794,6,5,15,12,193.24,198.84,196.04000000000002
2014-01-07,1610612758,1610612757,2013,123.0,119.0,242.0,103.25,107.5,112.6,106.25,32,10,22,0.313,34,26,8,0.765,6,4,13,13,202.2,205.76,203.98
2014-01-06,1610612755,1610612750,2013,95.0,126.0,221.0,104.0,111.6,106.6,103.85,33,12,21,0.364,33,16,17,0.485,7,5,10,6,208.96,204.56,206.76
2014-01-06,1610612751,1610612737,2013,91.0,86.0,177.0,96.6,101.15,104.05,102.1,33,12,21,0.364,34,18,16,0.529,7,5,12,6,192.56,196.6,194.57999999999998
2014-01-06,1610612746,1610612753,2013,101.0,81.0,182.0,103.6,96.55,94.65,99.3,36,23,13,0.639,33,10,23,0.303,14,9,7,3,205.36,195.44,200.4
2014-01-05,1610612765,1610612763,2013,84.0,112.0,196.0,100.75,103.45,97.05,97.3,33,14,19,0.424,32,14,18,0.438,6,8,7,7,201.12,190.92,196.01999999999998
2014-01-05,1610612739,1610612754,2013,78.0,82.0,160.0,97.95,102.8,98.65,89.45,33,11,22,0.333,32,26,6,0.813,9,2,16,10,196.08,183.6,189.84
2014-01-05,1610612748,1610612761,2013,102.0,97.0,199.0,104.1,99.55,100.4,98.45,33,25,8,0.758,31,16,15,0.516,14,11,6,10,202.68,196.76,199.72
2014-01-05,1610612764,1610612744,2013,96.0,112.0,208.0,97.55,97.35,103.15,99.15,30,14,16,0.467,35,22,13,0.629,7,7,11,11,195.32,199.08,197.2
2014-01-05,1610612760,1610612738,2013,119.0,96.0,215.0,107.4,97.9,94.8,96.9,33,26,7,0.7879999999999999,33,13,20,0.394,14,12,8,5,198.52,192.52,195.52
2014-01-05,1610612742,1610612752,2013,80.0,92.0,172.0,101.55,100.4,96.55,99.55,33,19,14,0.5760000000000001,32,10,22,0.313,11,8,4,6,203.6,188.92,196.26
2014-01-05,1610612747,1610612743,2013,115.0,137.0,252.0,98.6,102.2,97.85,100.45,33,14,19,0.424,32,15,17,0.469,8,6,8,7,198.84,204.6,201.72
2014-01-04,1610612754,1610612740,2013,99.0,82.0,181.0,99.0,90.25,105.35,104.1,31,25,6,0.8059999999999999,31,15,16,0.484,15,10,9,6,182.48,196.76,189.62
2014-01-04,1610612753,1610612748,2013,94.0,110.0,204.0,94.75,99.0,103.35,99.05,32,10,22,0.313,32,24,8,0.75,7,3,14,10,195.92,202.68,199.3
2014-01-04,1610612751,1610612739,2013,89.0,82.0,171.0,96.85,102.0,99.0,103.15,32,11,21,0.344,32,11,21,0.344,6,5,9,2,193.2,196.08,194.64
2014-01-04,1610612741,1610612737,2013,91.0,84.0,175.0,90.2,93.5,104.25,102.75,31,13,18,0.419,33,18,15,0.545,8,5,12,6,184.72,196.6,190.66
2014-01-04,1610612750,1610612760,2013,111.0,115.0,226.0,106.35,102.5,106.25,96.3,32,16,16,0.5,32,25,7,0.7809999999999999,10,6,14,11,203.28,198.52,200.9
2014-01-04,1610612759,1610612746,2013,116.0,92.0,208.0,105.25,100.85,103.85,96.1,33,25,8,0.758,35,23,12,0.657,12,13,14,9,202.52,205.36,203.94
2014-01-04,1610612756,1610612749,2013,116.0,100.0,216.0,105.15,101.65,93.3,99.75,31,19,12,0.613,32,7,25,0.219,11,8,3,4,206.52,193.04,199.78
2014-01-04,1610612757,1610612755,2013,99.0,101.0,200.0,112.75,105.75,103.95,112.4,33,26,7,0.7879999999999999,32,11,21,0.344,13,13,7,4,206.32,208.96,207.64
2014-01-04,1610612758,1610612766,2013,103.0,113.0,216.0,103.0,107.05,95.25,97.1,31,10,21,0.32299999999999995,34,14,20,0.412,6,4,8,6,202.56,186.28,194.42000000000002
2014-01-03,1610612764,1610612761,2013,88.0,101.0,189.0,98.35,97.3,100.75,98.95,29,14,15,0.483,30,15,15,0.5,7,7,6,9,195.08,196.76,195.92000000000002
2014-01-03,1610612737,1610612744,2013,100.0,101.0,201.0,103.85,103.15,103.7,99.8,32,18,14,0.563,34,21,13,0.618,12,6,11,10,196.2,199.08,197.64
2014-01-03,1610612738,1610612740,2013,92.0,95.0,187.0,95.35,96.45,106.65,104.75,32,13,19,0.406,30,14,16,0.467,8,5,9,5,192.8,196.76,194.78
2014-01-03,1610612745,1610612752,2013,102.0,100.0,202.0,102.75,100.4,96.1,99.55,34,21,13,0.618,31,10,21,0.32299999999999995,13,8,4,6,203.92,188.92,196.42
2014-01-03,1610612742,1610612746,2013,112.0,119.0,231.0,102.1,100.45,103.1,95.4,32,19,13,0.594,34,22,12,0.647,11,8,14,8,201.6,205.36,203.48000000000002
2014-01-03,1610612743,1610612763,2013,111.0,108.0,219.0,97.15,99.4,96.1,96.05,31,14,17,0.452,31,14,17,0.452,7,7,7,7,203.4,190.92,197.16
2014-01-03,1610612747,1610612762,2013,110.0,99.0,209.0,98.8,102.2,96.05,100.6,32,13,19,0.406,35,11,24,0.314,7,6,6,5,198.84,193.24,196.04000000000002
2014-01-02,1610612739,1610612753,2013,87.0,81.0,168.0,98.85,103.85,95.65,99.7,31,10,21,0.32299999999999995,31,10,21,0.32299999999999995,8,2,7,3,196.4,195.92,196.16
2014-01-02,1610612748,1610612744,2013,114.0,123.0,237.0,102.85,97.3,102.5,99.25,31,24,7,0.774,33,20,13,0.606,14,10,11,9,200.2,199.08,199.64
2014-01-02,1610612741,1610612738,2013,94.0,82.0,176.0,89.8,93.45,96.8,97.25,30,12,18,0.4,31,13,18,0.419,7,5,8,5,185.16,192.8,188.98000000000002
2014-01-02,1610612760,1610612751,2013,93.0,95.0,188.0,106.3,95.95,96.65,102.1,31,25,6,0.8059999999999999,31,10,21,0.32299999999999995,14,11,6,4,199.28,193.2,196.24
2014-01-02,1610612759,1610612752,2013,101.0,105.0,206.0,105.8,100.25,95.3,99.4,32,25,7,0.7809999999999999,30,9,21,0.3,12,13,4,5,202.28,188.92,195.6
2014-01-02,1610612756,1610612763,2013,91.0,99.0,190.0,105.9,102.35,95.1,96.25,30,19,11,0.633,30,13,17,0.433,11,8,7,6,205.6,190.92,198.26
2014-01-02,1610612762,1610612749,2013,96.0,87.0,183.0,95.6,101.15,93.65,100.6,34,10,24,0.294,31,7,24,0.226,5,5,3,4,193.56,193.04,193.3
2014-01-02,1610612757,1610612766,2013,134.0,104.0,238.0,110.95,105.3,94.1,94.7,32,25,7,0.7809999999999999,33,14,19,0.424,12,13,8,6,203.6,186.28,194.94
2014-01-02,1610612758,1610612755,2013,104.0,113.0,217.0,103.15,106.6,103.0,112.45,30,10,20,0.333,31,10,21,0.32299999999999995,6,4,7,3,202.44,208.96,205.7
2014-01-01,1610612764,1610612742,2013,78.0,87.0,165.0,99.25,98.1,102.75,101.65,28,14,14,0.5,31,18,13,0.581,7,7,11,7,196.44,201.6,199.01999999999998
2014-01-01,1610612761,1610612754,2013,95.0,82.0,177.0,100.0,99.65,100.05,90.3,29,14,15,0.483,30,25,5,0.833,5,9,15,10,197.4,182.48,189.94
2014-01-01,1610612750,1610612740,2013,124.0,112.0,236.0,106.35,101.65,105.7,104.15,31,15,16,0.484,29,14,15,0.483,9,6,9,5,203.32,196.76,200.04
2014-01-01,1610612743,1610612755,2013,102.0,114.0,216.0,97.9,99.35,102.2,112.65,30,14,16,0.467,30,9,21,0.3,7,7,7,2,202.6,208.96,205.78
2014-01-01,1610612746,1610612766,2013,112.0,85.0,197.0,102.65,96.25,94.15,93.1,33,21,12,0.636,32,14,18,0.438,13,8,8,6,205.72,186.28,196.0
2013-12-31,1610612738,1610612737,2013,91.0,92.0,183.0,96.9,97.65,104.75,103.1,30,13,17,0.433,31,17,14,0.5479999999999999,8,5,12,5,193.6,196.2,194.89999999999998
2013-12-31,1610612754,1610612739,2013,91.0,76.0,167.0,100.7,90.35,99.8,105.5,29,24,5,0.828,30,10,20,0.333,14,10,8,2,183.36,196.4,189.88
2013-12-31,1610612753,1610612744,2013,81.0,94.0,175.0,96.2,101.0,102.9,100.25,30,10,20,0.333,32,19,13,0.594,7,3,11,8,196.48,199.08,197.78
2013-12-31,1610612745,1610612758,2013,106.0,110.0,216.0,103.05,99.95,103.3,106.6,33,21,12,0.636,29,9,20,0.31,13,8,6,3,204.12,202.44,203.28
2013-12-31,1610612759,1610612751,2013,113.0,92.0,205.0,106.45,100.45,97.2,101.95,31,24,7,0.774,30,10,20,0.333,11,13,6,4,201.72,193.2,197.45999999999998
2013-12-31,1610612741,1610612761,2013,79.0,85.0,164.0,91.35,93.9,100.9,100.05,29,12,17,0.414,28,13,15,0.464,7,5,5,8,187.76,197.4,192.57999999999998
2013-12-31,1610612760,1610612757,2013,94.0,98.0,192.0,106.35,94.7,110.6,104.7,30,25,5,0.833,31,24,7,0.774,14,11,12,12,200.04,203.6,201.82
2013-12-31,1610612747,1610612749,2013,79.0,94.0,173.0,99.15,101.95,94.3,102.4,31,13,18,0.419,30,6,24,0.2,7,6,3,3,199.68,193.04,196.36
2013-12-30,1610612765,1610612764,2013,99.0,106.0,205.0,101.45,102.85,97.9,97.75,32,14,18,0.438,27,13,14,0.481,6,8,7,6,200.96,196.44,198.7
2013-12-30,1610612763,1610612741,2013,91.0,95.0,186.0,94.95,96.35,91.35,94.25,29,13,16,0.448,28,11,17,0.393,7,6,7,4,192.4,187.76,190.07999999999998
2013-12-30,1610612750,1610612742,2013,98.0,100.0,198.0,107.25,102.05,103.15,101.75,30,15,15,0.5,30,17,13,0.5670000000000001,9,6,11,6,203.44,201.6,202.51999999999998
2013-12-30,1610612740,1610612757,2013,110.0,108.0,218.0,105.0,103.0,110.6,104.1,28,13,15,0.464,30,24,6,0.8,8,5,12,12,194.64,203.6,199.12
2013-12-30,1610612743,1610612748,2013,94.0,97.0,191.0,98.75,99.45,104.0,97.2,29,14,15,0.483,30,23,7,0.767,7,7,14,9,202.8,200.2,201.5
2013-12-30,1610612762,1610612766,2013,83.0,80.0,163.0,95.55,101.7,94.6,93.1,33,9,24,0.273,31,14,17,0.452,4,5,8,6,194.96,186.28,190.62
2013-12-30,1610612746,1610612756,2013,88.0,107.0,195.0,103.35,96.2,105.75,103.3,32,21,11,0.6559999999999999,29,18,11,0.621,13,8,11,7,206.08,205.6,205.84
2013-12-29,1610612739,1610612744,2013,104.0,108.0,212.0,99.15,105.0,102.25,100.15,29,10,19,0.345,31,18,13,0.581,8,2,11,7,196.24,199.08,197.66000000000003
2013-12-29,1610612753,1610612737,2013,109.0,102.0,211.0,95.75,101.3,104.8,102.35,29,9,20,0.31,30,17,13,0.5670000000000001,6,3,12,5,196.12,196.2,196.16
2013-12-29,1610612760,1610612745,2013,117.0,86.0,203.0,105.75,94.95,104.75,100.25,29,24,5,0.828,32,21,11,0.6559999999999999,13,11,13,8,199.28,204.12,201.7
2013-12-29,1610612759,1610612758,2013,112.0,104.0,216.0,106.05,99.9,102.65,106.2,30,23,7,0.767,28,9,19,0.321,10,13,6,3,203.32,202.44,202.88
2013-12-29,1610612747,1610612755,2013,104.0,111.0,215.0,99.75,101.15,101.35,112.3,30,13,17,0.433,29,8,21,0.276,7,6,7,1,198.16,208.96,203.56
2013-12-28,1610612738,1610612739,2013,103.0,100.0,203.0,95.85,97.5,98.2,104.65,29,12,17,0.414,28,10,18,0.35700000000000004,7,5,8,2,193.0,196.24,194.62
2013-12-28,1610612754,1610612751,2013,105.0,91.0,196.0,100.2,89.75,97.65,101.6,28,23,5,0.821,29,10,19,0.345,13,10,6,4,183.96,193.2,188.57999999999998
2013-12-28,1610612761,1610612752,2013,115.0,100.0,215.0,100.9,99.6,94.6,98.25,27,12,15,0.444,29,9,20,0.31,4,8,4,5,196.76,188.92,192.83999999999997
2013-12-28,1610612764,1610612765,2013,106.0,82.0,188.0,98.2,99.05,101.6,102.2,26,12,14,0.462,31,14,17,0.452,6,6,6,8,196.56,200.96,198.76
2013-12-28,1610612737,1610612766,2013,118.0,116.0,234.0,103.25,101.25,93.9,92.05,29,16,13,0.552,30,14,16,0.467,11,5,8,6,193.92,186.28,190.1
2013-12-28,1610612741,1610612742,2013,83.0,105.0,188.0,92.0,93.05,103.1,103.1,27,11,16,0.407,29,16,13,0.552,7,4,11,5,188.2,201.6,194.89999999999998
2013-12-28,1610612745,1610612740,2013,107.0,98.0,205.0,104.85,99.6,105.35,103.2,31,20,11,0.645,27,13,14,0.481,12,8,8,5,202.32,194.64,198.48
2013-12-28,1610612763,1610612743,2013,120.0,99.0,219.0,93.25,96.05,99.3,98.25,28,12,16,0.429,28,14,14,0.5,6,6,7,7,191.12,202.8,196.96
2013-12-28,1610612749,1610612750,2013,95.0,117.0,212.0,93.65,101.1,106.45,102.9,29,6,23,0.207,29,14,15,0.483,3,3,9,5,192.68,203.44,198.06
2013-12-28,1610612756,1610612755,2013,115.0,101.0,216.0,104.9,103.25,101.2,113.3,28,17,11,0.607,28,8,20,0.28600000000000003,10,7,7,1,203.96,208.96,206.46
2013-12-28,1610612757,1610612748,2013,107.0,108.0,215.0,109.75,103.15,103.45,95.9,29,24,5,0.828,29,22,7,0.759,12,12,14,8,203.0,200.2,201.6
2013-12-28,1610612746,1610612762,2013,98.0,90.0,188.0,103.95,96.85,94.7,101.55,31,20,11,0.645,32,9,23,0.281,12,8,4,5,207.64,194.96,201.3
2013-12-27,1610612766,1610612760,2013,85.0,89.0,174.0,93.95,92.4,107.05,96.5,29,14,15,0.483,28,23,5,0.821,8,6,13,10,186.04,199.28,192.66
2013-12-27,1610612753,1610612765,2013,109.0,92.0,201.0,95.0,101.25,101.95,102.45,28,8,20,0.28600000000000003,30,14,16,0.467,5,3,6,8,195.52,200.96,198.24
2013-12-27,1610612751,1610612749,2013,104.0,93.0,197.0,97.3,102.4,92.85,101.1,28,9,19,0.321,28,6,22,0.214,5,4,3,3,193.36,192.68,193.02
2013-12-27,1610612752,1610612761,2013,83.0,95.0,178.0,94.95,99.0,101.35,100.95,28,9,19,0.321,26,11,15,0.423,4,5,4,7,190.56,196.76,193.66
2013-12-27,1610612750,1610612764,2013,120.0,98.0,218.0,105.1,103.3,98.05,98.3,28,13,15,0.464,25,12,13,0.48,8,5,6,6,202.4,196.56,199.48000000000002
2013-12-27,1610612740,1610612743,2013,105.0,89.0,194.0,105.0,103.95,100.5,98.75,26,12,14,0.462,27,14,13,0.519,7,5,7,7,194.64,202.8,198.72
2013-12-27,1610612762,1610612747,2013,105.0,103.0,208.0,95.0,101.65,100.15,101.7,31,8,23,0.258,29,13,16,0.448,3,5,7,6,193.56,198.16,195.86
2013-12-27,1610612758,1610612748,2013,108.0,103.0,211.0,101.55,105.9,103.5,95.25,27,8,19,0.29600000000000004,28,22,6,0.7859999999999999,5,3,14,8,202.04,200.2,201.12
2013-12-27,1610612744,1610612756,2013,115.0,86.0,201.0,101.6,100.25,105.05,102.0,30,17,13,0.5670000000000001,27,17,10,0.63,10,7,10,7,199.56,203.96,201.76
2013-12-26,1610612739,1610612737,2013,125.0,127.0,252.0,95.95,102.6,102.25,100.45,27,10,17,0.37,28,15,13,0.536,8,2,11,4,193.52,193.92,193.72
2013-12-26,1610612745,1610612763,2013,100.0,92.0,192.0,105.95,100.55,93.6,96.6,30,19,11,0.633,27,12,15,0.444,11,8,6,6,202.6,191.12,196.86
2013-12-26,1610612742,1610612759,2013,107.0,116.0,223.0,102.6,102.0,104.8,98.65,28,16,12,0.5710000000000001,29,22,7,0.759,11,5,10,12,201.12,203.32,202.22
2013-12-26,1610612757,1610612746,2013,116.0,112.0,228.0,109.4,102.7,102.9,96.3,28,23,5,0.821,30,20,10,0.667,11,12,12,8,202.04,207.64,204.83999999999997
2013-12-25,1610612751,1610612741,2013,78.0,95.0,173.0,98.3,103.05,91.6,94.0,27,9,18,0.333,26,10,16,0.385,5,4,7,3,193.72,188.2,190.95999999999998
2013-12-25,1610612752,1610612760,2013,94.0,123.0,217.0,95.55,98.3,106.05,97.35,27,9,18,0.333,27,22,5,0.815,4,5,13,9,189.24,199.28,194.26
2013-12-25,1610612747,1610612748,2013,95.0,101.0,196.0,99.9,102.3,103.45,95.55,28,13,15,0.464,27,21,6,0.778,7,6,14,7,199.68,200.2,199.94
2013-12-25,1610612759,1610612745,2013,98.0,111.0,209.0,104.5,97.05,105.85,100.95,28,22,6,0.7859999999999999,29,18,11,0.621,10,12,11,7,202.68,202.6,202.64
2013-12-25,1610612744,1610612746,2013,105.0,103.0,208.0,102.15,100.85,102.85,95.95,29,16,13,0.552,29,20,9,0.69,9,7,12,8,199.0,207.64,203.32
2013-12-23,1610612766,1610612749,2013,111.0,110.0,221.0,92.95,91.8,91.9,100.25,28,13,15,0.464,27,6,21,0.222,7,6,3,3,184.04,192.68,188.36
2013-12-23,1610612739,1610612765,2013,92.0,115.0,207.0,97.7,103.1,101.05,102.35,26,10,16,0.385,29,13,16,0.448,8,2,6,7,192.64,200.96,196.8
2013-12-23,1610612753,1610612752,2013,98.0,103.0,201.0,94.55,100.65,95.15,97.95,27,8,19,0.29600000000000004,26,8,18,0.308,5,3,4,4,195.6,189.24,192.42000000000002
2013-12-23,1610612751,1610612754,2013,86.0,103.0,189.0,98.55,102.7,99.75,90.95,26,9,17,0.34600000000000003,27,22,5,0.815,5,4,13,9,194.08,183.96,189.02
2013-12-23,1610612748,1610612737,2013,121.0,119.0,240.0,102.9,94.8,101.55,99.4,26,20,6,0.769,27,15,12,0.556,13,7,11,4,197.36,193.92,195.64
2013-12-23,1610612745,1610612742,2013,104.0,111.0,215.0,106.15,100.6,101.6,100.95,28,18,10,0.643,27,15,12,0.556,11,7,11,4,202.56,201.12,201.84
2013-12-23,1610612763,1610612762,2013,104.0,94.0,198.0,92.7,97.0,94.95,101.6,26,11,15,0.423,30,8,22,0.267,5,6,3,5,190.24,193.56,191.9
2013-12-23,1610612759,1610612761,2013,112.0,99.0,211.0,102.7,95.8,100.6,99.9,27,21,6,0.778,25,11,14,0.44,9,12,4,7,201.04,196.76,198.89999999999998
2013-12-23,1610612743,1610612744,2013,81.0,89.0,170.0,101.9,99.65,102.6,101.15,26,14,12,0.5379999999999999,28,15,13,0.536,7,7,9,6,204.04,199.0,201.51999999999998
2013-12-23,1610612756,1610612747,2013,117.0,90.0,207.0,104.25,102.2,100.35,102.0,26,16,10,0.615,27,13,14,0.481,9,7,7,6,203.72,199.68,201.7
2013-12-23,1610612758,1610612740,2013,100.0,113.0,213.0,101.05,105.1,104.1,104.75,26,8,18,0.308,25,11,14,0.44,5,3,7,4,202.32,194.64,198.48
2013-12-22,1610612754,1610612738,2013,106.0,79.0,185.0,99.0,91.2,96.45,96.65,26,21,5,0.8079999999999999,28,12,16,0.429,12,9,7,5,184.44,193.0,188.72
2013-12-22,1610612760,1610612761,2013,98.0,104.0,202.0,106.9,97.8,99.9,99.6,26,22,4,0.846,24,10,14,0.417,13,9,4,6,199.16,196.76,197.95999999999998
2013-12-22,1610612746,1610612750,2013,120.0,116.0,236.0,102.4,95.3,104.3,102.5,28,19,9,0.679,27,13,14,0.481,11,8,8,5,206.8,202.4,204.60000000000002
2013-12-21,1610612752,1610612763,2013,87.0,95.0,182.0,95.25,99.2,92.65,97.7,25,8,17,0.32,25,10,15,0.4,4,4,5,5,189.84,190.24,190.04000000000002
2013-12-21,1610612738,1610612764,2013,99.0,106.0,205.0,96.3,96.8,98.0,98.65,27,12,15,0.444,24,11,13,0.458,7,5,6,5,192.44,196.56,194.5
2013-12-21,1610612753,1610612758,2013,100.0,105.0,205.0,94.45,99.9,100.15,105.0,26,8,18,0.308,25,7,18,0.28,5,3,5,2,195.0,202.32,198.66
2013-12-21,1610612766,1610612762,2013,85.0,88.0,173.0,93.45,91.95,95.45,102.6,27,13,14,0.481,29,7,22,0.241,7,6,3,4,186.0,193.56,189.78
2013-12-21,1610612765,1610612745,2013,97.0,114.0,211.0,100.65,101.45,106.3,101.9,28,13,15,0.464,27,17,10,0.63,6,7,11,6,200.56,202.56,201.56
2013-12-21,1610612741,1610612739,2013,100.0,84.0,184.0,91.45,93.45,97.45,102.8,25,9,16,0.36,25,10,15,0.4,6,3,8,2,187.76,192.64,190.2
2013-12-21,1610612749,1610612755,2013,116.0,106.0,222.0,90.05,99.55,101.05,113.15,26,5,21,0.192,27,8,19,0.29600000000000004,2,3,7,1,191.68,208.96,200.32
2013-12-21,1610612759,1610612760,2013,100.0,113.0,213.0,102.65,94.95,107.2,98.3,26,21,5,0.8079999999999999,25,21,4,0.84,9,12,13,8,200.64,199.16,199.89999999999998
2013-12-21,1610612756,1610612742,2013,123.0,108.0,231.0,103.8,101.95,101.6,100.6,25,15,10,0.6,26,15,11,0.5770000000000001,8,7,11,4,202.96,201.12,202.04000000000002
2013-12-21,1610612757,1610612740,2013,110.0,107.0,217.0,109.1,101.9,103.45,104.3,27,22,5,0.815,24,11,13,0.458,10,12,7,4,201.88,194.64,198.26
2013-12-21,1610612744,1610612747,2013,102.0,83.0,185.0,103.15,101.75,100.45,101.7,27,14,13,0.519,26,13,13,0.5,8,6,7,6,199.08,199.68,199.38
2013-12-21,1610612746,1610612743,2013,112.0,91.0,203.0,102.25,96.1,102.9,100.15,27,18,9,0.667,25,14,11,0.56,10,8,7,7,206.52,204.04,205.28
2013-12-20,1610612755,1610612751,2013,121.0,120.0,241.0,99.7,111.1,96.85,102.0,26,7,19,0.269,25,9,16,0.36,6,1,5,4,207.0,194.08,200.54000000000002
2013-12-20,1610612737,1610612762,2013,118.0,85.0,203.0,100.3,99.4,95.6,101.8,26,14,12,0.5379999999999999,28,7,21,0.25,10,4,3,4,193.64,193.56,193.6
2013-12-20,1610612739,1610612749,2013,114.0,111.0,225.0,96.4,101.85,89.25,99.75,24,9,15,0.375,25,5,20,0.2,7,2,2,3,191.36,191.68,191.52
2013-12-20,1610612765,1610612766,2013,106.0,116.0,222.0,99.95,99.95,91.85,91.9,27,13,14,0.481,26,12,14,0.462,6,7,7,5,198.24,186.0,192.12
2013-12-20,1610612748,1610612758,2013,122.0,103.0,225.0,102.7,94.4,100.5,103.9,25,19,6,0.76,24,7,17,0.292,12,7,5,2,195.96,202.32,199.14
2013-12-20,1610612754,1610612745,2013,114.0,81.0,195.0,98.15,91.15,108.05,101.25,25,20,5,0.8,26,17,9,0.654,11,9,11,6,184.64,202.56,193.6
2013-12-20,1610612742,1610612761,2013,108.0,109.0,217.0,101.45,99.9,99.3,98.7,25,15,10,0.6,23,9,14,0.391,11,4,4,5,201.28,196.76,199.01999999999998
2013-12-20,1610612743,1610612756,2013,99.0,103.0,202.0,102.65,100.1,103.45,101.95,24,14,10,0.583,24,14,10,0.583,7,7,8,6,202.64,202.96,202.8
2013-12-20,1610612747,1610612750,2013,104.0,91.0,195.0,100.5,102.3,105.4,103.15,25,12,13,0.48,26,13,13,0.5,6,6,8,5,199.88,202.4,201.14
2013-12-19,1610612760,1610612741,2013,107.0,95.0,202.0,107.15,98.8,91.5,92.1,24,20,4,0.833,24,9,15,0.375,12,8,6,3,200.88,187.76,194.32
2013-12-19,1610612744,1610612759,2013,102.0,104.0,206.0,102.95,100.9,102.9,94.1,26,14,12,0.5379999999999999,25,20,5,0.8,8,6,9,11,198.28,200.64,199.45999999999998
2013-12-18,1610612748,1610612754,2013,97.0,94.0,191.0,103.35,95.25,98.25,90.85,24,18,6,0.75,24,20,4,0.833,11,7,11,9,196.52,184.64,190.57999999999998
2013-12-18,1610612753,1610612762,2013,82.0,86.0,168.0,95.7,99.9,95.85,103.45,25,8,17,0.32,27,6,21,0.222,5,3,3,3,196.32,193.56,194.94
2013-12-18,1610612761,1610612766,2013,102.0,104.0,206.0,98.95,98.7,90.8,91.6,22,9,13,0.409,25,11,14,0.44,4,5,7,4,195.32,186.0,190.66
2013-12-18,1610612737,1610612758,2013,124.0,107.0,231.0,99.75,99.2,100.4,103.15,25,13,12,0.52,23,7,16,0.304,9,4,5,2,191.8,202.32,197.06
2013-12-18,1610612738,1610612765,2013,106.0,107.0,213.0,95.15,95.9,99.35,100.3,26,12,14,0.462,26,12,14,0.462,7,5,6,6,192.92,198.24,195.57999999999998
2013-12-18,1610612751,1610612764,2013,107.0,113.0,220.0,96.7,100.75,98.15,98.4,24,9,15,0.375,23,10,13,0.435,5,4,6,4,193.52,196.56,195.04000000000002
2013-12-18,1610612749,1610612752,2013,101.0,107.0,208.0,88.35,98.95,94.95,98.7,24,5,19,0.208,24,7,17,0.292,2,3,4,3,192.32,189.84,191.07999999999998
2013-12-18,1610612750,1610612757,2013,120.0,109.0,229.0,104.4,101.75,109.55,101.4,25,12,13,0.48,26,22,4,0.846,7,5,10,12,200.84,201.88,201.36
2013-12-18,1610612742,1610612763,2013,105.0,91.0,196.0,102.35,100.55,91.7,97.85,24,14,10,0.583,24,10,14,0.417,10,4,5,5,201.36,190.24,195.8
2013-12-18,1610612756,1610612759,2013,101.0,108.0,209.0,102.75,100.75,103.5,93.5,23,14,9,0.609,24,19,5,0.792,8,6,9,10,201.36,200.64,201.0
2013-12-18,1610612745,1610612741,2013,109.0,94.0,203.0,107.3,101.9,90.8,91.5,25,16,9,0.64,23,9,14,0.391,10,6,6,3,201.6,187.76,194.68
2013-12-18,1610612746,1610612740,2013,108.0,95.0,203.0,103.7,97.25,103.65,103.1,26,17,9,0.654,23,11,12,0.478,9,8,7,4,205.32,194.64,199.98
2013-12-17,1610612766,1610612758,2013,95.0,87.0,182.0,90.1,92.1,101.25,102.7,24,10,14,0.417,22,7,15,0.318,6,4,5,2,186.04,202.32,194.18
2013-12-17,1610612739,1610612757,2013,116.0,119.0,235.0,95.5,100.6,109.05,100.4,23,9,14,0.391,25,21,4,0.84,7,2,10,11,190.0,201.88,195.94
2013-12-17,1610612763,1610612747,2013,92.0,96.0,188.0,91.45,98.2,100.65,102.6,23,10,13,0.435,24,11,13,0.458,5,5,6,5,188.96,199.88,194.42000000000002
2013-12-17,1610612743,1610612760,2013,93.0,105.0,198.0,102.9,100.5,105.95,99.15,23,14,9,0.609,23,19,4,0.826,7,7,12,7,203.16,200.88,202.01999999999998
2013-12-17,1610612744,1610612740,2013,104.0,93.0,197.0,104.0,100.95,103.5,103.4,25,13,12,0.52,22,11,11,0.5,7,6,7,4,199.32,194.64,196.98
2013-12-16,1610612754,1610612765,2013,96.0,101.0,197.0,97.9,89.5,99.45,100.95,23,20,3,0.87,25,11,14,0.44,11,9,6,5,185.8,198.24,192.02
2013-12-16,1610612737,1610612747,2013,114.0,100.0,214.0,98.6,98.95,100.85,103.05,24,12,12,0.5,23,11,12,0.478,8,4,6,5,191.12,199.88,195.5
2013-12-16,1610612738,1610612750,2013,101.0,97.0,198.0,96.1,96.3,104.9,102.15,25,11,14,0.44,24,12,12,0.5,6,5,7,5,192.4,200.84,196.62
2013-12-16,1610612751,1610612755,2013,130.0,94.0,224.0,95.25,101.05,101.25,110.95,23,8,15,0.348,25,7,18,0.28,4,4,6,1,191.48,207.0,199.24
2013-12-16,1610612748,1610612762,2013,117.0,94.0,211.0,102.6,95.4,94.8,102.45,23,17,6,0.7390000000000001,26,6,20,0.231,10,7,3,3,195.48,193.56,194.51999999999998
2013-12-16,1610612752,1610612764,2013,101.0,102.0,203.0,94.75,98.7,97.7,98.5,23,7,16,0.304,22,9,13,0.409,4,3,6,3,190.24,196.56,193.4
2013-12-16,1610612741,1610612753,2013,82.0,83.0,165.0,90.8,91.4,96.8,101.8,22,9,13,0.409,24,7,17,0.292,6,3,5,2,188.72,196.32,192.51999999999998
2013-12-16,1610612746,1610612759,2013,115.0,92.0,207.0,104.25,98.4,104.0,92.45,25,16,9,0.64,23,19,4,0.826,8,8,9,10,203.96,200.64,202.3
2013-12-15,1610612758,1610612745,2013,106.0,91.0,197.0,101.3,102.45,108.65,103.45,21,6,15,0.28600000000000003,24,16,8,0.667,4,2,10,6,202.4,201.6,202.0
2013-12-15,1610612763,1610612750,2013,93.0,101.0,194.0,92.2,97.65,105.5,102.0,22,10,12,0.455,23,11,12,0.478,5,5,7,4,188.32,200.84,194.57999999999998
2013-12-15,1610612765,1610612757,2013,109.0,111.0,220.0,99.5,101.35,108.3,99.2,24,11,13,0.458,24,20,4,0.833,6,5,10,10,198.12,201.88,200.0
2013-12-15,1610612760,1610612753,2013,101.0,98.0,199.0,106.25,98.9,96.6,101.95,22,18,4,0.818,23,7,16,0.304,11,7,5,2,200.44,196.32,198.38
2013-12-15,1610612743,1610612740,2013,102.0,93.0,195.0,101.75,100.75,103.9,102.4,22,13,9,0.591,21,11,10,0.524,6,7,7,4,203.32,194.64,198.98
2013-12-15,1610612756,1610612744,2013,106.0,102.0,208.0,102.65,100.2,103.4,101.05,22,13,9,0.591,24,13,11,0.542,7,6,7,6,200.2,199.32,199.76
2013-12-14,1610612766,1610612747,2013,85.0,88.0,173.0,90.55,92.85,101.15,105.05,23,10,13,0.435,22,10,12,0.455,6,4,6,4,187.44,199.88,193.66
2013-12-14,1610612764,1610612746,2013,97.0,113.0,210.0,97.95,98.3,103.95,98.25,21,9,12,0.429,24,15,9,0.625,6,3,8,7,195.24,203.96,199.60000000000002
2013-12-14,1610612748,1610612739,2013,114.0,107.0,221.0,102.05,94.7,95.35,100.35,22,16,6,0.727,22,9,13,0.409,9,7,7,2,194.36,190.0,192.18
2013-12-14,1610612752,1610612737,2013,111.0,106.0,217.0,94.2,98.85,98.45,98.65,22,6,16,0.273,23,12,11,0.522,3,3,8,4,189.92,191.12,190.51999999999998
2013-12-14,1610612741,1610612761,2013,77.0,99.0,176.0,91.65,90.9,98.75,99.95,21,9,12,0.429,21,8,13,0.381,6,3,4,4,189.6,195.32,192.45999999999998
2013-12-14,1610612755,1610612757,2013,105.0,139.0,244.0,101.1,109.8,107.0,98.85,24,7,17,0.292,23,19,4,0.826,6,1,10,9,205.36,201.88,203.62
2013-12-14,1610612742,1610612749,2013,106.0,93.0,199.0,102.6,100.85,88.95,98.55,23,13,10,0.565,23,5,18,0.217,9,4,2,3,201.76,192.32,197.04
2013-12-14,1610612762,1610612759,2013,84.0,100.0,184.0,94.65,102.45,104.25,94.0,25,6,19,0.24,22,18,4,0.818,3,3,9,9,193.16,200.64,196.89999999999998
2013-12-13,1610612754,1610612766,2013,99.0,94.0,193.0,97.8,89.15,90.1,92.05,22,19,3,0.8640000000000001,22,10,12,0.455,10,9,6,4,185.8,187.44,186.62
2013-12-13,1610612753,1610612739,2013,100.0,109.0,209.0,97.1,101.0,93.6,99.8,22,7,15,0.318,21,8,13,0.381,5,2,7,1,195.56,190.0,192.78
2013-12-13,1610612761,1610612755,2013,108.0,100.0,208.0,98.0,99.3,101.55,109.5,20,7,13,0.35,23,7,16,0.304,3,4,6,1,194.84,205.36,200.10000000000002
2013-12-13,1610612737,1610612764,2013,101.0,99.0,200.0,98.6,98.4,98.1,98.9,22,11,11,0.5,20,9,11,0.45,7,4,6,3,190.64,195.24,192.94
2013-12-13,1610612738,1610612752,2013,90.0,86.0,176.0,96.45,96.35,93.95,98.45,24,10,14,0.417,21,6,15,0.28600000000000003,5,5,3,3,193.68,189.92,191.8
2013-12-13,1610612765,1610612751,2013,103.0,99.0,202.0,98.9,101.35,95.7,101.5,23,10,13,0.435,22,8,14,0.364,5,5,4,4,196.52,191.48,194.0
2013-12-13,1610612740,1610612763,2013,104.0,98.0,202.0,103.95,101.7,91.8,96.55,20,10,10,0.5,21,10,11,0.476,6,4,5,5,194.96,188.32,191.64
2013-12-13,1610612760,1610612747,2013,122.0,97.0,219.0,105.3,98.85,100.75,104.7,21,17,4,0.81,21,10,11,0.476,10,7,6,4,199.0,199.88,199.44
2013-12-13,1610612749,1610612741,2013,90.0,91.0,181.0,89.9,99.2,92.3,91.75,22,5,17,0.227,20,8,12,0.4,2,3,6,2,193.12,189.6,191.36
2013-12-13,1610612759,1610612750,2013,117.0,110.0,227.0,103.45,93.2,104.6,100.8,21,17,4,0.81,22,11,11,0.5,8,9,7,4,199.92,200.84,200.38
2013-12-13,1610612743,1610612762,2013,93.0,103.0,196.0,102.0,100.3,93.85,102.65,21,13,8,0.619,24,5,19,0.208,6,7,3,2,203.44,193.16,198.3
2013-12-13,1610612756,1610612758,2013,116.0,107.0,223.0,101.25,98.65,100.0,101.35,21,12,9,0.5710000000000001,20,6,14,0.3,6,6,4,2,197.96,202.4,200.18
2013-12-13,1610612744,1610612745,2013,112.0,116.0,228.0,101.5,99.75,108.05,102.5,23,13,10,0.565,23,15,8,0.652,7,6,10,5,198.32,201.6,199.95999999999998
2013-12-12,1610612751,1610612746,2013,102.0,93.0,195.0,94.9,99.95,104.15,98.25,21,7,14,0.333,23,15,8,0.652,3,4,8,7,191.2,203.96,197.57999999999998
2013-12-12,1610612757,1610612745,2013,111.0,104.0,215.0,106.5,99.45,107.45,100.6,22,18,4,0.818,22,15,7,0.682,9,9,10,5,201.08,201.6,201.34
2013-12-11,1610612766,1610612753,2013,83.0,92.0,175.0,90.5,92.5,98.25,102.85,21,10,11,0.476,21,6,15,0.28600000000000003,6,4,5,1,189.76,195.56,192.66
2013-12-11,1610612738,1610612746,2013,88.0,96.0,184.0,96.95,96.8,103.85,98.75,23,10,13,0.435,22,14,8,0.636,5,5,8,6,194.04,203.96,199.0
2013-12-11,1610612763,1610612760,2013,100.0,116.0,216.0,91.0,95.7,104.55,98.75,20,10,10,0.5,20,16,4,0.8,5,5,10,6,186.44,199.0,192.72
2013-12-11,1610612749,1610612759,2013,77.0,109.0,186.0,90.55,98.6,102.55,93.6,21,5,16,0.238,20,16,4,0.8,2,3,8,8,194.6,199.92,197.26
2013-12-11,1610612750,1610612755,2013,106.0,99.0,205.0,105.3,101.6,101.25,109.4,21,10,11,0.476,22,7,15,0.318,6,4,6,1,199.72,205.36,202.54000000000002
2013-12-11,1610612740,1610612765,2013,111.0,106.0,217.0,102.9,101.15,99.0,101.35,19,9,10,0.474,22,10,12,0.455,5,4,5,5,194.56,196.52,195.54000000000002
2013-12-11,1610612752,1610612741,2013,83.0,78.0,161.0,94.3,98.7,93.15,92.95,20,5,15,0.25,19,8,11,0.421,2,3,6,2,191.24,189.6,190.42000000000002
2013-12-11,1610612758,1610612762,2013,101.0,122.0,223.0,99.2,100.05,92.15,102.8,19,6,13,0.316,23,4,19,0.174,4,2,3,1,202.16,193.16,197.66
2013-12-11,1610612744,1610612742,2013,95.0,93.0,188.0,102.5,99.55,102.6,101.45,22,12,10,0.545,22,13,9,0.591,6,6,9,4,199.28,201.76,200.51999999999998
2013-12-10,1610612739,1610612752,2013,109.0,94.0,203.0,92.25,100.15,94.35,98.5,20,7,13,0.35,19,5,14,0.263,6,1,2,3,189.28,191.24,190.26
2013-12-10,1610612754,1610612748,2013,90.0,84.0,174.0,97.55,89.55,103.35,95.9,21,18,3,0.857,21,16,5,0.762,9,9,9,7,185.72,194.36,190.04000000000002
2013-12-10,1610612761,1610612759,2013,103.0,116.0,219.0,98.25,97.1,101.55,94.5,19,7,12,0.368,19,15,4,0.789,3,4,8,7,193.04,199.92,196.48
2013-12-10,1610612737,1610612760,2013,92.0,101.0,193.0,99.1,98.1,103.3,98.55,21,11,10,0.524,19,15,4,0.789,7,4,10,5,192.52,199.0,195.76
2013-12-10,1610612751,1610612738,2013,104.0,96.0,200.0,93.8,99.15,96.55,96.35,20,6,14,0.3,22,10,12,0.455,2,4,5,5,189.12,194.04,191.57999999999998
2013-12-10,1610612765,1610612750,2013,94.0,121.0,215.0,98.65,99.15,104.7,101.9,21,10,11,0.476,20,9,11,0.45,5,5,6,3,195.76,199.72,197.74
2013-12-10,1610612741,1610612749,2013,74.0,78.0,152.0,94.7,93.25,90.8,99.4,18,8,10,0.444,20,4,16,0.2,6,2,2,2,190.36,194.6,192.48000000000002
2013-12-10,1610612747,1610612756,2013,108.0,114.0,222.0,99.6,103.55,100.75,98.15,20,10,10,0.5,20,11,9,0.55,6,4,6,5,197.8,197.96,197.88
2013-12-09,1610612766,1610612744,2013,115.0,111.0,226.0,89.35,91.45,100.65,97.6,20,9,11,0.45,21,12,9,0.5710000000000001,5,4,6,6,187.68,199.28,193.48000000000002
2013-12-09,1610612755,1610612746,2013,83.0,94.0,177.0,101.6,110.2,104.65,99.65,21,7,14,0.333,21,13,8,0.619,6,1,8,5,206.68,203.96,205.32
2013-12-09,1610612764,1610612743,2013,74.0,75.0,149.0,98.85,100.05,103.25,100.65,19,9,10,0.474,20,12,8,0.6,6,3,6,6,196.64,203.44,200.04
2013-12-09,1610612763,1610612753,2013,94.0,85.0,179.0,91.05,95.85,98.35,103.0,19,9,10,0.474,20,6,14,0.3,4,5,5,1,186.56,195.56,191.06
2013-12-09,1610612762,1610612757,2013,94.0,105.0,199.0,92.1,102.75,105.8,99.95,22,4,18,0.182,21,17,4,0.81,3,1,9,8,192.92,201.08,197.0
2013-12-09,1610612758,1610612742,2013,112.0,97.0,209.0,98.6,100.45,103.0,101.5,18,5,13,0.278,21,13,8,0.619,3,2,9,4,201.8,201.76,201.78
2013-12-08,1610612752,1610612738,2013,73.0,114.0,187.0,94.85,97.05,94.7,97.05,18,5,13,0.278,21,9,12,0.429,2,3,5,4,191.76,194.04,192.89999999999998
2013-12-08,1610612765,1610612748,2013,95.0,110.0,205.0,99.55,98.75,103.25,95.9,20,10,10,0.5,20,15,5,0.75,5,5,9,6,194.8,194.36,194.58
2013-12-08,1610612745,1610612753,2013,98.0,88.0,186.0,107.45,101.15,99.0,104.25,21,14,7,0.667,19,6,13,0.316,9,5,5,1,201.8,195.56,198.68
2013-12-08,1610612760,1610612754,2013,118.0,94.0,212.0,102.15,99.05,97.8,88.19999999999997,18,14,4,0.778,20,18,2,0.9,9,5,9,9,197.96,185.72,191.84
2013-12-08,1610612747,1610612761,2013,94.0,106.0,200.0,100.7,103.4,98.15,97.25,19,10,9,0.526,18,6,12,0.333,6,4,3,3,197.08,193.04,195.06
2013-12-07,1610612755,1610612743,2013,92.0,103.0,195.0,102.35,110.25,103.25,101.75,20,7,13,0.35,19,11,8,0.579,6,1,6,5,206.92,203.44,205.18
2013-12-07,1610612739,1610612746,2013,88.0,82.0,170.0,93.05,100.7,105.7,101.05,19,6,13,0.316,20,13,7,0.65,5,1,8,5,190.28,203.96,197.12
2013-12-07,1610612741,1610612765,2013,75.0,92.0,167.0,96.1,93.55,99.25,99.35,17,8,9,0.471,19,9,10,0.474,6,2,5,4,191.2,194.8,193.0
2013-12-07,1610612763,1610612744,2013,82.0,108.0,190.0,92.5,95.85,100.55,98.15,18,9,9,0.5,20,11,9,0.55,4,5,6,5,186.84,199.28,193.06
2013-12-07,1610612750,1610612748,2013,82.0,103.0,185.0,105.8,101.2,101.2,96.1,19,9,10,0.474,19,14,5,0.737,6,3,9,5,199.08,194.36,196.72000000000003
2013-12-07,1610612749,1610612751,2013,82.0,90.0,172.0,91.95,99.65,93.6,100.4,19,4,15,0.211,19,5,14,0.263,2,2,2,3,196.4,189.12,192.76
2013-12-07,1610612759,1610612754,2013,100.0,111.0,211.0,101.15,94.4,97.0,87.69999999999997,18,15,3,0.833,19,17,2,0.895,8,7,9,8,199.32,185.72,192.51999999999998
2013-12-07,1610612762,1610612758,2013,102.0,112.0,214.0,91.9,102.2,97.75,100.55,21,4,17,0.19,17,4,13,0.235,3,1,3,1,191.0,201.8,196.4
2013-12-07,1610612757,1610612742,2013,106.0,108.0,214.0,106.25,99.8,102.35,101.2,20,17,3,0.85,20,12,8,0.6,9,8,9,3,200.48,201.76,201.12
2013-12-06,1610612766,1610612755,2013,105.0,88.0,193.0,88.6,91.25,102.15,110.5,19,8,11,0.421,19,7,12,0.368,4,4,6,1,188.36,206.92,197.64
2013-12-06,1610612764,1610612749,2013,105.0,109.0,214.0,98.6,98.7,90.7,99.65,18,9,9,0.5,18,3,15,0.16699999999999998,6,3,2,1,195.72,196.4,196.06
2013-12-06,1610612737,1610612739,2013,108.0,89.0,197.0,98.15,99.0,92.8,99.8,20,10,10,0.5,18,6,12,0.333,6,4,5,1,192.68,190.28,191.48000000000002
2013-12-06,1610612738,1610612743,2013,106.0,98.0,204.0,94.45,97.0,102.75,100.95,20,8,12,0.4,18,11,7,0.611,4,4,6,5,193.88,203.44,198.66
2013-12-06,1610612752,1610612753,2013,121.0,83.0,204.0,93.05,96.65,100.05,103.6,17,4,13,0.235,18,6,12,0.333,1,3,5,1,191.48,195.56,193.51999999999998
2013-12-06,1610612745,1610612744,2013,105.0,83.0,188.0,107.85,102.25,101.9,97.4,20,13,7,0.65,19,11,8,0.579,8,5,6,5,201.92,199.28,200.6
2013-12-06,1610612740,1610612760,2013,95.0,109.0,204.0,102.9,101.1,101.85,99.25,18,9,9,0.5,17,13,4,0.765,5,4,9,4,194.2,197.96,196.07999999999998
2013-12-06,1610612756,1610612761,2013,106.0,97.0,203.0,100.25,98.4,98.15,96.4,19,10,9,0.526,17,6,11,0.353,5,5,3,3,197.2,193.04,195.12
2013-12-06,1610612757,1610612762,2013,130.0,98.0,228.0,105.2,100.15,91.2,100.05,19,16,3,0.8420000000000001,20,4,16,0.2,8,8,3,1,200.44,191.0,195.72
2013-12-06,1610612758,1610612747,2013,100.0,106.0,206.0,97.8,100.75,99.95,103.5,16,4,12,0.25,18,9,9,0.5,3,1,6,3,202.68,197.08,199.88
2013-12-05,1610612751,1610612752,2013,83.0,113.0,196.0,93.85,99.7,93.4,98.65,18,5,13,0.278,16,3,13,0.188,2,3,1,2,189.36,191.48,190.42000000000002
2013-12-05,1610612763,1610612746,2013,81.0,101.0,182.0,92.1,95.4,105.75,101.8,17,9,8,0.529,19,12,7,0.632,4,5,8,4,188.2,203.96,196.07999999999998
2013-12-05,1610612741,1610612748,2013,107.0,87.0,194.0,95.55,93.25,100.95,95.75,16,7,9,0.438,18,14,4,0.778,5,2,9,5,192.92,194.36,193.64
2013-12-04,1610612739,1610612743,2013,98.0,88.0,186.0,91.85,100.5,102.8,100.75,17,5,12,0.294,17,11,6,0.647,4,1,6,5,191.04,203.44,197.24
2013-12-04,1610612737,1610612746,2013,107.0,97.0,204.0,96.9,98.65,105.3,101.4,19,9,10,0.474,18,12,6,0.667,5,4,8,4,192.04,203.96,198.0
2013-12-04,1610612745,1610612756,2013,88.0,97.0,185.0,108.25,101.55,100.2,99.15,19,13,6,0.684,18,9,9,0.5,8,5,5,4,202.28,197.2,199.74
2013-12-04,1610612749,1610612765,2013,98.0,105.0,203.0,89.6,98.55,98.2,99.25,17,3,14,0.17600000000000002,18,8,10,0.444,2,1,5,3,197.72,194.8,196.26
2013-12-04,1610612740,1610612742,2013,97.0,100.0,197.0,102.7,100.55,101.8,100.5,17,9,8,0.529,19,11,8,0.579,5,4,9,2,194.24,201.76,198.0
2013-12-04,1610612762,1610612754,2013,86.0,95.0,181.0,91.5,100.25,97.15,87.25,19,4,15,0.211,18,16,2,0.889,3,1,9,7,191.48,185.72,188.6
2013-12-04,1610612757,1610612760,2013,111.0,104.0,215.0,104.45,99.25,101.5,98.85,18,15,3,0.833,16,13,3,0.813,7,8,9,4,199.96,197.96,198.96
2013-12-03,1610612755,1610612753,2013,126.0,125.0,251.0,101.55,109.75,98.9,102.0,18,6,12,0.333,17,6,11,0.353,5,1,5,1,204.16,195.56,199.86
2013-12-03,1610612738,1610612749,2013,108.0,100.0,208.0,94.6,96.05,89.55,98.25,19,7,12,0.368,16,3,13,0.188,3,4,2,1,193.92,197.72,195.82
2013-12-03,1610612751,1610612743,2013,87.0,111.0,198.0,94.15,99.1,102.8,102.3,17,5,12,0.294,16,10,6,0.625,2,3,6,4,190.4,203.44,196.92000000000002
2013-12-03,1610612748,1610612765,2013,97.0,107.0,204.0,101.45,95.15,96.9,99.2,17,14,3,0.8240000000000001,17,7,10,0.412,9,5,5,2,193.36,194.8,194.08
2013-12-03,1610612763,1610612756,2013,110.0,91.0,201.0,91.7,95.8,100.55,97.6,16,8,8,0.5,17,9,8,0.529,3,5,5,4,187.32,197.2,192.26
2013-12-03,1610612742,1610612766,2013,89.0,82.0,171.0,103.25,101.85,89.1,90.5,18,10,8,0.556,18,8,10,0.444,8,2,4,4,203.24,188.36,195.8
2013-12-03,1610612758,1610612760,2013,95.0,97.0,192.0,97.55,100.3,100.7,98.45,15,4,11,0.267,15,12,3,0.8,3,1,9,3,204.32,197.96,201.14
2013-12-03,1610612744,1610612761,2013,112.0,103.0,215.0,101.0,96.3,98.65,95.6,18,10,8,0.556,16,6,10,0.375,5,5,3,3,198.4,193.04,195.72
2013-12-02,1610612764,1610612753,2013,98.0,80.0,178.0,97.75,98.85,99.55,102.35,17,8,9,0.471,16,6,10,0.375,5,3,5,1,196.92,195.56,196.24
2013-12-02,1610612741,1610612740,2013,128.0,131.0,259.0,94.45,91.05,101.4,99.25,15,7,8,0.467,16,8,8,0.5,5,2,5,3,189.64,194.24,191.94
2013-12-02,1610612759,1610612737,2013,102.0,100.0,202.0,102.2,94.45,97.35,99.45,17,14,3,0.8240000000000001,18,9,9,0.5,7,7,5,4,198.52,192.04,195.28
2013-12-02,1610612762,1610612745,2013,109.0,103.0,212.0,89.75,100.4,108.55,100.7,18,3,15,0.16699999999999998,18,13,5,0.722,2,1,8,5,191.68,202.28,196.98000000000002
2013-12-02,1610612757,1610612754,2013,106.0,102.0,208.0,104.05,99.35,97.4,86.4,17,14,3,0.8240000000000001,17,16,1,0.941,6,8,9,7,200.44,185.72,193.07999999999998
2013-12-01,1610612761,1610612743,2013,98.0,112.0,210.0,99.9,96.0,101.25,102.85,15,6,9,0.4,15,9,6,0.6,3,3,6,3,191.6,203.44,197.51999999999998
2013-12-01,1610612746,1610612754,2013,100.0,105.0,205.0,105.3,101.65,97.25,85.35,17,12,5,0.706,16,15,1,0.938,8,4,9,6,203.0,185.72,194.36
2013-12-01,1610612765,1610612755,2013,115.0,100.0,215.0,96.1,99.1,101.8,108.75,16,6,10,0.375,17,6,11,0.353,4,2,5,1,193.84,204.16,199.0
2013-12-01,1610612758,1610612744,2013,113.0,115.0,228.0,96.45,99.05,101.0,96.95,14,4,10,0.28600000000000003,17,9,8,0.529,3,1,5,4,204.52,198.4,201.46
2013-12-01,1610612748,1610612766,2013,99.0,98.0,197.0,100.85,95.65,88.35,89.35,16,13,3,0.813,17,8,9,0.471,8,5,4,4,192.84,188.36,190.60000000000002
2013-12-01,1610612760,1610612750,2013,113.0,103.0,216.0,99.45,97.4,105.55,100.5,14,11,3,0.7859999999999999,18,9,9,0.5,8,3,6,3,198.04,199.08,198.56
2013-12-01,1610612752,1610612740,2013,99.0,103.0,202.0,93.7,97.45,101.2,99.05,15,3,12,0.2,15,7,8,0.467,1,2,5,2,190.96,194.24,192.60000000000002
2013-12-01,1610612747,1610612757,2013,108.0,114.0,222.0,100.1,103.1,102.85,97.65,17,9,8,0.529,16,13,3,0.813,6,3,6,7,196.32,200.44,198.38
2013-11-30,1610612764,1610612737,2013,108.0,101.0,209.0,97.65,99.35,96.7,98.95,16,7,9,0.438,17,9,8,0.529,4,3,5,4,197.84,192.04,194.94
2013-11-30,1610612739,1610612741,2013,97.0,93.0,190.0,91.8,100.05,95.0,90.95,16,4,12,0.25,14,7,7,0.5,3,1,5,2,191.4,189.64,190.51999999999998
2013-11-30,1610612763,1610612751,2013,88.0,97.0,185.0,91.8,95.7,94.0,99.6,15,8,7,0.5329999999999999,16,4,12,0.25,3,5,2,2,186.68,190.4,188.54000000000002
2013-11-30,1610612742,1610612750,2013,106.0,112.0,218.0,101.8,101.15,106.2,100.3,17,10,7,0.588,17,8,9,0.471,8,2,6,2,201.8,199.08,200.44
2013-11-30,1610612759,1610612745,2013,106.0,112.0,218.0,101.85,94.15,108.75,100.2,16,14,2,0.875,17,12,5,0.706,7,7,8,4,196.76,202.28,199.51999999999998
2013-11-30,1610612756,1610612762,2013,104.0,112.0,216.0,101.3,97.6,89.44999999999997,100.75,16,9,7,0.563,17,2,15,0.118,5,4,2,0,196.6,191.68,194.14
2013-11-30,1610612749,1610612738,2013,92.0,85.0,177.0,88.8,98.4,94.7,96.1,15,2,13,0.133,18,7,11,0.389,1,1,3,4,198.84,193.92,196.38
2013-11-29,1610612766,1610612749,2013,92.0,76.0,168.0,89.0,90.15,89.45,98.7,16,7,9,0.438,14,2,12,0.14300000000000002,3,4,1,1,188.72,198.84,193.78
2013-11-29,1610612753,1610612759,2013,91.0,109.0,200.0,99.1,101.95,101.7,94.8,15,6,9,0.4,15,13,2,0.867,5,1,7,6,196.68,196.76,196.72
2013-11-29,1610612761,1610612748,2013,83.0,90.0,173.0,100.7,96.35,101.95,96.85,14,6,8,0.429,15,12,3,0.8,3,3,8,4,192.6,192.84,192.72
2013-11-29,1610612737,1610612742,2013,88.0,87.0,175.0,97.5,99.9,102.05,101.0,16,8,8,0.5,16,10,6,0.625,4,4,8,2,191.96,201.8,196.88
2013-11-29,1610612738,1610612739,2013,103.0,86.0,189.0,94.65,96.95,92.1,100.15,17,6,11,0.353,15,4,11,0.267,2,4,3,1,193.56,191.4,192.48000000000002
2013-11-29,1610612765,1610612747,2013,102.0,106.0,208.0,95.95,98.6,98.75,102.55,15,6,9,0.4,16,8,8,0.5,4,2,6,2,194.64,196.32,195.48
2013-11-29,1610612745,1610612751,2013,114.0,95.0,209.0,108.05,100.2,94.65,98.25,16,11,5,0.688,15,4,11,0.267,7,4,2,2,201.64,190.4,196.01999999999998
2013-11-29,1610612760,1610612744,2013,113.0,112.0,225.0,98.9,97.05,99.9,95.85,13,10,3,0.769,16,9,7,0.563,7,3,5,4,197.88,198.4,198.14
2013-11-29,1610612754,1610612764,2013,93.0,73.0,166.0,97.4,87.5,99.05,98.8,15,14,1,0.933,15,7,8,0.467,8,6,4,3,186.84,197.84,192.34
2013-11-29,1610612755,1610612740,2013,105.0,121.0,226.0,101.65,108.95,99.85,98.4,16,6,10,0.375,14,6,8,0.429,5,1,5,1,203.28,194.24,198.76
2013-11-29,1610612743,1610612752,2013,97.0,95.0,192.0,101.75,103.1,93.85,97.05,14,8,6,0.5710000000000001,14,3,11,0.214,5,3,1,2,203.44,190.96,197.2
2013-11-29,1610612762,1610612756,2013,101.0,112.0,213.0,89.44999999999997,99.05,100.2,97.9,16,2,14,0.125,15,8,7,0.5329999999999999,2,0,5,3,191.8,196.6,194.2
2013-11-29,1610612758,1610612746,2013,98.0,104.0,202.0,96.9,98.35,105.4,100.45,13,4,9,0.308,16,11,5,0.688,3,1,8,3,204.52,203.0,203.76
2013-11-27,1610612766,1610612754,2013,74.0,99.0,173.0,89.44999999999997,89.65,97.35,88.94999999999997,15,7,8,0.467,14,13,1,0.929,3,4,8,5,190.28,186.84,188.56
2013-11-27,1610612753,1610612755,2013,105.0,94.0,199.0,98.2,101.55,102.0,109.15,14,5,9,0.35700000000000004,15,6,9,0.4,4,1,5,1,197.76,203.28,200.51999999999998
2013-11-27,1610612738,1610612763,2013,93.0,100.0,193.0,94.45,96.8,91.65,95.6,16,6,10,0.375,14,7,7,0.5,2,4,3,4,191.44,186.68,189.06
2013-11-27,1610612751,1610612747,2013,94.0,99.0,193.0,95.45,97.85,99.45,103.15,14,4,10,0.28600000000000003,15,7,8,0.467,2,2,6,1,191.76,196.32,194.04
2013-11-27,1610612739,1610612748,2013,84.0,95.0,179.0,91.6,100.0,102.4,98.35,14,4,10,0.28600000000000003,14,11,3,0.7859999999999999,3,1,8,3,192.0,192.84,192.42000000000002
2013-11-27,1610612765,1610612741,2013,79.0,99.0,178.0,97.35,99.25,94.2,91.05,14,6,8,0.429,13,6,7,0.462,4,2,5,1,194.84,189.64,192.24
2013-11-27,1610612745,1610612737,2013,113.0,84.0,197.0,107.8,101.2,96.95,99.5,15,10,5,0.667,15,8,7,0.5329999999999999,6,4,4,4,201.2,191.96,196.57999999999998
2013-11-27,1610612749,1610612764,2013,92.0,100.0,192.0,89.4,98.9,98.85,99.15,13,2,11,0.154,14,6,8,0.429,1,1,4,2,198.8,197.84,198.32
2013-11-27,1610612750,1610612743,2013,110.0,117.0,227.0,105.55,99.65,100.3,102.1,16,8,8,0.5,13,7,6,0.5379999999999999,6,2,5,2,197.12,203.44,200.28
2013-11-27,1610612760,1610612759,2013,94.0,88.0,182.0,99.65,96.7,102.0,95.0,12,9,3,0.75,14,13,1,0.929,6,3,7,6,198.48,196.76,197.62
2013-11-27,1610612742,1610612744,2013,103.0,99.0,202.0,101.8,100.45,99.95,95.45,15,9,6,0.6,15,9,6,0.6,7,2,5,4,202.52,198.4,200.46
2013-11-27,1610612756,1610612757,2013,120.0,106.0,226.0,98.8,97.35,102.25,95.85,14,7,7,0.5,15,13,2,0.867,4,3,6,7,194.2,200.44,197.32
2013-11-27,1610612746,1610612752,2013,93.0,80.0,173.0,105.9,101.4,93.9,97.95,15,10,5,0.667,13,3,10,0.231,7,3,1,2,205.12,190.96,198.04000000000002
2013-11-26,1610612761,1610612751,2013,100.0,102.0,202.0,100.7,95.8,95.2,97.9,13,6,7,0.462,13,3,10,0.231,3,3,2,1,191.32,191.76,191.54
2013-11-26,1610612764,1610612747,2013,116.0,111.0,227.0,97.35,98.45,98.65,102.8,13,5,8,0.385,14,7,7,0.5,3,2,6,1,196.12,196.32,196.22
2013-11-26,1610612737,1610612753,2013,92.0,109.0,201.0,96.0,98.1,97.0,101.5,14,8,6,0.5710000000000001,13,4,9,0.308,4,4,4,0,192.04,197.76,194.89999999999998
2013-11-26,1610612740,1610612744,2013,101.0,102.0,203.0,100.05,96.95,98.75,95.45,13,6,7,0.462,14,8,6,0.5710000000000001,5,1,5,3,194.32,198.4,196.36
2013-11-25,1610612766,1610612738,2013,86.0,96.0,182.0,90.65,89.05000000000003,94.1,97.7,14,7,7,0.5,15,5,10,0.333,3,4,2,3,190.2,191.44,190.82
2013-11-25,1610612754,1610612750,2013,98.0,84.0,182.0,96.25,88.85,106.4,99.2,13,12,1,0.923,15,8,7,0.5329999999999999,7,5,6,2,186.76,197.12,191.94
2013-11-25,1610612765,1610612749,2013,113.0,94.0,207.0,97.15,99.6,89.05000000000003,98.2,13,5,8,0.385,12,2,10,0.16699999999999998,3,2,1,1,194.36,198.8,196.58
2013-11-25,1610612748,1610612756,2013,107.0,92.0,199.0,103.1,98.55,99.5,96.95,13,10,3,0.769,13,7,6,0.5379999999999999,7,3,4,3,192.76,194.2,193.48
2013-11-25,1610612763,1610612745,2013,86.0,93.0,179.0,91.65,95.6,108.5,101.9,13,7,6,0.5379999999999999,14,9,5,0.643,3,4,6,3,186.76,201.2,193.98
2013-11-25,1610612742,1610612743,2013,96.0,110.0,206.0,101.7,100.05,99.65,101.7,14,9,5,0.643,12,6,6,0.5,7,2,5,1,201.68,203.44,202.56
2013-11-25,1610612759,1610612740,2013,112.0,93.0,205.0,102.1,95.55,101.2,97.1,13,12,1,0.923,12,6,6,0.5,6,6,5,1,196.8,194.32,195.56
2013-11-25,1610612762,1610612741,2013,89.0,83.0,172.0,90.35,99.9,94.15,90.4,15,1,14,0.067,12,6,6,0.5,1,0,5,1,193.04,189.64,191.33999999999997
2013-11-25,1610612757,1610612752,2013,102.0,91.0,193.0,101.2,95.75,93.9,97.85,14,12,2,0.857,12,3,9,0.25,5,7,1,2,199.84,190.96,195.4
2013-11-24,1610612751,1610612765,2013,97.0,109.0,206.0,94.45,96.95,96.65,99.15,12,3,9,0.25,12,4,8,0.333,2,1,3,1,191.4,194.36,192.88
2013-11-24,1610612746,1610612741,2013,121.0,82.0,203.0,105.75,102.85,94.6,89.05000000000003,14,9,5,0.643,11,6,5,0.545,6,3,5,1,205.72,189.64,197.68
2013-11-24,1610612753,1610612756,2013,96.0,104.0,200.0,96.75,101.15,99.5,97.05,12,4,8,0.333,12,6,6,0.5,4,0,4,2,198.24,194.2,196.22
2013-11-24,1610612760,1610612762,2013,95.0,73.0,168.0,99.1,97.45,91.65,100.3,11,8,3,0.727,14,1,13,0.071,5,3,1,0,198.56,193.04,195.8
2013-11-24,1610612747,1610612758,2013,100.0,86.0,186.0,99.05,103.2,97.6,99.4,13,6,7,0.462,12,4,8,0.333,5,1,3,1,197.48,204.52,201.0
2013-11-23,1610612746,1610612758,2013,103.0,102.0,205.0,104.8,102.45,97.55,99.65,13,8,5,0.615,11,4,7,0.364,5,3,3,1,206.0,204.52,205.26
2013-11-23,1610612754,1610612755,2013,106.0,98.0,204.0,95.5,87.8,101.95,108.15,12,11,1,0.917,14,6,8,0.429,6,5,5,1,185.32,203.28,194.3
2013-11-23,1610612764,1610612752,2013,98.0,89.0,187.0,97.35,99.15,94.6,98.05,12,4,8,0.333,11,3,8,0.273,2,2,1,2,195.16,190.96,193.06
2013-11-23,1610612737,1610612738,2013,87.0,94.0,181.0,96.75,97.95,94.25,98.3,13,8,5,0.615,14,4,10,0.28600000000000003,4,4,2,2,194.0,191.44,192.72
2013-11-23,1610612748,1610612753,2013,101.0,99.0,200.0,102.35,97.35,96.1,100.45,12,9,3,0.75,11,4,7,0.364,6,3,4,0,192.68,198.24,195.46
2013-11-23,1610612745,1610612750,2013,112.0,101.0,213.0,108.25,101.75,106.75,98.35,13,8,5,0.615,14,8,6,0.5710000000000001,5,3,6,2,201.0,197.12,199.06
2013-11-23,1610612749,1610612766,2013,72.0,96.0,168.0,91.0,99.0,89.6,89.75,11,2,9,0.182,13,6,7,0.462,1,1,3,3,199.52,190.2,194.86
2013-11-23,1610612759,1610612739,2013,126.0,96.0,222.0,100.45,96.2,92.3,98.95,12,11,1,0.917,13,4,9,0.308,5,6,3,1,195.88,192.0,193.94
2013-11-23,1610612743,1610612742,2013,102.0,100.0,202.0,100.4,103.25,101.45,99.45,11,5,6,0.455,13,9,4,0.6920000000000001,4,1,7,2,203.68,201.68,202.68
2013-11-23,1610612744,1610612757,2013,101.0,113.0,214.0,97.8,94.5,100.5,95.3,13,8,5,0.615,13,11,2,0.846,5,3,5,6,198.16,199.84,199.0
2013-11-22,1610612766,1610612756,2013,91.0,98.0,189.0,89.3,89.19999999999997,99.5,98.4,12,6,6,0.5,11,5,6,0.455,3,3,4,1,190.8,194.2,192.5
2013-11-22,1610612755,1610612749,2013,115.0,107.0,222.0,101.05,109.15,89.94999999999997,98.15,13,5,8,0.385,10,2,8,0.2,4,1,1,1,202.28,199.52,200.9
2013-11-22,1610612761,1610612764,2013,96.0,88.0,184.0,100.35,96.45,97.4,99.0,12,5,7,0.417,11,4,7,0.364,2,3,2,2,192.64,195.16,193.89999999999998
2013-11-22,1610612738,1610612754,2013,82.0,97.0,179.0,94.15,97.85,95.55,89.05,13,4,9,0.308,11,10,1,0.909,2,2,6,4,193.56,185.32,189.44
2013-11-22,1610612765,1610612737,2013,89.0,96.0,185.0,97.85,99.0,96.3,97.75,11,4,7,0.364,12,7,5,0.583,3,1,4,3,195.6,194.0,194.8
2013-11-22,1610612763,1610612759,2013,86.0,102.0,188.0,92.0,95.7,99.75,96.65,12,7,5,0.583,11,10,1,0.909,3,4,5,5,186.28,195.88,191.07999999999998
2013-11-22,1610612750,1610612751,2013,111.0,81.0,192.0,106.1,98.75,96.75,96.25,13,7,6,0.5379999999999999,11,3,8,0.273,5,2,2,1,197.4,191.4,194.4
2013-11-22,1610612740,1610612739,2013,104.0,100.0,204.0,100.45,97.45,92.2,99.0,11,5,6,0.455,12,4,8,0.333,4,1,3,1,194.32,192.0,193.16
2013-11-22,1610612742,1610612762,2013,103.0,93.0,196.0,100.9,99.5,91.7,100.55,12,8,4,0.667,13,1,12,0.077,6,2,1,0,201.92,193.04,197.48
2013-11-22,1610612757,1610612741,2013,98.0,95.0,193.0,100.0,95.5,93.75,89.9,12,10,2,0.833,10,6,4,0.6,4,6,5,1,200.12,189.64,194.88
2013-11-22,1610612747,1610612744,2013,102.0,95.0,197.0,98.7,103.45,97.8,94.6,12,5,7,0.417,12,8,4,0.667,4,1,5,3,196.44,198.16,197.3
2013-11-21,1610612760,1610612746,2013,105.0,91.0,196.0,98.5,97.85,104.7,101.25,10,7,3,0.7,12,8,4,0.667,4,3,5,3,199.8,206.0,202.9
2013-11-21,1610612743,1610612741,2013,97.0,87.0,184.0,100.4,103.65,94.05,89.35,10,4,6,0.4,9,6,3,0.667,3,1,5,1,205.4,189.64,197.51999999999998
2013-11-20,1610612766,1610612751,2013,95.0,91.0,186.0,89.8,89.55,97.75,96.8,11,5,6,0.455,10,3,7,0.3,2,3,2,1,190.76,191.4,191.07999999999998
2013-11-20,1610612739,1610612764,2013,91.0,98.0,189.0,92.6,98.45,97.1,99.2,11,4,7,0.364,10,3,7,0.3,3,1,2,1,192.24,195.16,193.7
2013-11-20,1610612752,1610612754,2013,96.0,103.0,199.0,94.55,98.0,94.2,89.19999999999997,10,3,7,0.3,10,9,1,0.9,1,2,6,3,190.68,185.32,188.0
2013-11-20,1610612753,1610612748,2013,92.0,120.0,212.0,96.75,99.95,101.8,97.4,10,4,6,0.4,11,8,3,0.727,4,0,6,2,197.64,192.68,195.16
2013-11-20,1610612755,1610612761,2013,98.0,108.0,206.0,101.0,108.0,100.0,96.45,12,5,7,0.417,11,4,7,0.364,4,1,2,2,200.56,192.64,196.6
2013-11-20,1610612737,1610612765,2013,93.0,85.0,178.0,96.15,96.95,98.55,99.5,11,6,5,0.545,10,4,6,0.4,3,3,3,1,194.6,195.6,195.1
2013-11-20,1610612749,1610612757,2013,82.0,91.0,173.0,90.85,97.75,99.3,96.05,9,2,7,0.222,11,9,2,0.818,1,1,4,5,200.28,200.12,200.2
2013-11-20,1610612750,1610612746,2013,98.0,102.0,200.0,105.2,98.45,104.85,102.25,12,7,5,0.583,11,7,4,0.636,5,2,5,2,196.64,206.0,201.32
2013-11-20,1610612740,1610612762,2013,105.0,98.0,203.0,99.85,97.35,90.9,99.7,10,4,6,0.4,12,1,11,0.083,3,1,1,0,193.52,193.04,193.28
2013-11-20,1610612759,1610612738,2013,104.0,93.0,197.0,100.2,95.85,93.5,96.75,10,9,1,0.9,12,4,8,0.333,4,5,2,2,196.04,193.56,194.8
2013-11-20,1610612756,1610612758,2013,106.0,113.0,219.0,99.55,98.3,97.75,99.5,10,5,5,0.5,10,3,7,0.3,4,1,3,0,193.76,204.52,199.14
2013-11-20,1610612742,1610612745,2013,123.0,120.0,243.0,99.7,97.85,107.35,100.85,11,7,4,0.636,12,8,4,0.667,5,2,5,3,200.48,201.0,200.74
2013-11-20,1610612744,1610612763,2013,81.0,88.0,169.0,98.6,94.55,91.95,96.95,11,8,3,0.727,11,6,5,0.545,5,3,3,3,199.48,186.28,192.88
2013-11-19,1610612764,1610612750,2013,104.0,100.0,204.0,97.1,98.45,105.2,98.6,9,2,7,0.222,11,7,4,0.636,1,1,5,2,195.08,196.64,195.86
2013-11-19,1610612765,1610612752,2013,92.0,86.0,178.0,98.9,99.45,95.2,98.7,9,3,6,0.333,9,3,6,0.333,2,1,1,2,196.76,190.68,193.72
2013-11-19,1610612748,1610612737,2013,104.0,88.0,192.0,101.2,97.35,96.1,96.35,10,7,3,0.7,10,6,4,0.6,5,2,3,3,192.92,194.6,193.76
2013-11-19,1610612745,1610612738,2013,109.0,85.0,194.0,107.65,102.4,93.5,96.15,11,7,4,0.636,11,4,7,0.364,4,3,2,2,200.92,193.56,197.24
2013-11-19,1610612758,1610612756,2013,107.0,104.0,211.0,97.35,98.7,99.0,98.2,9,2,7,0.222,9,5,4,0.556,2,0,4,1,204.48,193.76,199.12
2013-11-18,1610612751,1610612757,2013,98.0,108.0,206.0,98.15,95.85,99.35,97.05,9,3,6,0.333,10,8,2,0.8,2,1,4,4,190.16,200.12,195.14
2013-11-18,1610612741,1610612766,2013,86.0,81.0,167.0,93.0,89.69999999999997,90.4,90.9,8,5,3,0.625,10,5,5,0.5,4,1,2,3,190.2,190.76,190.48
2013-11-18,1610612760,1610612743,2013,115.0,113.0,228.0,97.4,96.75,99.15,102.5,9,6,3,0.667,9,4,5,0.444,3,3,3,1,198.4,205.4,201.9
2013-11-18,1610612742,1610612755,2013,97.0,94.0,191.0,99.7,98.3,100.45,108.35,10,6,4,0.6,11,5,6,0.455,4,2,4,1,201.76,200.56,201.16
2013-11-18,1610612762,1610612744,2013,87.0,98.0,185.0,90.55,99.3,98.25,95.65,11,1,10,0.091,10,7,3,0.7,1,0,5,2,192.92,199.48,196.2
2013-11-18,1610612746,1610612763,2013,102.0,106.0,208.0,104.4,102.1,91.1,96.5,10,7,3,0.7,10,5,5,0.5,5,2,3,2,205.28,186.28,195.78
2013-11-17,1610612761,1610612757,2013,110.0,118.0,228.0,100.2,95.05,98.55,97.15,10,4,6,0.4,9,7,2,0.778,2,2,4,3,191.16,200.12,195.64
2013-11-17,1610612758,1610612763,2013,86.0,97.0,183.0,98.45,99.45,90.4,97.45,8,2,6,0.25,9,4,5,0.444,2,0,3,1,206.28,186.28,196.28
2013-11-17,1610612747,1610612765,2013,114.0,99.0,213.0,97.3,103.7,99.5,98.95,11,4,7,0.364,8,3,5,0.375,3,1,2,1,197.28,196.76,197.01999999999998
2013-11-16,1610612766,1610612748,2013,81.0,97.0,178.0,91.65,90.8,100.2,98.95,9,5,4,0.556,9,6,3,0.667,2,3,5,1,191.36,192.92,192.14
2013-11-16,1610612753,1610612742,2013,100.0,108.0,208.0,96.5,99.5,99.65,97.75,9,4,5,0.444,9,5,4,0.556,4,0,4,1,196.68,201.76,199.22
2013-11-16,1610612764,1610612739,2013,96.0,103.0,199.0,96.8,97.6,91.3,98.2,8,2,6,0.25,10,3,7,0.3,1,1,3,0,194.64,192.24,193.44
2013-11-16,1610612752,1610612737,2013,90.0,110.0,200.0,95.0,97.8,94.75,97.15,8,3,5,0.375,9,5,4,0.556,1,2,3,2,191.24,194.6,192.92000000000002
2013-11-16,1610612741,1610612754,2013,110.0,94.0,204.0,92.2,90.2,93.45,88.19999999999997,7,4,3,0.5710000000000001,9,9,0,1.0,3,1,6,3,189.04,185.32,187.18
2013-11-16,1610612745,1610612743,2013,122.0,111.0,233.0,106.25,102.0,98.65,102.15,10,6,4,0.6,8,4,4,0.5,3,3,3,1,201.16,205.4,203.28
2013-11-16,1610612750,1610612738,2013,106.0,88.0,194.0,105.15,98.85,93.7,95.15,10,6,4,0.6,10,4,6,0.4,4,2,2,2,196.48,193.56,195.01999999999998
2013-11-16,1610612740,1610612755,2013,135.0,98.0,233.0,98.7,97.05,99.9,106.9,9,3,6,0.333,10,5,5,0.5,2,1,4,1,190.68,200.56,195.62
2013-11-16,1610612749,1610612760,2013,79.0,92.0,171.0,91.8,98.5,97.95,97.5,8,2,6,0.25,8,5,3,0.625,1,1,3,2,201.64,198.4,200.01999999999998
2013-11-16,1610612744,1610612762,2013,102.0,88.0,190.0,97.75,96.35,90.45,99.0,9,6,3,0.667,10,1,9,0.1,4,2,1,0,198.08,192.92,195.5
2013-11-16,1610612746,1610612751,2013,110.0,103.0,213.0,103.55,101.5,97.75,94.95,9,6,3,0.667,8,3,5,0.375,4,2,2,1,204.8,190.16,197.48000000000002
2013-11-15,1610612754,1610612749,2013,104.0,77.0,181.0,93.2,88.94999999999997,92.3,98.8,8,8,0,1.0,7,2,5,0.28600000000000003,5,3,1,1,185.76,201.64,193.7
2013-11-15,1610612761,1610612741,2013,80.0,96.0,176.0,100.85,94.6,92.35,90.85,9,4,5,0.444,6,3,3,0.5,2,2,3,0,191.88,189.04,190.45999999999998
2013-11-15,1610612737,1610612755,2013,113.0,103.0,216.0,93.9,97.65,99.8,105.75,8,4,4,0.5,9,5,4,0.556,2,2,4,1,194.4,200.56,197.48000000000002
2013-11-15,1610612738,1610612757,2013,96.0,109.0,205.0,93.75,94.2,98.0,98.6,9,4,5,0.444,8,6,2,0.75,2,2,4,2,193.8,200.12,196.96
2013-11-15,1610612739,1610612766,2013,80.0,86.0,166.0,92.05,98.7,91.1,91.5,9,3,6,0.333,8,4,4,0.5,3,0,2,2,193.8,191.36,192.58
2013-11-15,1610612748,1610612742,2013,110.0,104.0,214.0,99.45,98.15,99.25,96.8,8,5,3,0.625,8,5,3,0.625,4,1,4,1,192.76,201.76,197.26
2013-11-15,1610612743,1610612750,2013,117.0,113.0,230.0,98.7,101.4,104.25,98.55,7,3,4,0.429,9,6,3,0.667,2,1,4,2,203.68,196.48,200.07999999999998
2013-11-15,1610612756,1610612751,2013,98.0,100.0,198.0,99.3,98.8,99.45,97.15,8,5,3,0.625,7,2,5,0.28600000000000003,4,1,2,0,192.96,190.16,191.56
2013-11-15,1610612762,1610612759,2013,82.0,91.0,173.0,91.1,98.6,100.65,96.9,9,1,8,0.111,9,8,1,0.889,1,0,4,4,193.44,196.04,194.74
2013-11-15,1610612747,1610612763,2013,86.0,89.0,175.0,97.5,103.65,90.35,97.35,10,4,6,0.4,8,3,5,0.375,3,1,3,0,198.16,186.28,192.22
2013-11-15,1610612758,1610612765,2013,90.0,97.0,187.0,100.0,100.1,99.7,99.8,7,2,5,0.28600000000000003,7,2,5,0.28600000000000003,2,0,2,0,207.96,196.76,202.36
2013-11-14,1610612752,1610612745,2013,106.0,109.0,215.0,94.05,95.9,105.35,102.7,7,3,4,0.429,9,5,4,0.556,1,2,3,2,190.32,201.16,195.74
2013-11-14,1610612744,1610612760,2013,116.0,115.0,231.0,96.55,95.0,97.35,96.95,8,5,3,0.625,7,5,2,0.7140000000000001,3,2,3,2,196.68,198.4,197.54000000000002
2013-11-13,1610612753,1610612749,2013,94.0,91.0,185.0,96.0,100.05,92.5,98.55,8,3,5,0.375,6,2,4,0.333,3,0,1,1,197.84,201.64,199.74
2013-11-13,1610612755,1610612745,2013,123.0,117.0,240.0,98.6,105.05,104.25,101.5,8,4,4,0.5,8,5,3,0.625,3,1,3,2,197.24,201.16,199.2
2013-11-13,1610612738,1610612766,2013,83.0,89.0,172.0,93.4,94.25,91.45,92.6,8,4,4,0.5,7,3,4,0.429,2,2,2,1,195.32,191.36,193.34
2013-11-13,1610612763,1610612761,2013,87.0,103.0,190.0,91.15,97.05,99.85,95.25,7,3,4,0.429,8,3,5,0.375,3,0,2,1,185.64,191.88,188.76
2013-11-13,1610612750,1610612739,2013,124.0,95.0,219.0,103.4,98.85,92.0,97.45,8,5,3,0.625,8,3,5,0.375,3,2,3,0,195.48,193.8,194.64
2013-11-13,1610612737,1610612752,2013,91.0,95.0,186.0,94.8,98.1,93.4,96.0,7,4,3,0.5710000000000001,6,2,4,0.333,2,2,1,1,194.76,190.32,192.54
2013-11-13,1610612759,1610612764,2013,92.0,79.0,171.0,100.7,97.4,97.9,98.3,8,7,1,0.875,7,2,5,0.28600000000000003,3,4,1,1,197.08,194.64,195.86
2013-11-13,1610612743,1610612747,2013,111.0,99.0,210.0,99.05,101.9,97.7,103.0,6,2,4,0.333,9,4,5,0.444,1,1,3,1,204.24,198.16,201.2
2013-11-13,1610612762,1610612740,2013,111.0,105.0,216.0,90.35,99.0,97.8,96.45,8,0,8,0.0,8,3,5,0.375,0,0,2,1,192.36,190.68,191.52
2013-11-13,1610612757,1610612756,2013,90.0,89.0,179.0,98.0,99.45,99.95,98.85,7,5,2,0.7140000000000001,7,5,2,0.7140000000000001,3,2,4,1,201.12,192.96,197.04000000000002
2013-11-13,1610612758,1610612751,2013,107.0,86.0,193.0,99.0,100.25,98.95,95.75,6,1,5,0.16699999999999998,6,2,4,0.333,1,0,2,0,208.24,190.16,199.2
2013-11-13,1610612746,1610612760,2013,111.0,103.0,214.0,103.6,100.9,97.4,96.45,8,5,3,0.625,6,5,1,0.833,3,2,3,2,204.48,198.4,201.44
2013-11-12,1610612748,1610612749,2013,118.0,95.0,213.0,98.7,98.4,92.0,97.4,7,4,3,0.5710000000000001,5,2,3,0.4,3,1,1,1,191.32,201.64,196.48
2013-11-12,1610612742,1610612764,2013,105.0,95.0,200.0,99.4,97.3,98.1,99.05,7,4,3,0.5710000000000001,6,2,4,0.333,3,1,1,1,202.0,194.64,198.32
2013-11-12,1610612744,1610612765,2013,113.0,95.0,208.0,96.65,95.3,99.6,99.05,7,4,3,0.5710000000000001,6,2,4,0.333,2,2,2,0,195.64,196.76,196.2
2013-11-12,1610612747,1610612740,2013,116.0,95.0,211.0,96.3,103.1,98.55,96.7,8,3,5,0.375,7,3,4,0.429,2,1,2,1,198.12,190.68,194.4
2013-11-11,1610612766,1610612737,2013,94.0,103.0,197.0,91.5,91.7,94.55,99.05,6,3,3,0.5,6,3,3,0.5,2,1,2,1,191.6,194.76,193.18
2013-11-11,1610612754,1610612763,2013,95.0,79.0,174.0,93.25,90.7,92.15,96.95,7,7,0,1.0,6,3,3,0.5,4,3,3,0,186.72,185.64,186.18
2013-11-11,1610612755,1610612759,2013,85.0,109.0,194.0,98.9,103.45,99.45,98.3,7,4,3,0.5710000000000001,7,6,1,0.857,3,1,3,3,195.04,197.08,196.06
2013-11-11,1610612738,1610612753,2013,120.0,105.0,225.0,92.05,94.05,94.95,98.95,7,3,4,0.429,7,3,4,0.429,1,2,3,0,193.56,197.84,195.7
2013-11-11,1610612741,1610612739,2013,96.0,81.0,177.0,92.15,91.55,92.8,97.2,5,2,3,0.4,7,3,4,0.429,2,0,3,0,189.92,193.8,191.86
2013-11-11,1610612745,1610612761,2013,110.0,104.0,214.0,104.0,101.45,99.4,94.4,7,4,3,0.5710000000000001,7,3,4,0.429,2,2,2,1,201.28,191.88,196.57999999999998
2013-11-11,1610612762,1610612743,2013,81.0,100.0,181.0,91.9,99.1,99.45,103.35,7,0,7,0.0,5,1,4,0.2,0,0,1,0,191.64,204.24,197.94
2013-11-11,1610612757,1610612765,2013,109.0,103.0,212.0,97.85,99.95,99.85,98.5,6,4,2,0.667,5,2,3,0.4,2,2,2,0,201.04,196.76,198.89999999999998
2013-11-11,1610612746,1610612750,2013,109.0,107.0,216.0,102.8,99.4,102.5,98.65,7,4,3,0.5710000000000001,7,5,2,0.7140000000000001,2,2,3,2,203.92,195.48,199.7
2013-11-10,1610612752,1610612759,2013,89.0,120.0,209.0,93.2,93.9,98.05,98.25,5,2,3,0.4,6,5,1,0.833,1,1,3,2,189.16,197.08,193.12
2013-11-10,1610612760,1610612764,2013,106.0,105.0,211.0,97.1,96.55,97.65,99.1,5,4,1,0.8,5,2,3,0.4,2,2,1,1,196.92,194.64,195.77999999999997
2013-11-10,1610612756,1610612740,2013,101.0,94.0,195.0,100.05,100.0,98.65,96.85,6,4,2,0.667,6,3,3,0.5,3,1,2,1,192.4,190.68,191.54000000000002
2013-11-10,1610612747,1610612750,2013,90.0,113.0,203.0,97.0,102.2,102.2,99.05,7,3,4,0.429,6,4,2,0.667,2,1,3,1,198.72,195.48,197.1
2013-11-09,1610612761,1610612762,2013,115.0,91.0,206.0,98.5,94.25,90.85,97.65,6,2,4,0.333,6,0,6,0.0,1,1,0,0,191.04,191.64,191.33999999999997
2013-11-09,1610612737,1610612753,2013,104.0,94.0,198.0,93.85,99.4,95.4,99.3,5,2,3,0.4,6,3,3,0.5,1,1,3,0,193.6,197.84,195.72
2013-11-09,1610612751,1610612754,2013,91.0,96.0,187.0,99.55,95.9,93.3,90.8,5,2,3,0.4,6,6,0,1.0,2,0,4,2,189.96,186.72,188.34
2013-11-09,1610612739,1610612755,2013,127.0,125.0,252.0,91.0,96.0,96.8,101.5,6,2,4,0.333,6,4,2,0.667,2,0,3,1,191.36,195.04,193.2
2013-11-09,1610612748,1610612738,2013,110.0,111.0,221.0,98.35,97.05,90.05000000000003,92.9,6,4,2,0.667,6,2,4,0.333,3,1,1,1,190.2,193.56,191.88
2013-11-09,1610612745,1610612746,2013,94.0,107.0,201.0,104.35,101.3,101.6,99.9,6,4,2,0.667,6,3,3,0.5,2,2,2,1,202.88,203.92,203.39999999999998
2013-11-09,1610612763,1610612744,2013,108.0,90.0,198.0,91.1,96.5,97.15,94.45,5,2,3,0.4,6,4,2,0.667,2,0,2,2,184.52,195.64,190.07999999999998
2013-11-09,1610612749,1610612742,2013,83.0,91.0,174.0,94.4,97.95,100.7,98.55,4,2,2,0.5,6,3,3,0.5,1,1,3,0,202.88,202.0,202.44
2013-11-09,1610612758,1610612757,2013,85.0,96.0,181.0,100.15,101.3,97.2,100.85,5,1,4,0.2,5,3,2,0.6,1,0,2,1,209.08,201.04,205.06
2013-11-08,1610612766,1610612752,2013,91.0,101.0,192.0,90.9,91.1,91.7,93.45,5,3,2,0.6,4,1,3,0.25,2,1,1,0,191.76,189.16,190.45999999999998
2013-11-08,1610612754,1610612761,2013,91.0,84.0,175.0,94.05,91.55,98.9,95.15,5,5,0,1.0,5,2,3,0.4,3,2,1,1,186.28,191.04,188.66
2013-11-08,1610612753,1610612738,2013,89.0,91.0,180.0,95.35,100.75,89.4,92.7,5,3,2,0.6,5,1,4,0.2,3,0,1,0,197.12,193.56,195.34
2013-11-08,1610612755,1610612739,2013,94.0,79.0,173.0,97.15,103.75,91.75,96.4,5,3,2,0.6,5,2,3,0.4,2,1,2,0,194.88,191.36,193.12
2013-11-08,1610612764,1610612751,2013,112.0,108.0,220.0,97.5,98.3,98.5,94.95,4,1,3,0.25,4,2,2,0.5,0,1,2,0,193.44,189.96,191.7
2013-11-08,1610612765,1610612760,2013,110.0,119.0,229.0,98.45,97.5,96.45,95.55,4,2,2,0.5,4,3,1,0.75,2,0,2,1,195.4,196.92,196.16
2013-11-08,1610612741,1610612762,2013,97.0,73.0,170.0,94.4,94.6,92.0,96.8,4,1,3,0.25,5,0,5,0.0,1,0,0,0,189.24,191.64,190.44
2013-11-08,1610612750,1610612742,2013,116.0,108.0,224.0,101.05,98.4,100.0,97.5,5,3,2,0.6,5,3,2,0.6,2,1,3,0,194.44,202.0,198.22
2013-11-08,1610612740,1610612747,2013,96.0,85.0,181.0,98.3,98.0,97.9,103.05,5,2,3,0.4,6,3,3,0.5,1,1,2,1,190.52,198.72,194.62
2013-11-08,1610612759,1610612744,2013,76.0,74.0,150.0,99.5,98.7,99.8,97.1,5,4,1,0.8,5,4,1,0.8,2,2,2,2,200.36,195.64,198.0
2013-11-08,1610612756,1610612743,2013,114.0,103.0,217.0,99.35,99.95,99.9,103.2,5,3,2,0.6,4,1,3,0.25,2,1,1,0,191.4,204.24,197.82
2013-11-08,1610612757,1610612758,2013,104.0,91.0,195.0,96.55,101.1,100.85,101.0,4,2,2,0.5,4,1,3,0.25,1,1,1,0,201.28,209.08,205.18
2013-11-07,1610612748,1610612746,2013,102.0,97.0,199.0,97.65,96.8,100.85,99.5,5,3,2,0.6,5,3,2,0.6,2,1,2,1,189.92,203.92,196.92
2013-11-07,1610612743,1610612737,2013,109.0,107.0,216.0,99.25,102.15,93.0,99.3,3,0,3,0.0,4,2,2,0.5,0,0,1,1,204.24,193.6,198.92000000000002
2013-11-07,1610612745,1610612747,2013,98.0,99.0,197.0,105.5,101.35,98.95,104.0,5,4,1,0.8,5,2,3,0.4,2,2,2,0,203.84,198.72,201.28
2013-11-06,1610612766,1610612761,2013,92.0,90.0,182.0,90.7,90.75,99.35,94.65,4,2,2,0.5,4,2,2,0.5,1,1,1,1,192.24,191.04,191.64
2013-11-06,1610612754,1610612741,2013,97.0,80.0,177.0,93.85,91.65,94.95,95.25,4,4,0,1.0,3,1,2,0.333,2,2,1,0,186.76,189.24,188.0
2013-11-06,1610612753,1610612746,2013,98.0,90.0,188.0,96.1,101.4,101.95,100.0,4,2,2,0.5,4,3,1,0.75,2,0,2,1,197.84,203.92,200.88
2013-11-06,1610612755,1610612764,2013,102.0,116.0,218.0,97.05,102.55,95.6,97.6,4,3,1,0.75,3,0,3,0.0,2,1,0,0,193.2,193.44,193.32
2013-11-06,1610612738,1610612762,2013,97.0,87.0,184.0,89.9,93.15,92.5,96.45,4,0,4,0.0,4,0,4,0.0,0,0,0,0,193.4,191.64,192.51999999999998
2013-11-06,1610612763,1610612740,2013,84.0,99.0,183.0,92.8,96.8,98.1,98.4,4,2,2,0.5,4,1,3,0.25,2,0,1,0,185.56,190.52,188.04000000000002
2013-11-06,1610612749,1610612739,2013,109.0,104.0,213.0,93.9,98.2,91.15,96.55,3,1,2,0.333,4,2,2,0.5,0,1,2,0,202.04,191.36,196.7
2013-11-06,1610612750,1610612744,2013,93.0,106.0,199.0,101.9,98.1,99.5,97.8,4,3,1,0.75,4,3,1,0.75,2,1,2,1,194.4,195.64,195.01999999999998
2013-11-06,1610612759,1610612756,2013,99.0,96.0,195.0,100.0,98.45,99.45,100.05,4,3,1,0.75,4,3,1,0.75,1,2,2,1,199.88,191.4,195.64
2013-11-06,1610612760,1610612742,2013,107.0,93.0,200.0,96.35,96.0,99.4,97.2,3,2,1,0.667,4,3,1,0.75,1,1,3,0,198.44,202.0,200.22
2013-11-05,1610612761,1610612748,2013,95.0,104.0,199.0,99.0,93.35,96.3,96.6,3,2,1,0.667,4,2,2,0.5,1,1,2,0,189.92,189.92,189.92
2013-11-05,1610612751,1610612762,2013,104.0,88.0,192.0,98.6,95.6,93.35,96.0,3,1,2,0.333,3,0,3,0.0,1,0,0,0,189.88,191.64,190.76
2013-11-05,1610612765,1610612754,2013,91.0,99.0,190.0,98.0,97.8,94.0,92.25,3,2,1,0.667,3,3,0,1.0,2,0,2,1,195.44,186.76,191.1
2013-11-05,1610612752,1610612766,2013,97.0,102.0,199.0,91.75,92.95,90.7,92.45,3,1,2,0.333,3,1,2,0.333,1,0,1,0,188.8,192.24,190.52
2013-11-05,1610612740,1610612756,2013,98.0,104.0,202.0,97.75,98.45,99.3,101.45,3,1,2,0.333,3,2,1,0.667,1,0,2,0,189.72,191.4,190.56
2013-11-05,1610612742,1610612747,2013,123.0,104.0,227.0,97.8,97.1,98.9,103.3,3,2,1,0.667,4,2,2,0.5,2,0,2,0,201.2,198.72,199.95999999999998
2013-11-05,1610612743,1610612759,2013,94.0,102.0,196.0,101.15,102.75,99.55,98.05,2,0,2,0.0,3,2,1,0.667,0,0,1,1,204.84,199.88,202.36
2013-11-05,1610612757,1610612745,2013,101.0,116.0,217.0,96.4,101.1,105.3,102.25,3,2,1,0.667,4,3,1,0.75,1,1,2,1,199.8,203.84,201.82
2013-11-05,1610612758,1610612737,2013,100.0,105.0,205.0,100.95,101.35,92.35,99.2,3,1,2,0.333,3,1,2,0.333,1,0,1,0,208.44,193.6,201.01999999999998
2013-11-04,1610612739,1610612750,2013,93.0,92.0,185.0,91.7,97.5,102.55,97.55,3,1,2,0.333,3,3,0,1.0,1,0,2,1,191.64,194.4,193.01999999999998
2013-11-04,1610612755,1610612744,2013,90.0,110.0,200.0,97.55,101.65,100.55,99.15,3,3,0,1.0,3,2,1,0.667,2,1,2,0,193.32,195.64,194.48
2013-11-04,1610612763,1610612738,2013,95.0,88.0,183.0,93.25,96.55,90.0,94.1,3,1,2,0.333,3,0,3,0.0,1,0,0,0,185.96,193.4,189.68
2013-11-04,1610612746,1610612745,2013,137.0,118.0,255.0,100.65,98.85,105.1,102.0,3,2,1,0.667,3,3,0,1.0,1,1,2,1,200.88,203.84,202.36
2013-11-03,1610612765,1610612738,2013,87.0,77.0,164.0,97.75,99.9,92.15,94.15,2,1,1,0.5,2,0,2,0.0,1,0,0,0,196.44,193.4,194.92000000000002
2013-11-03,1610612748,1610612764,2013,103.0,93.0,196.0,96.1,95.75,95.55,97.3,3,1,2,0.333,2,0,2,0.0,1,0,0,0,189.52,193.44,191.48000000000002
2013-11-03,1610612753,1610612751,2013,107.0,86.0,193.0,95.6,101.7,100.15,95.7,3,1,2,0.333,2,1,1,0.5,1,0,1,0,197.8,189.88,193.84
2013-11-03,1610612760,1610612756,2013,103.0,96.0,199.0,97.2,95.75,98.9,101.45,2,1,1,0.5,2,2,0,1.0,0,1,2,0,198.88,191.4,195.14
2013-11-03,1610612752,1610612750,2013,100.0,109.0,209.0,91.25,91.5,102.95,96.85,2,1,1,0.5,2,2,0,1.0,1,0,2,0,187.8,194.4,191.10000000000002
2013-11-03,1610612747,1610612737,2013,105.0,103.0,208.0,97.75,103.3,93.4,99.0,3,1,2,0.333,2,1,1,0.5,1,0,1,0,198.88,193.6,196.24
2013-11-02,1610612754,1610612739,2013,89.0,74.0,163.0,93.65,92.1,91.9,98.85,2,2,0,1.0,2,1,1,0.5,1,1,1,0,187.84,191.64,189.74
2013-11-02,1610612755,1610612741,2013,107.0,104.0,211.0,97.25,101.45,94.25,94.0,2,2,0,1.0,2,1,1,0.5,1,1,1,0,191.96,189.24,190.60000000000002
2013-11-02,1610612740,1610612766,2013,105.0,84.0,189.0,98.0,98.55,91.1,92.2,2,0,2,0.0,2,1,1,0.5,0,0,1,0,190.92,192.24,191.57999999999998
2013-11-02,1610612742,1610612763,2013,111.0,99.0,210.0,97.25,97.05,92.85,95.65,2,1,1,0.5,2,1,1,0.5,1,0,1,0,200.96,185.96,193.46
2013-11-02,1610612749,1610612761,2013,90.0,97.0,187.0,95.05,98.5,98.35,94.35,2,1,1,0.5,2,1,1,0.5,0,1,1,0,203.0,189.92,196.45999999999998
2013-11-02,1610612762,1610612745,2013,93.0,104.0,197.0,94.5,96.15,105.7,102.25,2,0,2,0.0,2,2,0,1.0,0,0,2,0,191.88,203.84,197.86
2013-11-02,1610612757,1610612759,2013,115.0,105.0,220.0,94.45,100.55,99.5,96.95,2,1,1,0.5,2,2,0,1.0,0,1,1,1,198.72,199.88,199.3
2013-11-02,1610612744,1610612758,2013,98.0,87.0,185.0,101.15,100.2,101.35,101.5,2,1,1,0.5,2,1,1,0.5,1,0,1,0,195.04,208.44,201.74
2013-11-01,1610612766,1610612739,2013,90.0,84.0,174.0,92.3,93.4,93.35,100.3,1,0,1,0.0,1,1,0,1.0,0,0,1,0,192.88,191.64,192.26
2013-11-01,1610612753,1610612740,2013,110.0,90.0,200.0,94.8,102.6,97.65,97.8,2,0,2,0.0,1,0,1,0.0,0,0,0,0,198.44,190.92,194.68
2013-11-01,1610612764,1610612755,2013,102.0,109.0,211.0,95.8,96.55,96.65,100.7,1,0,1,0.0,1,1,0,1.0,0,0,1,0,191.36,191.96,191.66000000000003
2013-11-01,1610612737,1610612761,2013,102.0,95.0,197.0,92.4,99.0,98.65,94.6,1,0,1,0.0,1,1,0,1.0,0,0,1,0,193.12,189.92,191.51999999999998
2013-11-01,1610612738,1610612749,2013,98.0,105.0,203.0,91.8,93.75,95.0,99.05,1,0,1,0.0,1,0,1,0.0,0,0,0,0,193.2,203.0,198.1
2013-11-01,1610612745,1610612742,2013,113.0,105.0,218.0,103.95,101.1,98.35,97.05,1,1,0,1.0,1,1,0,1.0,1,0,1,0,205.08,200.96,203.02
2013-11-01,1610612763,1610612765,2013,111.0,108.0,219.0,92.0,94.35,97.05,99.1,1,0,1,0.0,1,1,0,1.0,0,0,1,0,184.88,196.44,190.66
2013-11-01,1610612750,1610612760,2013,100.0,81.0,181.0,102.25,97.75,98.95,95.6,1,1,0,1.0,1,1,0,1.0,1,0,0,1,195.2,198.88,197.04
2013-11-01,1610612751,1610612748,2013,101.0,100.0,201.0,100.3,94.85,95.7,95.65,1,0,1,0.0,2,1,1,0.5,0,0,1,0,188.8,189.52,189.16000000000003
2013-11-01,1610612743,1610612757,2013,98.0,113.0,211.0,101.0,101.8,94.0,100.3,1,0,1,0.0,1,0,1,0.0,0,0,0,0,205.52,198.72,202.12
2013-11-01,1610612756,1610612762,2013,87.0,84.0,171.0,98.85,103.1,95.7,97.45,1,1,0,1.0,1,0,1,0.0,1,0,0,0,192.24,191.88,192.06
2013-11-01,1610612758,1610612746,2013,101.0,110.0,211.0,101.2,101.15,99.7,98.15,1,1,0,1.0,2,1,1,0.5,1,0,1,0,209.68,200.88,205.28
2013-11-01,1610612747,1610612759,2013,85.0,91.0,176.0,97.95,104.75,99.65,96.8,2,1,1,0.5,1,1,0,1.0,1,0,1,0,200.88,199.88,200.38
2013-10-31,1610612741,1610612752,2013,82.0,81.0,163.0,94.1,93.75,91.6,91.4,1,0,1,0.0,1,1,0,1.0,0,0,1,0,190.4,187.8,189.10000000000002
2013-10-31,1610612746,1610612744,2013,126.0,115.0,241.0,98.85,97.15,100.15,98.75,1,0,1,0.0,1,1,0,1.0,0,0,1,0,199.48,195.04,197.26
2013-10-30,1610612739,1610612751,2013,98.0,94.0,192.0,93.0,99.85,100.65,94.6,0,0,0,0.0,0,0,0,0.0,0,0,0,0,192.52,188.8,190.66000000000003
2013-10-30,1610612755,1610612748,2013,114.0,110.0,224.0,95.85,99.75,95.9,94.75,0,0,0,0.0,1,1,0,1.0,0,0,1,0,190.0,189.52,189.76
2013-10-30,1610612761,1610612738,2013,93.0,87.0,180.0,98.9,95.65,92.5,94.55,0,0,0,0.0,0,0,0,0.0,0,0,0,0,191.36,193.2,192.28
2013-10-30,1610612765,1610612764,2013,113.0,102.0,215.0,96.35,99.1,94.7,96.05,0,0,0,0.0,0,0,0,0.0,0,0,0,0,194.92,191.36,193.14
2013-10-30,1610612752,1610612749,2013,90.0,83.0,173.0,93.1,92.2,96.0,100.2,0,0,0,0.0,0,0,0,0.0,0,0,0,0,188.92,203.0,195.95999999999998
2013-10-30,1610612745,1610612766,2013,96.0,83.0,179.0,104.2,101.85,93.25,94.15,0,0,0,0.0,0,0,0,0.0,0,0,0,0,206.08,192.88,199.48000000000002
2013-10-30,1610612750,1610612753,2013,120.0,115.0,235.0,101.3,96.65,93.45,101.45,0,0,0,0.0,1,0,1,0.0,0,0,0,0,194.24,198.44,196.34
2013-10-30,1610612740,1610612754,2013,90.0,95.0,185.0,97.65,97.2,92.65,91.85,0,0,0,0.0,1,1,0,1.0,0,0,1,0,192.64,187.84,190.24
2013-10-30,1610612742,1610612737,2013,118.0,109.0,227.0,96.35,96.75,91.8,98.05,0,0,0,0.0,0,0,0,0.0,0,0,0,0,200.08,193.12,196.60000000000002
2013-10-30,1610612759,1610612763,2013,101.0,94.0,195.0,99.15,97.1,92.45,93.95,0,0,0,0.0,0,0,0,0.0,0,0,0,0,200.0,184.88,192.44
2013-10-30,1610612762,1610612760,2013,98.0,101.0,199.0,95.95,96.8,98.4,94.7,0,0,0,0.0,0,0,0,0.0,0,0,0,0,192.12,198.88,195.5
2013-10-30,1610612756,1610612757,2013,104.0,91.0,195.0,97.6,102.95,94.4,99.55,0,0,0,0.0,0,0,0,0.0,0,0,0,0,191.36,198.72,195.04000000000002
2013-10-30,1610612758,1610612743,2013,90.0,88.0,178.0,101.85,102.6,101.85,102.7,0,0,0,0.0,0,0,0,0.0,0,0,0,0,211.64,205.52,208.57999999999998
2013-10-30,1610612744,1610612747,2013,125.0,94.0,219.0,99.7,99.35,97.05,103.45,0,0,0,0.0,1,1,0,1.0,0,0,1,0,196.0,200.88,198.44
2013-10-29,1610612754,1610612753,2013,97.0,87.0,184.0,93.1,91.65,94.5,102.3,8,3,5,0.375,8,2,6,0.25,0,3,1,1,188.68,198.44,193.56
2013-10-29,1610612748,1610612741,2013,107.0,95.0,202.0,95.05,93.95,93.8,93.7,8,5,3,0.625,8,8,0,1.0,3,2,5,3,189.12,190.4,189.76
2013-10-29,1610612747,1610612746,2013,116.0,103.0,219.0,96.2,103.05,98.5,96.0,8,4,4,0.5,8,5,3,0.625,4,0,2,3,199.16,199.48,199.32
2013-10-25,1610612753,1610612740,2013,82.0,101.0,183.0,94.85,102.1,97.0,98.0,7,2,5,0.28600000000000003,7,6,1,0.857,1,1,2,4,199.36,192.64,196.0
2013-10-25,1610612752,1610612766,2013,83.0,85.0,168.0,94.0,92.1,92.85,95.45,6,2,4,0.333,7,4,3,0.5710000000000001,0,2,2,2,189.48,192.88,191.18
2013-10-25,1610612748,1610612751,2013,87.0,108.0,195.0,95.35,93.4,100.9,95.0,7,5,2,0.7140000000000001,6,4,2,0.667,3,2,2,2,188.48,188.8,188.64
2013-10-25,1610612741,1610612743,2013,94.0,89.0,183.0,93.85,93.85,103.05,102.8,7,7,0,1.0,6,2,4,0.333,4,3,1,1,190.2,205.52,197.86
2013-10-25,1610612763,1610612745,2013,73.0,92.0,165.0,93.1,92.85,105.2,103.3,7,4,3,0.5710000000000001,6,5,1,0.833,2,2,3,2,185.72,206.08,195.9
2013-10-25,1610612742,1610612754,2013,77.0,98.0,175.0,97.95,96.95,92.15,93.05,7,4,3,0.5710000000000001,7,2,5,0.28600000000000003,1,3,0,2,201.88,188.68,195.28
2013-10-25,1610612747,1610612762,2013,111.0,106.0,217.0,95.2,102.05,95.5,96.45,7,3,4,0.429,7,1,6,0.14300000000000002,3,0,1,0,199.16,192.12,195.64
2013-10-25,1610612746,1610612758,2013,100.0,110.0,210.0,99.8,95.55,101.45,103.25,7,5,2,0.7140000000000001,6,4,2,0.667,2,3,3,1,198.32,211.64,204.98
2013-10-24,1610612766,1610612739,2013,105.0,92.0,197.0,92.15,95.45,92.7,99.4,6,3,3,0.5,7,4,3,0.5710000000000001,1,2,3,1,192.16,192.52,192.34
2013-10-24,1610612765,1610612750,2013,99.0,98.0,197.0,95.25,98.55,101.3,96.75,7,3,4,0.429,6,4,2,0.667,2,1,2,2,195.4,194.24,194.82
2013-10-24,1610612759,1610612745,2013,92.0,109.0,201.0,101.0,98.0,104.45,103.85,6,3,3,0.5,5,4,1,0.8,2,1,3,1,201.64,206.08,203.86
2013-10-24,1610612744,1610612757,2013,74.0,90.0,164.0,100.85,100.65,94.65,100.95,6,3,3,0.5,6,4,2,0.667,2,1,2,2,197.76,198.72,198.24
2013-10-23,1610612761,1610612763,2013,108.0,72.0,180.0,97.9,97.4,94.05,92.1,6,5,1,0.833,6,4,2,0.667,3,2,2,2,192.04,185.72,188.88
2013-10-23,1610612738,1610612751,2013,101.0,97.0,198.0,92.35,94.35,101.4,95.75,7,1,6,0.14300000000000002,5,4,1,0.8,1,0,2,2,192.28,188.8,190.54000000000002
2013-10-23,1610612755,1610612750,2013,102.0,125.0,227.0,95.45,98.4,98.9,96.25,6,2,4,0.333,5,3,2,0.6,1,1,2,1,189.28,194.24,191.76
2013-10-23,1610612739,1610612764,2013,82.0,101.0,183.0,93.35,100.0,94.25,97.0,6,4,2,0.667,6,1,5,0.16699999999999998,3,1,1,0,194.28,191.36,192.82
2013-10-23,1610612749,1610612752,2013,105.0,95.0,200.0,95.7,100.65,93.75,91.7,5,0,5,0.0,5,2,3,0.4,0,0,0,2,203.48,189.48,196.48
2013-10-23,1610612740,1610612748,2013,95.0,108.0,203.0,96.6,96.9,94.35,91.9,6,6,0,1.0,6,4,2,0.667,2,4,3,1,192.36,188.48,190.42000000000002
2013-10-23,1610612742,1610612737,2013,98.0,88.0,186.0,98.7,97.95,92.75,99.05,6,3,3,0.5,6,1,5,0.16699999999999998,0,3,0,1,203.68,193.12,198.4
2013-10-23,1610612743,1610612756,2013,79.0,98.0,177.0,104.55,102.25,97.95,105.35,5,2,3,0.4,6,4,2,0.667,1,1,2,2,206.56,191.36,198.96
2013-10-23,1610612760,1610612741,2013,95.0,104.0,199.0,98.1,94.25,93.75,93.3,6,4,2,0.667,6,6,0,1.0,2,2,4,2,199.84,190.2,195.01999999999998
2013-10-23,1610612758,1610612744,2013,91.0,90.0,181.0,101.95,103.65,101.3,100.5,5,3,2,0.6,5,3,2,0.6,2,1,2,1,213.56,197.76,205.66
2013-10-23,1610612746,1610612762,2013,103.0,99.0,202.0,99.95,96.05,95.2,96.3,6,4,2,0.667,6,1,5,0.16699999999999998,1,3,1,0,198.44,192.12,195.28
2013-10-22,1610612737,1610612754,2013,89.0,107.0,196.0,93.4,98.4,91.9,93.35,5,1,4,0.2,6,1,5,0.16699999999999998,0,1,0,1,194.64,188.68,191.66
2013-10-22,1610612765,1610612764,2013,99.0,96.0,195.0,95.45,99.45,94.6,97.05,6,2,4,0.333,5,1,4,0.2,1,1,1,0,194.36,191.36,192.86
2013-10-22,1610612759,1610612753,2013,123.0,101.0,224.0,99.95,97.5,94.5,101.25,5,2,3,0.4,6,2,4,0.333,1,1,1,1,200.04,199.36,199.7
2013-10-22,1610612756,1610612760,2013,88.0,76.0,164.0,98.5,105.35,99.15,93.6,5,3,2,0.6,5,4,1,0.8,1,2,2,2,191.48,199.84,195.66
2013-10-22,1610612747,1610612762,2013,108.0,94.0,202.0,95.7,103.15,94.85,96.4,6,2,4,0.333,5,1,4,0.2,2,0,1,0,199.12,192.12,195.62
2013-10-21,1610612761,1610612752,2013,123.0,120.0,243.0,96.45,96.35,92.25,89.35,5,4,1,0.8,4,2,2,0.5,2,2,0,2,190.76,189.48,190.12
2013-10-21,1610612739,1610612755,2013,104.0,93.0,197.0,92.5,100.2,95.35,98.55,5,3,2,0.6,5,2,3,0.4,2,1,1,1,195.08,189.28,192.18
2013-10-21,1610612741,1610612749,2013,105.0,84.0,189.0,94.4,94.65,95.65,100.1,5,5,0,1.0,4,0,4,0.0,3,2,0,0,190.24,203.48,196.86
2013-10-21,1610612745,1610612742,2013,100.0,95.0,195.0,105.0,104.25,98.5,97.55,4,3,1,0.75,5,3,2,0.6,2,1,0,3,207.28,203.68,205.48000000000002
2013-10-20,1610612737,1610612763,2013,82.0,90.0,172.0,94.15,98.3,94.1,93.6,4,1,3,0.25,5,3,2,0.6,0,1,2,1,195.76,185.72,190.74
2013-10-20,1610612753,1610612765,2013,87.0,86.0,173.0,95.0,102.25,95.75,99.65,5,1,4,0.2,5,2,3,0.4,0,1,1,1,199.76,194.36,197.06
2013-10-20,1610612750,1610612738,2013,104.0,89.0,193.0,99.55,97.8,92.9,94.65,4,2,2,0.5,6,1,5,0.16699999999999998,1,1,1,0,193.96,192.28,193.12
2013-10-20,1610612760,1610612762,2013,88.0,82.0,170.0,99.95,94.25,94.95,97.65,4,3,1,0.75,4,1,3,0.25,1,2,1,0,201.72,192.12,196.92000000000002
2013-10-20,1610612757,1610612758,2013,109.0,105.0,214.0,93.95,100.95,100.85,102.55,5,3,2,0.6,4,3,1,0.75,1,2,2,1,198.72,213.56,206.14
2013-10-19,1610612740,1610612764,2013,93.0,89.0,182.0,95.55,97.1,94.55,96.35,5,5,0,1.0,4,1,3,0.25,1,4,1,0,191.76,191.36,191.56
2013-10-19,1610612766,1610612742,2013,83.0,89.0,172.0,93.35,96.05,99.8,98.8,5,3,2,0.6,4,2,2,0.5,1,2,0,2,193.84,203.68,198.76
2013-10-19,1610612748,1610612759,2013,121.0,96.0,217.0,93.45,92.2,99.5,96.3,5,3,2,0.6,4,2,2,0.5,2,1,1,1,187.64,200.04,193.83999999999997
2013-10-19,1610612739,1610612754,2013,79.0,102.0,181.0,93.15,99.75,90.85,93.05,4,3,1,0.75,5,0,5,0.0,2,1,0,0,196.84,188.68,192.76
2013-10-19,1610612746,1610612743,2013,118.0,111.0,229.0,99.1,95.25,103.95,101.35,5,3,2,0.6,4,2,2,0.5,0,3,1,1,196.96,206.56,201.76
2013-10-18,1610612744,1610612747,2013,115.0,89.0,204.0,100.8,100.5,96.2,102.05,4,2,2,0.5,5,2,3,0.4,1,1,2,0,197.84,199.12,198.48000000000002
2013-10-18,1610612753,1610612763,2013,91.0,97.0,188.0,95.4,101.95,94.4,93.9,4,1,3,0.25,4,2,2,0.5,0,1,2,0,201.04,185.72,193.38
2013-10-18,1610612741,1610612754,2013,103.0,98.0,201.0,94.15,94.8,90.5,93.0,4,4,0,1.0,4,0,4,0.0,2,2,0,0,188.88,188.68,188.78
2013-10-18,1610612746,1610612757,2013,84.0,94.0,178.0,99.95,94.15,94.25,101.8,4,3,1,0.75,4,2,2,0.5,0,3,1,1,198.0,198.72,198.36
2013-10-17,1610612766,1610612755,2013,110.0,84.0,194.0,93.8,97.55,97.0,98.2,4,2,2,0.5,4,2,2,0.5,0,2,1,1,194.48,189.28,191.88
2013-10-17,1610612764,1610612752,2013,89.0,98.0,187.0,96.45,96.7,92.1,90.2,3,1,2,0.333,3,1,2,0.333,1,0,0,1,192.48,189.48,190.98
2013-10-17,1610612739,1610612765,2013,96.0,84.0,180.0,93.1,100.45,96.0,100.0,3,2,1,0.667,4,2,2,0.5,1,1,1,1,197.76,194.36,196.06
2013-10-17,1610612737,1610612759,2013,104.0,106.0,210.0,93.6,98.2,99.3,95.7,3,1,2,0.333,3,1,2,0.333,0,1,1,0,195.0,200.04,197.51999999999998
2013-10-17,1610612760,1610612740,2013,102.0,105.0,207.0,100.85,95.25,95.05,96.85,3,3,0,1.0,4,4,0,1.0,1,2,1,3,201.56,191.76,196.66
2013-10-17,1610612751,1610612748,2013,86.0,62.0,148.0,102.35,97.45,95.55,92.6,4,3,1,0.75,4,3,1,0.75,1,2,2,1,190.2,187.64,188.92
2013-10-17,1610612758,1610612756,2013,107.0,90.0,197.0,101.3,103.1,98.7,105.35,3,2,1,0.667,4,3,1,0.75,1,1,1,2,213.44,191.48,202.45999999999998
2013-10-16,1610612761,1610612738,2013,99.0,97.0,196.0,96.05,96.9,92.5,95.1,4,3,1,0.75,5,1,4,0.2,1,2,1,0,191.4,192.28,191.84
2013-10-16,1610612754,1610612742,2013,85.0,92.0,177.0,91.9,93.3,100.2,98.4,3,0,3,0.0,3,1,2,0.333,0,0,0,1,189.44,203.68,196.56
2013-10-16,1610612741,1610612765,2013,96.0,81.0,177.0,93.7,95.05,97.0,100.8,3,3,0,1.0,3,2,1,0.667,1,2,1,1,188.92,194.36,191.64
2013-10-16,1610612745,1610612753,2013,108.0,104.0,212.0,104.5,103.1,93.85,101.3,3,2,1,0.667,3,1,2,0.333,1,1,0,1,206.8,201.04,203.92000000000002
2013-10-16,1610612762,1610612757,2013,92.0,99.0,191.0,95.7,97.25,94.1,102.1,3,1,2,0.333,3,1,2,0.333,1,0,1,0,193.44,198.72,196.07999999999998
2013-10-15,1610612747,1610612744,2013,95.0,100.0,195.0,96.65,101.85,101.6,101.65,4,2,2,0.5,3,1,2,0.333,2,0,1,0,198.76,197.84,198.3
2013-10-15,1610612764,1610612748,2013,100.0,82.0,182.0,96.25,96.95,95.85,91.45,2,0,2,0.0,3,3,0,1.0,0,0,2,1,193.64,187.64,190.64
2013-10-15,1610612739,1610612766,2013,74.0,92.0,166.0,93.9,101.4,93.6,99.1,2,2,0,1.0,3,1,2,0.333,1,1,0,1,199.96,194.48,197.22
2013-10-15,1610612751,1610612738,2013,82.0,80.0,162.0,102.75,98.05,93.15,95.6,3,2,1,0.667,4,1,3,0.25,0,2,1,0,192.48,192.28,192.38
2013-10-15,1610612763,1610612749,2013,102.0,99.0,201.0,93.65,93.5,94.85,100.05,3,1,2,0.333,3,0,3,0.0,1,0,0,0,184.12,203.48,193.8
2013-10-15,1610612760,1610612743,2013,109.0,81.0,190.0,100.4,95.6,104.2,101.4,2,2,0,1.0,3,2,1,0.667,0,2,1,1,201.76,206.56,204.16
2013-10-15,1610612756,1610612746,2013,96.0,102.0,198.0,98.55,105.65,98.9,94.25,3,3,0,1.0,3,2,1,0.667,1,2,0,2,190.92,198.0,194.45999999999998
2013-10-14,1610612755,1610612751,2013,97.0,127.0,224.0,97.45,96.7,100.75,98.65,3,2,1,0.667,2,1,1,0.5,1,1,0,1,188.72,192.48,190.6
2013-10-14,1610612742,1610612753,2013,94.0,102.0,196.0,100.7,98.0,94.2,102.35,2,1,1,0.5,2,0,2,0.0,0,1,0,0,204.04,201.04,202.54
2013-10-14,1610612743,1610612759,2013,98.0,94.0,192.0,104.35,101.45,99.75,94.9,2,1,1,0.5,2,1,1,0.5,0,1,1,0,207.44,200.04,203.74
2013-10-14,1610612758,1610612746,2013,99.0,88.0,187.0,102.4,102.65,99.6,94.5,2,1,1,0.5,2,2,0,1.0,0,1,0,2,214.52,198.0,206.26
2013-10-13,1610612745,1610612754,2013,107.0,98.0,205.0,103.7,103.2,90.45,92.45,2,1,1,0.5,2,0,2,0.0,0,1,0,0,207.64,189.44,198.54
2013-10-13,1610612740,1610612737,2013,105.0,73.0,178.0,94.7,98.0,95.3,97.35,3,3,0,1.0,2,1,1,0.5,0,3,0,1,191.96,195.0,193.48000000000002
2013-10-13,1610612759,1610612756,2013,99.0,106.0,205.0,99.35,93.55,97.3,106.25,1,1,0,1.0,2,2,0,1.0,1,0,1,1,199.4,190.92,195.16
2013-10-12,1610612764,1610612741,2013,81.0,83.0,164.0,97.5,97.45,94.2,96.25,1,0,1,0.0,2,2,0,1.0,0,0,1,1,194.12,188.92,191.51999999999998
2013-10-12,1610612738,1610612752,2013,111.0,81.0,192.0,93.5,96.9,93.1,89.19999999999997,3,0,3,0.0,2,1,1,0.5,0,0,0,1,192.56,189.48,191.01999999999998
2013-10-12,1610612751,1610612765,2013,88.0,99.0,187.0,101.0,98.95,96.9,101.65,1,1,0,1.0,2,1,1,0.5,0,1,1,0,192.32,194.36,193.34
2013-10-12,1610612750,1610612761,2013,97.0,104.0,201.0,99.55,97.8,95.25,97.65,3,2,1,0.667,3,2,1,0.667,1,1,1,1,192.88,191.4,192.14
2013-10-12,1610612749,1610612766,2013,76.0,83.0,159.0,96.15,100.65,93.35,99.9,2,0,2,0.0,2,0,2,0.0,0,0,0,0,204.72,194.48,199.6
2013-10-12,1610612762,1610612746,2013,74.0,106.0,180.0,96.15,96.45,99.55,95.35,2,1,1,0.5,1,1,0,1.0,1,0,0,1,193.44,198.0,195.72
2013-10-11,1610612761,1610612752,2013,100.0,91.0,191.0,94.85,97.0,94.1,90.1,2,1,1,0.5,1,1,0,1.0,0,1,0,1,191.88,189.48,190.68
2013-10-11,1610612755,1610612738,2013,97.0,85.0,182.0,97.65,97.9,94.55,97.55,2,1,1,0.5,2,0,2,0.0,0,1,0,0,189.72,192.56,191.14
2013-10-11,1610612753,1610612739,2013,105.0,110.0,215.0,93.25,102.6,93.2,101.15,1,0,1,0.0,1,1,0,1.0,0,0,1,0,200.04,199.96,200.0
2013-10-11,1610612748,1610612766,2013,86.0,75.0,161.0,96.25,92.25,93.95,100.8,2,2,0,1.0,1,0,1,0.0,1,1,0,0,189.0,194.48,191.74
2013-10-11,1610612757,1610612762,2013,96.0,86.0,182.0,93.95,103.35,96.25,96.1,2,0,2,0.0,1,1,0,1.0,0,0,1,0,198.68,193.44,196.06
2013-10-10,1610612754,1610612745,2013,96.0,116.0,212.0,91.0,91.15,103.15,103.75,1,0,1,0.0,1,0,1,0.0,0,0,0,0,189.6,207.64,198.62
2013-10-10,1610612765,1610612748,2013,107.0,112.0,219.0,95.15,100.55,95.85,91.45,1,1,0,1.0,1,1,0,1.0,1,0,1,0,193.6,189.0,191.3
2013-10-10,1610612750,1610612749,2013,98.0,89.0,187.0,99.5,98.1,96.3,100.75,2,1,1,0.5,1,0,1,0.0,0,1,0,0,192.24,204.72,198.48000000000002
2013-10-10,1610612747,1610612758,2013,86.0,104.0,190.0,96.65,100.85,102.3,104.85,3,2,1,0.667,1,0,1,0.0,2,0,0,0,198.72,214.52,206.62
2013-10-09,1610612761,1610612750,2013,89.0,101.0,190.0,95.4,96.75,99.45,99.05,1,1,0,1.0,1,0,1,0.0,0,1,0,0,191.36,192.24,191.8
2013-10-09,1610612753,1610612740,2013,95.0,99.0,194.0,92.6,103.05,94.1,98.05,0,0,0,0.0,2,2,0,1.0,0,0,0,2,201.16,191.96,196.56
2013-10-09,1610612738,1610612752,2013,102.0,103.0,205.0,93.7,97.4,95.2,91.0,1,0,1,0.0,0,0,0,0.0,0,0,0,0,191.08,189.48,190.28
2013-10-09,1610612763,1610612742,2013,90.0,95.0,185.0,93.85,92.5,101.05,98.45,1,0,1,0.0,1,0,1,0.0,0,0,0,0,183.68,204.04,193.86
2013-10-09,1610612757,1610612756,2013,98.0,104.0,202.0,94.65,103.2,97.7,107.4,1,0,1,0.0,1,1,0,1.0,0,0,1,0,197.4,190.92,194.16
2013-10-08,1610612755,1610612760,2013,99.0,103.0,202.0,97.9,97.6,100.7,95.6,1,1,0,1.0,1,1,0,1.0,0,1,0,1,189.56,201.76,195.66
2013-10-08,1610612764,1610612751,2013,106.0,111.0,217.0,97.4,96.25,101.0,98.3,0,0,0,0.0,0,0,0,0.0,0,0,0,0,193.44,192.32,192.88
2013-10-08,1610612739,1610612749,2013,99.0,87.0,186.0,93.0,101.3,95.85,100.9,0,0,0,0.0,0,0,0,0.0,0,0,0,0,199.92,204.72,202.32
2013-10-08,1610612766,1610612737,2013,85.0,87.0,172.0,94.7,100.15,95.65,98.1,0,0,0,0.0,1,0,1,0.0,0,0,0,0,195.32,195.0,195.16
2013-10-08,1610612762,1610612744,2013,101.0,78.0,179.0,95.7,96.4,103.25,101.95,0,0,0,0.0,2,1,1,0.5,0,0,1,0,194.56,197.84,196.2
2013-10-08,1610612747,1610612743,2013,90.0,88.0,178.0,97.2,100.5,105.65,102.15,2,1,1,0.5,1,1,0,1.0,1,0,0,1,199.28,207.44,203.36
2013-10-07,1610612738,1610612761,2013,89.0,97.0,186.0,94.4,97.8,96.35,98.2,0,0,0,0.0,0,0,0,0.0,0,0,0,0,191.2,191.36,191.28
2013-10-07,1610612748,1610612737,2013,92.0,87.0,179.0,97.0,91.0,96.5,98.45,0,0,0,0.0,0,0,0,0.0,0,0,0,0,189.56,195.0,192.28
2013-10-07,1610612741,1610612763,2013,106.0,87.0,193.0,93.65,96.6,93.6,91.1,1,1,0,1.0,0,0,0,0.0,0,1,0,0,187.88,183.68,185.78
2013-10-07,1610612742,1610612740,2013,92.0,94.0,186.0,101.25,99.4,94.3,98.85,0,0,0,0.0,1,1,0,1.0,0,0,0,1,205.04,191.96,198.5
2013-10-07,1610612757,1610612746,2013,81.0,89.0,170.0,95.85,103.25,100.2,96.75,0,0,0,0.0,0,0,0,0.0,0,0,0,0,197.88,198.0,197.94
2013-10-07,1610612744,1610612758,2013,94.0,81.0,175.0,103.05,102.75,104.5,105.2,1,0,1,0.0,0,0,0,0.0,0,0,0,0,199.76,214.52,207.14
2013-10-06,1610612747,1610612743,2013,88.0,97.0,185.0,97.8,100.8,106.75,103.65,1,1,0,1.0,0,0,0,0.0,1,0,0,0,200.12,207.44,203.78
2013-10-05,1610612754,1610612741,2013,76.0,82.0,158.0,91.95,92.3,93.95,97.65,0,1,0,1.0,0,0,0,0.0,1,0,0,0,190.4,187.88,189.14
2013-10-05,1610612745,1610612740,2013,115.0,116.0,231.0,102.2,102.7,92.75,97.9,0,1,0,1.0,0,0,0,0.0,1,0,0,0,207.88,191.96,199.92000000000002
2013-10-05,1610612747,1610612744,2013,104.0,95.0,199.0,98.25,101.15,102.95,102.75,0,1,0,1.0,0,0,0,0.0,1,0,0,0,200.84,199.76,200.3
2013-06-20,1610612748,1610612759,2012,95.0,88.0,183.0,96.55,91.25,100.95,93.25,82,66,16,0.805,82,58,24,0.7070000000000001,37,29,35,23,189.8,199.4,194.60000000000002
2013-06-18,1610612748,1610612759,2012,103.0,100.0,203.0,96.3,90.55,101.25,93.9,82,66,16,0.805,82,58,24,0.7070000000000001,37,29,35,23,192.48,199.4,195.94
2013-06-16,1610612759,1610612748,2012,114.0,104.0,218.0,100.3,94.1,95.9,89.6,82,58,24,0.7070000000000001,82,66,16,0.805,35,23,37,29,199.96,192.48,196.22
2013-06-13,1610612759,1610612748,2012,93.0,109.0,202.0,101.05,93.7,95.6,89.85,82,58,24,0.7070000000000001,82,66,16,0.805,35,23,37,29,200.12,192.48,196.3
2013-06-11,1610612759,1610612748,2012,113.0,77.0,190.0,100.35,94.7,96.2,88.15,82,58,24,0.7070000000000001,82,66,16,0.805,35,23,37,29,199.8,192.48,196.14
2013-06-09,1610612748,1610612759,2012,103.0,84.0,187.0,96.55,88.3,100.45,94.1,82,66,16,0.805,82,58,24,0.7070000000000001,37,29,35,23,193.56,199.8,196.68
2013-06-06,1610612748,1610612759,2012,88.0,92.0,180.0,97.4,88.35,100.15,94.5,82,66,16,0.805,82,58,24,0.7070000000000001,37,29,35,23,195.2,199.8,197.5
2013-06-03,1610612748,1610612754,2012,99.0,76.0,175.0,97.7,89.2,92.15,91.85,82,66,16,0.805,81,49,32,0.605,37,29,30,19,196.36,190.4,193.38
2013-06-01,1610612754,1610612748,2012,91.0,77.0,168.0,93.05,93.85,98.25,88.95,81,49,32,0.605,82,66,16,0.805,30,19,37,29,190.6,196.36,193.48000000000002
2013-05-30,1610612748,1610612754,2012,90.0,79.0,169.0,99.2,90.05,93.35,94.55,82,66,16,0.805,81,49,32,0.605,37,29,30,19,197.6,190.6,194.1
2013-05-28,1610612754,1610612748,2012,99.0,92.0,191.0,93.35,94.65,100.0,89.55,81,49,32,0.605,82,66,16,0.805,30,19,37,29,190.88,197.6,194.24
2013-05-27,1610612763,1610612759,2012,86.0,93.0,179.0,93.9,90.95,99.9,95.2,82,56,26,0.6829999999999999,82,58,24,0.7070000000000001,32,24,35,23,183.64,199.8,191.72
2013-05-26,1610612754,1610612748,2012,96.0,114.0,210.0,92.3,93.8,99.15,89.8,81,49,32,0.605,82,66,16,0.805,30,19,37,29,191.16,197.6,194.38
2013-05-25,1610612763,1610612759,2012,93.0,104.0,197.0,94.4,90.45,99.2,95.15,82,56,26,0.6829999999999999,82,58,24,0.7070000000000001,32,24,35,23,183.72,199.8,191.76
2013-05-24,1610612748,1610612754,2012,93.0,97.0,190.0,99.2,89.1,92.9,94.45,82,66,16,0.805,81,49,32,0.605,37,29,30,19,198.88,191.16,195.01999999999998
2013-05-22,1610612748,1610612754,2012,103.0,102.0,205.0,99.35,88.35,93.4,94.5,82,66,16,0.805,81,49,32,0.605,37,29,30,19,198.4,191.16,194.78
2013-05-21,1610612759,1610612763,2012,93.0,89.0,182.0,99.45,94.9,94.4,90.15,82,58,24,0.7070000000000001,82,56,26,0.6829999999999999,35,23,32,24,199.72,183.72,191.72
2013-05-19,1610612759,1610612763,2012,105.0,83.0,188.0,98.5,95.15,94.45,89.19999999999997,82,58,24,0.7070000000000001,82,56,26,0.6829999999999999,35,23,32,24,200.48,183.72,192.1
2013-05-18,1610612754,1610612752,2012,106.0,99.0,205.0,93.1,94.25,95.0,89.8,81,49,32,0.605,82,54,28,0.659,30,19,31,23,191.44,189.48,190.45999999999998
2013-05-16,1610612752,1610612754,2012,85.0,75.0,160.0,96.15,90.5,94.5,93.9,82,54,28,0.659,81,49,32,0.605,31,23,30,19,191.48,191.44,191.45999999999998
2013-05-16,1610612744,1610612759,2012,82.0,94.0,176.0,103.75,102.45,98.55,95.85,82,47,35,0.573,82,58,24,0.7070000000000001,28,19,35,23,200.96,200.48,200.72
2013-05-15,1610612748,1610612741,2012,94.0,91.0,185.0,99.15,88.9,93.65,97.9,82,66,16,0.805,82,45,37,0.5489999999999999,37,29,24,21,198.92,187.88,193.39999999999998
2013-05-15,1610612760,1610612763,2012,84.0,88.0,172.0,101.65,95.2,94.75,88.8,82,60,22,0.732,82,56,26,0.6829999999999999,34,26,32,24,203.44,183.72,193.57999999999998
2013-05-14,1610612754,1610612752,2012,93.0,82.0,175.0,94.95,93.7,97.15,90.35,81,49,32,0.605,82,54,28,0.659,30,19,31,23,192.08,191.48,191.78
2013-05-14,1610612759,1610612744,2012,109.0,91.0,200.0,98.3,96.4,103.85,100.6,82,58,24,0.7070000000000001,82,47,35,0.573,35,23,28,19,200.8,200.96,200.88
2013-05-13,1610612741,1610612748,2012,65.0,88.0,153.0,95.45,98.35,100.15,90.35,82,45,37,0.5489999999999999,82,66,16,0.805,24,21,37,29,187.96,198.92,193.44
2013-05-13,1610612763,1610612760,2012,103.0,97.0,200.0,95.1,89.25,101.45,95.1,82,56,26,0.6829999999999999,82,60,22,0.732,32,24,34,26,182.24,203.44,192.84
2013-05-12,1610612744,1610612759,2012,97.0,87.0,184.0,105.25,101.15,98.1,96.9,82,47,35,0.573,82,58,24,0.7070000000000001,28,19,35,23,201.48,200.8,201.14
2013-05-11,1610612763,1610612760,2012,87.0,81.0,168.0,95.25,89.65,102.25,95.2,82,56,26,0.6829999999999999,82,60,22,0.732,32,24,34,26,181.68,203.44,192.56
2013-05-11,1610612754,1610612752,2012,82.0,71.0,153.0,95.6,93.8,98.6,90.5,81,49,32,0.605,82,54,28,0.659,30,19,31,23,193.04,191.48,192.26
2013-05-10,1610612741,1610612748,2012,94.0,104.0,198.0,95.1,97.35,99.85,90.4,82,45,37,0.5489999999999999,82,66,16,0.805,24,21,37,29,187.16,198.92,193.04
2013-05-10,1610612744,1610612759,2012,92.0,102.0,194.0,105.55,101.3,97.85,96.65,82,47,35,0.573,82,58,24,0.7070000000000001,28,19,35,23,201.84,200.8,201.32
2013-05-08,1610612748,1610612741,2012,115.0,78.0,193.0,99.55,90.35,95.8,96.1,82,66,16,0.805,82,45,37,0.5489999999999999,37,29,24,21,200.76,187.16,193.95999999999998
2013-05-08,1610612759,1610612744,2012,91.0,100.0,191.0,98.3,96.6,105.95,100.65,82,58,24,0.7070000000000001,82,47,35,0.573,35,23,28,19,200.48,201.84,201.16
2013-05-07,1610612752,1610612754,2012,105.0,79.0,184.0,98.9,91.65,96.65,93.1,82,54,28,0.659,81,49,32,0.605,31,23,30,19,192.52,193.04,192.78
2013-05-07,1610612760,1610612763,2012,93.0,99.0,192.0,102.75,94.4,95.25,89.3,82,60,22,0.732,82,56,26,0.6829999999999999,34,26,32,24,203.36,181.68,192.52
2013-05-06,1610612748,1610612741,2012,86.0,93.0,179.0,100.4,90.15,95.45,96.3,82,66,16,0.805,82,45,37,0.5489999999999999,37,29,24,21,200.4,187.16,193.78
2013-05-06,1610612759,1610612744,2012,129.0,127.0,256.0,97.05,95.1,104.45,99.4,82,58,24,0.7070000000000001,82,47,35,0.573,35,23,28,19,197.64,201.84,199.74
2013-05-05,1610612760,1610612763,2012,93.0,91.0,184.0,103.3,95.55,95.75,90.05,82,60,22,0.732,82,56,26,0.6829999999999999,34,26,32,24,203.76,181.68,192.72
2013-05-05,1610612752,1610612754,2012,95.0,102.0,197.0,99.55,91.6,95.75,92.7,82,54,28,0.659,81,49,32,0.605,31,23,30,19,191.56,193.04,192.3
2013-05-04,1610612751,1610612741,2012,93.0,99.0,192.0,101.75,98.25,95.4,96.65,82,49,33,0.598,82,45,37,0.5489999999999999,26,23,24,21,191.76,187.16,189.45999999999998
2013-05-03,1610612738,1610612752,2012,80.0,88.0,168.0,95.65,97.8,100.1,92.3,81,41,40,0.506,82,54,28,0.659,27,14,31,23,192.24,191.56,191.9
2013-05-03,1610612737,1610612754,2012,73.0,81.0,154.0,97.75,98.9,97.25,93.55,82,44,38,0.537,81,49,32,0.605,25,19,30,19,197.0,193.04,195.01999999999998
2013-05-03,1610612745,1610612760,2012,94.0,103.0,197.0,103.3,101.45,102.6,95.35,82,45,37,0.5489999999999999,82,60,22,0.732,29,16,34,26,207.84,203.76,205.8
2013-05-03,1610612763,1610612746,2012,118.0,105.0,223.0,94.45,88.65,100.0,96.65,82,56,26,0.6829999999999999,82,56,26,0.6829999999999999,32,24,32,24,179.64,198.0,188.82
2013-05-02,1610612741,1610612751,2012,92.0,95.0,187.0,95.25,96.85,102.1,98.65,82,45,37,0.5489999999999999,82,49,33,0.598,24,21,26,23,187.68,191.76,189.72
2013-05-02,1610612744,1610612743,2012,92.0,88.0,180.0,105.3,100.15,107.75,103.7,82,47,35,0.573,82,57,25,0.695,28,19,38,19,202.84,207.44,205.14
2013-05-01,1610612752,1610612738,2012,86.0,92.0,178.0,101.3,91.9,95.75,98.7,82,54,28,0.659,81,41,40,0.506,31,23,27,14,191.92,192.24,192.07999999999998
2013-05-01,1610612754,1610612737,2012,106.0,83.0,189.0,96.6,94.35,98.85,98.25,81,49,32,0.605,82,44,38,0.537,30,19,25,19,193.48,197.0,195.24
2013-05-01,1610612760,1610612745,2012,100.0,107.0,207.0,103.45,95.2,102.65,100.85,82,60,22,0.732,82,45,37,0.5489999999999999,34,26,29,16,203.6,207.84,205.72
2013-04-30,1610612743,1610612744,2012,107.0,100.0,207.0,107.45,103.7,104.6,99.5,82,57,25,0.695,82,47,35,0.573,38,19,28,19,208.72,202.84,205.78
2013-04-30,1610612746,1610612763,2012,93.0,103.0,196.0,100.0,95.5,94.0,89.35,82,56,26,0.6829999999999999,82,56,26,0.6829999999999999,32,24,32,24,198.52,179.64,189.07999999999998
2013-04-29,1610612751,1610612741,2012,110.0,91.0,201.0,101.35,98.0,95.9,96.2,82,49,33,0.598,82,45,37,0.5489999999999999,26,23,24,21,191.96,187.68,189.82
2013-04-29,1610612737,1610612754,2012,102.0,91.0,193.0,99.4,100.05,96.6,94.15,82,44,38,0.537,81,49,32,0.605,25,19,30,19,197.2,193.48,195.33999999999997
2013-04-29,1610612745,1610612760,2012,105.0,103.0,208.0,102.4,100.35,103.65,95.0,82,45,37,0.5489999999999999,82,60,22,0.732,29,16,34,26,208.6,203.6,206.1
2013-04-28,1610612738,1610612752,2012,97.0,90.0,187.0,96.5,98.6,101.3,91.2,81,41,40,0.506,82,54,28,0.659,27,14,31,23,191.4,191.92,191.66
2013-04-28,1610612749,1610612748,2012,77.0,88.0,165.0,97.75,101.95,101.25,91.45,82,38,44,0.463,82,66,16,0.805,21,17,37,29,206.4,200.4,203.4
2013-04-28,1610612747,1610612759,2012,82.0,103.0,185.0,98.65,100.05,96.95,96.35,82,45,37,0.5489999999999999,82,58,24,0.7070000000000001,29,16,35,23,202.12,197.64,199.88
2013-04-28,1610612744,1610612743,2012,115.0,101.0,216.0,103.9,99.05,108.4,103.6,82,47,35,0.573,82,57,25,0.695,28,19,38,19,200.88,208.72,204.8
2013-04-27,1610612741,1610612751,2012,142.0,134.0,276.0,94.7,95.45,99.4,95.95,82,45,37,0.5489999999999999,82,49,33,0.598,24,21,26,23,185.04,191.96,188.5
2013-04-27,1610612763,1610612746,2012,104.0,83.0,187.0,93.6,89.45,100.45,95.65,82,56,26,0.6829999999999999,82,56,26,0.6829999999999999,32,24,32,24,180.12,198.52,189.32
2013-04-27,1610612737,1610612754,2012,90.0,69.0,159.0,100.25,101.3,97.7,94.9,82,44,38,0.537,81,49,32,0.605,25,19,30,19,197.64,193.48,195.56
2013-04-27,1610612745,1610612760,2012,101.0,104.0,205.0,101.25,100.55,103.1,95.2,82,45,37,0.5489999999999999,82,60,22,0.732,29,16,34,26,209.12,203.6,206.36
2013-04-26,1610612738,1610612752,2012,76.0,90.0,166.0,98.05,99.2,100.8,92.05,81,41,40,0.506,82,54,28,0.659,27,14,31,23,191.52,191.92,191.72
2013-04-26,1610612747,1610612759,2012,89.0,120.0,209.0,100.1,99.85,96.75,96.4,82,45,37,0.5489999999999999,82,58,24,0.7070000000000001,29,16,35,23,201.84,197.64,199.74
2013-04-26,1610612744,1610612743,2012,110.0,108.0,218.0,103.15,99.3,108.55,103.55,82,47,35,0.573,82,57,25,0.695,28,19,38,19,200.16,208.72,204.44
2013-04-25,1610612749,1610612748,2012,91.0,104.0,195.0,97.9,102.1,101.45,91.45,82,38,44,0.463,82,66,16,0.805,21,17,37,29,207.24,200.4,203.82
2013-04-25,1610612741,1610612751,2012,79.0,76.0,155.0,95.2,96.05,101.25,96.8,82,45,37,0.5489999999999999,82,49,33,0.598,24,21,26,23,185.72,191.96,188.84
2013-04-25,1610612763,1610612746,2012,94.0,82.0,176.0,93.45,89.6,101.6,95.4,82,56,26,0.6829999999999999,82,56,26,0.6829999999999999,32,24,32,24,179.88,198.52,189.2
2013-04-24,1610612760,1610612745,2012,105.0,102.0,207.0,103.35,94.45,101.55,100.9,82,60,22,0.732,82,45,37,0.5489999999999999,34,26,29,16,203.72,209.12,206.42000000000002
2013-04-24,1610612754,1610612737,2012,113.0,98.0,211.0,97.4,94.55,99.4,100.55,81,49,32,0.605,82,44,38,0.537,30,19,25,19,192.4,197.64,195.01999999999998
2013-04-24,1610612759,1610612747,2012,102.0,91.0,193.0,96.85,96.5,100.15,99.55,82,58,24,0.7070000000000001,82,45,37,0.5489999999999999,35,23,29,16,197.68,201.84,199.76
2013-04-23,1610612748,1610612749,2012,98.0,86.0,184.0,101.45,91.2,98.1,102.1,82,66,16,0.805,82,38,44,0.463,37,29,21,17,200.44,207.24,203.84
2013-04-23,1610612752,1610612738,2012,87.0,71.0,158.0,101.75,93.2,98.8,99.2,82,54,28,0.659,81,41,40,0.506,31,23,27,14,193.96,191.52,192.74
2013-04-23,1610612743,1610612744,2012,117.0,131.0,248.0,107.05,101.0,101.85,98.9,82,57,25,0.695,82,47,35,0.573,38,19,28,19,207.6,200.16,203.88
2013-04-22,1610612751,1610612741,2012,82.0,90.0,172.0,101.65,97.2,96.35,96.7,82,49,33,0.598,82,45,37,0.5489999999999999,26,23,24,21,193.2,185.72,189.45999999999998
2013-04-22,1610612746,1610612763,2012,93.0,91.0,184.0,101.2,95.65,93.05,89.45,82,56,26,0.6829999999999999,82,56,26,0.6829999999999999,32,24,32,24,199.28,179.88,189.57999999999998
2013-04-21,1610612754,1610612737,2012,107.0,90.0,197.0,96.1,94.2,100.0,100.55,81,49,32,0.605,82,44,38,0.537,30,19,25,19,190.8,197.64,194.22
2013-04-21,1610612759,1610612747,2012,91.0,79.0,170.0,98.25,98.2,101.5,99.85,82,58,24,0.7070000000000001,82,45,37,0.5489999999999999,35,23,29,16,199.4,201.84,200.62
2013-04-21,1610612748,1610612749,2012,110.0,87.0,197.0,101.2,91.4,98.4,101.9,82,66,16,0.805,82,38,44,0.463,37,29,21,17,201.68,207.24,204.46
2013-04-21,1610612760,1610612745,2012,120.0,91.0,211.0,101.9,93.85,102.9,100.4,82,60,22,0.732,82,45,37,0.5489999999999999,34,26,29,16,203.92,209.12,206.51999999999998
2013-04-20,1610612752,1610612738,2012,85.0,78.0,163.0,103.15,93.5,98.6,99.95,82,54,28,0.659,81,41,40,0.506,31,23,27,14,195.36,191.52,193.44
2013-04-20,1610612743,1610612744,2012,97.0,95.0,192.0,108.05,100.95,101.95,99.45,82,57,25,0.695,82,47,35,0.573,38,19,28,19,208.96,200.16,204.56
2013-04-20,1610612751,1610612741,2012,106.0,89.0,195.0,99.95,96.55,95.85,97.45,82,49,33,0.598,82,45,37,0.5489999999999999,26,23,24,21,192.52,185.72,189.12
2013-04-20,1610612746,1610612763,2012,112.0,91.0,203.0,102.05,95.95,92.7,88.35,82,56,26,0.6829999999999999,82,56,26,0.6829999999999999,32,24,32,24,198.48,179.88,189.18
2013-04-17,1610612761,1610612738,2012,114.0,90.0,204.0,94.7,98.35,98.05,98.8,81,33,48,0.407,80,41,39,0.513,20,13,27,14,189.68,191.52,190.60000000000002
2013-04-17,1610612751,1610612765,2012,103.0,99.0,202.0,99.6,96.9,94.7,100.55,81,48,33,0.593,81,29,52,0.358,25,23,18,11,191.2,193.6,192.39999999999998
2013-04-17,1610612752,1610612737,2012,98.0,92.0,190.0,102.95,93.65,99.8,100.85,81,53,28,0.654,81,44,37,0.5429999999999999,30,23,25,19,195.08,197.64,196.36
2013-04-17,1610612766,1610612739,2012,105.0,98.0,203.0,94.15,101.05,93.15,100.95,81,20,61,0.247,81,24,57,0.29600000000000004,14,6,14,10,195.08,199.92,197.5
2013-04-17,1610612748,1610612753,2012,105.0,93.0,198.0,101.05,91.4,93.15,103.65,81,65,16,0.802,81,20,61,0.247,36,29,12,8,201.76,201.16,201.45999999999998
2013-04-17,1610612754,1610612755,2012,95.0,105.0,200.0,96.2,93.55,97.65,97.9,80,49,31,0.613,81,33,48,0.407,30,19,23,10,189.36,189.56,189.46
2013-04-17,1610612741,1610612764,2012,95.0,92.0,187.0,95.9,97.1,98.5,97.45,81,44,37,0.5429999999999999,81,29,52,0.358,23,21,22,7,184.8,193.44,189.12
2013-04-17,1610612763,1610612762,2012,86.0,70.0,156.0,92.9,89.05,97.25,97.3,81,55,26,0.679,81,43,38,0.531,31,24,30,13,179.76,194.56,187.16
2013-04-17,1610612742,1610612740,2012,99.0,87.0,186.0,101.35,100.4,92.1,98.9,81,40,41,0.494,81,27,54,0.333,23,17,16,11,205.08,191.96,198.52
2013-04-17,1610612759,1610612750,2012,95.0,108.0,203.0,98.1,97.35,98.6,99.65,81,58,23,0.716,81,30,51,0.37,35,23,20,10,199.08,192.24,195.66000000000003
2013-04-17,1610612760,1610612749,2012,89.0,95.0,184.0,103.55,94.35,99.4,103.1,81,60,21,0.741,81,37,44,0.457,34,26,21,16,204.56,207.24,205.9
2013-04-17,1610612743,1610612756,2012,118.0,98.0,216.0,107.7,100.45,98.05,106.55,81,56,25,0.691,81,25,56,0.309,37,19,17,8,209.16,190.92,200.04
2013-04-17,1610612747,1610612745,2012,99.0,95.0,194.0,101.5,100.0,103.3,100.7,81,44,37,0.5429999999999999,81,45,36,0.556,28,16,29,16,201.72,209.12,205.42000000000002
2013-04-17,1610612758,1610612746,2012,108.0,112.0,220.0,104.75,105.35,101.4,95.1,81,28,53,0.34600000000000003,81,55,26,0.679,20,8,32,23,214.16,198.48,206.32
2013-04-17,1610612757,1610612744,2012,88.0,99.0,187.0,96.3,103.4,102.0,100.0,81,33,48,0.407,81,46,35,0.568,22,11,28,18,200.16,200.16,200.16
2013-04-16,1610612737,1610612761,2012,96.0,113.0,209.0,99.8,99.8,93.95,97.1,80,44,36,0.55,80,32,48,0.4,25,19,20,12,197.64,189.68,193.66
2013-04-16,1610612746,1610612757,2012,93.0,77.0,170.0,102.6,96.3,99.25,104.05,80,54,26,0.675,80,33,47,0.413,31,23,22,11,200.16,200.16,200.16
2013-04-15,1610612766,1610612752,2012,106.0,95.0,201.0,92.75,101.25,102.7,93.6,80,19,61,0.238,80,53,27,0.6629999999999999,13,6,30,23,195.24,195.08,195.16000000000003
2013-04-15,1610612753,1610612741,2012,84.0,102.0,186.0,94.45,104.45,94.85,97.4,80,20,60,0.25,80,43,37,0.5379999999999999,12,8,23,20,202.16,184.8,193.48000000000002
2013-04-15,1610612739,1610612748,2012,95.0,96.0,191.0,93.0,101.3,101.6,91.35,80,24,56,0.3,80,64,16,0.8,14,10,36,28,199.56,201.76,200.66
2013-04-15,1610612751,1610612764,2012,106.0,101.0,207.0,99.95,97.4,97.95,96.9,80,47,33,0.588,80,29,51,0.363,24,23,22,7,190.4,193.44,191.92000000000002
2013-04-15,1610612765,1610612755,2012,109.0,101.0,210.0,93.8,100.75,96.2,97.5,80,28,52,0.35,80,33,47,0.413,17,11,23,10,192.8,189.56,191.18
2013-04-15,1610612749,1610612743,2012,111.0,112.0,223.0,99.25,103.25,107.75,99.85,80,37,43,0.463,80,55,25,0.688,21,16,37,18,207.4,209.16,208.28
2013-04-15,1610612742,1610612763,2012,97.0,103.0,200.0,101.3,99.55,91.75,88.55,80,40,40,0.5,80,54,26,0.675,23,17,31,23,204.88,179.76,192.32
2013-04-15,1610612760,1610612758,2012,104.0,95.0,199.0,104.3,93.3,106.45,107.2,80,59,21,0.738,80,28,52,0.35,33,26,20,8,205.24,214.16,209.7
2013-04-15,1610612750,1610612762,2012,80.0,96.0,176.0,99.95,99.0,97.85,98.75,80,30,50,0.375,80,42,38,0.525,20,10,30,12,191.88,194.56,193.22
2013-04-15,1610612756,1610612745,2012,119.0,112.0,231.0,97.45,106.2,103.0,99.55,80,24,56,0.3,80,45,35,0.563,16,8,29,16,189.52,209.12,199.32
2013-04-15,1610612744,1610612759,2012,116.0,106.0,222.0,101.45,99.55,98.2,96.65,80,45,35,0.563,80,58,22,0.725,27,18,35,23,198.52,199.08,198.8
2013-04-14,1610612748,1610612741,2012,105.0,93.0,198.0,101.2,91.5,94.35,97.2,79,63,16,0.797,79,43,36,0.544,35,28,23,20,201.6,184.8,193.2
2013-04-14,1610612761,1610612751,2012,93.0,87.0,180.0,93.5,97.25,101.55,96.85,79,31,48,0.392,79,47,32,0.595,19,12,24,23,190.32,190.4,190.36
2013-04-14,1610612752,1610612754,2012,90.0,80.0,170.0,102.85,94.55,97.95,93.35,79,52,27,0.6579999999999999,79,49,30,0.62,29,23,30,19,196.48,189.36,192.92000000000002
2013-04-14,1610612755,1610612739,2012,91.0,77.0,168.0,95.85,98.55,94.4,102.2,79,32,47,0.405,79,24,55,0.304,22,10,14,10,190.0,199.56,194.78
2013-04-14,1610612743,1610612757,2012,118.0,109.0,227.0,107.2,99.0,98.05,102.7,79,54,25,0.684,79,33,46,0.418,36,18,22,11,207.64,200.16,203.89999999999998
2013-04-14,1610612740,1610612742,2012,89.0,107.0,196.0,92.75,98.95,101.1,101.9,80,27,53,0.338,79,39,40,0.494,16,11,23,16,191.36,204.88,198.12
2013-04-14,1610612745,1610612758,2012,121.0,100.0,221.0,102.35,99.55,106.2,106.65,79,44,35,0.557,79,28,51,0.354,28,16,20,8,208.96,214.16,211.56
2013-04-14,1610612747,1610612759,2012,91.0,86.0,177.0,102.75,100.4,98.7,96.85,80,43,37,0.5379999999999999,79,58,21,0.7340000000000001,27,16,35,23,202.4,199.08,200.74
2013-04-13,1610612766,1610612749,2012,95.0,85.0,180.0,92.95,102.65,100.15,103.15,79,18,61,0.228,79,37,42,0.468,12,6,21,16,195.8,207.4,201.60000000000002
2013-04-13,1610612753,1610612738,2012,88.0,120.0,208.0,95.1,104.7,96.2,98.45,79,20,59,0.253,79,40,39,0.506,12,8,27,13,201.48,191.52,196.5
2013-04-13,1610612763,1610612746,2012,87.0,91.0,178.0,91.8,88.1,104.3,97.0,79,54,25,0.684,79,53,26,0.6709999999999999,31,23,31,22,180.16,200.16,190.16
2013-04-13,1610612750,1610612756,2012,105.0,93.0,198.0,98.55,99.35,97.7,106.35,79,29,50,0.3670000000000001,79,24,55,0.304,19,10,16,8,192.4,189.52,190.96
2013-04-12,1610612761,1610612741,2012,97.0,88.0,185.0,93.65,97.75,94.55,97.2,78,30,48,0.385,78,43,35,0.551,18,12,23,20,190.96,184.8,187.88
2013-04-12,1610612764,1610612755,2012,86.0,97.0,183.0,98.15,96.4,95.55,99.2,79,29,50,0.3670000000000001,78,31,47,0.397,22,7,22,9,195.24,190.0,192.62
2013-04-12,1610612754,1610612751,2012,109.0,117.0,226.0,97.05,92.45,100.55,96.7,78,49,29,0.628,78,46,32,0.59,30,19,24,22,187.32,190.4,188.86
2013-04-12,1610612737,1610612749,2012,109.0,104.0,213.0,98.35,99.25,100.0,103.55,79,43,36,0.544,78,37,41,0.474,24,19,21,16,198.92,207.4,203.16
2013-04-12,1610612748,1610612738,2012,109.0,101.0,210.0,100.65,91.0,96.6,98.05,78,62,16,0.795,78,40,38,0.513,34,28,27,13,201.0,191.52,196.26
2013-04-12,1610612765,1610612766,2012,113.0,93.0,206.0,92.95,100.35,93.55,103.1,79,27,52,0.342,78,18,60,0.231,16,11,12,6,192.88,195.8,194.34
2013-04-12,1610612739,1610612752,2012,91.0,101.0,192.0,95.05,102.2,102.5,95.85,78,24,54,0.308,78,51,27,0.654,14,10,29,22,200.52,196.48,198.5
2013-04-12,1610612740,1610612746,2012,93.0,96.0,189.0,93.2,99.4,104.85,96.85,79,27,52,0.342,78,52,26,0.667,16,11,31,21,191.84,200.16,196.0
2013-04-12,1610612745,1610612763,2012,78.0,82.0,160.0,104.0,99.5,92.5,88.45,78,44,34,0.564,78,53,25,0.679,28,16,31,22,211.68,180.16,195.92000000000002
2013-04-12,1610612742,1610612743,2012,108.0,105.0,213.0,101.3,102.05,107.6,99.55,78,38,40,0.487,78,54,24,0.6920000000000001,22,16,36,18,204.24,207.64,205.94
2013-04-12,1610612759,1610612758,2012,108.0,101.0,209.0,98.55,96.45,106.55,107.35,78,57,21,0.731,78,28,50,0.359,34,23,20,8,197.8,214.16,205.98000000000002
2013-04-12,1610612762,1610612750,2012,107.0,100.0,207.0,97.65,98.25,97.95,99.55,79,41,38,0.519,78,29,49,0.3720000000000001,29,12,19,10,194.32,192.4,193.36
2013-04-12,1610612757,1610612760,2012,90.0,106.0,196.0,99.65,102.65,104.8,93.5,78,33,45,0.423,79,58,21,0.7340000000000001,22,11,33,25,199.28,205.24,202.26
2013-04-12,1610612747,1610612744,2012,118.0,116.0,234.0,102.4,99.95,100.7,99.4,79,42,37,0.532,79,45,34,0.57,26,16,27,18,201.08,198.52,199.8
2013-04-11,1610612741,1610612752,2012,118.0,111.0,229.0,93.3,95.75,100.1,94.55,77,42,35,0.545,77,51,26,0.662,22,20,29,22,184.32,196.48,190.39999999999998
2013-04-11,1610612744,1610612760,2012,97.0,116.0,213.0,100.45,96.75,103.75,93.35,78,45,33,0.5770000000000001,78,57,21,0.731,27,18,33,24,198.36,205.24,201.8
2013-04-10,1610612755,1610612737,2012,101.0,124.0,225.0,95.0,98.7,97.05,99.15,77,31,46,0.403,78,42,36,0.5379999999999999,22,9,24,18,189.36,198.92,194.14
2013-04-10,1610612764,1610612748,2012,98.0,103.0,201.0,97.65,96.05,100.4,90.8,78,29,49,0.3720000000000001,77,61,16,0.792,22,7,34,27,195.08,201.0,198.04000000000002
2013-04-10,1610612753,1610612749,2012,113.0,103.0,216.0,94.15,105.45,100.35,103.25,78,19,59,0.244,77,37,40,0.481,11,8,21,16,200.44,207.4,203.92000000000002
2013-04-10,1610612739,1610612765,2012,104.0,111.0,215.0,94.7,101.75,92.25,101.6,77,24,53,0.312,78,26,52,0.333,14,10,16,10,199.56,192.88,196.22
2013-04-10,1610612738,1610612751,2012,93.0,101.0,194.0,96.65,97.3,100.15,96.05,77,40,37,0.519,77,45,32,0.584,27,13,24,21,190.8,190.4,190.60000000000002
2013-04-10,1610612742,1610612756,2012,91.0,102.0,193.0,101.25,101.7,97.7,106.7,77,38,39,0.494,78,23,55,0.295,22,16,16,7,204.16,189.52,196.84
2013-04-10,1610612758,1610612740,2012,121.0,110.0,231.0,106.55,107.45,92.7,98.6,77,27,50,0.35100000000000003,78,27,51,0.34600000000000003,19,8,16,11,213.08,191.84,202.46
2013-04-10,1610612757,1610612747,2012,106.0,113.0,219.0,99.8,101.7,102.15,99.75,77,33,44,0.429,78,41,37,0.526,22,11,26,15,198.52,201.08,199.8
2013-04-10,1610612743,1610612759,2012,96.0,86.0,182.0,108.0,99.65,99.4,96.1,77,53,24,0.688,77,57,20,0.74,35,18,34,23,208.88,197.8,203.34
2013-04-10,1610612746,1610612750,2012,111.0,95.0,206.0,104.5,97.5,97.9,99.45,77,51,26,0.662,77,29,48,0.377,30,21,19,10,199.2,192.4,195.8
2013-04-09,1610612754,1610612739,2012,99.0,94.0,193.0,97.5,92.6,95.9,101.5,77,48,29,0.623,76,24,52,0.316,29,19,14,10,186.4,199.56,192.98000000000002
2013-04-09,1610612751,1610612755,2012,104.0,83.0,187.0,100.9,97.3,95.5,98.6,76,44,32,0.579,76,31,45,0.408,23,21,22,9,190.2,189.36,189.78
2013-04-09,1610612752,1610612764,2012,120.0,99.0,219.0,99.55,94.85,96.6,94.8,76,50,26,0.6579999999999999,77,29,48,0.377,28,22,22,7,195.12,195.08,195.10000000000002
2013-04-09,1610612748,1610612749,2012,94.0,83.0,177.0,102.75,93.1,100.95,103.05,76,60,16,0.789,76,37,39,0.487,33,27,21,16,200.88,207.4,204.14
2013-04-09,1610612741,1610612761,2012,98.0,101.0,199.0,93.3,95.75,94.5,99.1,76,42,34,0.5529999999999999,77,29,48,0.377,22,20,18,11,183.92,190.96,187.44
2013-04-09,1610612763,1610612766,2012,94.0,75.0,169.0,93.2,89.75,93.95,104.35,77,52,25,0.675,77,18,59,0.234,30,22,12,6,180.36,195.8,188.08
2013-04-09,1610612745,1610612756,2012,101.0,98.0,199.0,105.75,99.75,97.05,106.2,77,43,34,0.5579999999999999,77,23,54,0.299,27,16,16,7,211.32,189.52,200.42000000000002
2013-04-09,1610612762,1610612760,2012,80.0,90.0,170.0,98.55,97.15,104.65,94.55,78,41,37,0.526,77,56,21,0.727,29,12,33,23,195.28,205.24,200.26
2013-04-09,1610612747,1610612740,2012,104.0,96.0,200.0,102.6,99.9,93.15,97.7,77,40,37,0.519,77,27,50,0.35100000000000003,25,15,16,11,202.16,191.84,197.0
2013-04-09,1610612744,1610612750,2012,105.0,89.0,194.0,99.85,97.45,98.15,100.0,77,44,33,0.5710000000000001,76,29,47,0.382,26,18,19,10,197.96,192.4,195.18
2013-04-07,1610612760,1610612752,2012,120.0,125.0,245.0,103.75,91.9,97.65,92.7,76,56,20,0.737,75,49,26,0.653,33,23,28,21,202.64,195.12,198.88
2013-04-07,1610612746,1610612747,2012,109.0,95.0,204.0,104.35,96.95,103.1,100.55,76,50,26,0.6579999999999999,76,40,36,0.526,29,21,25,15,197.84,202.16,200.0
2013-04-07,1610612738,1610612764,2012,107.0,96.0,203.0,94.85,95.95,95.9,93.8,76,39,37,0.513,76,29,47,0.382,26,13,22,7,190.4,195.08,192.74
2013-04-07,1610612739,1610612753,2012,91.0,85.0,176.0,95.8,102.5,94.7,105.75,75,23,52,0.307,77,19,58,0.247,13,10,11,8,200.36,200.44,200.4
2013-04-07,1610612758,1610612763,2012,87.0,89.0,176.0,107.85,109.0,93.85,90.25,76,27,49,0.355,76,51,25,0.6709999999999999,19,8,30,21,216.36,180.36,198.36
2013-04-07,1610612765,1610612741,2012,99.0,85.0,184.0,91.6,102.6,92.65,95.9,77,25,52,0.325,75,42,33,0.56,15,10,22,20,192.24,183.92,188.07999999999998
2013-04-07,1610612744,1610612762,2012,90.0,97.0,187.0,99.75,97.3,98.4,98.0,76,44,32,0.579,77,40,37,0.519,26,18,29,11,197.88,195.28,196.57999999999998
2013-04-07,1610612756,1610612740,2012,92.0,95.0,187.0,96.0,106.35,92.85,98.2,76,23,53,0.303,76,26,50,0.342,16,7,16,10,189.24,191.84,190.54000000000002
2013-04-07,1610612757,1610612742,2012,91.0,96.0,187.0,100.7,102.45,101.35,101.65,76,33,43,0.434,76,37,39,0.487,22,11,22,15,198.6,204.16,201.38
2013-04-06,1610612764,1610612754,2012,104.0,85.0,189.0,95.45,94.35,97.9,91.45,75,28,47,0.373,76,48,28,0.632,21,7,29,19,195.6,186.4,191.0
2013-04-06,1610612751,1610612766,2012,105.0,96.0,201.0,99.95,98.05,92.55,104.0,75,43,32,0.573,76,18,58,0.237,22,21,12,6,190.64,195.8,193.22
2013-04-06,1610612748,1610612755,2012,106.0,87.0,193.0,102.9,94.0,95.95,98.65,75,59,16,0.787,75,31,44,0.413,32,27,22,9,200.84,189.36,195.10000000000002
2013-04-06,1610612750,1610612765,2012,107.0,101.0,208.0,97.15,99.05,90.3,102.95,75,28,47,0.373,76,25,51,0.329,18,10,15,10,192.04,192.24,192.14
2013-04-06,1610612749,1610612761,2012,100.0,83.0,183.0,101.4,104.3,96.05,100.2,75,36,39,0.48,76,29,47,0.382,20,16,18,11,207.64,190.96,199.3
2013-04-06,1610612759,1610612737,2012,99.0,97.0,196.0,99.75,98.05,96.55,98.8,76,56,20,0.737,77,42,35,0.545,33,23,24,18,199.48,198.92,199.2
2013-04-06,1610612743,1610612745,2012,132.0,114.0,246.0,106.65,99.1,104.85,98.45,76,52,24,0.684,76,43,33,0.5660000000000001,34,18,27,16,207.08,211.32,209.2
2013-04-05,1610612738,1610612739,2012,91.0,97.0,188.0,96.2,96.8,95.9,103.8,75,39,36,0.52,74,22,52,0.297,26,13,13,9,190.64,200.36,195.5
2013-04-05,1610612752,1610612749,2012,101.0,83.0,184.0,97.55,93.2,102.8,104.9,74,48,26,0.649,74,36,38,0.486,27,21,20,16,196.4,207.64,202.01999999999998
2013-04-05,1610612737,1610612755,2012,90.0,101.0,191.0,97.4,98.55,95.25,98.65,76,42,34,0.5529999999999999,74,30,44,0.405,24,18,22,8,197.96,189.36,193.66000000000003
2013-04-05,1610612766,1610612748,2012,79.0,89.0,168.0,92.35,104.8,103.3,94.1,75,18,57,0.24,74,58,16,0.784,12,6,32,26,197.08,200.84,198.96
2013-04-05,1610612754,1610612760,2012,75.0,97.0,172.0,99.85,90.7,104.05,93.4,75,48,27,0.64,75,55,20,0.733,29,19,33,22,186.36,202.64,194.5
2013-04-05,1610612741,1610612753,2012,87.0,86.0,173.0,91.65,95.9,95.65,106.5,74,41,33,0.5539999999999999,76,19,57,0.25,21,20,11,8,183.6,200.44,192.01999999999998
2013-04-05,1610612750,1610612761,2012,93.0,95.0,188.0,96.55,99.15,95.9,100.7,74,28,46,0.378,75,28,47,0.373,18,10,18,10,193.24,190.96,192.10000000000002
2013-04-05,1610612762,1610612740,2012,95.0,83.0,178.0,98.2,98.95,94.25,98.45,76,39,37,0.513,75,26,49,0.34700000000000003,28,11,16,10,195.76,191.84,193.8
2013-04-05,1610612756,1610612744,2012,107.0,111.0,218.0,95.25,105.15,98.75,97.75,75,23,52,0.307,75,43,32,0.573,16,7,26,17,189.52,197.88,193.7
2013-04-05,1610612758,1610612742,2012,108.0,117.0,225.0,108.4,107.3,99.7,100.75,75,27,48,0.36,75,36,39,0.48,19,8,22,14,216.12,204.16,210.14
2013-04-05,1610612757,1610612745,2012,98.0,116.0,214.0,100.4,100.95,104.85,98.9,75,33,42,0.44,75,42,33,0.56,22,11,27,15,197.8,211.32,204.56
2013-04-05,1610612747,1610612763,2012,86.0,84.0,170.0,103.85,102.6,94.8,90.55,75,39,36,0.52,75,51,24,0.68,24,15,30,21,204.0,180.36,192.18
2013-04-04,1610612751,1610612741,2012,90.0,92.0,182.0,99.6,98.05,92.3,95.15,74,43,31,0.581,73,40,33,0.5479999999999999,22,21,21,19,191.24,183.6,187.42000000000002
2013-04-04,1610612743,1610612742,2012,95.0,94.0,189.0,107.85,99.8,100.2,101.0,75,51,24,0.68,74,36,38,0.486,33,18,22,14,207.44,204.16,205.8
2013-04-04,1610612760,1610612759,2012,100.0,88.0,188.0,105.4,94.55,100.9,97.35,74,54,20,0.73,75,56,19,0.747,32,22,33,23,203.0,199.48,201.24
2013-04-03,1610612761,1610612764,2012,88.0,78.0,166.0,95.6,101.2,96.05,94.15,74,27,47,0.365,74,28,46,0.378,17,10,21,7,191.56,195.6,193.57999999999998
2013-04-03,1610612766,1610612755,2012,88.0,83.0,171.0,92.9,105.9,95.2,98.9,74,17,57,0.23,73,30,43,0.411,11,6,22,8,199.6,189.36,194.48000000000002
2013-04-03,1610612737,1610612752,2012,82.0,95.0,177.0,99.4,99.2,97.9,93.95,75,42,33,0.56,73,47,26,0.644,24,18,27,20,198.56,196.4,197.48000000000002
2013-04-03,1610612739,1610612751,2012,95.0,113.0,208.0,96.3,102.75,98.9,97.2,73,22,51,0.301,73,42,31,0.575,13,9,22,20,199.56,191.24,195.4
2013-04-03,1610612738,1610612765,2012,98.0,93.0,191.0,97.1,96.9,90.4,103.05,74,38,36,0.514,75,25,50,0.333,25,13,15,10,192.28,192.24,192.26
2013-04-03,1610612749,1610612750,2012,98.0,107.0,205.0,104.0,105.25,95.35,98.45,73,36,37,0.493,73,27,46,0.37,20,16,18,9,207.48,193.24,200.36
2013-04-03,1610612759,1610612753,2012,98.0,84.0,182.0,101.05,97.3,96.35,105.8,74,55,19,0.743,75,19,56,0.253,32,23,11,8,199.4,200.44,199.92000000000002
2013-04-03,1610612762,1610612743,2012,96.0,113.0,209.0,98.75,98.8,107.6,100.95,75,39,36,0.52,74,50,24,0.6759999999999999,28,11,33,17,196.6,207.44,202.01999999999998
2013-04-03,1610612758,1610612745,2012,102.0,112.0,214.0,108.4,107.1,104.8,99.65,74,27,47,0.365,74,41,33,0.5539999999999999,19,8,27,14,214.48,211.32,212.89999999999998
2013-04-03,1610612757,1610612763,2012,76.0,94.0,170.0,101.5,101.35,95.5,90.85,74,33,41,0.446,74,50,24,0.6759999999999999,22,11,30,20,198.56,180.36,189.46
2013-04-03,1610612746,1610612756,2012,126.0,101.0,227.0,103.4,96.6,95.0,105.2,75,49,26,0.653,74,23,51,0.311,28,21,16,7,196.16,189.52,192.84
2013-04-03,1610612744,1610612740,2012,98.0,88.0,186.0,98.2,97.5,94.15,99.3,74,42,32,0.568,74,26,48,0.35100000000000003,25,17,16,10,199.76,191.84,195.8
2013-04-02,1610612764,1610612741,2012,90.0,86.0,176.0,96.8,95.0,92.8,95.0,73,27,46,0.37,72,40,32,0.556,20,7,21,19,195.4,183.6,189.5
2013-04-02,1610612748,1610612752,2012,90.0,102.0,192.0,104.65,94.2,97.6,93.85,73,58,15,0.795,72,46,26,0.639,32,26,27,19,200.88,196.4,198.64
2013-04-02,1610612747,1610612742,2012,101.0,81.0,182.0,103.35,102.8,100.7,101.55,74,38,36,0.514,73,36,37,0.493,23,15,22,14,205.72,204.16,204.94
2013-04-01,1610612761,1610612765,2012,98.0,108.0,206.0,96.15,101.2,89.8,102.9,73,27,46,0.37,74,24,50,0.324,17,10,15,9,190.64,192.24,191.44
2013-04-01,1610612737,1610612739,2012,102.0,94.0,196.0,98.8,99.65,96.55,102.55,74,41,33,0.5539999999999999,72,22,50,0.306,23,18,13,9,199.04,199.56,199.3
2013-04-01,1610612749,1610612766,2012,131.0,102.0,233.0,102.55,105.3,92.0,104.65,72,35,37,0.486,73,17,56,0.233,19,16,11,6,205.2,199.6,202.39999999999998
2013-04-01,1610612763,1610612759,2012,92.0,90.0,182.0,96.15,90.75,102.0,98.65,73,49,24,0.6709999999999999,73,55,18,0.753,29,20,32,23,179.88,199.4,189.64
2013-04-01,1610612745,1610612753,2012,111.0,103.0,214.0,104.6,100.0,95.3,104.65,73,40,33,0.5479999999999999,74,19,55,0.257,26,14,11,8,210.44,200.44,205.44
2013-04-01,1610612750,1610612738,2012,110.0,100.0,210.0,94.8,98.45,97.6,96.75,72,26,46,0.361,73,38,35,0.521,17,9,25,13,191.68,192.28,191.98000000000002
2013-04-01,1610612762,1610612757,2012,112.0,102.0,214.0,98.9,98.75,101.75,101.3,74,38,36,0.514,73,33,40,0.452,27,11,22,11,195.12,198.56,196.84
2013-04-01,1610612746,1610612754,2012,106.0,109.0,215.0,102.6,96.95,98.9,89.0,74,49,25,0.662,74,47,27,0.635,28,21,29,18,196.2,186.36,191.28
2013-03-31,1610612764,1610612761,2012,109.0,92.0,201.0,97.3,96.05,96.35,100.15,72,26,46,0.361,72,27,45,0.375,19,7,17,10,194.68,190.64,192.66
2013-03-31,1610612740,1610612739,2012,112.0,92.0,204.0,93.55,99.45,96.85,102.4,73,25,48,0.342,71,22,49,0.31,15,10,13,9,189.92,199.56,194.74
2013-03-31,1610612741,1610612765,2012,95.0,94.0,189.0,92.5,95.45,89.2,103.85,71,39,32,0.5489999999999999,73,24,49,0.329,20,19,15,9,183.36,192.24,187.8
2013-03-31,1610612759,1610612748,2012,86.0,88.0,174.0,103.4,98.0,105.2,94.55,72,55,17,0.764,72,57,15,0.792,32,23,32,25,201.24,200.88,201.06
2013-03-31,1610612752,1610612738,2012,108.0,89.0,197.0,96.6,94.0,97.45,95.95,71,45,26,0.634,72,38,34,0.528,26,19,25,13,195.96,192.28,194.12
2013-03-30,1610612742,1610612741,2012,100.0,98.0,198.0,100.65,101.8,91.05,94.0,72,35,37,0.486,70,39,31,0.557,21,14,20,19,204.44,183.36,193.9
2013-03-30,1610612737,1610612753,2012,97.0,88.0,185.0,98.95,100.8,95.7,105.35,73,40,33,0.5479999999999999,73,19,54,0.26,22,18,11,8,199.76,200.44,200.1
2013-03-30,1610612755,1610612766,2012,100.0,92.0,192.0,94.7,99.65,92.65,104.25,72,29,43,0.403,72,17,55,0.236,21,8,11,6,189.08,199.6,194.34
2013-03-30,1610612745,1610612746,2012,98.0,81.0,179.0,105.8,101.9,103.65,96.45,72,39,33,0.542,73,49,24,0.6709999999999999,25,14,28,21,213.68,196.2,204.94
2013-03-30,1610612750,1610612763,2012,86.0,99.0,185.0,95.2,97.85,95.75,91.35,71,26,45,0.366,72,48,24,0.667,17,9,29,19,191.96,179.88,185.92000000000002
2013-03-30,1610612749,1610612760,2012,99.0,109.0,208.0,102.3,104.7,105.9,95.7,71,35,36,0.493,73,53,20,0.726,19,16,32,21,204.52,203.0,203.76
2013-03-30,1610612762,1610612751,2012,116.0,107.0,223.0,98.55,98.1,97.8,96.2,73,37,36,0.507,72,42,30,0.583,26,11,22,20,193.6,191.24,192.42000000000002
2013-03-30,1610612756,1610612754,2012,104.0,112.0,216.0,94.0,103.75,97.7,87.25,73,23,50,0.315,73,46,27,0.63,16,7,29,17,188.52,186.36,187.44
2013-03-30,1610612758,1610612747,2012,98.0,103.0,201.0,109.35,107.5,103.6,103.85,73,27,46,0.37,73,37,36,0.507,19,8,23,14,214.72,205.72,210.22
2013-03-30,1610612744,1610612757,2012,125.0,98.0,223.0,98.2,98.5,100.0,100.0,73,41,32,0.562,72,33,39,0.458,24,17,22,11,199.44,198.56,199.0
2013-03-29,1610612753,1610612764,2012,97.0,92.0,189.0,95.45,106.0,96.95,96.0,72,18,54,0.25,71,26,45,0.366,10,8,19,7,199.8,194.68,197.24
2013-03-29,1610612738,1610612737,2012,118.0,107.0,225.0,96.85,95.8,98.7,99.45,71,37,34,0.521,72,40,32,0.556,24,13,22,18,190.12,199.76,194.94
2013-03-29,1610612752,1610612766,2012,111.0,102.0,213.0,95.45,94.0,91.4,103.75,70,44,26,0.629,71,17,54,0.239,25,19,11,6,195.64,199.6,197.62
2013-03-29,1610612765,1610612761,2012,82.0,99.0,181.0,91.05,104.35,96.0,100.45,72,24,48,0.333,71,26,45,0.366,15,9,17,9,191.56,190.64,191.1
2013-03-29,1610612739,1610612755,2012,87.0,97.0,184.0,97.75,102.55,94.5,100.25,70,22,48,0.314,71,28,43,0.394,13,9,21,7,200.68,189.08,194.88
2013-03-29,1610612763,1610612745,2012,103.0,94.0,197.0,95.55,91.3,106.5,102.45,71,47,24,0.662,71,39,32,0.5489999999999999,28,19,25,14,178.04,213.68,195.86
2013-03-29,1610612740,1610612748,2012,89.0,108.0,197.0,93.95,99.1,105.5,94.6,72,25,47,0.34700000000000003,71,56,15,0.789,15,10,32,24,190.64,200.88,195.76
2013-03-29,1610612750,1610612760,2012,101.0,93.0,194.0,94.8,98.05,105.95,96.1,70,25,45,0.35700000000000004,72,53,19,0.736,16,9,32,21,193.0,203.0,198.0
2013-03-29,1610612759,1610612746,2012,104.0,102.0,206.0,104.7,98.0,103.0,96.8,71,54,17,0.7609999999999999,72,49,23,0.6809999999999999,31,23,28,21,200.72,196.2,198.45999999999998
2013-03-29,1610612743,1610612751,2012,109.0,87.0,196.0,107.0,101.1,98.5,95.6,73,49,24,0.6709999999999999,71,42,29,0.5920000000000001,32,17,22,20,206.4,191.24,198.82
2013-03-29,1610612757,1610612762,2012,95.0,105.0,200.0,100.5,99.7,98.15,98.0,71,33,38,0.465,72,36,36,0.5,22,11,26,10,198.08,193.6,195.84
2013-03-28,1610612749,1610612747,2012,113.0,103.0,216.0,101.35,104.15,103.6,103.15,70,34,36,0.486,72,37,35,0.514,18,16,23,14,203.72,205.72,204.72
2013-03-28,1610612742,1610612754,2012,78.0,103.0,181.0,102.3,101.45,97.6,88.44999999999997,71,35,36,0.493,72,45,27,0.625,21,14,29,16,205.48,186.36,195.92000000000002
2013-03-28,1610612756,1610612758,2012,103.0,117.0,220.0,93.2,102.75,108.5,108.5,72,23,49,0.319,72,26,46,0.361,16,7,19,7,187.04,214.72,200.88
2013-03-27,1610612761,1610612737,2012,88.0,107.0,195.0,96.7,99.55,99.05,100.2,70,26,44,0.371,71,39,32,0.5489999999999999,17,9,22,17,190.36,199.76,195.06
2013-03-27,1610612755,1610612749,2012,100.0,92.0,192.0,93.85,99.45,101.05,104.15,70,27,43,0.386,69,34,35,0.493,20,7,18,16,189.44,203.72,196.57999999999998
2013-03-27,1610612766,1610612753,2012,114.0,108.0,222.0,90.4,102.9,95.45,106.25,70,16,54,0.229,71,18,53,0.254,10,6,10,8,198.64,199.8,199.22
2013-03-27,1610612739,1610612738,2012,92.0,93.0,185.0,97.9,102.7,97.85,95.6,69,22,47,0.319,70,36,34,0.514,13,9,24,12,200.32,190.12,195.22
2013-03-27,1610612752,1610612763,2012,108.0,101.0,209.0,95.0,93.2,94.3,89.5,69,43,26,0.623,70,47,23,0.6709999999999999,24,19,28,19,195.48,178.04,186.76
2013-03-27,1610612741,1610612748,2012,101.0,97.0,198.0,90.65,93.4,104.95,92.9,69,38,31,0.551,70,56,14,0.8,19,19,32,24,182.56,200.88,191.72
2013-03-27,1610612740,1610612746,2012,91.0,105.0,196.0,94.9,98.6,102.05,96.05,71,25,46,0.35200000000000004,71,48,23,0.6759999999999999,15,10,28,20,188.68,196.2,192.44
2013-03-27,1610612745,1610612754,2012,91.0,100.0,191.0,107.85,102.6,98.1,89.6,70,39,31,0.557,71,44,27,0.62,25,14,29,15,215.04,186.36,200.7
2013-03-27,1610612760,1610612764,2012,103.0,80.0,183.0,105.8,97.6,98.05,95.35,71,52,19,0.732,70,26,44,0.371,31,21,19,7,204.56,194.68,199.62
2013-03-27,1610612750,1610612747,2012,117.0,120.0,237.0,93.65,97.05,102.45,102.65,69,25,44,0.362,71,36,35,0.507,16,9,23,13,192.04,205.72,198.88
2013-03-27,1610612759,1610612743,2012,100.0,99.0,199.0,104.75,98.3,107.45,101.55,70,53,17,0.757,72,49,23,0.6809999999999999,30,23,32,17,200.4,206.4,203.4
2013-03-27,1610612762,1610612756,2012,103.0,88.0,191.0,97.45,98.25,93.0,102.25,71,35,36,0.493,71,23,48,0.324,25,10,16,7,193.76,187.04,190.39999999999998
2013-03-27,1610612744,1610612758,2012,98.0,105.0,203.0,98.65,98.3,108.3,109.0,72,41,31,0.569,71,25,46,0.35200000000000004,24,17,19,6,199.28,214.72,207.0
2013-03-27,1610612757,1610612751,2012,93.0,111.0,204.0,101.15,99.35,97.8,95.65,70,33,37,0.471,70,41,29,0.586,22,11,22,19,196.56,191.24,193.9
2013-03-26,1610612738,1610612752,2012,85.0,100.0,185.0,98.45,94.8,94.9,93.95,69,36,33,0.522,68,42,26,0.618,24,12,24,18,190.64,195.48,193.06
2013-03-26,1610612765,1610612750,2012,82.0,105.0,187.0,91.45,103.75,93.95,99.3,71,24,47,0.338,68,24,44,0.353,15,9,16,8,190.68,192.04,191.36
2013-03-26,1610612742,1610612746,2012,109.0,102.0,211.0,103.0,101.35,101.45,95.5,70,34,36,0.486,70,48,22,0.6859999999999999,20,14,28,20,205.64,196.2,200.92
2013-03-25,1610612764,1610612763,2012,107.0,94.0,201.0,97.1,95.45,94.0,88.25,69,25,44,0.362,69,47,22,0.6809999999999999,18,7,28,19,194.44,178.04,186.24
2013-03-25,1610612753,1610612748,2012,94.0,108.0,202.0,94.55,106.25,104.7,92.7,70,18,52,0.257,69,55,14,0.797,10,8,32,23,199.52,200.88,200.2
2013-03-25,1610612754,1610612737,2012,100.0,94.0,194.0,99.35,89.45,99.5,100.3,70,43,27,0.614,70,39,31,0.557,28,15,22,17,186.12,199.76,192.94
2013-03-25,1610612740,1610612743,2012,110.0,86.0,196.0,94.4,99.5,108.85,101.95,70,24,46,0.343,71,49,22,0.69,14,10,32,17,188.24,206.4,197.32
2013-03-25,1610612762,1610612755,2012,107.0,91.0,198.0,97.1,98.0,93.65,98.8,70,34,36,0.486,69,27,42,0.391,24,10,20,7,195.04,189.44,192.24
2013-03-25,1610612744,1610612747,2012,109.0,103.0,212.0,98.6,98.05,102.3,101.85,71,40,31,0.563,70,36,34,0.514,23,17,23,13,198.64,205.72,202.18
2013-03-24,1610612749,1610612737,2012,99.0,104.0,203.0,100.6,104.05,99.7,99.15,68,34,34,0.5,69,38,31,0.551,18,16,22,16,202.92,199.76,201.33999999999997
2013-03-24,1610612748,1610612766,2012,109.0,77.0,186.0,104.6,93.7,90.35,101.8,68,54,14,0.794,69,16,53,0.232,31,23,10,6,201.28,198.64,199.95999999999998
2013-03-24,1610612745,1610612759,2012,96.0,95.0,191.0,110.05,103.3,105.2,98.2,69,38,31,0.551,69,53,16,0.768,24,14,30,23,215.88,200.4,208.14
2013-03-24,1610612760,1610612757,2012,103.0,83.0,186.0,107.0,98.25,102.2,100.05,70,51,19,0.7290000000000001,69,33,36,0.478,30,21,22,11,205.12,196.56,200.84
2013-03-24,1610612750,1610612741,2012,97.0,104.0,201.0,93.8,99.3,90.1,93.0,67,24,43,0.358,68,37,31,0.544,16,8,19,18,190.56,182.56,186.56
2013-03-24,1610612742,1610612762,2012,113.0,108.0,221.0,102.4,101.2,97.15,98.35,69,33,36,0.478,69,34,35,0.493,19,14,24,10,203.56,195.04,199.3
2013-03-24,1610612756,1610612751,2012,100.0,102.0,202.0,92.4,102.8,97.15,94.85,70,23,47,0.329,69,40,29,0.58,16,7,22,18,185.44,191.24,188.34
2013-03-24,1610612758,1610612755,2012,103.0,117.0,220.0,109.15,108.6,92.4,98.35,70,25,45,0.35700000000000004,68,26,42,0.382,19,6,20,6,213.48,189.44,201.45999999999998
2013-03-23,1610612766,1610612765,2012,91.0,92.0,183.0,90.45,102.2,92.1,104.15,68,16,52,0.235,70,23,47,0.329,10,6,15,8,200.52,190.68,195.60000000000002
2013-03-23,1610612752,1610612761,2012,110.0,84.0,194.0,95.4,93.8,97.5,98.95,67,41,26,0.612,69,26,43,0.377,23,18,17,9,196.64,190.36,193.5
2013-03-23,1610612741,1610612754,2012,87.0,84.0,171.0,90.9,93.15,99.15,90.1,67,36,31,0.537,69,43,26,0.623,18,18,28,15,181.96,186.12,184.04000000000002
2013-03-23,1610612763,1610612738,2012,110.0,106.0,216.0,93.0,87.75,98.1,94.95,68,46,22,0.6759999999999999,68,36,32,0.529,27,19,24,12,176.44,190.64,183.54
2013-03-23,1610612743,1610612758,2012,101.0,95.0,196.0,110.2,102.0,108.95,108.45,70,48,22,0.6859999999999999,69,25,44,0.362,31,17,19,6,208.16,213.48,210.82
2013-03-23,1610612746,1610612751,2012,101.0,95.0,196.0,101.7,95.55,96.1,94.25,69,47,22,0.6809999999999999,68,40,28,0.588,27,20,22,18,196.44,191.24,193.84
2013-03-23,1610612744,1610612764,2012,101.0,92.0,193.0,98.9,99.25,96.8,95.2,70,39,31,0.557,68,25,43,0.368,22,17,18,7,198.72,194.44,196.57999999999998
2013-03-22,1610612761,1610612752,2012,94.0,99.0,193.0,97.55,98.95,95.0,95.35,68,26,42,0.382,66,40,26,0.606,17,9,23,17,190.6,196.64,193.62
2013-03-22,1610612753,1610612760,2012,89.0,97.0,186.0,95.6,106.6,107.0,97.25,69,18,51,0.261,69,50,19,0.725,10,8,30,20,199.44,205.12,202.28
2013-03-22,1610612754,1610612749,2012,102.0,78.0,180.0,99.1,90.05000000000003,101.9,104.55,68,42,26,0.618,67,34,33,0.507,27,15,18,16,186.44,202.92,194.68
2013-03-22,1610612737,1610612757,2012,93.0,104.0,197.0,100.2,98.55,102.2,100.9,68,38,30,0.5589999999999999,68,32,36,0.471,22,16,22,10,199.84,196.56,198.2
2013-03-22,1610612748,1610612765,2012,103.0,89.0,192.0,105.0,93.7,92.9,104.0,67,53,14,0.7909999999999999,69,23,46,0.333,30,23,15,8,201.76,190.68,196.22
2013-03-22,1610612740,1610612763,2012,90.0,83.0,173.0,94.25,100.15,94.1,87.8,69,23,46,0.333,67,46,21,0.687,13,10,27,19,188.92,176.44,182.68
2013-03-22,1610612745,1610612739,2012,116.0,78.0,194.0,109.7,104.15,98.65,101.3,68,37,31,0.544,68,22,46,0.324,23,14,13,9,217.72,200.32,209.01999999999998
2013-03-22,1610612742,1610612738,2012,104.0,94.0,198.0,103.0,101.05,97.9,94.6,68,32,36,0.471,67,36,31,0.537,18,14,24,12,203.8,190.64,197.22
2013-03-22,1610612759,1610612762,2012,104.0,97.0,201.0,104.8,97.65,97.25,98.4,68,52,16,0.765,68,34,34,0.5,29,23,24,10,200.6,195.04,197.82
2013-03-22,1610612756,1610612750,2012,86.0,117.0,203.0,91.55,101.8,92.95,99.6,69,23,46,0.333,66,23,43,0.348,16,7,16,7,184.84,190.56,187.7
2013-03-22,1610612747,1610612764,2012,100.0,103.0,203.0,102.85,102.0,95.45,94.45,69,36,33,0.522,67,24,43,0.358,23,13,18,6,203.84,194.44,199.14
2013-03-21,1610612741,1610612757,2012,89.0,99.0,188.0,90.7,92.3,102.4,102.35,66,36,30,0.545,67,31,36,0.463,18,18,22,9,181.68,196.56,189.12
2013-03-21,1610612743,1610612755,2012,101.0,100.0,201.0,110.75,102.2,92.5,98.8,69,47,22,0.6809999999999999,67,26,41,0.388,30,17,20,6,208.04,189.44,198.74
2013-03-21,1610612758,1610612750,2012,101.0,98.0,199.0,108.65,108.8,92.45,99.8,68,24,44,0.353,65,23,42,0.354,18,6,16,7,212.96,190.56,201.76
2013-03-20,1610612766,1610612761,2012,107.0,101.0,208.0,90.2,102.2,97.1,98.25,67,15,52,0.224,67,26,41,0.388,9,6,17,9,200.28,190.6,195.44
2013-03-20,1610612739,1610612748,2012,95.0,98.0,193.0,98.5,101.4,105.6,93.95,67,22,45,0.328,66,52,14,0.7879999999999999,13,9,30,22,200.36,201.76,201.06
2013-03-20,1610612752,1610612753,2012,106.0,94.0,200.0,94.5,94.95,93.95,105.2,65,39,26,0.6,68,18,50,0.265,22,17,10,8,197.36,199.44,198.4
2013-03-20,1610612737,1610612749,2012,98.0,90.0,188.0,99.1,98.7,101.7,104.45,67,37,30,0.552,66,34,32,0.515,21,16,18,16,200.8,202.92,201.86
2013-03-20,1610612763,1610612760,2012,90.0,89.0,179.0,93.85,87.15,108.05,98.5,66,45,21,0.682,68,50,18,0.735,26,19,30,20,177.52,205.12,191.32
2013-03-20,1610612740,1610612738,2012,87.0,86.0,173.0,94.85,99.0,98.15,94.95,68,22,46,0.324,66,36,30,0.545,12,10,24,12,189.32,190.64,189.98
2013-03-20,1610612745,1610612762,2012,100.0,93.0,193.0,110.65,104.8,96.8,98.5,67,36,31,0.537,67,34,33,0.507,22,14,24,10,218.72,195.04,206.88
2013-03-20,1610612742,1610612751,2012,96.0,113.0,209.0,103.45,100.35,95.1,93.95,67,32,35,0.478,67,39,28,0.5820000000000001,18,14,22,17,204.44,191.24,197.84
2013-03-20,1610612759,1610612744,2012,104.0,93.0,197.0,104.7,96.9,98.9,99.0,67,51,16,0.7609999999999999,69,39,30,0.565,28,23,22,17,201.08,198.72,199.9
2013-03-20,1610612756,1610612764,2012,79.0,88.0,167.0,92.55,102.85,95.25,95.1,68,23,45,0.338,66,23,43,0.348,16,7,18,5,185.8,194.44,190.12
2013-03-20,1610612746,1610612755,2012,101.0,72.0,173.0,101.45,96.1,92.5,98.25,68,46,22,0.6759999999999999,66,26,40,0.394,26,20,20,6,197.4,189.44,193.42000000000002
2013-03-19,1610612754,1610612753,2012,95.0,73.0,168.0,98.55,90.85,95.2,105.8,67,41,26,0.612,67,18,49,0.269,26,15,10,8,186.92,199.44,193.18
2013-03-19,1610612749,1610612757,2012,102.0,95.0,197.0,101.6,104.95,102.6,102.5,65,33,32,0.508,66,31,35,0.47,17,16,22,9,203.08,196.56,199.82
2013-03-19,1610612760,1610612743,2012,104.0,114.0,218.0,108.8,97.7,110.6,102.15,67,50,17,0.746,68,46,22,0.6759999999999999,30,20,30,16,205.12,208.04,206.57999999999998
2013-03-19,1610612758,1610612746,2012,116.0,101.0,217.0,107.65,109.05,101.6,95.6,67,23,44,0.343,67,46,21,0.687,17,6,26,20,212.48,197.4,204.94
2013-03-18,1610612755,1610612757,2012,101.0,100.0,201.0,90.9,97.65,102.6,102.35,65,25,40,0.385,65,31,34,0.477,19,6,22,9,188.96,196.56,192.76
2013-03-18,1610612766,1610612764,2012,119.0,114.0,233.0,88.85,101.7,93.95,93.75,66,14,52,0.212,65,23,42,0.354,8,6,18,5,198.64,194.44,196.54
2013-03-18,1610612739,1610612754,2012,90.0,111.0,201.0,99.15,101.4,97.1,90.4,66,22,44,0.333,66,40,26,0.606,13,9,26,14,200.36,186.92,193.64
2013-03-18,1610612737,1610612742,2012,113.0,127.0,240.0,98.1,96.95,102.55,99.65,66,37,29,0.561,66,31,35,0.47,21,16,18,13,200.16,204.44,202.3
2013-03-18,1610612765,1610612751,2012,82.0,119.0,201.0,93.65,102.95,94.45,95.8,68,23,45,0.338,66,38,28,0.5760000000000001,15,8,22,16,190.44,191.24,190.84
2013-03-18,1610612738,1610612748,2012,103.0,105.0,208.0,97.95,93.75,105.35,93.05,65,36,29,0.5539999999999999,65,51,14,0.785,24,12,30,21,189.28,201.76,195.51999999999998
2013-03-18,1610612741,1610612743,2012,118.0,119.0,237.0,89.55,90.5,109.9,101.0,65,36,29,0.5539999999999999,67,45,22,0.672,18,18,30,15,179.36,208.04,193.7
2013-03-18,1610612763,1610612750,2012,92.0,77.0,169.0,93.4,87.85,93.65,100.3,65,44,21,0.677,64,23,41,0.359,25,19,16,7,177.48,190.56,184.01999999999998
2013-03-18,1610612740,1610612744,2012,72.0,93.0,165.0,95.9,98.55,99.15,101.35,67,22,45,0.328,68,38,30,0.5589999999999999,12,10,22,16,189.88,198.72,194.3
2013-03-18,1610612756,1610612747,2012,99.0,76.0,175.0,92.2,103.35,103.8,102.85,67,22,45,0.328,68,36,32,0.529,15,7,23,13,187.56,203.84,195.7
2013-03-18,1610612762,1610612752,2012,83.0,90.0,173.0,97.55,98.55,95.0,95.5,66,34,32,0.515,64,38,26,0.594,24,10,22,16,194.84,197.36,196.10000000000002
2013-03-17,1610612761,1610612748,2012,91.0,108.0,199.0,96.8,97.85,104.4,93.6,66,26,40,0.394,64,50,14,0.7809999999999999,17,9,30,20,189.4,201.76,195.57999999999998
2013-03-17,1610612749,1610612753,2012,115.0,109.0,224.0,101.2,104.4,93.95,104.9,64,32,32,0.5,66,18,48,0.273,16,16,10,8,201.28,199.44,200.36
2013-03-17,1610612746,1610612752,2012,93.0,80.0,173.0,101.8,97.05,95.8,96.15,66,45,21,0.682,63,38,25,0.603,25,20,22,16,198.32,197.36,197.84
2013-03-17,1610612745,1610612744,2012,78.0,108.0,186.0,111.5,104.65,99.2,104.45,66,36,30,0.545,67,37,30,0.552,22,14,22,15,220.64,198.72,209.68
2013-03-17,1610612750,1610612740,2012,97.0,95.0,192.0,93.7,100.55,96.05,99.35,63,22,41,0.349,66,22,44,0.333,15,7,12,10,190.08,189.88,189.98000000000002
2013-03-17,1610612742,1610612760,2012,101.0,107.0,208.0,103.0,99.05,108.25,97.9,65,31,34,0.477,66,49,17,0.742,18,13,30,19,204.36,205.12,204.74
2013-03-17,1610612751,1610612737,2012,93.0,105.0,198.0,94.45,95.0,98.1,97.35,65,38,27,0.585,65,36,29,0.5539999999999999,22,16,21,15,190.72,200.16,195.44
2013-03-17,1610612747,1610612758,2012,113.0,102.0,215.0,103.4,102.55,106.6,109.4,67,35,32,0.522,66,23,43,0.348,22,13,17,6,202.64,212.48,207.56
2013-03-16,1610612764,1610612756,2012,127.0,105.0,232.0,92.05,92.2,91.75,101.5,64,22,42,0.344,66,22,44,0.333,17,5,15,7,193.08,187.56,190.32
2013-03-16,1610612738,1610612766,2012,105.0,88.0,193.0,97.7,94.25,89.19999999999997,102.55,64,35,29,0.547,65,14,51,0.215,23,12,8,6,188.68,198.64,193.66
2013-03-16,1610612755,1610612754,2012,98.0,91.0,189.0,89.9,96.15,96.85,90.35,64,24,40,0.375,65,40,25,0.615,18,6,26,14,189.12,186.92,188.01999999999998
2013-03-16,1610612759,1610612739,2012,119.0,113.0,232.0,104.15,96.2,99.4,101.65,66,50,16,0.758,65,22,43,0.338,27,23,13,9,199.56,200.36,199.96
2013-03-16,1610612762,1610612763,2012,90.0,84.0,174.0,97.35,98.2,93.8,88.5,65,33,32,0.508,64,44,20,0.688,23,10,25,19,196.24,177.48,186.86
2013-03-16,1610612757,1610612765,2012,112.0,101.0,213.0,102.05,102.3,92.85,102.3,64,30,34,0.469,67,23,44,0.343,21,9,15,8,195.2,190.44,192.82
2013-03-15,1610612761,1610612766,2012,92.0,78.0,170.0,97.1,97.6,90.0,102.9,65,25,40,0.385,64,14,50,0.219,16,9,8,6,189.88,198.64,194.26
2013-03-15,1610612764,1610612740,2012,96.0,87.0,183.0,92.55,92.65,96.65,99.75,63,21,42,0.333,65,22,43,0.338,16,5,12,10,193.68,189.88,191.78
2013-03-15,1610612754,1610612747,2012,93.0,99.0,192.0,97.1,90.4,103.05,102.05,64,40,24,0.625,66,34,32,0.515,26,14,22,12,186.32,202.64,194.48
2013-03-15,1610612737,1610612756,2012,107.0,94.0,201.0,98.9,98.2,91.7,101.8,64,35,29,0.547,65,22,43,0.338,20,15,15,7,199.52,187.56,193.54000000000002
2013-03-15,1610612745,1610612750,2012,108.0,100.0,208.0,111.55,105.5,93.75,100.85,65,35,30,0.5379999999999999,62,22,40,0.355,21,14,15,7,219.6,190.08,204.84
2013-03-15,1610612760,1610612753,2012,117.0,104.0,221.0,108.0,97.25,93.6,104.7,65,48,17,0.738,65,18,47,0.277,29,19,10,8,203.6,199.44,201.51999999999998
2013-03-15,1610612749,1610612748,2012,94.0,107.0,201.0,100.9,104.25,104.3,93.15,63,32,31,0.508,63,49,14,0.778,16,16,30,19,200.84,201.76,201.3
2013-03-15,1610612742,1610612739,2012,96.0,86.0,182.0,103.55,100.4,99.75,102.5,64,30,34,0.469,64,22,42,0.344,17,13,13,9,205.4,200.36,202.88
2013-03-15,1610612743,1610612763,2012,87.0,80.0,167.0,111.2,101.9,94.25,89.44999999999997,66,44,22,0.667,63,44,19,0.698,29,15,25,19,210.08,177.48,193.78
2013-03-15,1610612744,1610612741,2012,95.0,113.0,208.0,100.1,103.45,88.69999999999997,92.15,66,37,29,0.561,64,35,29,0.547,22,15,18,17,198.84,179.36,189.10000000000002
2013-03-14,1610612759,1610612742,2012,92.0,91.0,183.0,104.85,96.75,103.85,100.8,65,49,16,0.754,63,30,33,0.476,26,23,17,13,199.4,205.4,202.4
2013-03-14,1610612757,1610612752,2012,105.0,90.0,195.0,101.8,101.8,95.3,95.75,63,29,34,0.46,62,38,24,0.613,20,9,22,16,195.32,197.36,196.34
2013-03-13,1610612755,1610612748,2012,94.0,98.0,192.0,89.65,95.25,104.3,93.45,63,24,39,0.381,62,48,14,0.774,18,6,30,18,189.36,201.76,195.56
2013-03-13,1610612764,1610612749,2012,106.0,93.0,199.0,92.15,92.5,102.1,103.45,62,20,42,0.32299999999999995,62,32,30,0.516,15,5,16,16,193.96,200.84,197.4
2013-03-13,1610612754,1610612750,2012,107.0,91.0,198.0,97.45,91.0,94.0,100.7,63,39,24,0.619,61,22,39,0.361,25,14,15,7,185.64,190.08,187.86
2013-03-13,1610612738,1610612761,2012,112.0,88.0,200.0,96.4,94.3,97.55,96.75,63,34,29,0.54,64,25,39,0.391,22,12,16,9,189.0,189.88,189.44
2013-03-13,1610612737,1610612747,2012,96.0,92.0,188.0,99.3,98.4,103.35,102.1,63,34,29,0.54,65,34,31,0.523,19,15,22,12,199.88,202.64,201.26
2013-03-13,1610612745,1610612756,2012,111.0,81.0,192.0,112.25,107.05,92.4,101.75,64,34,30,0.531,64,22,42,0.344,20,14,15,7,219.76,187.56,203.66
2013-03-13,1610612760,1610612762,2012,110.0,87.0,197.0,107.8,97.35,97.5,97.05,64,47,17,0.7340000000000001,64,33,31,0.516,28,19,23,10,204.84,196.24,200.54000000000002
2013-03-13,1610612758,1610612741,2012,121.0,79.0,200.0,105.3,110.15,89.8,91.65,65,22,43,0.338,63,35,28,0.556,16,6,18,17,212.88,179.36,196.12
2013-03-13,1610612743,1610612752,2012,117.0,94.0,211.0,111.25,102.7,95.05,94.2,65,43,22,0.662,61,38,23,0.623,28,15,22,16,209.36,197.36,203.36
2013-03-13,1610612746,1610612763,2012,85.0,96.0,181.0,102.25,96.6,94.6,90.2,65,45,20,0.6920000000000001,62,43,19,0.6940000000000001,25,20,25,18,199.2,177.48,188.33999999999997
2013-03-13,1610612744,1610612765,2012,105.0,97.0,202.0,99.85,103.45,91.95,101.95,65,36,29,0.5539999999999999,66,23,43,0.348,21,15,15,8,198.0,190.44,194.22
2013-03-12,1610612766,1610612738,2012,100.0,74.0,174.0,89.7,104.2,97.65,94.05,63,13,50,0.206,62,34,28,0.5479999999999999,7,6,22,12,199.48,189.0,194.24
2013-03-12,1610612753,1610612747,2012,97.0,106.0,203.0,92.55,103.7,103.6,102.25,64,18,46,0.281,64,33,31,0.516,10,8,22,11,197.96,202.64,200.3
2013-03-12,1610612739,1610612764,2012,95.0,90.0,185.0,100.95,103.4,92.55,92.5,63,21,42,0.333,61,20,41,0.328,12,9,15,5,200.16,193.96,197.06
2013-03-12,1610612751,1610612740,2012,108.0,98.0,206.0,93.3,95.35,97.05,99.9,64,37,27,0.578,64,22,42,0.344,21,16,12,10,190.92,189.88,190.39999999999998
2013-03-12,1610612748,1610612737,2012,98.0,81.0,179.0,105.1,94.8,100.4,99.2,61,47,14,0.77,62,34,28,0.5479999999999999,29,18,19,15,202.24,199.88,201.06
2013-03-12,1610612749,1610612742,2012,108.0,115.0,223.0,102.15,102.8,103.3,100.7,61,32,29,0.525,62,29,33,0.468,16,16,17,12,199.08,205.4,202.24
2013-03-12,1610612750,1610612759,2012,107.0,83.0,190.0,94.4,100.85,106.35,96.75,60,21,39,0.35,64,49,15,0.7659999999999999,14,7,26,23,190.28,199.4,194.84
2013-03-12,1610612757,1610612763,2012,97.0,102.0,199.0,101.7,101.6,93.75,89.44999999999997,62,29,33,0.468,61,42,19,0.6890000000000001,20,9,25,17,195.2,177.48,186.33999999999997
2013-03-11,1610612755,1610612751,2012,106.0,97.0,203.0,88.95,94.6,92.3,95.1,62,23,39,0.371,63,37,26,0.5870000000000001,17,6,21,16,189.44,190.92,190.18
2013-03-11,1610612759,1610612760,2012,105.0,93.0,198.0,105.85,96.5,108.4,96.85,63,48,15,0.762,63,47,16,0.746,25,23,28,19,200.52,204.84,202.68
2013-03-11,1610612762,1610612765,2012,103.0,90.0,193.0,97.55,97.5,92.65,101.9,63,32,31,0.508,65,23,42,0.354,22,10,15,8,196.84,190.44,193.64
2013-03-11,1610612756,1610612743,2012,93.0,108.0,201.0,92.4,100.75,110.7,103.9,63,22,41,0.349,64,42,22,0.6559999999999999,15,7,28,14,187.56,209.36,198.46
2013-03-11,1610612744,1610612752,2012,92.0,63.0,155.0,100.45,105.25,97.0,93.95,64,35,29,0.547,60,38,22,0.633,20,15,22,16,199.6,197.36,198.48000000000002
2013-03-10,1610612760,1610612738,2012,91.0,79.0,170.0,109.7,97.75,99.25,95.65,62,46,16,0.742,61,34,27,0.557,27,19,22,12,207.16,189.0,198.07999999999998
2013-03-10,1610612747,1610612741,2012,90.0,81.0,171.0,104.2,102.4,90.4,90.95,63,32,31,0.508,62,35,27,0.565,21,11,18,17,204.88,179.36,192.12
2013-03-10,1610612761,1610612739,2012,100.0,96.0,196.0,97.65,97.65,100.7,103.3,63,24,39,0.381,62,21,41,0.339,15,9,12,9,189.96,200.16,195.06
2013-03-10,1610612753,1610612755,2012,99.0,91.0,190.0,92.7,104.35,88.7,95.1,63,17,46,0.27,61,23,38,0.377,9,8,17,6,197.72,189.44,193.57999999999998
2013-03-10,1610612748,1610612754,2012,105.0,91.0,196.0,104.8,94.95,98.05,89.55,60,46,14,0.767,62,39,23,0.629,28,18,25,14,202.6,185.64,194.12
2013-03-10,1610612740,1610612757,2012,98.0,96.0,194.0,96.25,100.1,100.75,101.0,63,21,42,0.333,61,29,32,0.475,11,10,20,9,189.32,195.2,192.26
2013-03-10,1610612750,1610612742,2012,77.0,100.0,177.0,95.55,101.4,103.85,102.1,59,21,38,0.35600000000000004,61,28,33,0.459,14,7,17,11,191.36,205.4,198.38
2013-03-10,1610612758,1610612749,2012,113.0,115.0,228.0,105.85,110.3,101.8,102.8,64,22,42,0.344,60,31,29,0.517,16,6,16,15,211.32,199.08,205.2
2013-03-10,1610612746,1610612765,2012,129.0,97.0,226.0,100.85,96.95,92.2,100.95,64,44,20,0.688,64,23,41,0.359,24,20,15,8,197.4,190.44,193.92000000000002
2013-03-09,1610612737,1610612751,2012,80.0,93.0,173.0,101.05,99.45,92.2,95.25,61,34,27,0.557,62,36,26,0.581,19,15,21,15,201.0,190.92,195.95999999999998
2013-03-09,1610612752,1610612762,2012,113.0,84.0,197.0,97.0,94.6,98.1,97.0,59,37,22,0.627,62,32,30,0.516,21,16,22,10,197.68,196.84,197.26
2013-03-09,1610612764,1610612766,2012,104.0,87.0,191.0,92.05,92.95,90.1,104.45,60,19,41,0.317,62,13,49,0.21,14,5,7,6,192.96,199.48,196.22
2013-03-09,1610612763,1610612740,2012,96.0,85.0,181.0,94.0,89.05,96.55,99.45,60,41,19,0.6829999999999999,62,21,41,0.339,24,17,11,10,177.64,189.32,183.48
2013-03-09,1610612743,1610612750,2012,111.0,88.0,199.0,110.25,104.55,96.05,101.5,63,41,22,0.6509999999999999,58,21,37,0.362,27,14,14,7,210.32,191.36,200.84
2013-03-09,1610612756,1610612745,2012,107.0,105.0,212.0,91.75,100.4,112.5,107.6,62,21,41,0.339,63,34,29,0.54,14,7,20,14,186.48,219.76,203.12
2013-03-09,1610612744,1610612749,2012,93.0,103.0,196.0,101.1,105.05,102.15,103.35,63,35,28,0.556,59,30,29,0.508,20,15,16,14,198.96,199.08,199.02
2013-03-08,1610612766,1610612760,2012,94.0,116.0,210.0,90.05000000000003,103.5,108.85,98.25,61,13,48,0.213,61,45,16,0.738,7,6,27,18,199.08,207.16,203.12
2013-03-08,1610612753,1610612754,2012,86.0,115.0,201.0,93.15,103.45,96.6,90.1,62,17,45,0.274,61,38,23,0.623,9,8,25,13,197.64,185.64,191.64
2013-03-08,1610612751,1610612764,2012,95.0,78.0,173.0,92.3,95.2,92.5,92.9,61,35,26,0.574,59,19,40,0.322,20,15,14,5,193.12,192.96,193.04000000000002
2013-03-08,1610612765,1610612742,2012,99.0,102.0,201.0,93.1,100.8,104.6,102.75,63,23,40,0.365,60,27,33,0.45,15,8,17,10,190.88,205.4,198.14
2013-03-08,1610612739,1610612763,2012,92.0,103.0,195.0,102.2,102.9,92.95,89.6,61,21,40,0.344,59,40,19,0.6779999999999999,12,9,24,16,201.76,177.64,189.7
2013-03-08,1610612738,1610612737,2012,107.0,102.0,209.0,98.85,95.55,101.15,99.4,60,33,27,0.55,60,34,26,0.5670000000000001,21,12,19,15,189.12,201.0,195.06
2013-03-08,1610612748,1610612755,2012,102.0,93.0,195.0,105.2,94.7,88.30000000000003,95.45,59,45,14,0.763,60,23,37,0.383,27,18,17,6,203.52,189.44,196.48000000000002
2013-03-08,1610612741,1610612762,2012,89.0,88.0,177.0,90.05,90.8,99.3,97.65,61,34,27,0.557,61,32,29,0.525,17,17,22,10,179.68,196.84,188.26
2013-03-08,1610612759,1610612757,2012,106.0,136.0,242.0,105.7,93.8,98.1,100.5,62,48,14,0.774,60,28,32,0.467,25,23,20,8,199.0,195.2,197.1
2013-03-08,1610612758,1610612756,2012,121.0,112.0,233.0,104.75,111.1,91.1,99.75,63,21,42,0.333,61,21,40,0.344,15,6,14,7,210.32,186.48,198.39999999999998
2013-03-08,1610612747,1610612761,2012,118.0,116.0,234.0,102.8,101.55,97.65,97.9,62,31,31,0.5,62,24,38,0.387,20,11,15,9,204.16,189.96,197.06
2013-03-08,1610612744,1610612745,2012,88.0,94.0,182.0,100.45,104.95,114.05,107.2,62,35,27,0.565,62,33,29,0.532,20,15,20,13,200.0,219.76,209.88
2013-03-07,1610612752,1610612760,2012,94.0,95.0,189.0,97.6,95.05,109.55,98.4,58,37,21,0.638,60,44,16,0.733,21,16,27,17,197.92,207.16,202.54
2013-03-07,1610612743,1610612746,2012,107.0,92.0,199.0,110.95,104.6,99.9,96.5,62,40,22,0.645,63,44,19,0.698,26,14,24,20,209.8,197.4,203.60000000000002
2013-03-06,1610612766,1610612751,2012,78.0,99.0,177.0,89.95,103.7,91.75,95.55,60,13,47,0.217,60,34,26,0.5670000000000001,7,6,20,14,199.24,193.12,196.18
2013-03-06,1610612739,1610612762,2012,104.0,101.0,205.0,102.75,103.35,98.8,97.95,60,20,40,0.333,60,32,28,0.5329999999999999,11,9,22,10,200.32,196.84,198.57999999999998
2013-03-06,1610612754,1610612738,2012,81.0,83.0,164.0,98.1,91.0,99.2,96.25,60,38,22,0.633,59,32,27,0.542,25,13,21,11,186.72,189.12,187.92000000000002
2013-03-06,1610612737,1610612755,2012,107.0,96.0,203.0,101.25,99.35,87.95,94.85,59,33,26,0.5589999999999999,59,23,36,0.39,18,15,17,6,199.0,189.44,194.22
2013-03-06,1610612748,1610612753,2012,97.0,96.0,193.0,106.5,95.7,92.2,103.45,58,44,14,0.759,61,17,44,0.279,26,18,9,8,204.56,197.64,201.1
2013-03-06,1610612765,1610612752,2012,77.0,87.0,164.0,93.75,102.3,97.05,95.25,62,23,39,0.371,57,36,21,0.632,15,8,21,15,192.36,197.92,195.14
2013-03-06,1610612763,1610612757,2012,91.0,85.0,176.0,93.7,90.0,99.4,101.7,58,39,19,0.672,59,28,31,0.475,23,16,20,8,177.08,195.2,186.14
2013-03-06,1610612740,1610612747,2012,102.0,108.0,210.0,97.15,99.3,101.7,101.05,61,21,40,0.344,61,30,31,0.4920000000000001,11,10,20,10,188.2,204.16,196.18
2013-03-06,1610612750,1610612764,2012,87.0,82.0,169.0,96.2,102.2,94.0,93.95,57,20,37,0.35100000000000003,58,19,39,0.328,13,7,14,5,191.64,192.96,192.3
2013-03-06,1610612742,1610612745,2012,112.0,108.0,220.0,104.7,103.2,113.65,105.7,59,26,33,0.441,61,33,28,0.541,16,10,20,13,203.48,219.76,211.62
2013-03-06,1610612759,1610612741,2012,101.0,83.0,184.0,105.95,94.05,90.35,90.4,61,47,14,0.77,60,34,26,0.5670000000000001,24,23,17,17,198.84,179.68,189.26
2013-03-06,1610612756,1610612761,2012,71.0,98.0,169.0,92.05,99.95,97.8,99.75,60,21,39,0.35,61,23,38,0.377,14,7,15,8,188.44,189.96,189.2
2013-03-06,1610612746,1610612749,2012,117.0,101.0,218.0,99.0,96.1,102.0,102.2,62,43,19,0.6940000000000001,58,30,28,0.517,23,20,16,14,196.96,199.08,198.02
2013-03-06,1610612744,1610612758,2012,87.0,83.0,170.0,101.25,105.65,104.6,111.2,61,34,27,0.557,62,21,41,0.339,19,15,15,6,201.28,210.32,205.8
2013-03-05,1610612755,1610612738,2012,101.0,109.0,210.0,87.9,94.55,98.15,96.35,58,23,35,0.397,58,31,27,0.534,17,6,21,10,190.04,189.12,189.57999999999998
2013-03-05,1610612760,1610612747,2012,122.0,105.0,227.0,108.75,97.35,101.1,100.25,59,43,16,0.7290000000000001,60,30,30,0.5,26,17,20,10,206.24,204.16,205.2
2013-03-05,1610612758,1610612743,2012,113.0,120.0,233.0,104.55,111.05,110.55,104.2,61,21,40,0.344,61,39,22,0.639,15,6,26,13,208.56,209.8,209.18
2013-03-04,1610612739,1610612752,2012,97.0,102.0,199.0,102.65,103.65,97.65,95.7,59,20,39,0.339,56,35,21,0.625,11,9,21,14,199.36,197.92,198.64
2013-03-04,1610612749,1610612762,2012,109.0,108.0,217.0,102.05,101.9,97.75,96.5,57,29,28,0.509,59,32,27,0.542,15,14,22,10,199.6,196.84,198.22
2013-03-04,1610612740,1610612753,2012,102.0,105.0,207.0,97.65,99.85,91.45,103.6,60,21,39,0.35,60,16,44,0.267,11,10,9,7,188.12,197.64,192.88
2013-03-04,1610612750,1610612748,2012,81.0,97.0,178.0,96.3,101.9,106.6,96.15,56,20,36,0.35700000000000004,57,43,14,0.754,13,7,26,17,192.12,204.56,198.34
2013-03-04,1610612743,1610612737,2012,104.0,88.0,192.0,111.4,105.7,102.05,98.75,60,38,22,0.633,58,33,25,0.569,25,13,18,15,209.84,199.0,204.42000000000002
2013-03-04,1610612757,1610612766,2012,122.0,105.0,227.0,98.5,101.95,88.6,102.7,58,27,31,0.466,59,13,46,0.22,19,8,7,6,195.56,199.24,197.4
2013-03-04,1610612744,1610612761,2012,125.0,118.0,243.0,99.35,104.45,97.2,99.15,60,33,27,0.55,60,23,37,0.383,18,15,15,8,199.48,189.96,194.72
2013-03-03,1610612752,1610612748,2012,93.0,99.0,192.0,97.25,95.15,106.25,95.25,55,35,20,0.636,56,42,14,0.75,21,14,26,16,199.08,204.56,201.82
2013-03-03,1610612746,1610612760,2012,104.0,108.0,212.0,99.55,95.15,109.25,98.2,61,43,18,0.705,58,42,16,0.7240000000000001,23,20,26,16,195.08,206.24,200.66000000000003
2013-03-03,1610612764,1610612755,2012,90.0,87.0,177.0,93.8,93.25,88.69999999999997,95.0,57,18,39,0.316,57,23,34,0.404,13,5,17,6,194.28,190.04,192.16
2013-03-03,1610612753,1610612763,2012,82.0,108.0,190.0,92.6,103.75,92.45,91.1,59,16,43,0.271,57,38,19,0.667,9,7,23,15,199.08,177.08,188.08
2013-03-03,1610612758,1610612766,2012,119.0,83.0,202.0,102.65,112.55,88.7,101.4,60,20,40,0.333,58,13,45,0.224,14,6,7,6,207.8,199.24,203.52
2013-03-03,1610612745,1610612742,2012,136.0,103.0,239.0,112.05,105.15,104.2,101.35,60,32,28,0.5329999999999999,58,26,32,0.448,19,13,16,10,219.12,203.48,211.3
2013-03-03,1610612759,1610612765,2012,114.0,75.0,189.0,105.65,95.55,94.1,100.85,60,46,14,0.767,61,23,38,0.377,23,23,15,8,199.68,192.36,196.02
2013-03-03,1610612754,1610612741,2012,97.0,92.0,189.0,98.35,90.85,90.95,89.95,59,37,22,0.627,59,34,25,0.5760000000000001,24,13,17,17,187.2,179.68,183.44
2013-03-03,1610612747,1610612737,2012,99.0,98.0,197.0,101.35,99.75,101.6,98.5,59,29,30,0.4920000000000001,57,33,24,0.579,19,10,18,15,202.92,199.0,200.95999999999998
2013-03-02,1610612755,1610612744,2012,104.0,97.0,201.0,88.35,94.15,99.9,104.0,56,22,34,0.393,59,33,26,0.5589999999999999,16,6,18,15,190.16,199.48,194.82
2013-03-02,1610612741,1610612751,2012,96.0,85.0,181.0,91.0,88.6,92.25,96.2,58,33,25,0.569,59,34,25,0.5760000000000001,16,17,20,14,180.28,193.12,186.7
2013-03-02,1610612749,1610612761,2012,122.0,114.0,236.0,100.3,101.35,97.65,97.45,56,28,28,0.5,59,23,36,0.39,14,14,15,8,197.52,189.96,193.74
2013-03-02,1610612757,1610612750,2012,109.0,94.0,203.0,97.45,101.9,96.0,101.75,57,26,31,0.456,55,20,35,0.364,18,8,13,7,194.72,192.12,193.42000000000002
2013-03-01,1610612761,1610612754,2012,81.0,93.0,174.0,98.5,97.75,97.45,91.5,58,23,35,0.397,58,36,22,0.621,15,8,24,12,191.68,187.2,189.44
2013-03-01,1610612764,1610612752,2012,88.0,96.0,184.0,95.1,93.5,97.7,96.05,56,18,38,0.321,54,34,20,0.63,13,5,21,13,195.48,199.08,197.28
2013-03-01,1610612753,1610612745,2012,110.0,118.0,228.0,92.1,103.15,111.15,104.35,58,16,42,0.276,59,31,28,0.525,9,7,19,12,198.44,219.12,208.78
2013-03-01,1610612738,1610612744,2012,94.0,86.0,180.0,97.35,96.55,101.3,104.4,57,30,27,0.526,58,33,25,0.569,20,10,18,15,189.76,199.48,194.62
2013-03-01,1610612739,1610612746,2012,89.0,105.0,194.0,103.85,103.8,99.1,95.2,58,20,38,0.345,60,42,18,0.7,11,9,23,19,199.52,195.08,197.3
2013-03-01,1610612748,1610612763,2012,98.0,91.0,189.0,106.3,94.25,92.6,90.55,55,41,14,0.745,56,38,18,0.679,25,16,23,15,204.04,177.08,190.56
2013-03-01,1610612751,1610612742,2012,90.0,98.0,188.0,92.45,95.75,104.0,101.85,58,34,24,0.586,57,25,32,0.439,20,14,16,9,193.0,203.48,198.24
2013-03-01,1610612740,1610612765,2012,100.0,95.0,195.0,97.85,99.7,94.5,100.2,59,20,39,0.339,60,23,37,0.383,10,10,15,8,188.56,192.36,190.46
2013-03-01,1610612759,1610612758,2012,130.0,102.0,232.0,104.6,94.75,101.6,111.0,59,45,14,0.763,59,20,39,0.339,22,23,14,6,197.2,207.8,202.5
2013-03-01,1610612762,1610612766,2012,98.0,68.0,166.0,96.85,99.35,90.6,101.5,58,31,27,0.534,57,13,44,0.228,21,10,7,6,198.44,199.24,198.84
2013-03-01,1610612756,1610612737,2012,92.0,87.0,179.0,91.5,100.2,100.15,98.75,59,20,39,0.339,56,33,23,0.589,13,7,18,15,189.68,199.0,194.34
2013-03-01,1610612743,1610612760,2012,105.0,103.0,208.0,111.55,106.15,109.95,98.65,59,37,22,0.627,57,42,15,0.737,24,13,26,16,209.16,206.24,207.7
2013-02-28,1610612754,1610612746,2012,91.0,99.0,190.0,97.8,90.5,99.15,95.7,57,36,21,0.632,59,41,18,0.695,24,12,23,18,188.48,195.08,191.78
2013-02-28,1610612741,1610612755,2012,93.0,82.0,175.0,90.4,89.35,88.5,93.95,57,32,25,0.561,55,22,33,0.4,15,17,16,6,179.96,190.16,185.06
2013-02-28,1610612747,1610612750,2012,116.0,94.0,210.0,101.2,99.7,95.9,101.15,58,28,30,0.483,54,20,34,0.37,18,10,13,7,202.24,192.12,197.18
2013-02-27,1610612753,1610612758,2012,101.0,125.0,226.0,91.9,101.2,100.15,110.65,57,16,41,0.281,58,19,39,0.328,9,7,14,5,195.96,207.8,201.88
2013-02-27,1610612739,1610612761,2012,103.0,92.0,195.0,103.45,103.7,99.1,97.45,57,19,38,0.333,57,23,34,0.404,10,9,15,8,199.76,191.68,195.72
2013-02-27,1610612764,1610612765,2012,95.0,96.0,191.0,96.35,93.25,95.65,101.75,55,18,37,0.327,59,22,37,0.373,13,5,15,7,195.24,192.36,193.8
2013-02-27,1610612752,1610612744,2012,109.0,105.0,214.0,97.25,95.15,101.15,104.4,53,33,20,0.623,57,33,24,0.579,20,13,18,15,197.08,199.48,198.28
2013-02-27,1610612763,1610612742,2012,90.0,84.0,174.0,92.15,90.45,105.25,103.3,55,37,18,0.6729999999999999,56,25,31,0.446,22,15,16,9,178.28,203.48,190.88
2013-02-27,1610612745,1610612749,2012,107.0,110.0,217.0,111.95,104.05,99.2,101.2,58,31,27,0.534,55,27,28,0.491,19,12,14,13,217.56,197.52,207.54000000000002
2013-02-27,1610612760,1610612740,2012,119.0,74.0,193.0,109.45,99.2,99.25,99.05,56,41,15,0.732,58,20,38,0.345,25,16,10,10,206.4,188.56,197.48000000000002
2013-02-27,1610612759,1610612756,2012,101.0,105.0,206.0,104.75,93.15,91.55,99.95,58,45,13,0.7759999999999999,58,19,39,0.328,22,23,13,6,196.36,189.68,193.02
2013-02-27,1610612762,1610612737,2012,91.0,102.0,193.0,98.0,99.75,99.2,98.85,57,31,26,0.544,55,32,23,0.5820000000000001,21,10,18,14,198.44,199.0,198.72
2013-02-27,1610612757,1610612743,2012,109.0,111.0,220.0,96.15,100.7,109.6,104.75,56,26,30,0.464,58,36,22,0.621,18,8,24,12,194.76,209.16,201.95999999999998
2013-02-26,1610612755,1610612753,2012,84.0,98.0,182.0,88.55000000000003,93.55,91.55,103.0,54,22,32,0.407,56,15,41,0.268,16,6,9,6,189.48,195.96,192.72
2013-02-26,1610612754,1610612744,2012,108.0,97.0,205.0,97.65,90.4,100.65,104.15,56,35,21,0.625,56,33,23,0.589,23,12,18,15,187.72,199.48,193.6
2013-02-26,1610612748,1610612758,2012,141.0,129.0,270.0,103.7,92.6,98.35,109.65,54,40,14,0.741,57,19,38,0.333,24,16,14,5,202.16,207.8,204.98000000000002
2013-02-26,1610612741,1610612739,2012,98.0,101.0,199.0,90.3,89.5,103.0,104.7,56,32,24,0.5710000000000001,56,18,38,0.321,15,17,10,8,179.52,199.76,189.64
2013-02-26,1610612740,1610612751,2012,97.0,101.0,198.0,98.8,97.95,92.85,95.35,57,20,37,0.35100000000000003,57,33,24,0.579,10,10,20,13,186.2,193.0,189.6
2013-02-26,1610612742,1610612749,2012,90.0,95.0,185.0,106.0,103.55,99.8,101.5,55,25,30,0.455,54,26,28,0.481,16,9,14,12,204.6,197.52,201.06
2013-02-26,1610612756,1610612750,2012,84.0,83.0,167.0,91.35,100.15,95.95,102.25,57,18,39,0.316,53,20,33,0.377,12,6,13,7,191.48,192.12,191.8
2013-02-26,1610612746,1610612766,2012,106.0,84.0,190.0,99.2,96.6,90.85,101.2,58,40,18,0.69,56,13,43,0.232,22,18,7,6,195.08,199.24,197.16000000000003
2013-02-25,1610612761,1610612764,2012,84.0,90.0,174.0,100.3,98.1,96.55,93.8,56,23,33,0.411,54,17,37,0.315,15,8,13,4,192.04,195.24,193.64
2013-02-25,1610612765,1610612737,2012,103.0,114.0,217.0,95.75,100.55,97.65,98.65,58,22,36,0.379,54,31,23,0.574,15,7,18,13,190.4,199.0,194.7
2013-02-25,1610612743,1610612747,2012,119.0,108.0,227.0,109.4,104.9,99.95,98.5,57,35,22,0.614,57,28,29,0.491,23,12,18,10,207.6,202.24,204.92000000000002
2013-02-25,1610612762,1610612738,2012,107.0,110.0,217.0,97.25,98.65,96.95,96.0,56,31,25,0.5539999999999999,56,29,27,0.518,21,10,20,9,196.76,189.76,193.26
2013-02-24,1610612742,1610612747,2012,99.0,103.0,202.0,106.7,103.3,99.95,98.95,54,25,29,0.463,56,27,29,0.482,16,9,18,9,204.72,202.24,203.48000000000002
2013-02-24,1610612750,1610612744,2012,99.0,100.0,199.0,95.6,101.2,101.45,104.8,52,20,32,0.385,55,32,23,0.5820000000000001,13,7,18,14,190.76,199.48,195.12
2013-02-24,1610612748,1610612739,2012,109.0,105.0,214.0,104.2,92.8,103.05,104.45,53,39,14,0.736,55,18,37,0.327,23,16,10,8,203.0,199.76,201.38
2013-02-24,1610612740,1610612758,2012,110.0,95.0,205.0,98.05,97.6,98.85,109.85,56,19,37,0.339,56,19,37,0.339,9,10,14,5,184.96,207.8,196.38
2013-02-24,1610612751,1610612763,2012,72.0,76.0,148.0,94.9,96.85,94.0,90.9,56,33,23,0.589,54,36,18,0.667,20,13,22,14,194.4,178.28,186.34
2013-02-24,1610612752,1610612755,2012,99.0,93.0,192.0,97.35,95.9,88.35,93.4,52,32,20,0.615,53,22,31,0.415,19,13,16,6,197.32,189.48,193.39999999999998
2013-02-24,1610612756,1610612759,2012,87.0,97.0,184.0,91.75,99.75,104.4,93.05,56,18,38,0.321,57,44,13,0.772,12,6,22,22,191.36,196.36,193.86
2013-02-24,1610612757,1610612738,2012,92.0,86.0,178.0,96.15,100.9,97.1,95.45,55,25,30,0.455,55,29,26,0.527,17,8,20,9,195.36,189.76,192.56
2013-02-24,1610612760,1610612741,2012,102.0,72.0,174.0,109.0,101.1,90.35,88.7,55,40,15,0.727,55,32,23,0.5820000000000001,24,16,15,17,207.4,179.52,193.46
2013-02-23,1610612764,1610612745,2012,105.0,103.0,208.0,95.95,92.8,110.75,103.4,53,16,37,0.302,57,31,26,0.544,12,4,19,12,193.28,217.56,205.42000000000002
2013-02-23,1610612766,1610612743,2012,99.0,113.0,212.0,91.0,101.15,109.05,104.2,55,13,42,0.236,56,34,22,0.607,7,6,23,11,197.48,207.6,202.54
2013-02-23,1610612753,1610612739,2012,94.0,118.0,212.0,92.15,102.8,102.15,104.9,55,15,40,0.273,54,17,37,0.315,9,6,10,7,195.0,199.76,197.38
2013-02-23,1610612755,1610612748,2012,90.0,114.0,204.0,89.25,92.75,103.35,93.5,52,22,30,0.423,52,38,14,0.731,16,6,23,15,189.0,203.0,196.0
2013-02-23,1610612765,1610612754,2012,72.0,90.0,162.0,97.3,100.45,98.15,92.25,57,22,35,0.386,55,34,21,0.618,15,7,23,11,191.68,187.72,189.7
2013-02-23,1610612749,1610612737,2012,102.0,103.0,205.0,100.1,101.3,97.65,98.95,53,26,27,0.491,53,30,23,0.5660000000000001,14,12,18,12,196.84,199.0,197.92000000000002
2013-02-23,1610612746,1610612762,2012,107.0,94.0,201.0,99.2,96.7,97.35,98.65,57,39,18,0.684,55,31,24,0.564,21,18,21,10,195.4,196.76,196.07999999999998
2013-02-22,1610612761,1610612752,2012,100.0,98.0,198.0,100.55,98.55,97.4,95.75,55,22,33,0.4,51,32,19,0.627,14,8,19,13,195.04,197.32,196.18
2013-02-22,1610612764,1610612743,2012,119.0,113.0,232.0,95.05,92.1,108.4,103.85,52,15,37,0.28800000000000003,55,34,21,0.618,11,4,23,11,191.68,207.6,199.64
2013-02-22,1610612766,1610612741,2012,75.0,105.0,180.0,92.45,101.2,90.1,89.9,54,13,41,0.241,54,31,23,0.574,7,6,15,16,198.2,179.52,188.86
2013-02-22,1610612754,1610612765,2012,114.0,82.0,196.0,97.25,92.55,98.0,99.1,54,33,21,0.611,56,22,34,0.393,22,11,15,7,185.72,191.68,188.7
2013-02-22,1610612751,1610612745,2012,96.0,106.0,202.0,94.95,95.85,110.2,103.85,55,33,22,0.6,56,30,26,0.536,20,13,19,11,192.8,217.56,205.18
2013-02-22,1610612737,1610612758,2012,122.0,108.0,230.0,96.7,98.3,98.3,108.4,52,29,23,0.5579999999999999,55,19,36,0.345,17,12,14,5,197.16,207.8,202.48000000000002
2013-02-22,1610612763,1610612753,2012,88.0,82.0,170.0,93.85,90.25,93.25,103.45,53,35,18,0.66,54,15,39,0.278,21,14,9,6,179.04,195.0,187.01999999999998
2013-02-22,1610612740,1610612742,2012,100.0,104.0,204.0,97.35,97.15,106.65,103.0,55,19,36,0.345,53,24,29,0.453,9,10,16,8,184.56,204.72,194.64
2013-02-22,1610612760,1610612750,2012,127.0,111.0,238.0,108.35,100.35,95.1,99.7,54,39,15,0.722,51,20,31,0.392,23,16,13,7,205.72,190.76,198.24
2013-02-22,1610612756,1610612738,2012,88.0,113.0,201.0,92.2,99.05,96.25,96.95,55,18,37,0.327,54,28,26,0.519,12,6,20,8,190.2,189.76,189.98
2013-02-22,1610612747,1610612757,2012,111.0,107.0,218.0,99.45,99.4,95.65,100.5,55,26,29,0.473,54,25,29,0.463,17,9,17,8,200.64,195.36,198.0
2013-02-22,1610612744,1610612759,2012,107.0,101.0,208.0,101.85,104.45,104.25,92.35,54,31,23,0.574,56,44,12,0.7859999999999999,17,14,22,22,199.12,196.36,197.74
2013-02-21,1610612741,1610612748,2012,67.0,86.0,153.0,92.65,90.2,105.45,95.1,53,31,22,0.585,51,37,14,0.725,15,16,23,14,181.08,203.0,192.04000000000002
2013-02-21,1610612746,1610612759,2012,90.0,116.0,206.0,100.0,94.75,103.35,92.9,56,39,17,0.696,55,43,12,0.782,21,18,22,21,196.12,196.36,196.24
2013-02-20,1610612761,1610612763,2012,82.0,88.0,170.0,101.25,99.5,94.05,90.2,54,22,32,0.407,52,34,18,0.654,14,8,21,13,195.28,179.04,187.16
2013-02-20,1610612766,1610612765,2012,99.0,105.0,204.0,92.25,100.85,97.3,99.0,53,13,40,0.245,55,21,34,0.382,7,6,15,6,199.12,191.68,195.4
2013-02-20,1610612754,1610612752,2012,125.0,91.0,216.0,95.05,91.8,97.55,94.5,53,32,21,0.604,50,32,18,0.64,21,11,19,13,184.04,197.32,190.68
2013-02-20,1610612739,1610612740,2012,105.0,100.0,205.0,101.85,104.05,96.85,95.8,53,16,37,0.302,54,19,35,0.35200000000000004,9,7,9,10,198.68,184.56,191.62
2013-02-20,1610612737,1610612748,2012,90.0,103.0,193.0,96.25,97.6,104.8,95.2,51,29,22,0.569,50,36,14,0.72,17,12,23,13,196.44,203.0,199.72
2013-02-20,1610612749,1610612751,2012,94.0,97.0,191.0,100.45,102.2,95.85,96.8,52,26,26,0.5,54,32,22,0.593,14,12,20,12,197.12,192.8,194.96
2013-02-20,1610612745,1610612760,2012,122.0,119.0,241.0,108.8,104.1,107.5,98.75,55,29,26,0.527,53,39,14,0.736,18,11,23,16,215.12,205.72,210.42000000000002
2013-02-20,1610612750,1610612755,2012,94.0,87.0,181.0,94.25,99.85,89.85,92.5,50,19,31,0.38,51,22,29,0.431,12,7,16,6,190.4,189.0,189.7
2013-02-20,1610612742,1610612753,2012,111.0,96.0,207.0,106.3,102.35,93.7,103.3,52,23,29,0.442,53,15,38,0.28300000000000003,15,8,9,6,205.44,195.0,200.22
2013-02-20,1610612747,1610612738,2012,113.0,99.0,212.0,99.05,100.05,95.45,96.35,54,25,29,0.463,53,28,25,0.528,16,9,20,8,199.64,189.76,194.7
2013-02-20,1610612744,1610612756,2012,108.0,98.0,206.0,101.5,103.7,92.15,97.7,53,30,23,0.5660000000000001,54,18,36,0.333,16,14,12,6,197.4,190.2,193.8
2013-02-19,1610612764,1610612761,2012,88.0,96.0,184.0,96.3,93.05,100.45,100.1,51,15,36,0.294,53,21,32,0.396,11,4,14,7,191.32,195.28,193.3
2013-02-19,1610612753,1610612766,2012,92.0,105.0,197.0,93.8,102.85,91.4,101.05,52,15,37,0.28800000000000003,52,12,40,0.231,9,6,7,5,194.12,199.12,196.62
2013-02-19,1610612751,1610612749,2012,113.0,111.0,224.0,95.15,95.2,100.1,101.35,53,31,22,0.585,51,26,25,0.51,19,12,14,12,191.8,197.12,194.46
2013-02-19,1610612765,1610612763,2012,91.0,105.0,196.0,97.1,98.85,93.45,89.8,54,21,33,0.389,51,33,18,0.647,15,6,21,12,192.2,179.04,185.62
2013-02-19,1610612740,1610612741,2012,87.0,96.0,183.0,97.35,96.2,93.2,91.1,53,19,34,0.358,52,30,22,0.5770000000000001,9,10,15,15,184.72,181.08,182.9
2013-02-19,1610612743,1610612738,2012,97.0,90.0,187.0,109.35,104.6,94.8,96.8,54,33,21,0.611,52,28,24,0.5379999999999999,22,11,20,8,208.36,189.76,199.06
2013-02-19,1610612762,1610612744,2012,115.0,101.0,216.0,97.05,98.5,100.85,102.7,54,30,24,0.556,52,30,22,0.5770000000000001,20,10,16,14,195.36,197.4,196.38
2013-02-19,1610612758,1610612759,2012,102.0,108.0,210.0,99.1,107.8,102.35,92.55,54,19,35,0.35200000000000004,54,42,12,0.778,14,5,22,20,207.72,196.36,202.04000000000002
2013-02-19,1610612757,1610612756,2012,98.0,102.0,200.0,97.0,101.35,91.0,97.75,53,25,28,0.472,53,17,36,0.321,17,8,12,5,196.24,190.2,193.22
2013-02-14,1610612760,1610612748,2012,100.0,110.0,210.0,108.05,98.5,103.15,94.55,52,39,13,0.75,49,35,14,0.7140000000000001,23,16,23,12,205.28,203.0,204.14
2013-02-14,1610612747,1610612746,2012,101.0,125.0,226.0,98.95,98.95,98.15,94.35,53,25,28,0.472,55,38,17,0.691,16,9,21,17,198.6,196.12,197.36
2013-02-13,1610612753,1610612737,2012,76.0,108.0,184.0,95.5,103.05,95.05,98.05,51,15,36,0.294,50,28,22,0.56,9,6,17,11,195.12,196.44,195.78
2013-02-13,1610612739,1610612759,2012,95.0,96.0,191.0,102.3,104.85,101.7,92.8,52,16,36,0.308,53,41,12,0.774,9,7,22,19,198.32,196.36,197.34
2013-02-13,1610612754,1610612766,2012,101.0,77.0,178.0,94.35,91.8,91.45,100.95,52,31,21,0.596,51,12,39,0.235,20,11,7,5,185.08,199.12,192.10000000000002
2013-02-13,1610612738,1610612741,2012,71.0,69.0,140.0,96.25,97.8,95.15,92.6,51,27,24,0.529,51,30,21,0.588,19,8,15,15,191.8,181.08,186.44
2013-02-13,1610612751,1610612743,2012,119.0,108.0,227.0,94.85,94.45,108.6,103.7,52,30,22,0.5770000000000001,53,33,20,0.623,18,12,22,11,191.32,208.36,199.84
2013-02-13,1610612752,1610612761,2012,88.0,92.0,180.0,97.95,95.0,101.5,100.65,49,32,17,0.653,52,20,32,0.385,19,13,14,6,197.48,195.28,196.38
2013-02-13,1610612765,1610612764,2012,96.0,85.0,181.0,96.65,99.1,95.6,93.2,53,20,33,0.377,50,15,35,0.3,14,6,11,4,192.2,191.32,191.76
2013-02-13,1610612749,1610612755,2012,94.0,92.0,186.0,100.9,102.6,89.85,92.55,50,25,25,0.5,50,22,28,0.44,13,12,16,6,197.96,189.0,193.48000000000002
2013-02-13,1610612740,1610612757,2012,99.0,63.0,162.0,96.15,97.1,98.95,101.25,52,18,34,0.34600000000000003,52,25,27,0.481,8,10,17,8,185.4,196.24,190.82
2013-02-13,1610612750,1610612762,2012,93.0,97.0,190.0,95.0,100.15,97.05,98.5,49,19,30,0.388,53,29,24,0.547,12,7,20,9,189.64,195.36,192.5
2013-02-13,1610612742,1610612758,2012,123.0,100.0,223.0,104.95,102.3,97.55,105.9,51,22,29,0.431,53,19,34,0.358,14,8,14,5,203.76,207.72,205.74
2013-02-13,1610612746,1610612745,2012,106.0,96.0,202.0,98.45,94.55,109.0,104.05,54,37,17,0.685,54,29,25,0.537,20,17,18,11,195.76,215.12,205.44
2013-02-12,1610612761,1610612743,2012,109.0,108.0,217.0,101.0,99.15,109.3,103.1,51,19,32,0.373,52,33,19,0.635,13,6,22,11,194.24,208.36,201.3
2013-02-12,1610612748,1610612757,2012,117.0,104.0,221.0,102.45,94.2,98.05,99.6,48,34,14,0.708,51,25,26,0.49,22,12,17,8,203.24,196.24,199.74
2013-02-12,1610612763,1610612758,2012,108.0,101.0,209.0,91.7,89.7,97.15,106.15,50,32,18,0.64,52,19,33,0.365,20,12,14,5,178.68,207.72,193.2
2013-02-12,1610612762,1610612760,2012,109.0,94.0,203.0,96.8,98.65,107.7,97.2,52,28,24,0.5379999999999999,51,39,12,0.765,19,9,23,16,195.52,205.28,200.4
2013-02-12,1610612747,1610612756,2012,91.0,85.0,176.0,99.6,99.05,90.7,97.55,52,24,28,0.462,52,17,35,0.327,15,9,12,5,199.16,190.2,194.68
2013-02-12,1610612744,1610612745,2012,107.0,116.0,223.0,100.3,101.35,108.2,104.05,51,30,21,0.588,53,28,25,0.528,16,14,18,10,196.8,215.12,205.96
2013-02-11,1610612755,1610612746,2012,90.0,107.0,197.0,90.3,92.75,98.05,95.35,49,22,27,0.449,53,36,17,0.679,16,6,20,16,187.92,195.76,191.83999999999997
2013-02-11,1610612766,1610612738,2012,94.0,91.0,185.0,91.35,101.65,96.35,96.9,50,11,39,0.22,50,27,23,0.54,6,5,19,8,198.88,191.8,195.34
2013-02-11,1610612739,1610612750,2012,92.0,100.0,192.0,102.4,104.7,94.2,100.85,51,16,35,0.314,48,18,30,0.375,9,7,12,6,199.64,189.64,194.64
2013-02-11,1610612754,1610612751,2012,84.0,89.0,173.0,94.9,91.35,95.9,94.9,51,31,20,0.608,51,29,22,0.569,20,11,18,11,184.68,191.32,188.0
2013-02-11,1610612765,1610612740,2012,86.0,105.0,191.0,97.4,99.25,96.45,97.75,52,20,32,0.385,51,17,34,0.333,14,6,8,9,192.0,185.4,188.7
2013-02-11,1610612741,1610612759,2012,89.0,103.0,192.0,94.75,92.0,102.4,93.85,50,30,20,0.6,52,40,12,0.769,15,15,22,18,180.24,196.36,188.3
2013-02-11,1610612749,1610612764,2012,90.0,102.0,192.0,101.6,101.75,94.55,93.15,49,25,24,0.51,49,14,35,0.28600000000000003,13,12,11,3,197.32,191.32,194.32
2013-02-11,1610612742,1610612737,2012,101.0,105.0,206.0,104.2,102.6,94.55,97.3,50,22,28,0.44,49,27,22,0.551,14,8,17,10,201.96,196.44,199.2
2013-02-10,1610612752,1610612746,2012,88.0,102.0,190.0,98.55,94.05,97.45,94.8,48,32,16,0.667,52,35,17,0.6729999999999999,19,13,20,15,197.4,195.76,196.57999999999998
2013-02-10,1610612748,1610612747,2012,107.0,97.0,204.0,102.35,93.8,100.0,99.1,47,33,14,0.7020000000000001,51,24,27,0.471,21,12,15,9,202.48,199.16,200.82
2013-02-10,1610612738,1610612743,2012,118.0,114.0,232.0,95.6,95.75,108.85,102.6,49,26,23,0.531,51,33,18,0.647,18,8,22,11,190.76,208.36,199.56
2013-02-10,1610612761,1610612740,2012,102.0,89.0,191.0,100.4,98.3,96.35,97.65,50,18,32,0.36,50,17,33,0.34,12,6,8,9,193.72,185.4,189.56
2013-02-10,1610612753,1610612757,2012,110.0,104.0,214.0,94.4,104.0,96.8,99.2,50,14,36,0.28,50,25,25,0.5,8,6,17,8,194.2,196.24,195.22
2013-02-10,1610612763,1610612750,2012,105.0,88.0,193.0,91.5,90.2,94.35,100.3,49,31,18,0.633,47,18,29,0.383,19,12,12,6,178.56,189.64,184.1
2013-02-10,1610612751,1610612759,2012,86.0,111.0,197.0,96.75,94.35,102.4,93.85,50,29,21,0.58,51,39,12,0.765,18,11,22,17,189.68,196.36,193.02
2013-02-10,1610612756,1610612760,2012,69.0,97.0,166.0,91.1,97.85,108.65,98.8,51,17,34,0.333,50,38,12,0.76,12,5,23,15,189.96,205.28,197.62
2013-02-10,1610612758,1610612745,2012,117.0,111.0,228.0,96.6,105.85,107.2,103.35,51,18,33,0.353,52,28,24,0.5379999999999999,13,5,18,10,206.04,215.12,210.57999999999998
2013-02-09,1610612739,1610612743,2012,103.0,111.0,214.0,101.95,104.25,108.35,102.15,50,16,34,0.32,50,32,18,0.64,9,7,22,10,198.84,208.36,203.60000000000002
2013-02-09,1610612755,1610612766,2012,87.0,76.0,163.0,91.3,93.95,92.95,102.35,48,21,27,0.438,49,11,38,0.224,15,6,6,5,189.44,198.88,194.16
2013-02-09,1610612749,1610612765,2012,100.0,105.0,205.0,102.0,101.15,97.4,99.6,48,25,23,0.521,51,19,32,0.373,13,12,14,5,196.96,192.0,194.48000000000002
2013-02-09,1610612742,1610612744,2012,116.0,91.0,207.0,102.65,103.35,101.0,101.35,49,21,28,0.429,50,30,20,0.6,13,8,16,14,201.44,196.8,199.12
2013-02-09,1610612758,1610612762,2012,120.0,109.0,229.0,96.0,105.2,95.8,97.9,50,17,33,0.34,51,28,23,0.5489999999999999,12,5,19,9,204.32,195.52,199.92000000000002
2013-02-08,1610612764,1610612751,2012,89.0,74.0,163.0,94.8,94.6,96.7,95.1,48,13,35,0.271,49,29,20,0.5920000000000001,10,3,18,11,193.16,189.68,191.42000000000002
2013-02-08,1610612766,1610612747,2012,93.0,100.0,193.0,93.2,102.7,100.6,100.7,48,11,37,0.229,50,23,27,0.46,6,5,15,8,198.76,199.16,198.95999999999998
2013-02-08,1610612754,1610612761,2012,98.0,100.0,198.0,94.45,90.4,99.1,98.0,50,31,19,0.62,49,17,32,0.34700000000000003,20,11,12,5,184.76,193.72,189.24
2013-02-08,1610612737,1610612740,2012,100.0,111.0,211.0,95.0,96.75,95.75,97.45,48,27,21,0.563,49,16,33,0.327,17,10,8,8,196.44,185.4,190.92000000000002
2013-02-08,1610612765,1610612759,2012,119.0,109.0,228.0,95.7,98.35,102.25,93.5,50,18,32,0.36,50,39,11,0.78,13,5,22,17,191.52,196.36,193.94
2013-02-08,1610612739,1610612753,2012,119.0,108.0,227.0,100.45,103.8,94.95,104.3,49,15,34,0.306,49,14,35,0.28600000000000003,8,7,8,6,196.84,194.2,195.51999999999998
2013-02-08,1610612748,1610612746,2012,111.0,89.0,200.0,101.95,93.95,98.85,94.7,46,32,14,0.696,51,35,16,0.6859999999999999,20,12,20,15,202.28,195.76,199.01999999999998
2013-02-08,1610612763,1610612744,2012,99.0,93.0,192.0,90.75,89.85,100.8,102.15,48,30,18,0.625,49,30,19,0.612,18,12,16,14,178.0,196.8,187.4
2013-02-08,1610612745,1610612757,2012,118.0,103.0,221.0,107.35,103.0,96.9,98.3,51,27,24,0.529,49,25,24,0.51,17,10,17,8,213.48,196.24,204.86
2013-02-08,1610612760,1610612756,2012,127.0,96.0,223.0,107.65,98.65,91.25,96.9,49,37,12,0.755,50,17,33,0.34,22,15,12,5,204.28,189.96,197.12
2013-02-08,1610612750,1610612752,2012,94.0,100.0,194.0,94.5,100.4,98.55,94.2,46,18,28,0.391,47,31,16,0.66,12,6,19,12,188.16,197.4,192.78
2013-02-08,1610612762,1610612741,2012,89.0,93.0,182.0,96.35,97.95,94.9,92.0,50,28,22,0.56,49,29,20,0.5920000000000001,19,9,15,14,195.76,180.24,188.0
2013-02-07,1610612738,1610612747,2012,116.0,95.0,211.0,94.15,94.95,100.95,100.25,48,25,23,0.521,49,23,26,0.469,17,8,15,8,190.08,199.16,194.62
2013-02-07,1610612743,1610612741,2012,128.0,96.0,224.0,106.85,101.9,94.9,90.3,49,31,18,0.633,48,29,19,0.604,21,10,15,14,207.4,180.24,193.82
2013-02-06,1610612761,1610612738,2012,95.0,99.0,194.0,98.95,98.25,93.65,95.2,48,17,31,0.354,47,24,23,0.511,12,5,17,7,193.92,190.08,192.0
2013-02-06,1610612755,1610612754,2012,69.0,88.0,157.0,92.3,95.0,94.1,90.7,47,21,26,0.447,49,30,19,0.612,15,6,20,10,191.08,184.76,187.92000000000002
2013-02-06,1610612764,1610612752,2012,106.0,96.0,202.0,94.75,94.65,98.0,93.55,47,12,35,0.255,46,31,15,0.674,9,3,19,12,192.04,197.4,194.72
2013-02-06,1610612753,1610612746,2012,76.0,86.0,162.0,95.85,104.85,99.5,94.55,48,14,34,0.292,50,34,16,0.68,8,6,20,14,195.72,195.76,195.74
2013-02-06,1610612739,1610612766,2012,122.0,95.0,217.0,99.3,104.7,93.0,100.65,48,14,34,0.292,47,11,36,0.234,7,7,6,5,195.4,198.76,197.07999999999998
2013-02-06,1610612737,1610612763,2012,103.0,92.0,195.0,96.15,98.1,90.3,89.1,47,26,21,0.5529999999999999,47,30,17,0.638,16,10,18,12,196.8,178.0,187.4
2013-02-06,1610612748,1610612745,2012,114.0,108.0,222.0,101.35,92.15,105.9,101.7,45,31,14,0.6890000000000001,50,27,23,0.54,19,12,17,10,201.6,213.48,207.54
2013-02-06,1610612765,1610612751,2012,90.0,93.0,183.0,96.35,98.55,96.7,96.0,49,18,31,0.3670000000000001,48,28,20,0.583,13,5,18,10,191.48,189.68,190.57999999999998
2013-02-06,1610612740,1610612756,2012,93.0,84.0,177.0,96.2,98.9,91.85,97.95,48,15,33,0.313,49,17,32,0.34700000000000003,7,8,12,5,184.92,189.96,187.44
2013-02-06,1610612760,1610612744,2012,119.0,98.0,217.0,107.35,98.9,100.6,100.35,48,36,12,0.75,48,30,18,0.625,21,15,16,14,202.16,196.8,199.48000000000002
2013-02-06,1610612742,1610612757,2012,105.0,99.0,204.0,102.15,103.9,96.3,98.25,48,20,28,0.417,48,25,23,0.521,12,8,17,8,202.36,196.24,199.3
2013-02-06,1610612750,1610612759,2012,94.0,104.0,198.0,95.35,100.55,101.7,94.15,45,18,27,0.4,49,38,11,0.7759999999999999,12,6,22,16,186.4,196.36,191.38
2013-02-06,1610612762,1610612749,2012,100.0,86.0,186.0,96.65,97.85,101.7,100.9,49,27,22,0.551,47,25,22,0.532,18,9,13,12,195.92,196.96,196.44
2013-02-05,1610612754,1610612737,2012,114.0,103.0,217.0,92.8,89.7,96.2,98.55,48,29,19,0.604,46,26,20,0.565,19,10,16,10,183.56,196.8,190.18
2013-02-05,1610612751,1610612747,2012,83.0,92.0,175.0,97.4,95.45,102.05,102.4,47,28,19,0.596,48,22,26,0.458,18,10,15,7,190.8,199.16,194.98000000000002
2013-02-05,1610612763,1610612756,2012,90.0,96.0,186.0,89.85,87.9,92.4,99.0,46,30,16,0.652,48,16,32,0.333,18,12,12,4,178.44,189.96,184.2
2013-02-05,1610612745,1610612744,2012,140.0,109.0,249.0,105.15,101.4,101.5,99.9,49,26,23,0.531,47,30,17,0.638,16,10,16,14,211.96,196.8,204.38
2013-02-05,1610612743,1610612749,2012,112.0,104.0,216.0,106.65,101.95,101.2,100.1,48,30,18,0.625,46,25,21,0.5429999999999999,20,10,13,12,206.84,196.96,201.9
2013-02-04,1610612754,1610612741,2012,111.0,101.0,212.0,92.1,89.2,93.6,89.35,47,28,19,0.596,47,29,18,0.617,18,10,15,14,183.0,180.24,181.62
2013-02-04,1610612755,1610612753,2012,78.0,61.0,139.0,93.35,95.95,97.65,106.2,46,20,26,0.435,47,14,33,0.298,14,6,8,6,191.88,195.72,193.8
2013-02-04,1610612764,1610612746,2012,98.0,90.0,188.0,94.05,94.5,99.7,95.4,46,11,35,0.239,49,34,15,0.6940000000000001,8,3,20,14,191.48,195.76,193.62
2013-02-04,1610612752,1610612765,2012,99.0,85.0,184.0,98.05,94.55,96.95,98.8,45,30,15,0.667,48,18,30,0.375,18,12,13,5,197.08,191.48,194.28
2013-02-04,1610612748,1610612766,2012,99.0,94.0,193.0,101.15,92.3,92.35,100.55,44,30,14,0.682,46,11,35,0.239,18,12,6,5,201.2,198.76,199.98
2013-02-04,1610612760,1610612742,2012,112.0,91.0,203.0,106.35,98.75,102.85,103.85,47,35,12,0.745,47,20,27,0.426,20,15,12,8,202.4,202.36,202.38
2013-02-04,1610612750,1610612757,2012,98.0,100.0,198.0,94.65,99.9,96.1,98.75,44,18,26,0.409,47,24,23,0.511,12,6,17,7,187.8,196.24,192.02
2013-02-04,1610612762,1610612758,2012,98.0,91.0,189.0,97.45,99.1,96.7,105.1,48,26,22,0.542,49,17,32,0.34700000000000003,17,9,12,5,195.48,204.32,199.89999999999998
2013-02-03,1610612738,1610612746,2012,106.0,104.0,210.0,93.05,93.75,98.4,94.7,46,23,23,0.5,48,34,14,0.708,16,7,20,14,189.16,195.76,192.45999999999998
2013-02-03,1610612765,1610612747,2012,97.0,98.0,195.0,96.9,98.6,103.05,103.3,47,18,29,0.383,47,21,26,0.447,13,5,15,6,191.72,199.16,195.44
2013-02-03,1610612761,1610612748,2012,85.0,100.0,185.0,99.5,98.5,101.75,93.55,47,17,30,0.362,43,29,14,0.674,12,5,18,11,194.32,201.2,197.76
2013-02-02,1610612737,1610612741,2012,76.0,93.0,169.0,97.0,97.65,94.45,90.85,45,26,19,0.578,46,28,18,0.609,16,10,15,13,196.64,180.24,188.44
2013-02-02,1610612752,1610612758,2012,120.0,81.0,201.0,96.75,95.05,97.5,103.8,44,29,15,0.659,48,17,31,0.354,17,12,12,5,195.32,204.32,199.82
2013-02-02,1610612739,1610612760,2012,115.0,110.0,225.0,97.85,103.7,105.8,98.05,47,13,34,0.277,46,35,11,0.7609999999999999,6,7,20,15,193.92,202.4,198.16
2013-02-02,1610612745,1610612766,2012,109.0,95.0,204.0,104.75,101.1,92.0,100.6,48,25,23,0.521,45,11,34,0.244,15,10,6,5,212.72,198.76,205.74
2013-02-02,1610612750,1610612740,2012,115.0,86.0,201.0,93.85,100.25,96.5,98.35,43,17,26,0.395,47,15,32,0.319,11,6,7,8,187.0,184.92,185.95999999999998
2013-02-02,1610612749,1610612753,2012,107.0,98.0,205.0,99.95,99.9,97.25,105.5,45,24,21,0.5329999999999999,46,14,32,0.304,12,12,8,6,196.4,195.72,196.06
2013-02-02,1610612759,1610612764,2012,96.0,86.0,182.0,103.0,95.65,93.6,94.05,48,37,11,0.7709999999999999,45,11,34,0.244,21,16,8,3,196.6,191.48,194.04
2013-02-02,1610612757,1610612762,2012,105.0,99.0,204.0,95.3,98.05,96.7,99.05,46,23,23,0.5,47,26,21,0.5529999999999999,16,7,17,9,197.44,195.48,196.45999999999998
2013-02-02,1610612744,1610612756,2012,113.0,93.0,206.0,101.6,101.15,92.3,98.2,46,29,17,0.63,47,16,31,0.34,15,14,12,4,195.12,189.96,192.54000000000002
2013-02-01,1610612761,1610612746,2012,98.0,73.0,171.0,99.7,98.8,100.55,95.5,46,16,30,0.348,47,34,13,0.723,11,5,20,14,195.68,195.76,195.72
2013-02-01,1610612754,1610612748,2012,102.0,89.0,191.0,92.2,88.95,101.55,93.65,46,27,19,0.5870000000000001,42,29,13,0.69,17,10,18,11,183.12,201.2,192.16
2013-02-01,1610612738,1610612753,2012,97.0,84.0,181.0,92.35,94.2,98.4,105.55,45,22,23,0.489,45,14,31,0.311,15,7,8,6,188.6,195.72,192.16
2013-02-01,1610612751,1610612741,2012,93.0,89.0,182.0,96.55,95.65,93.55,90.2,46,27,19,0.5870000000000001,45,28,17,0.622,17,10,15,13,191.8,180.24,186.02
2013-02-01,1610612752,1610612749,2012,96.0,86.0,182.0,97.25,96.25,100.6,99.8,43,28,15,0.6509999999999999,44,24,20,0.545,16,12,12,12,195.72,196.4,196.06
2013-02-01,1610612755,1610612758,2012,89.0,80.0,169.0,93.8,97.5,98.35,104.5,45,19,26,0.422,47,17,30,0.362,13,6,12,5,192.64,204.32,198.48
2013-02-01,1610612765,1610612739,2012,117.0,99.0,216.0,96.5,98.6,97.25,102.05,46,17,29,0.37,46,13,33,0.28300000000000003,12,5,6,7,190.76,193.92,192.33999999999997
2013-02-01,1610612763,1610612764,2012,85.0,76.0,161.0,90.05000000000003,89.05,93.2,94.8,45,29,16,0.644,44,11,33,0.25,17,12,8,3,181.04,191.48,186.26
2013-02-01,1610612743,1610612740,2012,113.0,98.0,211.0,106.5,101.6,96.5,97.45,47,29,18,0.617,46,15,31,0.326,19,10,7,8,206.76,184.92,195.83999999999997
2013-02-01,1610612762,1610612757,2012,86.0,77.0,163.0,96.55,99.9,96.05,98.7,46,25,21,0.5429999999999999,45,23,22,0.511,16,9,16,7,195.68,197.44,196.56
2013-02-01,1610612756,1610612742,2012,99.0,109.0,208.0,93.4,97.95,101.95,105.35,46,16,30,0.348,46,19,27,0.413,12,4,12,7,189.28,202.36,195.82
2013-02-01,1610612750,1610612747,2012,100.0,111.0,211.0,94.55,100.0,103.05,103.2,42,17,25,0.405,46,20,26,0.435,11,6,15,5,185.56,199.16,192.36
2013-01-31,1610612760,1610612763,2012,106.0,89.0,195.0,105.7,98.25,90.4,89.8,45,34,11,0.7559999999999999,44,29,15,0.659,19,15,17,12,202.76,181.04,191.89999999999998
2013-01-31,1610612744,1610612742,2012,100.0,97.0,197.0,102.35,101.3,101.2,104.95,45,28,17,0.622,45,19,26,0.422,14,14,12,7,194.68,202.36,198.52
2013-01-30,1610612755,1610612764,2012,92.0,84.0,176.0,93.65,98.1,93.15,94.7,44,18,26,0.409,43,11,32,0.256,12,6,8,3,194.08,191.48,192.78
2013-01-30,1610612754,1610612765,2012,98.0,79.0,177.0,92.05,89.25,97.75,98.55,45,26,19,0.578,45,17,28,0.378,16,10,12,5,182.8,190.76,186.78
2013-01-30,1610612738,1610612758,2012,99.0,81.0,180.0,92.1,95.1,98.85,105.0,44,21,23,0.477,46,17,29,0.37,14,7,12,5,189.68,204.32,197.0
2013-01-30,1610612752,1610612753,2012,113.0,97.0,210.0,96.6,95.7,98.45,104.4,42,27,15,0.643,44,14,30,0.318,15,12,8,6,196.44,195.72,196.07999999999998
2013-01-30,1610612737,1610612761,2012,93.0,92.0,185.0,96.95,98.05,99.25,99.25,44,25,19,0.568,45,16,29,0.35600000000000004,15,10,11,5,196.08,195.68,195.88
2013-01-30,1610612751,1610612748,2012,85.0,105.0,190.0,97.05,95.0,101.25,94.85,45,27,18,0.6,41,28,13,0.6829999999999999,17,10,18,10,191.88,201.2,196.54
2013-01-30,1610612749,1610612741,2012,88.0,104.0,192.0,101.1,99.25,93.15,90.25,43,24,19,0.5579999999999999,44,27,17,0.614,12,12,15,12,196.68,180.24,188.46
2013-01-30,1610612750,1610612746,2012,90.0,96.0,186.0,95.45,100.45,100.9,94.85,41,17,24,0.415,46,33,13,0.7170000000000001,11,6,20,13,187.12,195.76,191.44
2013-01-30,1610612759,1610612766,2012,102.0,78.0,180.0,102.9,95.75,93.1,101.25,47,36,11,0.7659999999999999,44,11,33,0.25,20,16,6,5,197.4,198.76,198.07999999999998
2013-01-30,1610612743,1610612745,2012,118.0,110.0,228.0,105.45,101.15,104.85,100.4,46,28,18,0.609,47,25,22,0.532,18,10,15,10,204.84,212.72,208.78
2013-01-30,1610612762,1610612740,2012,104.0,99.0,203.0,95.65,99.9,96.4,96.95,45,24,21,0.5329999999999999,45,15,30,0.333,15,9,7,8,195.24,184.92,190.07999999999998
2013-01-30,1610612756,1610612747,2012,92.0,86.0,178.0,93.85,98.15,103.85,103.4,45,15,30,0.333,45,20,25,0.444,11,4,15,5,190.04,199.16,194.6
2013-01-29,1610612739,1610612744,2012,95.0,108.0,203.0,97.5,101.35,102.7,101.2,45,13,32,0.289,44,27,17,0.614,6,7,14,13,193.4,194.68,194.04000000000002
2013-01-29,1610612765,1610612749,2012,90.0,117.0,207.0,98.25,96.1,99.25,99.25,44,17,27,0.386,42,23,19,0.5479999999999999,12,5,12,11,189.08,196.68,192.88
2013-01-29,1610612757,1610612742,2012,106.0,104.0,210.0,96.2,98.05,101.3,105.35,44,22,22,0.5,44,19,25,0.4320000000000001,15,7,12,7,196.96,202.36,199.66000000000003
2013-01-29,1610612747,1610612740,2012,111.0,106.0,217.0,103.3,102.8,95.8,96.35,44,19,25,0.4320000000000001,44,15,29,0.341,14,5,7,8,197.52,184.92,191.22
2013-01-28,1610612761,1610612744,2012,102.0,114.0,216.0,98.8,98.05,101.25,101.05,44,16,28,0.364,43,26,17,0.605,11,5,14,12,193.32,194.68,194.0
2013-01-28,1610612755,1610612763,2012,100.0,103.0,203.0,93.85,97.8,90.2,89.1,43,18,25,0.419,43,28,15,0.6509999999999999,12,6,17,11,193.24,181.04,187.14
2013-01-28,1610612764,1610612758,2012,94.0,96.0,190.0,92.8,94.7,98.3,105.15,42,11,31,0.262,45,16,29,0.35600000000000004,8,3,12,4,193.2,204.32,198.76
2013-01-28,1610612751,1610612753,2012,97.0,77.0,174.0,96.7,95.75,98.7,104.1,44,26,18,0.591,43,14,29,0.326,16,10,8,6,193.0,195.72,194.36
2013-01-28,1610612741,1610612766,2012,93.0,85.0,178.0,92.85,89.85,94.05,102.65,43,26,17,0.605,43,11,32,0.256,14,12,6,5,180.32,198.76,189.54
2013-01-28,1610612743,1610612754,2012,102.0,101.0,203.0,104.95,100.0,91.95,88.6,45,27,18,0.6,44,26,18,0.591,17,10,16,10,204.04,182.8,193.42000000000002
2013-01-28,1610612762,1610612745,2012,80.0,125.0,205.0,96.6,98.45,104.35,101.45,44,24,20,0.545,46,24,22,0.522,15,9,15,9,194.64,212.72,203.68
2013-01-27,1610612738,1610612748,2012,100.0,98.0,198.0,92.25,94.75,101.6,94.45,43,20,23,0.465,40,28,12,0.7,13,7,18,10,189.48,201.2,195.33999999999997
2013-01-27,1610612747,1610612760,2012,105.0,96.0,201.0,103.1,103.0,106.1,97.6,43,18,25,0.419,44,34,10,0.773,13,5,19,15,197.12,202.76,199.94
2013-01-27,1610612753,1610612765,2012,102.0,104.0,206.0,98.25,103.75,96.9,95.6,42,14,28,0.333,43,16,27,0.3720000000000001,8,6,12,4,195.64,189.08,192.36
2013-01-27,1610612763,1610612740,2012,83.0,91.0,174.0,90.65,88.65,95.1,96.85,42,28,14,0.667,43,14,29,0.326,17,11,7,7,182.68,184.92,183.8
2013-01-27,1610612752,1610612737,2012,106.0,104.0,210.0,96.1,95.95,96.85,97.45,41,26,15,0.634,43,25,18,0.581,14,12,15,10,195.16,196.08,195.62
2013-01-27,1610612742,1610612756,2012,110.0,95.0,205.0,101.15,105.6,93.75,97.45,43,18,25,0.419,44,15,29,0.341,11,7,11,4,202.16,190.04,196.1
2013-01-27,1610612746,1610612757,2012,96.0,83.0,179.0,100.95,94.95,97.95,98.85,45,32,13,0.711,43,22,21,0.512,19,13,15,7,196.12,196.96,196.54000000000002
2013-01-26,1610612761,1610612739,2012,98.0,99.0,197.0,98.75,97.65,97.25,100.55,43,16,27,0.3720000000000001,44,12,32,0.273,11,5,6,6,192.04,193.4,192.72
2013-01-26,1610612755,1610612752,2012,97.0,80.0,177.0,93.75,98.5,97.7,95.7,42,17,25,0.405,40,26,14,0.65,11,6,14,12,194.68,195.16,194.92000000000002
2013-01-26,1610612764,1610612741,2012,86.0,73.0,159.0,93.25,96.05,94.6,90.75,41,10,31,0.244,42,26,16,0.619,7,3,14,12,194.32,180.32,187.32
2013-01-26,1610612766,1610612750,2012,102.0,101.0,203.0,93.65,102.6,95.0,100.5,42,10,32,0.238,40,17,23,0.425,5,5,11,6,198.24,187.12,192.68
2013-01-26,1610612745,1610612751,2012,119.0,106.0,225.0,103.35,100.8,95.7,94.8,45,23,22,0.511,43,26,17,0.605,14,9,16,10,210.52,193.0,201.76
2013-01-26,1610612749,1610612744,2012,109.0,102.0,211.0,98.05,99.7,101.0,100.35,41,22,19,0.537,42,26,16,0.619,11,11,14,12,195.24,194.68,194.96
2013-01-26,1610612759,1610612756,2012,108.0,99.0,207.0,103.95,95.35,93.75,97.9,46,35,11,0.7609999999999999,43,15,28,0.349,19,16,11,4,197.56,190.04,193.8
2013-01-26,1610612743,1610612758,2012,121.0,93.0,214.0,105.2,101.05,98.15,104.15,44,26,18,0.591,44,16,28,0.364,16,10,12,4,202.48,204.32,203.39999999999998
2013-01-26,1610612762,1610612754,2012,114.0,110.0,224.0,97.45,97.9,91.1,87.8,43,23,20,0.535,43,26,17,0.605,14,9,16,10,193.2,182.8,188.0
2013-01-26,1610612757,1610612746,2012,101.0,100.0,201.0,97.7,98.5,100.35,93.7,42,21,21,0.5,44,32,12,0.727,14,7,19,13,196.0,196.12,196.06
2013-01-25,1610612764,1610612750,2012,114.0,101.0,215.0,92.35,96.1,94.6,99.9,40,9,31,0.225,39,17,22,0.436,6,3,11,6,192.84,187.12,189.98000000000002
2013-01-25,1610612737,1610612738,2012,123.0,111.0,234.0,95.35,97.65,91.1,93.75,42,24,18,0.5710000000000001,42,20,22,0.476,14,10,13,7,193.64,189.48,191.56
2013-01-25,1610612748,1610612765,2012,110.0,88.0,198.0,101.15,94.65,96.4,94.6,39,27,12,0.6920000000000001,42,16,26,0.381,17,10,12,4,200.8,189.08,194.94
2013-01-25,1610612739,1610612749,2012,113.0,108.0,221.0,96.45,100.35,97.15,98.35,43,11,32,0.256,40,22,18,0.55,5,6,11,11,191.92,195.24,193.57999999999998
2013-01-25,1610612741,1610612744,2012,103.0,87.0,190.0,94.3,92.4,101.85,100.0,41,25,16,0.61,41,26,15,0.634,13,12,14,12,180.2,194.68,187.44
2013-01-25,1610612763,1610612751,2012,101.0,77.0,178.0,90.1,88.8,95.95,93.9,41,27,14,0.659,42,26,16,0.619,16,11,16,10,184.04,193.0,188.51999999999998
2013-01-25,1610612740,1610612745,2012,82.0,100.0,182.0,94.5,95.7,104.15,102.8,42,14,28,0.333,44,22,22,0.5,7,7,14,8,185.8,210.52,198.16000000000003
2013-01-25,1610612742,1610612759,2012,107.0,113.0,220.0,101.75,104.75,102.8,94.9,42,18,24,0.429,45,34,11,0.7559999999999999,11,7,19,15,200.32,197.56,198.94
2013-01-25,1610612758,1610612760,2012,95.0,105.0,200.0,99.95,105.25,107.05,97.55,43,16,27,0.3720000000000001,43,33,10,0.767,12,4,19,14,205.0,202.76,203.88
2013-01-25,1610612747,1610612762,2012,102.0,84.0,186.0,103.5,104.65,97.85,97.3,42,17,25,0.405,42,23,19,0.5479999999999999,12,5,14,9,197.72,193.2,195.45999999999998
2013-01-24,1610612753,1610612761,2012,95.0,97.0,192.0,98.0,103.05,98.85,99.45,41,14,27,0.341,42,15,27,0.35700000000000004,8,6,11,4,196.28,192.04,194.16
2013-01-24,1610612738,1610612752,2012,86.0,89.0,175.0,92.65,95.05,98.25,96.3,41,20,21,0.488,39,25,14,0.6409999999999999,13,7,14,11,190.2,195.16,192.68
2013-01-24,1610612756,1610612746,2012,93.0,88.0,181.0,94.05,97.7,101.5,93.3,42,14,28,0.333,43,32,11,0.7440000000000001,10,4,19,13,191.44,196.12,193.78
2013-01-23,1610612741,1610612765,2012,85.0,82.0,167.0,95.05,92.75,97.3,96.4,40,24,16,0.6,41,16,25,0.39,12,12,12,4,180.84,189.08,184.96
2013-01-23,1610612766,1610612737,2012,92.0,104.0,196.0,93.85,102.6,94.15,98.0,41,10,31,0.244,41,23,18,0.561,5,5,14,9,197.48,193.64,195.56
2013-01-23,1610612758,1610612756,2012,96.0,106.0,202.0,100.0,106.05,93.65,98.3,42,16,26,0.381,41,13,28,0.317,12,4,10,3,204.84,191.44,198.14
2013-01-23,1610612748,1610612761,2012,123.0,116.0,239.0,100.3,93.35,98.05,98.65,38,26,12,0.684,41,15,26,0.366,16,10,11,4,200.32,192.04,196.18
2013-01-23,1610612757,1610612754,2012,100.0,80.0,180.0,97.75,99.15,91.5,86.65,41,20,21,0.488,42,26,16,0.619,13,7,16,10,196.92,182.8,189.86
2013-01-23,1610612763,1610612747,2012,106.0,93.0,199.0,88.8,87.69999999999997,104.2,105.15,40,26,14,0.65,41,17,24,0.415,15,11,12,5,182.24,197.72,189.98000000000002
2013-01-23,1610612745,1610612743,2012,95.0,105.0,200.0,105.7,104.25,105.25,101.9,43,22,21,0.512,43,25,18,0.581,14,8,16,9,211.0,202.48,206.74
2013-01-23,1610612744,1610612760,2012,104.0,99.0,203.0,101.8,99.85,106.95,97.5,40,25,15,0.625,42,33,9,0.7859999999999999,13,12,19,14,195.32,202.76,199.04
2013-01-23,1610612750,1610612751,2012,83.0,91.0,174.0,95.0,99.0,96.1,94.15,38,17,21,0.447,41,25,16,0.61,11,6,16,9,187.24,193.0,190.12
2013-01-23,1610612759,1610612740,2012,106.0,102.0,208.0,102.45,94.5,94.2,95.55,44,33,11,0.75,41,14,27,0.341,18,15,7,7,198.48,185.8,192.14
2013-01-23,1610612762,1610612764,2012,92.0,88.0,180.0,97.6,96.95,91.55,96.6,41,22,19,0.537,39,9,30,0.231,13,9,6,3,194.96,192.84,193.9
2013-01-22,1610612746,1610612760,2012,97.0,109.0,206.0,101.3,91.7,106.15,97.6,42,32,10,0.762,41,32,9,0.78,19,13,19,13,194.24,202.76,198.5
2013-01-22,1610612739,1610612738,2012,95.0,90.0,185.0,95.95,100.6,92.6,95.35,42,10,32,0.238,40,20,20,0.5,4,6,13,7,192.6,190.2,191.39999999999998
2013-01-22,1610612749,1610612755,2012,110.0,102.0,212.0,96.55,97.5,93.8,99.25,39,21,18,0.5379999999999999,41,17,24,0.415,10,11,11,6,193.88,194.68,194.28
2013-01-22,1610612765,1610612753,2012,105.0,90.0,195.0,95.85,96.3,97.55,102.15,40,15,25,0.375,40,14,26,0.35,11,4,8,6,189.2,196.28,192.74
2013-01-21,1610612763,1610612754,2012,81.0,82.0,163.0,88.9,88.25,92.05,87.8,39,26,13,0.667,41,25,16,0.61,15,11,16,9,182.6,182.8,182.7
2013-01-21,1610612740,1610612758,2012,114.0,105.0,219.0,92.95,95.1,99.9,106.0,40,13,27,0.325,41,16,25,0.39,6,7,12,4,183.56,204.84,194.2
2013-01-21,1610612766,1610612745,2012,94.0,100.0,194.0,94.25,104.2,105.05,103.75,40,10,30,0.25,42,21,21,0.5,5,5,14,7,197.24,211.0,204.12
2013-01-21,1610612737,1610612750,2012,104.0,96.0,200.0,94.6,97.7,95.85,98.9,40,22,18,0.55,37,17,20,0.459,13,9,11,6,192.32,187.24,189.78
2013-01-21,1610612752,1610612751,2012,85.0,88.0,173.0,99.15,97.0,96.15,95.0,38,25,13,0.6579999999999999,40,24,16,0.6,14,11,16,8,194.96,193.0,193.98000000000002
2013-01-21,1610612744,1610612746,2012,106.0,99.0,205.0,101.2,100.0,101.35,91.1,39,24,15,0.615,41,32,9,0.78,12,12,19,13,195.72,194.24,194.98000000000002
2013-01-21,1610612755,1610612759,2012,85.0,90.0,175.0,93.95,100.0,102.75,95.2,40,17,23,0.425,43,32,11,0.7440000000000001,11,6,18,14,193.96,198.48,196.22
2013-01-21,1610612741,1610612747,2012,95.0,83.0,178.0,94.45,92.7,104.75,105.4,39,23,16,0.59,40,17,23,0.425,11,12,12,5,180.64,197.72,189.18
2013-01-21,1610612757,1610612764,2012,95.0,98.0,193.0,97.75,98.95,91.3,96.8,40,20,20,0.5,38,8,30,0.211,13,7,6,2,196.84,192.84,194.84
2013-01-20,1610612761,1610612747,2012,108.0,103.0,211.0,97.8,98.3,105.0,105.7,40,14,26,0.35,39,17,22,0.436,10,4,12,5,191.44,197.72,194.57999999999998
2013-01-20,1610612753,1610612742,2012,105.0,111.0,216.0,97.4,101.25,99.9,104.25,39,14,25,0.359,41,17,24,0.415,8,6,11,6,195.52,200.32,197.92000000000002
2013-01-20,1610612765,1610612738,2012,103.0,88.0,191.0,94.55,96.3,92.9,94.95,39,14,25,0.359,39,20,19,0.513,10,4,13,7,189.56,190.2,189.88
2013-01-20,1610612743,1610612760,2012,121.0,118.0,239.0,104.7,100.4,105.25,96.15,42,24,18,0.5710000000000001,40,32,8,0.8,15,9,19,13,201.0,202.76,201.88
2013-01-19,1610612766,1610612758,2012,93.0,97.0,190.0,94.5,104.35,99.3,106.25,39,10,29,0.256,40,15,25,0.375,5,5,12,3,197.16,204.84,201.0
2013-01-19,1610612737,1610612759,2012,93.0,98.0,191.0,95.15,97.55,104.55,96.85,39,22,17,0.564,42,31,11,0.738,13,9,18,13,190.96,198.48,194.72
2013-01-19,1610612741,1610612763,2012,82.0,85.0,167.0,94.8,93.15,89.35,89.1,38,23,15,0.605,38,25,13,0.6579999999999999,11,12,15,10,181.72,182.6,182.16
2013-01-19,1610612740,1610612744,2012,112.0,116.0,228.0,91.7,94.45,100.45,99.25,39,13,26,0.333,38,23,15,0.605,6,7,12,11,181.68,195.72,188.7
2013-01-19,1610612750,1610612745,2012,92.0,79.0,171.0,96.0,99.2,107.1,104.0,36,16,20,0.444,41,21,20,0.512,10,6,14,7,188.56,211.0,199.78
2013-01-19,1610612762,1610612739,2012,109.0,98.0,207.0,97.35,97.3,95.6,100.3,40,21,19,0.525,41,10,31,0.244,12,9,4,6,196.44,192.6,194.51999999999998
2013-01-19,1610612757,1610612749,2012,104.0,110.0,214.0,97.45,97.95,95.9,96.7,39,20,19,0.513,38,20,18,0.526,13,7,10,10,197.4,193.88,195.64
2013-01-19,1610612746,1610612764,2012,94.0,87.0,181.0,101.75,90.9,90.8,95.6,40,31,9,0.775,37,8,29,0.21600000000000005,18,13,6,2,194.6,192.84,193.72
2013-01-18,1610612738,1610612741,2012,99.0,100.0,199.0,92.55,93.9,94.55,92.45,38,20,18,0.526,37,22,15,0.595,13,7,11,11,189.32,181.72,185.51999999999998
2013-01-18,1610612755,1610612761,2012,108.0,101.0,209.0,93.55,99.85,98.25,98.55,39,16,23,0.41,39,14,25,0.359,10,6,10,4,192.6,191.44,192.01999999999998
2013-01-18,1610612753,1610612766,2012,100.0,106.0,206.0,97.35,100.2,94.2,104.4,38,14,24,0.368,38,9,29,0.237,8,6,5,4,195.28,197.16,196.22
2013-01-18,1610612754,1610612745,2012,105.0,95.0,200.0,91.6,87.1,107.8,103.55,40,24,16,0.6,40,21,19,0.525,15,9,14,7,182.48,211.0,196.74
2013-01-18,1610612751,1610612737,2012,94.0,89.0,183.0,96.8,95.8,95.7,97.6,39,23,16,0.59,38,22,16,0.579,15,8,13,9,193.68,190.96,192.32
2013-01-18,1610612763,1610612758,2012,85.0,69.0,154.0,90.5,90.55,100.65,107.95,37,24,13,0.649,39,15,24,0.385,14,10,12,3,184.56,204.84,194.7
2013-01-18,1610612759,1610612744,2012,95.0,88.0,183.0,104.95,96.85,101.5,99.6,41,30,11,0.732,37,23,14,0.622,17,13,12,11,199.12,195.72,197.42000000000002
2013-01-18,1610612743,1610612764,2012,108.0,112.0,220.0,104.9,100.1,89.94999999999997,95.4,41,24,17,0.585,36,7,29,0.194,15,9,6,1,199.68,192.84,196.26
2013-01-18,1610612742,1610612760,2012,114.0,117.0,231.0,98.8,102.25,105.25,96.0,40,17,23,0.425,39,31,8,0.795,11,6,19,12,199.0,202.76,200.88
2013-01-17,1610612765,1610612752,2012,87.0,102.0,189.0,94.9,96.25,99.15,97.05,38,14,24,0.368,37,24,13,0.649,10,4,14,10,189.76,194.96,192.36
2013-01-17,1610612750,1610612746,2012,77.0,90.0,167.0,96.85,99.75,101.95,91.5,35,16,19,0.457,39,30,9,0.769,10,6,18,12,189.52,194.6,192.06
2013-01-17,1610612756,1610612749,2012,94.0,98.0,192.0,93.05,97.4,95.95,97.5,40,13,27,0.325,37,19,18,0.514,10,3,10,9,192.76,193.88,193.32
2013-01-17,1610612747,1610612748,2012,90.0,99.0,189.0,105.65,106.4,100.85,93.6,38,17,21,0.447,37,25,12,0.6759999999999999,12,5,16,9,197.92,200.32,199.12
2013-01-16,1610612761,1610612741,2012,105.0,107.0,212.0,97.75,96.9,93.85,91.5,38,14,24,0.368,36,21,15,0.583,10,4,11,10,189.48,181.72,185.6
2013-01-16,1610612753,1610612754,2012,97.0,86.0,183.0,96.5,100.2,91.3,86.05,37,13,24,0.35100000000000003,39,24,15,0.615,7,6,15,9,194.8,182.48,188.64
2013-01-16,1610612737,1610612751,2012,109.0,95.0,204.0,95.65,98.05,96.95,94.65,37,21,16,0.568,38,23,15,0.605,12,9,15,8,190.6,193.68,192.14
2013-01-16,1610612738,1610612740,2012,78.0,90.0,168.0,93.85,94.1,91.9,95.3,37,20,17,0.541,38,12,26,0.316,13,7,6,6,189.96,181.68,185.82
2013-01-16,1610612760,1610612743,2012,117.0,97.0,214.0,105.1,96.55,104.65,98.7,38,30,8,0.789,40,24,16,0.6,18,12,15,9,202.92,199.68,201.3
2013-01-16,1610612742,1610612745,2012,105.0,100.0,205.0,98.0,103.0,107.6,103.45,39,16,23,0.41,39,21,18,0.5379999999999999,10,6,14,7,199.88,211.0,205.44
2013-01-16,1610612759,1610612763,2012,103.0,82.0,185.0,105.5,97.35,90.4,89.5,40,29,11,0.725,36,24,12,0.667,16,13,14,10,199.44,184.56,192.0
2013-01-16,1610612758,1610612764,2012,95.0,94.0,189.0,100.45,107.35,89.6,96.05,38,14,24,0.368,35,7,28,0.2,11,3,6,1,205.64,192.84,199.24
2013-01-16,1610612757,1610612739,2012,88.0,93.0,181.0,97.65,97.0,96.05,101.05,38,20,18,0.526,40,9,31,0.225,13,7,4,5,197.48,192.6,195.04
2013-01-16,1610612744,1610612748,2012,75.0,92.0,167.0,102.9,99.6,101.3,95.1,36,23,13,0.639,36,24,12,0.667,12,11,16,8,197.4,200.32,198.86
2013-01-15,1610612755,1610612740,2012,99.0,111.0,210.0,93.8,99.35,90.75,94.95,38,16,22,0.421,37,11,26,0.297,10,6,6,5,192.12,181.68,186.9
2013-01-15,1610612766,1610612754,2012,76.0,103.0,179.0,96.0,105.15,90.75,87.4,37,9,28,0.243,38,23,15,0.605,5,4,15,8,198.08,182.48,190.28
2013-01-15,1610612751,1610612761,2012,113.0,106.0,219.0,96.15,94.35,96.55,96.4,37,22,15,0.595,37,14,23,0.378,14,8,10,4,192.36,189.48,190.92000000000002
2013-01-15,1610612745,1610612746,2012,109.0,117.0,226.0,107.6,103.4,101.35,91.25,38,21,17,0.5529999999999999,38,29,9,0.763,14,7,18,11,208.4,194.6,201.5
2013-01-15,1610612743,1610612757,2012,115.0,111.0,226.0,103.85,97.85,98.0,97.1,39,23,16,0.59,37,20,17,0.541,14,9,13,7,199.44,197.48,198.45999999999998
2013-01-15,1610612747,1610612749,2012,104.0,88.0,192.0,106.55,107.15,95.6,97.4,37,16,21,0.4320000000000001,36,19,17,0.528,11,5,10,9,197.64,193.88,195.76
2013-01-14,1610612764,1610612753,2012,120.0,91.0,211.0,88.45,96.55,97.05,98.9,34,6,28,0.17600000000000002,36,13,23,0.361,5,1,7,6,192.6,194.8,193.7
2013-01-14,1610612738,1610612766,2012,100.0,89.0,189.0,93.65,93.55,96.05,105.8,36,19,17,0.528,36,9,27,0.25,12,7,5,4,190.08,198.08,194.08
2013-01-14,1610612741,1610612737,2012,97.0,58.0,155.0,93.65,92.85,97.05,97.2,35,20,15,0.5710000000000001,36,21,15,0.583,10,10,12,9,182.28,190.6,186.44
2013-01-14,1610612763,1610612746,2012,73.0,99.0,172.0,91.25,88.45,101.05,92.8,35,24,11,0.6859999999999999,37,28,9,0.757,14,10,18,10,185.56,194.6,190.07999999999998
2013-01-14,1610612742,1610612750,2012,113.0,98.0,211.0,98.05,103.65,96.65,99.3,38,15,23,0.395,34,16,18,0.471,9,6,10,6,199.84,189.52,194.68
2013-01-14,1610612762,1610612748,2012,104.0,97.0,201.0,97.4,97.6,101.3,94.3,39,20,19,0.513,35,24,11,0.6859999999999999,11,9,16,8,195.4,200.32,197.86
2013-01-14,1610612756,1610612760,2012,90.0,102.0,192.0,93.05,97.2,105.0,96.0,39,13,26,0.333,37,29,8,0.784,10,3,18,11,192.4,202.92,197.66
2013-01-14,1610612758,1610612739,2012,124.0,118.0,242.0,99.6,106.45,94.2,99.65,37,13,24,0.35100000000000003,39,9,30,0.231,10,3,4,5,203.76,192.6,198.18
2013-01-13,1610612752,1610612740,2012,100.0,87.0,187.0,99.95,98.05,90.9,95.25,36,23,13,0.639,36,11,25,0.306,13,10,6,5,195.44,181.68,188.56
2013-01-13,1610612761,1610612749,2012,96.0,107.0,203.0,96.15,95.75,94.5,97.35,36,14,22,0.389,35,18,17,0.514,10,4,10,8,188.08,193.88,190.98000000000002
2013-01-13,1610612751,1610612754,2012,97.0,86.0,183.0,95.7,94.9,91.3,87.15,36,21,15,0.583,37,23,14,0.622,13,8,15,8,192.72,182.48,187.6
2013-01-13,1610612759,1610612750,2012,106.0,88.0,194.0,105.7,97.9,97.5,98.4,39,28,11,0.718,33,16,17,0.485,15,13,10,6,199.68,189.52,194.60000000000002
2013-01-13,1610612743,1610612744,2012,116.0,105.0,221.0,103.7,98.1,102.85,98.65,38,22,16,0.579,35,23,12,0.657,13,9,12,11,198.88,197.4,198.14
2013-01-13,1610612757,1610612760,2012,83.0,87.0,170.0,97.85,97.7,106.45,97.3,36,20,16,0.556,36,28,8,0.778,13,7,18,10,198.24,202.92,200.57999999999998
2013-01-13,1610612747,1610612739,2012,113.0,93.0,206.0,104.75,106.45,93.2,98.55,36,15,21,0.417,38,9,29,0.237,10,5,4,5,196.12,192.6,194.36
2013-01-12,1610612746,1610612753,2012,101.0,104.0,205.0,101.85,92.55,97.5,99.0,36,28,8,0.778,35,12,23,0.343,18,10,7,5,193.36,194.8,194.08
2013-01-12,1610612764,1610612737,2012,93.0,83.0,176.0,89.05000000000003,97.45,97.5,97.6,33,5,28,0.152,35,21,14,0.6,4,1,12,9,193.96,190.6,192.28
2013-01-12,1610612754,1610612766,2012,96.0,88.0,184.0,90.95,87.35,96.3,106.4,36,22,14,0.611,35,9,26,0.257,14,8,5,4,181.96,198.08,190.02
2013-01-12,1610612755,1610612745,2012,107.0,100.0,207.0,93.9,100.15,107.2,103.75,37,15,22,0.405,37,21,16,0.568,9,6,14,7,190.12,208.4,199.26
2013-01-12,1610612765,1610612762,2012,87.0,90.0,177.0,95.75,97.15,97.1,98.2,37,14,23,0.378,38,19,19,0.5,10,4,11,8,188.64,195.4,192.01999999999998
2013-01-12,1610612741,1610612756,2012,81.0,97.0,178.0,93.4,92.0,93.15,98.45,34,20,14,0.588,38,12,26,0.316,10,10,10,2,182.36,192.4,187.38
2013-01-12,1610612742,1610612763,2012,104.0,83.0,187.0,97.9,104.75,91.9,87.7,37,14,23,0.378,34,24,10,0.706,8,6,14,10,200.2,185.56,192.88
2013-01-12,1610612758,1610612748,2012,99.0,128.0,227.0,99.25,104.9,99.8,94.0,36,13,23,0.361,34,23,11,0.6759999999999999,10,3,16,7,203.84,200.32,202.07999999999998
2013-01-11,1610612761,1610612766,2012,99.0,78.0,177.0,96.25,96.7,96.95,106.15,35,13,22,0.371,34,9,25,0.265,9,4,5,4,187.56,198.08,192.82
2013-01-11,1610612738,1610612745,2012,103.0,91.0,194.0,92.65,93.75,107.55,104.6,35,18,17,0.514,36,21,15,0.583,11,7,14,7,188.72,208.4,198.56
2013-01-11,1610612751,1610612756,2012,99.0,79.0,178.0,95.85,96.4,94.05,98.55,35,20,15,0.5710000000000001,37,12,25,0.324,12,8,10,2,193.56,192.4,192.98000000000002
2013-01-11,1610612737,1610612762,2012,103.0,95.0,198.0,97.9,98.5,98.2,98.55,34,20,14,0.588,37,19,18,0.514,11,9,11,8,191.12,195.4,193.26
2013-01-11,1610612752,1610612741,2012,101.0,108.0,209.0,100.5,97.95,92.45,91.6,35,23,12,0.657,33,19,14,0.5760000000000001,13,10,10,9,193.72,182.36,188.04000000000002
2013-01-11,1610612763,1610612759,2012,101.0,98.0,199.0,92.0,86.9,107.4,97.95,33,23,10,0.6970000000000001,38,28,10,0.737,13,10,15,13,184.16,199.68,191.92000000000002
2013-01-11,1610612740,1610612750,2012,104.0,92.0,196.0,90.8,94.7,97.65,98.25,35,10,25,0.28600000000000003,32,16,16,0.5,5,5,10,6,181.88,189.52,185.7
2013-01-11,1610612749,1610612765,2012,87.0,103.0,190.0,95.55,96.85,94.3,97.3,34,18,16,0.529,36,13,23,0.361,10,8,10,3,194.32,188.64,191.48
2013-01-11,1610612743,1610612739,2012,98.0,91.0,189.0,103.9,97.75,92.6,98.1,37,21,16,0.568,37,9,28,0.243,12,9,4,5,199.48,192.6,196.04
2013-01-11,1610612747,1610612760,2012,101.0,116.0,217.0,104.45,105.15,105.65,97.65,35,15,20,0.429,35,27,8,0.7709999999999999,10,5,18,9,195.16,202.92,199.04
2013-01-11,1610612744,1610612757,2012,103.0,97.0,200.0,103.0,99.05,96.9,97.35,34,22,12,0.647,35,20,15,0.5710000000000001,11,11,13,7,197.48,198.24,197.86
2013-01-10,1610612754,1610612752,2012,81.0,76.0,157.0,91.85,88.15,101.15,98.7,35,21,14,0.6,34,23,11,0.6759999999999999,13,8,13,10,182.0,193.72,187.86
2013-01-10,1610612758,1610612742,2012,112.0,117.0,229.0,98.1,103.9,97.8,105.0,35,13,22,0.371,36,13,23,0.361,10,3,8,5,202.96,200.2,201.57999999999998
2013-01-10,1610612757,1610612748,2012,92.0,90.0,182.0,97.45,97.6,100.3,94.75,34,19,15,0.5589999999999999,33,23,10,0.6970000000000001,12,7,16,7,198.92,200.32,199.62
2013-01-09,1610612761,1610612755,2012,90.0,72.0,162.0,97.05,98.65,95.3,101.0,34,12,22,0.353,36,15,21,0.417,8,4,9,6,188.24,190.12,189.18
2013-01-09,1610612766,1610612762,2012,102.0,112.0,214.0,96.75,105.75,98.4,99.65,33,9,24,0.273,36,18,18,0.5,5,4,11,7,196.12,195.4,195.76
2013-01-09,1610612739,1610612737,2012,99.0,83.0,182.0,93.5,99.85,98.4,97.7,36,8,28,0.222,33,20,13,0.606,3,5,11,9,193.04,191.12,192.07999999999998
2013-01-09,1610612738,1610612756,2012,87.0,79.0,166.0,93.7,94.8,93.95,100.05,34,17,17,0.5,36,12,24,0.333,10,7,10,2,189.52,192.4,190.96
2013-01-09,1610612741,1610612749,2012,96.0,104.0,200.0,92.3,90.8,95.0,96.65,32,19,13,0.594,33,17,16,0.515,10,9,10,7,180.2,194.32,187.26
2013-01-09,1610612740,1610612745,2012,88.0,79.0,167.0,90.35,95.75,108.15,105.3,34,9,25,0.265,35,21,14,0.6,4,5,14,7,182.56,208.4,195.48000000000002
2013-01-09,1610612759,1610612747,2012,108.0,105.0,213.0,106.95,97.45,104.35,104.1,37,27,10,0.73,34,15,19,0.441,14,13,10,5,199.04,195.16,197.1
2013-01-09,1610612760,1610612750,2012,106.0,84.0,190.0,105.65,98.15,98.3,97.4,34,26,8,0.765,31,16,15,0.516,17,9,10,6,203.16,189.52,196.34
2013-01-09,1610612743,1610612753,2012,108.0,105.0,213.0,103.6,97.05,95.85,97.65,36,20,16,0.556,34,12,22,0.353,11,9,7,5,200.2,194.8,197.5
2013-01-09,1610612746,1610612742,2012,99.0,93.0,192.0,102.5,92.4,98.95,105.5,35,27,8,0.7709999999999999,35,13,22,0.371,17,10,8,5,194.08,200.2,197.14
2013-01-09,1610612744,1610612763,2012,87.0,94.0,181.0,103.45,98.6,92.05,87.5,33,22,11,0.667,32,22,10,0.688,11,11,13,9,197.8,184.16,190.98000000000002
2013-01-08,1610612755,1610612751,2012,89.0,109.0,198.0,96.15,100.45,95.15,96.1,35,15,20,0.429,34,19,15,0.5589999999999999,9,6,12,7,189.04,193.56,191.3
2013-01-08,1610612754,1610612748,2012,87.0,77.0,164.0,92.35,89.5,102.1,95.9,34,20,14,0.588,32,23,9,0.7190000000000001,12,8,16,7,182.6,200.32,191.45999999999998
2013-01-08,1610612749,1610612756,2012,108.0,99.0,207.0,94.15,96.1,93.55,98.55,32,16,16,0.5,35,12,23,0.343,9,7,10,2,194.2,192.4,193.3
2013-01-08,1610612745,1610612747,2012,125.0,112.0,237.0,107.25,104.95,104.0,103.2,34,20,14,0.588,33,15,18,0.455,13,7,10,5,206.72,195.16,200.94
2013-01-08,1610612750,1610612737,2012,108.0,103.0,211.0,97.8,97.55,98.3,96.85,30,15,15,0.5,32,20,12,0.625,9,6,11,9,188.24,191.12,189.68
2013-01-07,1610612764,1610612760,2012,101.0,99.0,200.0,88.2,96.6,106.2,97.85,32,4,28,0.125,33,26,7,0.7879999999999999,3,1,17,9,192.88,203.16,198.01999999999998
2013-01-07,1610612752,1610612738,2012,96.0,102.0,198.0,101.65,98.55,93.0,94.55,33,23,10,0.6970000000000001,33,16,17,0.485,13,10,10,6,193.56,189.52,191.54000000000002
2013-01-07,1610612741,1610612739,2012,118.0,92.0,210.0,91.45,90.1,94.55,99.5,31,18,13,0.581,35,8,27,0.229,9,9,3,5,179.84,193.04,186.44
2013-01-07,1610612740,1610612759,2012,95.0,88.0,183.0,89.8,96.15,107.55,97.95,33,8,25,0.242,36,27,9,0.75,3,5,14,13,182.8,199.04,190.92000000000002
2013-01-07,1610612762,1610612742,2012,100.0,94.0,194.0,98.6,100.05,99.1,105.2,35,17,18,0.486,34,13,21,0.382,10,7,8,5,195.72,200.2,197.95999999999998
2013-01-07,1610612758,1610612763,2012,81.0,113.0,194.0,99.45,103.1,91.1,87.8,34,13,21,0.382,31,21,10,0.677,10,3,13,8,202.84,184.16,193.5
2013-01-07,1610612757,1610612753,2012,125.0,119.0,244.0,96.3,96.35,94.2,96.25,33,18,15,0.545,33,12,21,0.364,11,7,7,5,198.16,194.8,196.48000000000002
2013-01-06,1610612761,1610612760,2012,92.0,104.0,196.0,97.3,97.75,105.6,97.75,33,12,21,0.364,32,25,7,0.7809999999999999,8,4,17,8,188.04,203.16,195.6
2013-01-06,1610612748,1610612764,2012,99.0,71.0,170.0,101.75,97.95,89.65,96.7,31,22,9,0.71,31,4,27,0.129,15,7,3,1,201.6,192.88,197.24
2013-01-06,1610612765,1610612766,2012,101.0,108.0,209.0,94.1,97.1,94.8,106.4,35,13,22,0.371,32,8,24,0.25,10,3,5,3,187.12,196.12,191.62
2013-01-06,1610612756,1610612763,2012,81.0,92.0,173.0,94.2,98.8,91.85,88.6,34,12,22,0.353,30,20,10,0.667,10,2,13,7,193.72,184.16,188.94
2013-01-06,1610612747,1610612743,2012,105.0,112.0,217.0,104.7,103.0,103.2,97.2,32,15,17,0.469,35,19,16,0.5429999999999999,10,5,11,8,194.6,200.2,197.39999999999998
2013-01-05,1610612737,1610612738,2012,81.0,89.0,170.0,98.95,96.95,94.35,96.0,31,20,11,0.645,32,15,17,0.469,11,9,10,5,193.32,189.52,191.42000000000002
2013-01-05,1610612753,1610612752,2012,106.0,114.0,220.0,93.2,95.45,101.1,99.8,32,12,20,0.375,32,22,10,0.688,7,5,13,9,193.88,193.56,193.72
2013-01-05,1610612754,1610612749,2012,95.0,80.0,175.0,93.35,90.85,95.45,97.0,33,19,14,0.5760000000000001,31,16,15,0.516,11,8,9,7,183.6,194.2,188.89999999999998
2013-01-05,1610612751,1610612758,2012,113.0,93.0,206.0,95.05,97.3,99.75,101.45,33,18,15,0.545,33,13,20,0.394,11,7,10,3,193.28,202.84,198.06
2013-01-05,1610612739,1610612745,2012,104.0,112.0,216.0,93.25,98.45,107.05,105.7,34,8,26,0.235,33,19,14,0.5760000000000001,3,5,13,6,193.0,206.72,199.86
2013-01-05,1610612750,1610612757,2012,97.0,102.0,199.0,97.3,96.9,95.3,95.7,29,15,14,0.517,32,17,15,0.531,9,6,11,6,188.96,198.16,193.56
2013-01-05,1610612742,1610612740,2012,96.0,99.0,195.0,99.65,105.3,90.1,96.25,33,13,20,0.394,32,7,25,0.219,8,5,3,4,199.6,182.8,191.2
2013-01-05,1610612759,1610612755,2012,109.0,86.0,195.0,106.45,98.25,96.1,99.75,35,26,9,0.743,34,15,19,0.441,13,13,9,6,199.12,189.04,194.07999999999998
2013-01-05,1610612743,1610612762,2012,110.0,91.0,201.0,102.35,97.55,98.75,99.85,34,18,16,0.529,34,17,17,0.5,10,8,10,7,200.44,195.72,198.07999999999998
2013-01-05,1610612746,1610612744,2012,115.0,89.0,204.0,102.55,92.0,103.55,97.95,34,26,8,0.765,32,22,10,0.688,16,10,11,11,193.96,197.8,195.88
2013-01-04,1610612761,1610612758,2012,96.0,105.0,201.0,99.15,99.5,98.55,102.45,32,12,20,0.375,32,12,20,0.375,8,4,10,2,188.56,202.84,195.7
2013-01-04,1610612764,1610612751,2012,113.0,115.0,228.0,88.6,96.85,93.95,96.75,30,4,26,0.133,32,17,15,0.531,3,1,11,6,190.0,193.28,191.64
2013-01-04,1610612766,1610612739,2012,104.0,106.0,210.0,94.15,106.15,91.85,97.45,31,8,23,0.258,33,7,26,0.212,5,3,3,4,194.44,193.0,193.72
2013-01-04,1610612765,1610612737,2012,85.0,84.0,169.0,94.3,96.85,100.35,97.5,34,12,22,0.353,30,20,10,0.667,9,3,11,9,188.08,193.32,190.7
2013-01-04,1610612748,1610612741,2012,89.0,96.0,185.0,102.4,97.6,91.35,90.75,30,22,8,0.733,30,17,13,0.5670000000000001,15,7,9,8,201.24,179.84,190.54000000000002
2013-01-04,1610612738,1610612754,2012,94.0,75.0,169.0,94.65,97.85,93.55,90.0,31,14,17,0.452,32,19,13,0.594,9,5,11,8,189.28,183.6,186.44
2013-01-04,1610612763,1610612757,2012,84.0,86.0,170.0,91.85,88.19999999999997,96.05,96.9,29,20,9,0.69,31,16,15,0.516,13,7,11,5,185.76,198.16,191.95999999999998
2013-01-04,1610612760,1610612755,2012,109.0,85.0,194.0,106.15,98.4,95.8,98.9,31,24,7,0.774,33,15,18,0.455,16,8,9,6,203.36,189.04,196.2
2013-01-04,1610612749,1610612745,2012,101.0,115.0,216.0,94.8,96.35,107.15,106.6,30,16,14,0.5329999999999999,32,18,14,0.563,9,7,13,5,194.28,206.72,200.5
2013-01-04,1610612756,1610612762,2012,80.0,87.0,167.0,95.75,99.85,99.2,100.05,33,12,21,0.364,33,16,17,0.485,10,2,10,6,196.32,195.72,196.01999999999998
2013-01-04,1610612746,1610612747,2012,107.0,102.0,209.0,102.25,91.65,105.35,102.1,33,25,8,0.758,31,15,16,0.484,15,10,10,5,192.88,194.6,193.74
2013-01-03,1610612752,1610612759,2012,100.0,83.0,183.0,101.5,100.0,107.8,97.7,31,21,10,0.677,34,26,8,0.765,12,9,13,13,193.0,199.12,196.06
2013-01-03,1610612743,1610612750,2012,97.0,101.0,198.0,102.7,96.7,96.5,96.85,33,18,15,0.545,28,14,14,0.5,10,8,9,5,200.08,188.96,194.52
2013-01-02,1610612761,1610612757,2012,102.0,79.0,181.0,98.2,100.2,96.35,96.7,31,11,20,0.355,30,16,14,0.5329999999999999,7,4,11,5,189.36,198.16,193.76
2013-01-02,1610612753,1610612741,2012,94.0,96.0,190.0,92.95,96.15,90.55,91.1,31,12,19,0.387,29,16,13,0.552,7,5,9,7,194.8,179.84,187.32
2013-01-02,1610612739,1610612758,2012,94.0,97.0,191.0,91.75,96.75,98.8,102.95,32,7,25,0.219,31,11,20,0.355,3,4,10,1,193.56,202.84,198.2
2013-01-02,1610612754,1610612764,2012,89.0,81.0,170.0,94.25,90.1,89.6,97.75,31,18,13,0.581,29,4,25,0.138,10,8,3,1,185.4,190.0,187.7
2013-01-02,1610612738,1610612763,2012,83.0,93.0,176.0,95.85,97.65,92.6,88.55,30,14,16,0.467,28,19,9,0.679,9,5,13,6,189.56,185.76,187.66
2013-01-02,1610612748,1610612742,2012,119.0,109.0,228.0,101.7,97.15,98.7,104.95,29,21,8,0.7240000000000001,32,13,19,0.406,14,7,8,5,199.68,199.6,199.64
2013-01-02,1610612749,1610612759,2012,110.0,117.0,227.0,93.6,95.15,107.85,96.8,29,16,13,0.552,33,25,8,0.758,9,7,13,12,193.12,199.12,196.12
2013-01-02,1610612745,1610612740,2012,104.0,92.0,196.0,108.15,107.8,89.69999999999997,96.15,31,17,14,0.5479999999999999,31,7,24,0.226,12,5,3,4,207.16,182.8,194.98000000000002
2013-01-02,1610612760,1610612751,2012,93.0,110.0,203.0,107.2,96.35,92.95,96.85,30,24,6,0.8,31,16,15,0.516,16,8,11,5,203.48,193.28,198.38
2013-01-02,1610612762,1610612750,2012,106.0,84.0,190.0,99.0,100.4,97.05,96.7,32,15,17,0.469,27,14,13,0.519,9,6,9,5,196.6,188.96,192.78
2013-01-02,1610612756,1610612755,2012,95.0,89.0,184.0,96.7,99.75,95.75,98.8,32,11,21,0.344,32,15,17,0.469,9,2,9,6,198.16,189.04,193.6
2013-01-02,1610612744,1610612746,2012,115.0,94.0,209.0,102.9,97.9,101.35,90.2,31,21,10,0.677,32,25,7,0.7809999999999999,10,11,15,10,197.64,192.88,195.26
2013-01-01,1610612764,1610612742,2012,94.0,103.0,197.0,90.2,98.0,97.45,105.3,28,4,24,0.14300000000000002,31,12,19,0.387,3,1,8,4,189.6,199.6,194.6
2013-01-01,1610612752,1610612757,2012,100.0,105.0,205.0,102.55,99.75,95.45,97.4,30,21,9,0.7,29,15,14,0.517,12,9,11,4,192.0,198.16,195.07999999999998
2013-01-01,1610612765,1610612758,2012,103.0,97.0,200.0,95.0,95.85,98.45,102.95,33,11,22,0.333,30,11,19,0.3670000000000001,8,3,10,1,187.84,202.84,195.34
2013-01-01,1610612740,1610612737,2012,86.0,95.0,181.0,89.4,96.5,100.0,97.8,30,7,23,0.233,29,19,10,0.655,3,4,11,8,183.0,193.32,188.16
2013-01-01,1610612743,1610612746,2012,92.0,78.0,170.0,103.55,97.65,103.0,91.45,32,17,15,0.531,31,25,6,0.8059999999999999,9,8,15,10,201.0,192.88,196.94
2013-01-01,1610612747,1610612755,2012,99.0,103.0,202.0,106.1,102.05,95.8,98.75,30,15,15,0.5,31,14,17,0.452,10,5,9,5,194.32,189.04,191.68
2012-12-31,1610612754,1610612763,2012,88.0,83.0,171.0,93.45,89.65,93.65,88.85,30,17,13,0.5670000000000001,27,19,8,0.7040000000000001,9,8,13,6,187.64,185.76,186.7
2012-12-31,1610612741,1610612766,2012,81.0,91.0,172.0,91.1,91.2,95.0,107.4,28,16,12,0.5710000000000001,30,7,23,0.233,9,7,5,2,180.72,194.44,187.57999999999998
2012-12-31,1610612753,1610612748,2012,110.0,112.0,222.0,92.95,96.35,100.4,96.85,30,12,18,0.4,28,20,8,0.7140000000000001,7,5,14,6,193.52,199.68,196.60000000000002
2012-12-31,1610612745,1610612737,2012,123.0,104.0,227.0,107.85,107.65,99.55,96.0,30,16,14,0.5329999999999999,28,19,9,0.679,11,5,11,8,206.76,193.32,200.04
2012-12-31,1610612759,1610612751,2012,104.0,73.0,177.0,108.95,98.15,94.25,96.15,32,24,8,0.75,30,16,14,0.5329999999999999,12,12,11,5,200.56,193.28,196.92000000000002
2012-12-31,1610612760,1610612756,2012,114.0,96.0,210.0,107.35,97.1,96.95,99.25,29,23,6,0.7929999999999999,31,11,20,0.355,15,8,9,2,203.56,198.16,200.86
2012-12-30,1610612765,1610612749,2012,96.0,94.0,190.0,95.6,96.2,93.8,95.45,32,10,22,0.313,28,16,12,0.5710000000000001,7,3,9,7,188.64,193.12,190.88
2012-12-30,1610612742,1610612759,2012,86.0,111.0,197.0,97.25,104.25,108.95,99.15,30,12,18,0.4,31,23,8,0.742,8,4,12,11,198.48,200.56,199.51999999999998
2012-12-30,1610612758,1610612738,2012,118.0,96.0,214.0,98.2,103.0,95.2,96.9,29,10,19,0.345,29,14,15,0.483,9,1,9,5,201.4,189.56,195.48000000000002
2012-12-30,1610612746,1610612762,2012,107.0,96.0,203.0,102.55,91.9,99.05,100.45,30,24,6,0.8,31,15,16,0.484,14,10,9,6,191.88,196.6,194.24
2012-12-29,1610612766,1610612740,2012,95.0,98.0,193.0,95.15,107.35,89.9,97.3,29,7,22,0.241,29,6,23,0.207,5,2,3,3,192.4,183.0,187.7
2012-12-29,1610612737,1610612754,2012,109.0,100.0,209.0,99.3,95.65,93.25,88.65,27,18,9,0.667,29,17,12,0.586,10,8,9,8,192.52,187.64,190.07999999999998
2012-12-29,1610612753,1610612761,2012,88.0,123.0,211.0,93.95,95.4,97.1,101.65,29,12,17,0.414,30,10,20,0.333,7,5,7,3,193.4,189.36,191.38
2012-12-29,1610612751,1610612739,2012,103.0,100.0,203.0,93.9,95.6,92.15,97.1,29,15,14,0.517,31,7,24,0.226,10,5,3,4,192.2,193.56,192.88
2012-12-29,1610612741,1610612764,2012,87.0,77.0,164.0,91.5,92.4,90.15,98.25,27,15,12,0.556,27,4,23,0.14800000000000002,8,7,3,1,181.44,189.6,185.51999999999998
2012-12-29,1610612763,1610612743,2012,81.0,72.0,153.0,94.9,90.15,105.1,99.7,26,18,8,0.6920000000000001,31,17,14,0.5479999999999999,12,6,9,8,186.92,201.0,193.95999999999998
2012-12-29,1610612745,1610612760,2012,94.0,124.0,218.0,109.7,106.6,106.0,96.95,29,16,13,0.552,28,22,6,0.7859999999999999,11,5,15,7,205.8,203.56,204.68
2012-12-29,1610612750,1610612756,2012,111.0,107.0,218.0,96.3,96.05,96.7,99.4,26,13,13,0.5,30,11,19,0.3670000000000001,8,5,9,2,187.6,198.16,192.88
2012-12-29,1610612749,1610612748,2012,104.0,85.0,189.0,94.45,96.85,100.9,96.1,27,15,12,0.556,27,20,7,0.741,8,7,14,6,193.96,199.68,196.82
2012-12-29,1610612757,1610612755,2012,89.0,85.0,174.0,96.95,99.0,95.7,98.9,28,14,14,0.5,30,14,16,0.467,10,4,9,5,198.88,189.04,193.95999999999998
2012-12-29,1610612744,1610612738,2012,101.0,83.0,184.0,102.45,98.15,95.9,96.95,30,20,10,0.667,28,14,14,0.5,9,11,9,5,199.04,189.56,194.3
2012-12-28,1610612764,1610612753,2012,105.0,97.0,202.0,89.35,98.2,94.6,95.45,26,3,23,0.115,28,12,16,0.429,2,1,7,5,188.24,193.4,190.82
2012-12-28,1610612754,1610612756,2012,97.0,91.0,188.0,92.85,88.35,96.2,99.25,28,16,12,0.5710000000000001,29,11,18,0.379,8,8,9,2,188.08,198.16,193.12
2012-12-28,1610612751,1610612766,2012,97.0,81.0,178.0,93.95,95.8,95.55,106.85,28,14,14,0.5,28,7,21,0.25,9,5,5,2,192.88,192.4,192.64
2012-12-28,1610612765,1610612748,2012,109.0,99.0,208.0,94.7,95.75,100.15,95.85,31,9,22,0.29,26,20,6,0.769,6,3,14,6,188.04,199.68,193.86
2012-12-28,1610612739,1610612737,2012,94.0,102.0,196.0,92.2,97.15,98.0,95.4,30,7,23,0.233,26,17,9,0.654,3,4,10,7,192.2,192.52,192.36
2012-12-28,1610612740,1610612761,2012,97.0,104.0,201.0,89.8,97.6,96.4,101.35,28,6,22,0.214,29,9,20,0.31,3,3,7,2,181.96,189.36,185.66000000000003
2012-12-28,1610612742,1610612743,2012,85.0,106.0,191.0,98.45,104.15,105.05,100.75,29,12,17,0.414,30,16,14,0.5329999999999999,8,4,9,7,197.68,201.0,199.34
2012-12-28,1610612759,1610612745,2012,122.0,116.0,238.0,107.85,98.55,108.15,105.15,30,22,8,0.733,28,16,12,0.5710000000000001,11,11,11,5,199.52,205.8,202.66000000000003
2012-12-28,1610612762,1610612746,2012,114.0,116.0,230.0,98.05,98.7,101.35,90.55,30,15,15,0.5,29,23,6,0.7929999999999999,9,6,14,9,195.68,191.88,193.78
2012-12-28,1610612758,1610612752,2012,106.0,105.0,211.0,97.4,102.7,102.85,100.15,28,9,19,0.321,29,21,8,0.7240000000000001,8,1,12,9,201.32,192.0,196.66
2012-12-28,1610612747,1610612757,2012,104.0,87.0,191.0,105.0,101.9,97.75,98.1,29,14,15,0.483,27,14,13,0.519,9,5,10,4,194.0,198.88,196.44
2012-12-28,1610612744,1610612755,2012,96.0,89.0,185.0,102.7,99.05,95.9,98.25,29,19,10,0.655,29,14,15,0.483,8,11,9,5,199.24,189.04,194.14
2012-12-27,1610612760,1610612742,2012,111.0,105.0,216.0,106.4,97.15,98.1,103.6,27,21,6,0.778,28,12,16,0.429,14,7,8,4,202.28,197.68,199.98000000000002
2012-12-27,1610612746,1610612738,2012,106.0,77.0,183.0,101.1,90.7,97.1,96.4,28,22,6,0.7859999999999999,27,14,13,0.519,13,9,9,5,192.48,189.56,191.01999999999998
2012-12-26,1610612764,1610612739,2012,84.0,87.0,171.0,88.95,98.0,93.05,98.35,25,3,22,0.12,29,6,23,0.207,2,1,3,3,189.76,192.2,190.98
2012-12-26,1610612766,1610612748,2012,92.0,105.0,197.0,96.05,106.5,99.8,95.85,27,7,20,0.259,25,19,6,0.76,5,2,14,5,191.56,199.68,195.62
2012-12-26,1610612753,1610612740,2012,94.0,97.0,191.0,94.4,94.3,90.3,98.65,27,12,15,0.444,27,5,22,0.185,7,5,3,2,192.8,181.96,187.38
2012-12-26,1610612737,1610612765,2012,126.0,119.0,245.0,96.75,94.45,93.45,93.25,25,16,9,0.64,30,9,21,0.3,9,7,6,3,190.72,188.04,189.38
2012-12-26,1610612749,1610612751,2012,108.0,93.0,201.0,94.0,96.45,94.65,93.8,26,14,12,0.5379999999999999,27,14,13,0.519,7,7,9,5,193.32,192.88,193.1
2012-12-26,1610612763,1610612755,2012,89.0,99.0,188.0,95.05,90.05000000000003,96.25,98.8,25,18,7,0.72,28,13,15,0.464,12,6,9,4,187.16,189.04,188.1
2012-12-26,1610612750,1610612745,2012,84.0,87.0,171.0,96.6,95.45,109.25,106.05,25,13,12,0.52,27,15,12,0.556,8,5,11,4,189.04,205.8,197.42000000000002
2012-12-26,1610612759,1610612761,2012,100.0,80.0,180.0,107.9,98.5,97.25,101.25,29,21,8,0.7240000000000001,28,9,19,0.321,10,11,7,2,201.04,189.36,195.2
2012-12-26,1610612743,1610612747,2012,126.0,114.0,240.0,103.45,100.35,104.2,100.9,29,15,14,0.517,28,14,14,0.5,8,7,9,5,200.8,194.0,197.4
2012-12-26,1610612762,1610612744,2012,83.0,94.0,177.0,98.65,98.3,103.25,99.95,29,15,14,0.517,28,18,10,0.643,9,6,8,10,197.52,199.24,198.38
2012-12-26,1610612756,1610612752,2012,97.0,99.0,196.0,95.75,99.15,103.0,99.3,28,11,17,0.393,28,20,8,0.7140000000000001,9,2,12,8,197.0,192.0,194.5
2012-12-26,1610612757,1610612758,2012,109.0,91.0,200.0,96.65,98.3,97.75,102.55,26,13,13,0.5,27,9,18,0.333,9,4,8,1,199.04,201.32,200.18
2012-12-25,1610612751,1610612738,2012,76.0,93.0,169.0,95.15,92.95,97.25,97.2,26,14,12,0.5379999999999999,26,13,13,0.5,9,5,9,4,195.68,189.56,192.62
2012-12-25,1610612747,1610612752,2012,100.0,94.0,194.0,104.35,100.7,103.05,99.55,27,13,14,0.481,27,20,7,0.741,8,5,12,8,194.28,192.0,193.14
2012-12-25,1610612748,1610612760,2012,103.0,97.0,200.0,100.15,96.4,105.75,96.3,24,18,6,0.75,26,21,5,0.8079999999999999,13,5,14,7,199.04,202.28,200.66
2012-12-25,1610612741,1610612745,2012,97.0,120.0,217.0,91.0,90.4,108.5,106.0,26,15,11,0.5770000000000001,26,14,12,0.5379999999999999,8,7,11,3,179.8,205.8,192.8
2012-12-25,1610612746,1610612743,2012,112.0,100.0,212.0,100.85,90.7,103.6,100.0,27,21,6,0.778,28,15,13,0.536,12,9,8,7,190.92,200.8,195.86
2012-12-23,1610612751,1610612755,2012,95.0,92.0,187.0,95.5,93.2,95.5,97.15,25,13,12,0.52,27,13,14,0.481,8,5,9,4,196.52,189.04,192.78
2012-12-23,1610612752,1610612750,2012,94.0,91.0,185.0,102.75,98.8,96.55,94.85,26,19,7,0.731,24,13,11,0.542,11,8,8,5,192.32,189.04,190.68
2012-12-23,1610612753,1610612762,2012,93.0,97.0,190.0,94.2,94.4,97.95,97.45,26,12,14,0.462,28,14,14,0.5,7,5,9,5,193.4,197.52,195.46
2012-12-23,1610612759,1610612742,2012,129.0,91.0,220.0,106.95,98.95,98.7,101.9,28,20,8,0.7140000000000001,27,12,15,0.444,9,11,8,4,200.08,197.68,198.88
2012-12-23,1610612756,1610612746,2012,77.0,103.0,180.0,97.2,99.6,100.85,91.35,27,11,16,0.407,26,20,6,0.769,9,2,12,8,198.08,190.92,194.5
2012-12-23,1610612758,1610612757,2012,108.0,96.0,204.0,97.15,103.35,96.4,98.6,26,8,18,0.308,25,13,12,0.52,7,1,9,4,202.12,199.04,200.57999999999998
2012-12-22,1610612764,1610612765,2012,87.0,96.0,183.0,89.15,98.25,92.75,93.7,24,3,21,0.125,29,8,21,0.276,2,1,6,2,190.72,188.04,189.38
2012-12-22,1610612737,1610612741,2012,92.0,75.0,167.0,96.2,94.3,92.85,91.1,24,15,9,0.625,25,15,10,0.6,8,7,8,7,191.56,179.8,185.68
2012-12-22,1610612748,1610612762,2012,105.0,89.0,194.0,100.55,97.25,98.15,97.15,23,17,6,0.7390000000000001,27,14,13,0.519,12,5,9,5,200.32,197.52,198.92000000000002
2012-12-22,1610612740,1610612754,2012,75.0,81.0,156.0,91.9,99.55,92.6,89.0,26,5,21,0.192,27,15,12,0.556,3,2,8,7,183.2,188.08,185.64
2012-12-22,1610612745,1610612763,2012,121.0,96.0,217.0,107.1,105.65,94.85,89.05000000000003,25,13,12,0.52,24,18,6,0.75,10,3,12,6,205.36,187.16,196.26
2012-12-22,1610612749,1610612739,2012,82.0,94.0,176.0,94.5,96.55,92.3,98.55,25,14,11,0.56,28,5,23,0.179,7,7,3,2,194.48,192.2,193.33999999999997
2012-12-22,1610612743,1610612766,2012,110.0,88.0,198.0,103.3,100.5,96.6,106.35,27,14,13,0.519,26,7,19,0.269,7,7,5,2,200.28,191.56,195.92000000000002
2012-12-22,1610612757,1610612756,2012,96.0,93.0,189.0,97.05,99.55,98.4,100.3,24,12,12,0.5,26,11,15,0.423,8,4,9,2,198.56,198.08,198.32
2012-12-22,1610612744,1610612747,2012,115.0,118.0,233.0,102.8,98.85,103.3,100.6,27,18,9,0.667,26,12,14,0.462,8,10,8,4,198.64,194.28,196.45999999999998
2012-12-21,1610612761,1610612753,2012,93.0,90.0,183.0,97.85,101.05,93.4,93.85,27,8,19,0.29600000000000004,25,12,13,0.48,6,2,7,5,190.76,193.4,192.07999999999998
2012-12-21,1610612755,1610612737,2012,99.0,80.0,179.0,94.85,97.1,97.4,94.1,26,12,14,0.462,23,15,8,0.652,8,4,8,7,188.0,191.56,189.78
2012-12-21,1610612738,1610612749,2012,94.0,99.0,193.0,97.45,96.9,94.8,96.65,25,13,12,0.52,24,13,11,0.542,9,4,7,6,188.36,194.48,191.42000000000002
2012-12-21,1610612752,1610612741,2012,106.0,110.0,216.0,102.65,98.0,93.1,90.1,25,19,6,0.76,24,14,10,0.583,11,8,8,6,192.28,179.8,186.04000000000002
2012-12-21,1610612765,1610612764,2012,100.0,68.0,168.0,92.9,94.45,90.0,97.7,28,7,21,0.25,23,3,20,0.13,5,2,2,1,189.2,190.72,189.95999999999998
2012-12-21,1610612739,1610612754,2012,89.0,99.0,188.0,92.15,99.35,91.9,89.5,27,5,22,0.185,26,14,12,0.5379999999999999,3,2,8,6,192.32,188.08,190.2
2012-12-21,1610612763,1610612742,2012,92.0,82.0,174.0,95.5,89.7,98.75,102.45,23,17,6,0.7390000000000001,26,12,14,0.462,11,6,8,4,188.24,197.68,192.96
2012-12-21,1610612759,1610612740,2012,99.0,94.0,193.0,106.3,98.45,92.85,100.45,27,19,8,0.7040000000000001,25,5,20,0.2,8,11,3,2,200.52,183.2,191.86
2012-12-21,1610612746,1610612758,2012,97.0,85.0,182.0,100.45,90.9,96.9,103.1,25,19,6,0.76,25,8,17,0.32,11,8,7,1,191.84,202.12,196.98000000000002
2012-12-21,1610612744,1610612766,2012,115.0,100.0,215.0,101.75,99.05,96.55,106.9,26,17,9,0.654,25,7,18,0.28,7,10,5,2,198.36,191.56,194.96
2012-12-20,1610612750,1610612760,2012,99.0,93.0,192.0,96.2,94.2,105.55,96.05,23,12,11,0.522,25,21,4,0.84,7,5,14,7,189.36,202.28,195.82
2012-12-20,1610612742,1610612748,2012,95.0,110.0,205.0,99.7,101.5,99.75,96.5,25,12,13,0.48,22,16,6,0.727,8,4,12,4,197.56,200.32,198.94
2012-12-20,1610612757,1610612743,2012,101.0,93.0,194.0,96.5,100.05,103.7,100.15,23,11,12,0.478,26,14,12,0.5379999999999999,7,4,7,7,198.4,200.28,199.34
2012-12-19,1610612761,1610612765,2012,97.0,91.0,188.0,97.4,101.0,93.05,94.85,26,7,19,0.269,27,7,20,0.259,5,2,5,2,190.24,189.2,189.72
2012-12-19,1610612752,1610612751,2012,100.0,86.0,186.0,102.65,97.9,94.85,93.35,24,18,6,0.75,24,13,11,0.542,10,8,8,5,192.84,196.52,194.68
2012-12-19,1610612753,1610612764,2012,90.0,83.0,173.0,92.3,95.05,90.55,98.2,24,11,13,0.458,22,3,19,0.136,6,5,2,1,194.4,190.72,192.56
2012-12-19,1610612754,1610612762,2012,104.0,84.0,188.0,92.0,90.2,98.6,96.85,25,13,12,0.52,26,14,12,0.5379999999999999,7,6,9,5,187.96,197.52,192.74
2012-12-19,1610612738,1610612739,2012,103.0,91.0,194.0,97.3,97.65,92.65,99.9,24,12,12,0.5,26,5,21,0.192,8,4,3,2,187.8,192.32,190.06
2012-12-19,1610612737,1610612760,2012,92.0,100.0,192.0,97.25,93.85,104.6,96.3,22,15,7,0.682,24,20,4,0.833,8,7,14,6,191.76,202.28,197.01999999999998
2012-12-19,1610612745,1610612755,2012,125.0,103.0,228.0,105.85,105.3,93.9,95.85,24,12,12,0.5,25,12,13,0.48,9,3,8,4,203.72,188.0,195.86
2012-12-19,1610612756,1610612766,2012,121.0,104.0,225.0,97.85,100.1,95.45,105.8,25,10,15,0.4,24,7,17,0.292,8,2,5,2,196.48,191.56,194.01999999999998
2012-12-19,1610612763,1610612749,2012,90.0,80.0,170.0,96.2,90.0,95.85,96.7,22,16,6,0.727,23,13,10,0.565,10,6,7,6,189.32,194.48,191.89999999999998
2012-12-19,1610612758,1610612744,2012,131.0,127.0,258.0,94.65,101.9,100.85,98.45,24,7,17,0.292,25,17,8,0.68,6,1,7,10,200.2,198.36,199.28
2012-12-19,1610612746,1610612740,2012,93.0,77.0,170.0,101.1,91.25,93.8,100.8,24,18,6,0.75,24,5,19,0.208,10,8,3,2,191.8,183.2,187.5
2012-12-18,1610612764,1610612737,2012,95.0,100.0,195.0,90.1,97.65,96.65,94.3,21,3,18,0.14300000000000002,21,14,7,0.667,2,1,8,6,191.72,191.76,191.74
2012-12-18,1610612739,1610612761,2012,99.0,113.0,212.0,92.4,98.45,96.65,101.35,25,5,20,0.2,25,6,19,0.24,3,2,5,1,191.44,190.24,190.84
2012-12-18,1610612751,1610612762,2012,90.0,92.0,182.0,96.05,93.8,101.0,99.0,23,13,10,0.565,25,13,12,0.52,8,5,9,4,196.6,197.52,197.06
2012-12-18,1610612748,1610612750,2012,103.0,92.0,195.0,99.75,95.55,95.6,93.4,21,15,6,0.7140000000000001,22,12,10,0.545,11,4,7,5,199.4,189.36,194.38
2012-12-18,1610612741,1610612738,2012,100.0,89.0,189.0,92.65,90.5,97.3,96.95,23,13,10,0.565,23,12,11,0.522,7,6,8,4,179.08,187.8,183.44
2012-12-18,1610612749,1610612754,2012,98.0,93.0,191.0,95.45,97.45,92.05,90.1,22,12,10,0.545,24,13,11,0.542,6,6,7,6,194.6,187.96,191.28
2012-12-18,1610612742,1610612755,2012,107.0,100.0,207.0,100.65,101.45,93.3,94.45,24,11,13,0.458,24,12,12,0.5,7,4,8,4,197.48,188.0,192.74
2012-12-18,1610612743,1610612759,2012,112.0,106.0,218.0,103.75,99.65,106.2,97.7,25,13,12,0.52,26,19,7,0.731,6,7,8,11,199.84,200.52,200.18
2012-12-18,1610612747,1610612766,2012,101.0,100.0,201.0,103.3,99.45,94.45,105.0,25,11,14,0.44,23,7,16,0.304,7,4,5,2,194.4,191.56,192.98000000000002
2012-12-18,1610612744,1610612740,2012,103.0,96.0,199.0,101.05,98.25,93.45,99.75,24,16,8,0.667,23,5,18,0.217,6,10,3,2,198.32,183.2,190.76
2012-12-17,1610612753,1610612750,2012,102.0,93.0,195.0,92.95,95.1,96.3,93.1,23,10,13,0.435,21,12,9,0.5710000000000001,5,5,7,5,193.52,189.36,191.44
2012-12-17,1610612752,1610612745,2012,96.0,109.0,205.0,103.05,96.65,105.8,105.1,23,18,5,0.7829999999999999,23,11,12,0.478,10,8,9,2,192.64,203.72,198.18
2012-12-17,1610612765,1610612746,2012,76.0,88.0,164.0,94.55,95.95,101.95,92.2,26,7,19,0.269,23,17,6,0.7390000000000001,5,2,10,7,191.32,191.8,191.56
2012-12-17,1610612763,1610612741,2012,80.0,71.0,151.0,96.85,90.7,92.85,90.6,21,15,6,0.7140000000000001,22,13,9,0.591,9,6,7,6,190.44,179.08,184.76
2012-12-17,1610612760,1610612759,2012,107.0,93.0,200.0,104.1,97.0,107.15,97.35,23,19,4,0.826,25,19,6,0.76,13,6,8,11,202.12,200.52,201.32
2012-12-17,1610612756,1610612758,2012,101.0,90.0,191.0,98.15,100.85,94.5,101.5,24,9,15,0.375,23,7,16,0.304,7,2,6,1,197.24,200.2,198.72
2012-12-16,1610612761,1610612745,2012,103.0,96.0,199.0,96.7,101.3,105.85,104.45,24,5,19,0.208,22,11,11,0.5,4,1,9,2,189.32,203.72,196.51999999999998
2012-12-16,1610612755,1610612747,2012,98.0,111.0,209.0,93.35,93.55,102.05,99.3,23,12,11,0.522,24,10,14,0.417,8,4,7,3,187.6,194.4,191.0
2012-12-16,1610612758,1610612743,2012,97.0,122.0,219.0,93.95,100.25,102.5,99.4,22,7,15,0.318,24,12,12,0.5,6,1,6,6,200.6,199.84,200.22
2012-12-16,1610612757,1610612740,2012,95.0,94.0,189.0,97.55,100.65,93.55,99.45,22,10,12,0.455,22,5,17,0.227,6,4,3,2,198.96,183.2,191.07999999999998
2012-12-15,1610612737,1610612744,2012,93.0,115.0,208.0,96.45,92.85,100.6,98.5,20,14,6,0.7,23,15,8,0.652,8,6,6,9,191.96,198.32,195.14
2012-12-15,1610612766,1610612753,2012,98.0,107.0,205.0,93.9,104.35,91.35,94.7,22,7,15,0.318,22,9,13,0.409,5,2,5,4,191.12,193.52,192.32
2012-12-15,1610612752,1610612739,2012,103.0,102.0,205.0,102.35,95.9,91.85,98.6,22,17,5,0.773,24,5,19,0.208,9,8,3,2,193.36,191.44,192.4
2012-12-15,1610612748,1610612764,2012,102.0,72.0,174.0,100.85,96.9,90.7,97.25,20,14,6,0.7,20,3,17,0.15,10,4,2,1,200.36,191.72,196.04000000000002
2012-12-15,1610612765,1610612754,2012,77.0,88.0,165.0,95.2,96.15,91.95,90.7,25,7,18,0.28,23,12,11,0.522,5,2,7,5,191.16,187.96,189.56
2012-12-15,1610612741,1610612751,2012,83.0,82.0,165.0,93.65,91.15,96.8,94.45,21,12,9,0.5710000000000001,22,13,9,0.591,6,6,8,5,179.76,196.6,188.18
2012-12-15,1610612750,1610612742,2012,114.0,106.0,220.0,95.35,91.6,100.2,100.8,20,11,9,0.55,23,11,12,0.478,6,5,7,4,188.12,197.48,192.8
2012-12-15,1610612749,1610612746,2012,85.0,111.0,196.0,96.45,97.0,101.7,92.65,21,12,9,0.5710000000000001,22,16,6,0.727,6,6,10,6,195.12,191.8,193.46
2012-12-15,1610612759,1610612738,2012,103.0,88.0,191.0,107.0,97.2,98.25,97.8,24,18,6,0.75,22,12,10,0.545,7,11,8,4,200.16,187.8,193.98000000000002
2012-12-15,1610612762,1610612763,2012,86.0,99.0,185.0,102.35,98.75,95.9,90.55,24,13,11,0.542,20,14,6,0.7,9,4,9,5,197.6,190.44,194.01999999999998
2012-12-14,1610612761,1610612742,2012,95.0,74.0,169.0,97.3,102.0,101.2,101.25,23,4,19,0.174,22,11,11,0.5,3,1,7,4,190.72,197.48,194.1
2012-12-14,1610612764,1610612747,2012,96.0,102.0,198.0,90.95,97.55,102.25,100.3,19,3,16,0.158,23,9,14,0.391,2,1,7,2,191.76,194.4,193.07999999999998
2012-12-14,1610612754,1610612755,2012,95.0,85.0,180.0,91.35,90.45,94.4,93.6,22,11,11,0.5,22,12,10,0.545,6,5,8,4,188.8,187.6,188.2
2012-12-14,1610612753,1610612744,2012,99.0,85.0,184.0,91.5,94.9,100.2,98.6,21,8,13,0.381,22,15,7,0.682,4,4,6,9,194.0,198.32,196.16
2012-12-14,1610612751,1610612765,2012,107.0,105.0,212.0,95.55,92.9,95.1,96.05,21,12,9,0.5710000000000001,24,7,17,0.292,7,5,5,2,195.68,191.16,193.42000000000002
2012-12-14,1610612739,1610612749,2012,86.0,90.0,176.0,91.65,99.1,96.9,97.1,23,5,18,0.217,20,11,9,0.55,3,2,6,5,191.76,195.12,193.44
2012-12-14,1610612740,1610612750,2012,102.0,113.0,215.0,91.55,97.65,94.0,91.75,21,5,16,0.238,19,10,9,0.526,3,2,6,4,182.32,188.12,185.22
2012-12-14,1610612745,1610612738,2012,101.0,89.0,190.0,106.3,105.65,99.55,97.0,21,10,11,0.476,21,12,9,0.5710000000000001,8,2,8,4,204.88,187.8,196.34
2012-12-14,1610612760,1610612758,2012,113.0,103.0,216.0,103.75,96.4,93.5,98.7,22,18,4,0.818,21,7,14,0.333,12,6,6,1,199.56,200.6,200.07999999999998
2012-12-14,1610612756,1610612762,2012,99.0,84.0,183.0,97.8,101.1,102.35,99.0,23,8,15,0.348,23,13,10,0.565,6,2,9,4,199.16,197.6,198.38
2012-12-14,1610612743,1610612763,2012,99.0,94.0,193.0,101.95,99.3,96.05,90.3,23,11,12,0.478,19,14,5,0.737,5,6,9,5,200.08,190.44,195.26
2012-12-13,1610612737,1610612766,2012,113.0,90.0,203.0,95.9,93.8,94.3,104.7,19,13,6,0.684,21,7,14,0.333,7,6,5,2,191.44,191.12,191.28
2012-12-13,1610612752,1610612747,2012,116.0,107.0,223.0,100.05,94.9,101.45,99.35,21,16,5,0.762,22,9,13,0.409,8,8,7,2,191.68,194.4,193.04000000000002
2012-12-13,1610612757,1610612759,2012,98.0,90.0,188.0,98.65,101.85,106.7,96.4,21,9,12,0.429,23,18,5,0.7829999999999999,5,4,7,11,197.84,200.16,199.0
2012-12-12,1610612761,1610612751,2012,88.0,94.0,182.0,98.1,102.35,96.25,93.75,22,4,18,0.182,20,11,9,0.55,3,1,7,4,192.0,195.68,193.84
2012-12-12,1610612753,1610612737,2012,80.0,86.0,166.0,92.1,96.0,96.5,94.9,20,8,12,0.4,18,12,6,0.667,4,4,7,5,193.12,191.44,192.28
2012-12-12,1610612754,1610612739,2012,96.0,81.0,177.0,91.65,91.3,92.85,99.65,21,10,11,0.476,22,5,17,0.227,5,5,3,2,188.04,191.76,189.89999999999998
2012-12-12,1610612755,1610612741,2012,89.0,96.0,185.0,93.75,93.5,92.75,90.65,21,12,9,0.5710000000000001,20,11,9,0.55,8,4,6,5,187.56,179.76,183.66
2012-12-12,1610612766,1610612746,2012,94.0,100.0,194.0,94.2,103.5,101.25,92.9,20,7,13,0.35,21,15,6,0.7140000000000001,5,2,10,5,191.28,191.8,191.54000000000002
2012-12-12,1610612748,1610612744,2012,95.0,97.0,192.0,102.05,97.85,99.95,98.55,19,14,5,0.737,21,14,7,0.667,10,4,6,8,198.8,198.32,198.56
2012-12-12,1610612738,1610612742,2012,117.0,115.0,232.0,98.7,95.95,100.15,101.05,20,11,9,0.55,21,11,10,0.524,7,4,7,4,185.48,197.48,191.48
2012-12-12,1610612749,1610612758,2012,98.0,85.0,183.0,95.8,97.85,93.65,98.95,19,10,9,0.526,20,7,13,0.35,5,5,6,1,196.96,200.6,198.78
2012-12-12,1610612745,1610612764,2012,99.0,93.0,192.0,106.15,105.1,90.55,97.6,20,9,11,0.45,18,3,15,0.16699999999999998,7,2,2,1,205.2,191.76,198.48
2012-12-12,1610612760,1610612740,2012,92.0,88.0,180.0,104.4,96.7,90.85,97.4,21,17,4,0.81,20,5,15,0.25,11,6,3,2,200.72,182.32,191.51999999999998
2012-12-12,1610612750,1610612743,2012,108.0,105.0,213.0,92.7,90.25,101.7,100.2,18,9,9,0.5,22,11,11,0.5,5,4,5,6,187.52,200.08,193.8
2012-12-12,1610612756,1610612763,2012,82.0,80.0,162.0,97.95,101.45,97.15,91.65,22,7,15,0.318,18,14,4,0.778,5,2,9,5,202.72,190.44,196.57999999999998
2012-12-12,1610612762,1610612759,2012,99.0,96.0,195.0,102.25,98.75,107.5,96.9,22,12,10,0.545,22,18,4,0.818,8,4,7,11,197.44,200.16,198.8
2012-12-11,1610612751,1610612752,2012,97.0,100.0,197.0,96.2,94.1,100.25,95.05,19,11,8,0.579,20,15,5,0.75,7,4,8,7,195.44,191.68,193.56
2012-12-11,1610612739,1610612747,2012,100.0,94.0,194.0,93.55,100.5,101.25,99.65,21,4,17,0.19,21,9,12,0.429,2,2,7,2,193.0,194.4,193.7
2012-12-11,1610612765,1610612743,2012,94.0,101.0,195.0,95.2,96.25,101.65,101.0,23,7,16,0.304,21,10,11,0.476,5,2,5,5,191.0,200.08,195.54000000000002
2012-12-11,1610612740,1610612764,2012,70.0,77.0,147.0,91.75,97.85,91.75,98.8,19,5,14,0.263,17,2,15,0.118,3,2,2,0,183.96,191.76,187.86
2012-12-11,1610612741,1610612746,2012,89.0,94.0,183.0,92.4,90.4,101.5,92.9,19,11,8,0.579,20,14,6,0.7,6,5,10,4,179.8,191.8,185.8
2012-12-10,1610612755,1610612765,2012,104.0,97.0,201.0,93.35,93.9,95.2,96.5,20,11,9,0.55,22,7,15,0.318,7,4,5,2,186.32,191.0,188.66
2012-12-10,1610612766,1610612744,2012,96.0,104.0,200.0,94.45,103.15,100.45,99.25,19,7,12,0.368,20,13,7,0.65,5,2,6,7,191.76,198.32,195.04
2012-12-10,1610612748,1610612737,2012,101.0,92.0,193.0,103.0,98.6,97.0,95.35,18,13,5,0.722,17,12,5,0.706,9,4,7,5,198.32,191.44,194.88
2012-12-10,1610612745,1610612759,2012,126.0,134.0,260.0,104.2,103.05,105.65,94.9,19,9,10,0.474,21,17,4,0.81,7,2,7,10,202.48,200.16,201.32
2012-12-10,1610612742,1610612758,2012,119.0,96.0,215.0,99.15,100.35,93.8,97.6,20,10,10,0.5,19,7,12,0.368,6,4,6,1,196.76,200.6,198.68
2012-12-10,1610612757,1610612761,2012,92.0,74.0,166.0,98.9,103.2,98.85,103.1,20,8,12,0.4,21,4,17,0.19,4,4,3,1,200.48,192.0,196.24
2012-12-09,1610612746,1610612761,2012,102.0,83.0,185.0,101.45,94.15,98.4,101.6,19,13,6,0.684,20,4,16,0.2,9,4,3,1,193.04,192.0,192.51999999999998
2012-12-09,1610612751,1610612749,2012,88.0,97.0,185.0,97.15,94.25,95.95,97.95,18,11,7,0.611,18,9,9,0.5,7,4,5,4,195.92,196.96,196.44
2012-12-09,1610612760,1610612754,2012,104.0,93.0,197.0,104.6,96.45,90.95,91.15,20,16,4,0.8,20,10,10,0.5,10,6,5,5,200.88,188.04,194.45999999999998
2012-12-09,1610612752,1610612743,2012,112.0,106.0,218.0,99.6,94.4,101.7,100.45,19,14,5,0.737,20,10,10,0.5,7,7,5,5,190.64,200.08,195.36
2012-12-09,1610612756,1610612753,2012,90.0,98.0,188.0,97.85,100.15,91.85,96.45,21,7,14,0.333,19,7,12,0.368,5,2,4,3,202.76,193.12,197.94
2012-12-09,1610612747,1610612762,2012,110.0,117.0,227.0,101.15,97.75,101.1,98.4,20,9,11,0.45,21,11,10,0.524,7,2,8,3,192.96,197.44,195.2
2012-12-08,1610612746,1610612756,2012,117.0,99.0,216.0,101.1,94.9,97.85,100.5,18,12,6,0.667,20,7,13,0.35,8,4,5,2,192.52,202.76,197.64
2012-12-08,1610612764,1610612744,2012,97.0,101.0,198.0,92.1,97.25,99.75,98.65,16,2,14,0.125,19,12,7,0.632,2,0,6,6,191.72,198.32,195.01999999999998
2012-12-08,1610612766,1610612759,2012,102.0,132.0,234.0,94.85,102.4,103.25,95.1,18,7,11,0.389,20,16,4,0.8,5,2,7,9,189.88,200.16,195.01999999999998
2012-12-08,1610612738,1610612755,2012,92.0,79.0,171.0,98.5,96.95,94.5,94.05,19,10,9,0.526,19,11,8,0.579,6,4,7,4,185.08,186.32,185.7
2012-12-08,1610612748,1610612740,2012,106.0,90.0,196.0,102.15,98.9,90.65,97.4,17,12,5,0.706,18,5,13,0.278,8,4,3,2,198.48,183.96,191.22
2012-12-08,1610612739,1610612765,2012,97.0,104.0,201.0,93.45,100.25,93.95,97.05,20,4,16,0.2,21,6,15,0.28600000000000003,2,2,5,1,193.32,191.0,192.16
2012-12-08,1610612741,1610612752,2012,93.0,85.0,178.0,92.4,90.5,100.3,94.2,18,10,8,0.556,18,14,4,0.778,5,5,7,7,179.84,190.64,185.24
2012-12-08,1610612763,1610612737,2012,83.0,93.0,176.0,98.15,91.7,97.3,96.25,17,14,3,0.8240000000000001,16,11,5,0.688,9,5,7,4,190.72,191.44,191.07999999999998
2012-12-08,1610612745,1610612742,2012,109.0,116.0,225.0,103.0,102.0,98.3,99.45,18,9,9,0.5,19,9,10,0.474,7,2,6,3,201.92,196.76,199.33999999999997
2012-12-08,1610612757,1610612758,2012,80.0,99.0,179.0,99.75,102.25,94.0,98.5,19,8,11,0.421,18,6,12,0.333,4,4,6,0,201.32,200.6,200.95999999999998
2012-12-07,1610612755,1610612738,2012,95.0,94.0,189.0,94.15,94.85,97.55,97.55,18,10,8,0.556,18,10,8,0.556,6,4,6,4,185.84,185.08,185.46
2012-12-07,1610612754,1610612743,2012,89.0,92.0,181.0,91.3,91.1,101.75,100.35,19,10,9,0.526,19,9,10,0.474,5,5,5,4,188.84,200.08,194.46
2012-12-07,1610612751,1610612744,2012,102.0,109.0,211.0,96.8,93.65,97.85,97.95,17,11,6,0.647,18,11,7,0.611,7,4,6,5,195.68,198.32,197.0
2012-12-07,1610612737,1610612764,2012,104.0,95.0,199.0,97.6,96.2,92.45,96.75,15,10,5,0.667,15,2,13,0.133,6,4,2,0,190.48,191.72,191.1
2012-12-07,1610612765,1610612741,2012,104.0,108.0,212.0,93.95,96.05,91.1,89.75,20,6,14,0.3,17,9,8,0.529,5,1,5,4,189.36,179.84,184.60000000000002
2012-12-07,1610612740,1610612763,2012,89.0,96.0,185.0,90.95,97.55,97.75,91.85,17,5,12,0.294,16,13,3,0.813,3,2,9,4,184.88,190.72,187.8
2012-12-07,1610612750,1610612739,2012,91.0,73.0,164.0,92.35,90.1,94.6,101.0,17,8,9,0.471,19,4,15,0.211,4,4,2,2,188.28,193.32,190.8
2012-12-07,1610612749,1610612766,2012,108.0,93.0,201.0,95.25,98.4,94.3,101.85,17,8,9,0.471,17,7,10,0.412,4,4,5,2,196.56,189.88,193.22
2012-12-07,1610612759,1610612745,2012,114.0,92.0,206.0,102.1,95.35,103.6,102.45,19,15,4,0.789,17,9,8,0.529,6,9,7,2,200.64,201.92,201.27999999999997
2012-12-07,1610612762,1610612761,2012,131.0,99.0,230.0,99.5,98.0,98.65,100.5,20,10,10,0.5,19,4,15,0.211,7,3,3,1,196.88,192.0,194.44
2012-12-07,1610612760,1610612747,2012,114.0,108.0,222.0,103.65,96.25,99.5,95.9,19,15,4,0.789,19,9,10,0.474,9,6,7,2,199.88,192.96,196.42000000000002
2012-12-07,1610612758,1610612753,2012,91.0,82.0,173.0,94.7,99.55,92.75,97.65,17,5,12,0.294,18,7,11,0.389,5,0,4,3,201.88,193.12,197.5
2012-12-06,1610612748,1610612752,2012,92.0,112.0,204.0,102.25,98.35,100.2,94.0,16,12,4,0.75,17,13,4,0.765,8,4,7,6,198.24,190.64,194.44
2012-12-06,1610612756,1610612742,2012,94.0,97.0,191.0,98.3,100.05,97.25,99.15,19,7,12,0.368,18,8,10,0.444,5,2,6,2,202.72,196.76,199.74
2012-12-05,1610612766,1610612752,2012,98.0,100.0,198.0,93.9,101.3,100.05,93.85,16,7,9,0.438,16,12,4,0.75,5,2,7,5,188.8,190.64,189.72
2012-12-05,1610612754,1610612757,2012,99.0,92.0,191.0,91.0,91.75,99.9,101.55,18,9,9,0.5,18,8,10,0.444,4,5,4,4,189.84,201.32,195.57999999999998
2012-12-05,1610612738,1610612750,2012,104.0,94.0,198.0,96.3,97.25,92.65,88.69999999999997,17,9,8,0.529,16,8,8,0.5,5,4,4,4,182.92,188.28,185.6
2012-12-05,1610612765,1610612744,2012,97.0,104.0,201.0,93.35,94.85,97.7,97.95,19,6,13,0.316,17,10,7,0.588,5,1,6,4,188.24,198.32,193.28
2012-12-05,1610612737,1610612743,2012,108.0,104.0,212.0,97.05,94.4,102.35,100.9,14,9,5,0.643,18,9,9,0.5,5,4,5,4,192.88,200.08,196.48000000000002
2012-12-05,1610612739,1610612741,2012,85.0,95.0,180.0,94.35,101.1,90.05000000000003,89.44999999999997,18,4,14,0.222,16,8,8,0.5,2,2,5,3,194.24,179.84,187.04000000000002
2012-12-05,1610612740,1610612747,2012,87.0,103.0,190.0,91.1,97.25,98.85,97.5,16,5,11,0.313,18,8,10,0.444,3,2,7,1,183.04,192.96,188.0
2012-12-05,1610612759,1610612749,2012,110.0,99.0,209.0,101.65,95.35,95.05,98.1,18,14,4,0.778,16,8,8,0.5,5,9,4,4,201.52,196.56,199.04000000000002
2012-12-05,1610612762,1610612753,2012,87.0,81.0,168.0,100.0,98.0,93.0,98.9,19,9,10,0.474,17,7,10,0.412,6,3,4,3,197.96,193.12,195.54000000000002
2012-12-05,1610612758,1610612761,2012,107.0,100.0,207.0,94.05,99.15,98.05,100.55,16,4,12,0.25,18,4,14,0.222,4,0,3,1,202.76,192.0,197.38
2012-12-05,1610612746,1610612742,2012,112.0,90.0,202.0,100.55,95.0,97.45,99.05,17,11,6,0.647,17,8,9,0.471,7,4,6,2,193.28,196.76,195.01999999999998
2012-12-04,1610612755,1610612750,2012,88.0,105.0,193.0,93.95,93.35,91.45,88.9,17,10,7,0.588,15,7,8,0.467,6,4,4,3,185.52,188.28,186.9
2012-12-04,1610612764,1610612748,2012,105.0,101.0,206.0,92.25,95.35,101.15,97.7,14,1,13,0.071,15,12,3,0.8,1,0,8,4,192.36,198.24,195.3
2012-12-04,1610612751,1610612760,2012,111.0,117.0,228.0,96.05,93.1,103.05,96.05,16,11,5,0.688,18,14,4,0.778,7,4,9,5,194.4,199.88,197.14
2012-12-04,1610612741,1610612754,2012,76.0,80.0,156.0,91.1,89.94999999999997,91.45,92.45,15,8,7,0.5329999999999999,17,8,9,0.471,5,3,4,4,181.28,189.84,185.56
2012-12-04,1610612763,1610612756,2012,108.0,98.0,206.0,97.65,92.95,98.1,100.4,15,12,3,0.8,18,7,11,0.389,8,4,5,2,190.16,202.72,196.44
2012-12-04,1610612745,1610612747,2012,107.0,105.0,212.0,103.7,102.3,98.4,97.8,16,8,8,0.5,17,8,9,0.471,6,2,7,1,201.2,192.96,197.07999999999998
2012-12-03,1610612766,1610612757,2012,112.0,118.0,230.0,92.8,100.4,98.6,101.25,15,7,8,0.467,17,7,10,0.412,5,2,4,3,187.48,201.32,194.39999999999998
2012-12-03,1610612765,1610612739,2012,89.0,79.0,168.0,94.5,95.2,95.8,101.7,18,5,13,0.278,17,4,13,0.235,4,1,2,2,189.64,194.24,191.94
2012-12-03,1610612740,1610612749,2012,102.0,81.0,183.0,90.85,97.3,95.7,98.0,15,4,11,0.267,15,8,7,0.5329999999999999,2,2,4,4,183.16,196.56,189.86
2012-12-03,1610612743,1610612761,2012,113.0,110.0,223.0,101.65,99.6,97.55,100.25,17,8,9,0.471,17,4,13,0.235,4,4,3,1,200.56,192.0,196.28
2012-12-03,1610612762,1610612746,2012,104.0,105.0,209.0,98.85,97.1,99.7,95.05,18,9,9,0.5,16,10,6,0.625,6,3,7,3,197.48,193.28,195.38
2012-12-03,1610612744,1610612753,2012,94.0,102.0,196.0,97.15,96.85,93.45,99.9,16,10,6,0.625,16,6,10,0.375,6,4,4,2,198.56,193.12,195.84
2012-12-02,1610612752,1610612756,2012,106.0,99.0,205.0,100.65,94.4,97.75,100.45,15,11,4,0.733,17,7,10,0.412,6,5,5,2,190.48,202.72,196.6
2012-12-02,1610612747,1610612753,2012,103.0,113.0,216.0,98.0,97.4,91.8,99.0,16,8,8,0.5,15,5,10,0.333,7,1,4,1,193.12,193.12,193.12
2012-12-01,1610612748,1610612751,2012,102.0,89.0,191.0,101.25,98.3,94.95,92.9,14,11,3,0.7859999999999999,15,11,4,0.733,7,4,7,4,197.28,194.4,195.84
2012-12-01,1610612739,1610612757,2012,117.0,118.0,235.0,94.2,100.6,97.25,100.25,16,4,12,0.25,16,6,10,0.375,2,2,4,2,191.6,201.32,196.45999999999998
2012-12-01,1610612741,1610612755,2012,93.0,88.0,181.0,91.15,90.0,93.3,92.95,14,7,7,0.5,16,10,6,0.625,4,3,6,4,180.2,185.52,182.86
2012-12-01,1610612740,1610612760,2012,79.0,100.0,179.0,91.15,96.3,103.35,98.15,14,4,10,0.28600000000000003,17,13,4,0.765,2,2,9,4,183.56,199.88,191.72
2012-12-01,1610612745,1610612762,2012,124.0,116.0,240.0,102.85,102.3,98.05,96.4,15,7,8,0.467,17,9,8,0.529,5,2,6,3,199.92,197.48,198.7
2012-12-01,1610612749,1610612738,2012,91.0,88.0,179.0,95.85,98.45,96.3,97.75,14,7,7,0.5,16,9,7,0.563,3,4,5,4,198.2,182.92,190.56
2012-12-01,1610612759,1610612763,2012,99.0,95.0,194.0,101.85,96.0,97.4,92.4,17,13,4,0.765,14,12,2,0.857,4,9,8,4,202.36,190.16,196.26
2012-12-01,1610612742,1610612765,2012,92.0,77.0,169.0,97.2,98.9,95.1,95.2,16,7,9,0.438,17,5,12,0.294,5,2,4,1,198.2,189.64,193.92
2012-12-01,1610612746,1610612758,2012,116.0,81.0,197.0,98.75,95.55,95.5,99.25,15,9,6,0.6,15,4,11,0.267,6,3,4,0,193.44,202.76,198.1
2012-12-01,1610612744,1610612754,2012,103.0,92.0,195.0,97.05,97.6,91.35,91.7,15,9,6,0.6,16,8,8,0.5,5,4,4,4,198.8,189.84,194.32
2012-11-30,1610612761,1610612756,2012,101.0,97.0,198.0,96.6,99.15,97.75,100.75,16,3,13,0.188,16,7,9,0.438,2,1,5,2,191.28,202.72,197.0
2012-11-30,1610612766,1610612755,2012,98.0,104.0,202.0,92.5,100.1,92.35,93.1,14,7,7,0.5,15,9,6,0.6,5,2,6,3,187.56,185.52,186.54000000000002
2012-11-30,1610612753,1610612751,2012,86.0,98.0,184.0,92.7,99.1,94.8,93.9,14,5,9,0.35700000000000004,14,10,4,0.7140000000000001,4,1,7,3,192.0,194.4,193.2
2012-11-30,1610612738,1610612757,2012,96.0,78.0,174.0,96.95,98.75,98.35,101.3,15,8,7,0.5329999999999999,15,6,9,0.4,4,4,4,2,183.96,201.32,192.64
2012-11-30,1610612752,1610612764,2012,108.0,87.0,195.0,99.5,94.7,92.95,95.15,14,10,4,0.7140000000000001,13,1,12,0.077,5,5,1,0,189.64,192.36,191.0
2012-11-30,1610612737,1610612739,2012,111.0,113.0,224.0,96.1,92.7,93.65,100.3,13,9,4,0.6920000000000001,15,3,12,0.2,5,4,2,1,191.0,191.6,191.3
2012-11-30,1610612763,1610612765,2012,90.0,78.0,168.0,98.65,93.5,95.0,95.45,13,11,2,0.846,16,5,11,0.313,7,4,4,1,190.6,189.64,190.12
2012-11-30,1610612760,1610612762,2012,106.0,94.0,200.0,103.35,98.05,97.65,95.5,16,12,4,0.75,16,9,7,0.563,8,4,6,3,200.16,197.48,198.82
2012-11-30,1610612750,1610612749,2012,95.0,85.0,180.0,91.8,91.2,96.45,97.7,14,6,8,0.429,13,7,6,0.5379999999999999,3,3,3,4,188.76,198.2,193.48
2012-11-30,1610612758,1610612754,2012,92.0,97.0,189.0,95.3,99.3,91.0,91.95,14,4,10,0.28600000000000003,15,7,8,0.467,4,0,4,3,203.76,189.84,196.8
2012-11-30,1610612747,1610612743,2012,122.0,103.0,225.0,96.45,97.2,100.95,98.6,15,7,8,0.467,16,8,8,0.5,6,1,4,4,192.24,200.56,196.4
2012-11-29,1610612748,1610612759,2012,105.0,100.0,205.0,101.25,97.2,101.8,95.5,13,10,3,0.769,16,13,3,0.813,6,4,4,9,196.48,202.36,199.42000000000002
2012-11-29,1610612744,1610612743,2012,106.0,105.0,211.0,95.8,96.5,99.45,97.5,14,8,6,0.5710000000000001,15,8,7,0.5329999999999999,4,4,4,4,197.72,200.56,199.14
2012-11-28,1610612764,1610612757,2012,84.0,82.0,166.0,94.8,96.65,98.9,102.3,12,0,12,0.0,14,6,8,0.429,0,0,4,2,193.52,201.32,197.42000000000002
2012-11-28,1610612753,1610612759,2012,89.0,110.0,199.0,93.85,98.4,101.3,96.25,13,5,8,0.385,15,12,3,0.8,4,1,4,8,192.12,202.36,197.24
2012-11-28,1610612738,1610612751,2012,83.0,95.0,178.0,97.6,98.85,94.8,94.2,14,8,6,0.5710000000000001,13,9,4,0.6920000000000001,4,4,7,2,183.8,194.4,189.10000000000002
2012-11-28,1610612737,1610612766,2012,94.0,91.0,185.0,95.75,92.45,92.7,100.5,12,8,4,0.667,13,7,6,0.5379999999999999,4,4,5,2,191.8,187.56,189.68
2012-11-28,1610612765,1610612756,2012,117.0,77.0,194.0,94.2,96.55,98.9,99.6,15,4,11,0.267,15,7,8,0.467,3,1,5,2,188.48,202.72,195.6
2012-11-28,1610612741,1610612742,2012,101.0,78.0,179.0,90.7,90.15,98.25,98.95,13,6,7,0.462,15,7,8,0.467,3,3,5,2,181.0,198.2,189.6
2012-11-28,1610612749,1610612752,2012,88.0,102.0,190.0,97.45,97.15,98.9,95.2,12,7,5,0.583,13,9,4,0.6920000000000001,3,4,5,4,199.92,189.64,194.77999999999997
2012-11-28,1610612763,1610612761,2012,103.0,82.0,185.0,99.0,94.5,98.5,99.3,12,10,2,0.833,15,3,12,0.2,6,4,2,1,190.76,191.28,191.01999999999998
2012-11-28,1610612740,1610612762,2012,84.0,96.0,180.0,92.2,96.45,98.55,97.3,13,4,9,0.308,15,8,7,0.5329999999999999,2,2,6,2,183.52,197.48,190.5
2012-11-28,1610612760,1610612745,2012,120.0,98.0,218.0,101.75,96.95,102.35,101.15,15,11,4,0.733,14,7,7,0.5,7,4,5,2,200.56,199.92,200.24
2012-11-28,1610612746,1610612750,2012,101.0,95.0,196.0,98.1,94.35,91.6,90.95,14,8,6,0.5710000000000001,13,6,7,0.462,5,3,3,3,193.4,188.76,191.07999999999998
2012-11-27,1610612755,1610612742,2012,100.0,98.0,198.0,92.25,92.7,98.25,98.9,14,8,6,0.5710000000000001,14,7,7,0.5,5,3,5,2,185.12,198.2,191.66
2012-11-27,1610612739,1610612756,2012,78.0,91.0,169.0,94.65,100.25,99.15,100.8,14,3,11,0.214,14,6,8,0.429,2,1,5,1,191.76,202.72,197.24
2012-11-27,1610612745,1610612761,2012,117.0,101.0,218.0,101.25,99.85,98.4,98.5,13,6,7,0.462,14,3,11,0.214,4,2,2,1,200.08,191.28,195.68
2012-11-27,1610612758,1610612750,2012,89.0,97.0,186.0,96.7,99.45,91.3,90.5,13,4,9,0.308,12,5,7,0.417,4,0,3,2,204.92,188.76,196.83999999999997
2012-11-27,1610612747,1610612754,2012,77.0,79.0,156.0,96.7,97.95,92.05,92.2,14,7,7,0.5,14,6,8,0.429,6,1,4,2,194.8,189.84,192.32
2012-11-26,1610612751,1610612752,2012,96.0,89.0,185.0,94.25,95.5,99.35,95.85,12,8,4,0.667,12,9,3,0.75,6,2,5,4,194.28,189.64,191.95999999999998
2012-11-26,1610612764,1610612759,2012,92.0,118.0,210.0,94.65,95.65,100.45,96.85,11,0,11,0.0,14,11,3,0.7859999999999999,0,0,4,7,193.12,202.36,197.74
2012-11-26,1610612765,1610612757,2012,108.0,101.0,209.0,94.2,95.8,98.5,100.65,14,3,11,0.214,13,6,7,0.462,2,1,4,2,187.2,201.32,194.26
2012-11-26,1610612741,1610612749,2012,92.0,93.0,185.0,91.1,90.2,96.5,96.9,12,6,6,0.5,11,6,5,0.545,3,3,3,3,181.72,199.92,190.82
2012-11-26,1610612763,1610612739,2012,84.0,78.0,162.0,98.4,94.7,95.7,101.7,11,9,2,0.818,13,3,10,0.231,5,4,2,1,193.24,191.76,192.5
2012-11-26,1610612760,1610612766,2012,114.0,69.0,183.0,101.45,98.55,92.9,99.85,14,10,4,0.7140000000000001,12,7,5,0.583,6,4,5,2,201.4,187.56,194.48000000000002
2012-11-26,1610612762,1610612743,2012,105.0,103.0,208.0,97.8,97.25,97.9,96.65,14,7,7,0.5,14,8,6,0.5710000000000001,5,2,4,4,196.64,200.56,198.6
2012-11-26,1610612746,1610612740,2012,98.0,105.0,203.0,98.0,93.8,90.7,96.3,13,8,5,0.615,12,3,9,0.25,5,3,2,1,192.84,183.52,188.18
2012-11-25,1610612761,1610612759,2012,106.0,111.0,217.0,98.0,96.3,100.7,96.9,13,3,10,0.231,13,10,3,0.769,2,1,4,6,188.92,202.36,195.64
2012-11-25,1610612752,1610612765,2012,121.0,100.0,221.0,98.45,94.1,93.1,95.0,11,8,3,0.727,13,3,10,0.231,4,4,2,1,188.2,187.2,187.7
2012-11-25,1610612751,1610612757,2012,98.0,85.0,183.0,94.25,95.65,98.95,100.55,11,7,4,0.636,12,6,6,0.5,5,2,4,2,195.12,201.32,198.22
2012-11-25,1610612755,1610612756,2012,104.0,101.0,205.0,92.7,92.6,98.5,100.6,13,7,6,0.5379999999999999,13,6,7,0.462,4,3,5,1,184.32,202.72,193.51999999999998
2012-11-25,1610612753,1610612738,2012,110.0,116.0,226.0,93.1,97.7,96.5,97.85,12,5,7,0.417,13,7,6,0.5379999999999999,4,1,4,3,191.12,183.8,187.46
2012-11-25,1610612743,1610612740,2012,102.0,84.0,186.0,97.85,96.15,91.0,95.55,13,7,6,0.5379999999999999,11,3,8,0.273,3,4,2,1,201.08,183.52,192.3
2012-11-24,1610612755,1610612760,2012,109.0,116.0,225.0,92.6,90.55,100.55,98.3,12,7,5,0.583,13,9,4,0.6920000000000001,4,3,6,3,181.76,201.4,191.57999999999998
2012-11-24,1610612764,1610612766,2012,106.0,108.0,214.0,94.0,94.5,91.6,99.8,10,0,10,0.0,11,6,5,0.545,0,0,5,1,193.32,187.56,190.44
2012-11-24,1610612737,1610612746,2012,104.0,93.0,197.0,94.55,92.15,97.95,94.0,11,7,4,0.636,12,8,4,0.667,3,4,5,3,190.12,192.84,191.48000000000002
2012-11-24,1610612748,1610612739,2012,110.0,108.0,218.0,100.2,96.75,94.6,100.35,12,9,3,0.75,12,3,9,0.25,5,4,2,1,194.56,191.76,193.16
2012-11-24,1610612742,1610612747,2012,89.0,115.0,204.0,98.5,98.15,95.55,97.9,13,7,6,0.5379999999999999,13,6,7,0.462,5,2,6,0,197.24,194.8,196.02
2012-11-24,1610612749,1610612741,2012,86.0,93.0,179.0,96.45,96.75,91.05,90.25,10,6,4,0.6,11,5,6,0.455,3,3,3,2,201.16,181.72,191.44
2012-11-24,1610612758,1610612762,2012,108.0,97.0,205.0,96.4,99.4,97.65,96.65,12,3,9,0.25,13,7,6,0.5379999999999999,3,0,5,2,206.16,196.64,201.39999999999998
2012-11-24,1610612744,1610612750,2012,96.0,85.0,181.0,95.35,97.2,91.45,91.25,13,7,6,0.5379999999999999,11,5,6,0.455,3,4,3,2,198.4,188.76,193.57999999999998
2012-11-23,1610612766,1610612737,2012,91.0,101.0,192.0,91.4,99.25,93.5,91.75,10,6,4,0.6,10,6,4,0.6,5,1,3,3,187.28,190.12,188.7
2012-11-23,1610612753,1610612739,2012,108.0,104.0,212.0,92.65,97.55,93.15,100.3,11,4,7,0.364,11,3,8,0.273,3,1,2,1,191.12,191.76,191.44
2012-11-23,1610612738,1610612760,2012,108.0,100.0,208.0,95.85,97.75,99.8,97.45,12,6,6,0.5,12,9,3,0.75,3,3,6,3,182.76,201.4,192.07999999999998
2012-11-23,1610612751,1610612746,2012,86.0,76.0,162.0,94.3,97.1,98.25,93.3,10,6,4,0.6,11,8,3,0.727,4,2,5,3,197.36,192.84,195.10000000000002
2012-11-23,1610612765,1610612761,2012,91.0,90.0,181.0,92.35,94.15,97.8,96.35,12,2,10,0.16699999999999998,12,3,9,0.25,1,1,2,1,188.84,188.92,188.88
2012-11-23,1610612754,1610612759,2012,97.0,104.0,201.0,91.85,92.05,100.45,97.4,13,6,7,0.462,12,9,3,0.75,4,2,4,5,189.08,202.36,195.72000000000003
2012-11-23,1610612763,1610612747,2012,106.0,98.0,204.0,97.7,93.8,94.85,97.55,10,8,2,0.8,12,6,6,0.5,4,4,6,0,194.16,194.8,194.48000000000002
2012-11-23,1610612745,1610612752,2012,131.0,103.0,234.0,100.05,99.95,97.7,92.9,12,5,7,0.417,10,8,2,0.8,3,2,4,4,197.64,188.2,192.92
2012-11-23,1610612743,1610612744,2012,102.0,91.0,193.0,97.65,96.8,95.7,96.5,12,6,6,0.5,12,7,5,0.583,2,4,3,4,201.88,198.4,200.14
2012-11-23,1610612762,1610612758,2012,104.0,102.0,206.0,97.25,96.25,97.0,98.6,12,6,6,0.5,11,3,8,0.273,4,2,3,0,196.72,206.16,201.44
2012-11-23,1610612756,1610612740,2012,111.0,108.0,219.0,98.15,99.85,89.45,94.2,12,5,7,0.417,10,3,7,0.3,4,1,2,1,201.32,183.52,192.42000000000002
2012-11-23,1610612757,1610612750,2012,103.0,95.0,198.0,98.35,101.4,92.05,91.75,11,5,6,0.455,10,5,5,0.5,3,2,3,2,202.76,188.76,195.76
2012-11-21,1610612766,1610612761,2012,98.0,97.0,195.0,91.5,98.8,96.6,95.25,9,5,4,0.556,11,3,8,0.273,4,1,2,1,187.88,188.92,188.39999999999998
2012-11-21,1610612753,1610612765,2012,90.0,74.0,164.0,91.85,98.7,93.2,95.05,10,3,7,0.3,11,2,9,0.182,2,1,1,1,192.84,188.84,190.84
2012-11-21,1610612739,1610612755,2012,92.0,83.0,175.0,92.9,101.3,92.55,90.0,10,2,8,0.2,11,7,4,0.636,1,1,4,3,192.8,181.76,187.28
2012-11-21,1610612754,1610612740,2012,115.0,107.0,222.0,90.8,90.45,88.25,92.5,12,5,7,0.417,9,3,6,0.333,3,2,2,1,188.0,183.52,185.76
2012-11-21,1610612738,1610612759,2012,100.0,112.0,212.0,94.8,97.05,100.0,97.85,11,6,5,0.545,11,8,3,0.727,3,3,4,4,181.2,202.36,191.78
2012-11-21,1610612737,1610612764,2012,101.0,100.0,201.0,92.6,90.45,93.4,94.35,9,5,4,0.556,9,0,9,0.0,2,3,0,0,189.68,193.32,191.5
2012-11-21,1610612748,1610612749,2012,113.0,106.0,219.0,100.6,96.75,96.6,97.0,11,8,3,0.727,9,6,3,0.667,4,4,3,3,192.0,201.16,196.57999999999998
2012-11-21,1610612760,1610612746,2012,117.0,111.0,228.0,99.3,96.75,96.7,92.05,11,8,3,0.727,10,8,2,0.8,5,3,5,3,200.2,192.84,196.51999999999998
2012-11-21,1610612745,1610612741,2012,93.0,89.0,182.0,99.6,99.35,90.2,89.75,11,4,7,0.364,10,5,5,0.5,2,2,3,2,197.56,181.72,189.64
2012-11-21,1610612750,1610612743,2012,94.0,101.0,195.0,91.75,91.35,97.65,97.5,9,5,4,0.556,11,5,6,0.455,3,2,2,3,188.88,201.88,195.38
2012-11-21,1610612742,1610612752,2012,114.0,111.0,225.0,98.95,97.8,97.05,91.95,12,6,6,0.5,9,8,1,0.889,4,2,4,4,196.16,188.2,192.18
2012-11-21,1610612756,1610612757,2012,114.0,87.0,201.0,97.75,101.0,98.45,101.9,11,4,7,0.364,10,5,5,0.5,3,1,3,2,199.64,202.76,201.2
2012-11-21,1610612758,1610612747,2012,113.0,97.0,210.0,97.0,98.55,94.8,97.55,10,2,8,0.2,11,6,5,0.545,2,0,6,0,205.92,194.8,200.36
2012-11-21,1610612744,1610612751,2012,102.0,93.0,195.0,95.55,97.85,94.05,97.05,11,6,5,0.545,9,6,3,0.667,2,4,4,2,198.72,197.36,198.04000000000002
2012-11-20,1610612755,1610612761,2012,106.0,98.0,204.0,92.5,90.5,95.3,94.75,10,6,4,0.6,10,3,7,0.3,3,3,2,1,180.08,188.92,184.5
2012-11-20,1610612740,1610612752,2012,80.0,102.0,182.0,88.65,91.15,97.35,93.0,8,3,5,0.375,8,7,1,0.875,2,1,4,3,182.88,188.2,185.54
2012-11-20,1610612747,1610612751,2012,95.0,90.0,185.0,94.65,98.0,93.9,96.85,10,5,5,0.5,8,6,2,0.75,5,0,4,2,195.4,197.36,196.38
2012-11-19,1610612764,1610612754,2012,89.0,96.0,185.0,93.75,95.0,90.8,91.6,8,0,8,0.0,11,4,7,0.364,0,0,3,1,193.44,188.0,190.72
2012-11-19,1610612766,1610612749,2012,102.0,98.0,200.0,90.6,99.1,97.3,97.95,8,4,4,0.5,8,6,2,0.75,3,1,3,3,186.16,201.16,193.66
2012-11-19,1610612737,1610612753,2012,81.0,72.0,153.0,93.85,91.3,92.6,99.9,8,4,4,0.5,9,3,6,0.333,1,3,2,1,191.04,192.84,191.94
2012-11-19,1610612763,1610612743,2012,92.0,97.0,189.0,98.35,93.85,96.8,97.75,9,8,1,0.889,10,4,6,0.4,4,4,2,2,193.92,201.88,197.89999999999998
2012-11-19,1610612742,1610612744,2012,101.0,105.0,206.0,98.75,97.7,95.2,98.0,11,6,5,0.545,10,5,5,0.5,4,2,2,3,195.32,198.72,197.01999999999998
2012-11-19,1610612759,1610612746,2012,87.0,92.0,179.0,101.65,98.8,97.0,92.95,10,8,2,0.8,9,7,2,0.778,4,4,5,2,201.96,192.84,197.4
2012-11-19,1610612762,1610612745,2012,102.0,91.0,193.0,97.15,96.1,100.0,99.5,11,5,6,0.455,10,4,6,0.4,3,2,2,2,197.56,197.56,197.56
2012-11-18,1610612752,1610612754,2012,88.0,76.0,164.0,97.95,94.15,90.5,91.4,7,6,1,0.857,10,4,6,0.4,3,3,3,1,188.72,188.0,188.36
2012-11-18,1610612761,1610612753,2012,97.0,86.0,183.0,94.8,95.9,92.2,99.7,9,2,7,0.222,8,3,5,0.375,1,1,2,1,189.64,192.84,191.24
2012-11-18,1610612755,1610612739,2012,86.0,79.0,165.0,92.3,90.3,94.0,102.45,9,5,4,0.556,9,2,7,0.222,2,3,1,1,181.28,192.8,187.04000000000002
2012-11-18,1610612758,1610612751,2012,90.0,99.0,189.0,97.1,98.75,94.5,97.3,9,2,7,0.222,7,5,2,0.7140000000000001,2,0,4,1,206.56,197.36,201.96
2012-11-18,1610612760,1610612744,2012,119.0,109.0,228.0,99.35,96.2,95.25,96.2,10,7,3,0.7,9,5,4,0.556,4,3,2,3,197.72,198.72,198.22
2012-11-18,1610612765,1610612738,2012,103.0,83.0,186.0,92.05,95.45,96.2,97.65,10,1,9,0.1,10,6,4,0.6,0,1,3,3,189.16,181.2,185.18
2012-11-18,1610612757,1610612741,2012,102.0,94.0,196.0,98.05,102.05,90.5,88.05,9,4,5,0.444,9,5,4,0.556,2,2,3,2,201.88,181.72,191.8
2012-11-18,1610612747,1610612745,2012,119.0,108.0,227.0,93.6,97.75,100.1,99.4,9,4,5,0.444,9,4,5,0.444,4,0,2,2,195.08,197.56,196.32
2012-11-17,1610612738,1610612761,2012,107.0,89.0,196.0,95.5,97.75,95.45,94.85,9,5,4,0.556,8,2,6,0.25,2,3,1,1,179.88,189.64,184.76
2012-11-17,1610612764,1610612762,2012,76.0,83.0,159.0,94.85,96.45,98.7,96.3,7,0,7,0.0,10,4,6,0.4,0,0,3,1,194.52,197.56,196.04000000000002
2012-11-17,1610612766,1610612763,2012,87.0,94.0,181.0,90.65,100.1,98.5,94.55,7,4,3,0.5710000000000001,8,7,1,0.875,3,1,4,3,186.6,193.92,190.26
2012-11-17,1610612739,1610612742,2012,95.0,103.0,198.0,93.45,102.3,98.05,98.25,8,2,6,0.25,10,5,5,0.5,1,1,4,1,192.28,195.32,193.8
2012-11-17,1610612749,1610612740,2012,117.0,113.0,230.0,96.05,96.6,87.9,90.65,7,5,2,0.7140000000000001,7,3,4,0.429,2,3,2,1,199.56,182.88,191.22
2012-11-17,1610612759,1610612743,2012,126.0,100.0,226.0,100.4,98.7,96.65,96.0,9,7,2,0.778,9,4,5,0.444,3,4,2,2,200.56,201.88,201.22
2012-11-17,1610612746,1610612741,2012,101.0,80.0,181.0,95.95,93.65,91.5,87.69999999999997,8,6,2,0.75,8,5,3,0.625,4,2,3,2,192.88,181.72,187.3
2012-11-17,1610612756,1610612748,2012,88.0,97.0,185.0,98.7,102.05,100.75,97.15,10,4,6,0.4,10,7,3,0.7,3,1,4,3,200.2,192.0,196.1
2012-11-16,1610612755,1610612762,2012,99.0,93.0,192.0,91.95,89.80000000000003,99.0,95.65,8,4,4,0.5,9,4,5,0.444,1,3,3,1,180.56,197.56,189.06
2012-11-16,1610612754,1610612742,2012,103.0,83.0,186.0,90.6,91.6,98.05,97.75,9,3,6,0.333,9,5,4,0.556,2,1,4,1,189.52,195.32,192.42000000000002
2012-11-16,1610612765,1610612753,2012,106.0,110.0,216.0,92.55,93.8,90.75,98.25,9,1,8,0.111,7,2,5,0.28600000000000003,0,1,2,0,187.52,192.84,190.18
2012-11-16,1610612740,1610612760,2012,95.0,110.0,205.0,87.94999999999997,89.4,99.25,96.6,6,3,3,0.5,9,6,3,0.667,2,1,4,2,181.88,197.72,189.8
2012-11-16,1610612750,1610612744,2012,98.0,106.0,204.0,91.05,90.6,94.6,95.7,8,5,3,0.625,8,4,4,0.5,3,2,2,2,188.76,198.72,193.74
2012-11-16,1610612763,1610612752,2012,105.0,95.0,200.0,98.15,94.75,97.9,94.2,7,6,1,0.857,6,6,0,1.0,3,3,3,3,193.16,188.72,190.94
2012-11-16,1610612758,1610612737,2012,96.0,112.0,208.0,97.4,99.5,92.2,91.55,8,2,6,0.25,7,3,4,0.429,2,0,1,2,206.52,191.04,198.78
2012-11-16,1610612757,1610612745,2012,119.0,117.0,236.0,98.0,101.7,98.55,98.5,8,3,5,0.375,8,4,4,0.5,1,2,2,2,198.24,197.56,197.9
2012-11-16,1610612747,1610612756,2012,114.0,102.0,216.0,91.9,98.35,98.15,101.6,8,3,5,0.375,9,4,5,0.444,3,0,3,1,193.56,200.2,196.88
2012-11-15,1610612751,1610612738,2012,102.0,97.0,199.0,94.15,97.65,94.6,97.3,6,4,2,0.667,8,5,3,0.625,3,1,2,3,197.44,179.88,188.66
2012-11-15,1610612759,1610612752,2012,100.0,104.0,204.0,100.65,97.9,97.4,94.4,8,7,1,0.875,5,5,0,1.0,3,4,3,2,201.04,188.72,194.88
2012-11-15,1610612743,1610612748,2012,93.0,98.0,191.0,97.05,95.4,100.55,97.75,8,4,4,0.5,9,6,3,0.667,2,2,4,2,202.4,192.0,197.2
2012-11-14,1610612755,1610612765,2012,76.0,94.0,170.0,92.7,90.45,91.6,94.1,7,4,3,0.5710000000000001,8,0,8,0.0,1,3,0,0,181.24,187.52,184.38
2012-11-14,1610612738,1610612762,2012,98.0,93.0,191.0,94.75,97.2,98.35,94.9,7,4,3,0.5710000000000001,8,4,4,0.5,1,3,3,1,179.28,197.56,188.42000000000002
2012-11-14,1610612749,1610612754,2012,99.0,85.0,184.0,96.4,97.1,90.5,92.4,6,4,2,0.667,8,3,5,0.375,1,3,2,1,201.68,189.52,195.60000000000002
2012-11-14,1610612745,1610612740,2012,100.0,96.0,196.0,98.5,98.5,87.69999999999997,89.55000000000003,7,3,4,0.429,5,3,2,0.6,1,2,2,1,197.32,181.88,189.6
2012-11-14,1610612760,1610612763,2012,97.0,107.0,204.0,99.2,96.25,97.1,94.25,8,6,2,0.75,6,5,1,0.833,4,2,3,2,196.84,193.16,195.0
2012-11-14,1610612750,1610612766,2012,87.0,89.0,176.0,92.2,91.9,90.7,100.9,7,5,2,0.7140000000000001,6,3,3,0.5,3,2,3,0,188.52,186.6,187.56
2012-11-14,1610612742,1610612764,2012,107.0,101.0,208.0,96.65,97.45,94.75,95.85,8,4,4,0.5,6,0,6,0.0,3,1,0,0,194.48,194.52,194.5
2012-11-14,1610612756,1610612741,2012,106.0,112.0,218.0,97.5,100.5,90.85,87.4,8,4,4,0.5,7,4,3,0.5710000000000001,3,1,3,1,199.88,181.72,190.8
2012-11-14,1610612746,1610612748,2012,107.0,100.0,207.0,95.8,93.95,100.45,96.35,7,5,2,0.7140000000000001,8,6,2,0.75,3,2,4,2,192.04,192.0,192.01999999999998
2012-11-14,1610612744,1610612737,2012,92.0,88.0,180.0,95.15,96.9,92.0,91.45,7,3,4,0.429,6,3,3,0.5,1,2,1,2,200.92,191.04,195.98
2012-11-13,1610612766,1610612764,2012,92.0,76.0,168.0,90.1,101.35,95.35,96.25,5,2,3,0.4,5,0,5,0.0,2,0,0,0,187.24,194.52,190.88
2012-11-13,1610612753,1610612752,2012,89.0,99.0,188.0,91.4,98.05,95.8,94.95,6,2,4,0.333,4,4,0,1.0,2,0,3,1,192.48,188.72,190.6
2012-11-13,1610612754,1610612761,2012,72.0,74.0,146.0,91.55,92.6,96.65,96.4,7,3,4,0.429,7,1,6,0.14300000000000002,2,1,1,0,191.32,189.64,190.48
2012-11-13,1610612751,1610612739,2012,114.0,101.0,215.0,93.35,97.65,93.3,102.3,5,3,2,0.6,7,2,5,0.28600000000000003,2,1,1,1,196.8,192.28,194.54000000000002
2012-11-13,1610612758,1610612757,2012,86.0,103.0,189.0,98.3,99.5,97.3,102.05,7,2,5,0.28600000000000003,7,2,5,0.28600000000000003,2,0,1,1,206.84,198.24,202.54000000000002
2012-11-13,1610612747,1610612759,2012,82.0,84.0,166.0,92.1,99.1,100.55,98.9,7,3,4,0.429,7,6,1,0.857,3,0,3,3,196.2,201.04,198.62
2012-11-12,1610612761,1610612762,2012,133.0,140.0,273.0,94.2,93.35,95.5,93.95,6,1,5,0.16699999999999998,7,3,4,0.429,1,0,3,0,186.56,197.56,192.06
2012-11-12,1610612755,1610612749,2012,96.0,105.0,201.0,91.85,89.1,96.8,97.15,6,4,2,0.667,5,3,2,0.6,1,3,1,2,180.72,201.68,191.2
2012-11-12,1610612765,1610612760,2012,90.0,92.0,182.0,91.8,94.5,100.15,97.75,7,0,7,0.0,7,5,2,0.7140000000000001,0,0,4,1,188.28,196.84,192.56
2012-11-12,1610612741,1610612738,2012,95.0,101.0,196.0,90.25,86.65,93.45,96.55,6,4,2,0.667,6,3,3,0.5,3,1,1,2,180.64,179.28,179.95999999999998
2012-11-12,1610612745,1610612748,2012,110.0,113.0,223.0,98.1,98.1,99.35,95.5,6,3,3,0.5,7,5,2,0.7140000000000001,1,2,4,1,195.84,192.0,193.92000000000002
2012-11-12,1610612742,1610612750,2012,82.0,90.0,172.0,97.75,97.65,92.2,92.75,7,4,3,0.5710000000000001,6,4,2,0.667,3,1,3,1,194.08,188.52,191.3
2012-11-12,1610612756,1610612743,2012,110.0,100.0,210.0,96.85,100.95,97.35,95.1,7,3,4,0.429,7,4,3,0.5710000000000001,2,1,2,2,199.16,202.4,200.78
2012-11-12,1610612757,1610612737,2012,87.0,95.0,182.0,97.4,102.0,92.7,91.45,6,2,4,0.333,5,2,3,0.4,1,1,1,1,200.28,191.04,195.66
2012-11-11,1610612751,1610612753,2012,82.0,74.0,156.0,93.35,98.65,91.5,98.35,4,2,2,0.5,5,2,3,0.4,1,1,2,0,197.64,192.48,195.06
2012-11-11,1610612746,1610612737,2012,89.0,76.0,165.0,96.3,95.25,94.35,91.05,6,4,2,0.667,4,2,2,0.5,2,2,1,1,192.24,191.04,191.64
2012-11-11,1610612763,1610612748,2012,104.0,86.0,190.0,96.3,93.75,99.6,95.35,5,4,1,0.8,6,5,1,0.833,2,2,4,1,192.16,192.0,192.07999999999998
2012-11-11,1610612760,1610612739,2012,106.0,91.0,197.0,100.1,97.9,92.6,102.8,6,4,2,0.667,6,2,4,0.333,3,1,1,1,195.76,192.28,194.01999999999998
2012-11-11,1610612747,1610612758,2012,103.0,90.0,193.0,90.7,99.25,98.25,100.1,6,2,4,0.333,6,2,4,0.333,2,0,2,0,195.4,206.84,201.12
2012-11-10,1610612761,1610612755,2012,83.0,93.0,176.0,93.8,93.35,91.75,89.55,5,1,4,0.2,5,3,2,0.6,1,0,1,2,187.08,180.72,183.9
2012-11-10,1610612754,1610612764,2012,89.0,85.0,174.0,90.95,92.4,95.9,96.05,6,2,4,0.333,4,0,4,0.0,1,1,0,0,191.96,194.52,193.24
2012-11-10,1610612766,1610612742,2012,101.0,97.0,198.0,88.45,101.5,98.95,98.75,4,1,3,0.25,6,4,2,0.667,1,0,3,1,187.52,194.08,190.8
2012-11-10,1610612741,1610612750,2012,87.0,80.0,167.0,90.5,87.05000000000003,93.6,94.2,5,3,2,0.6,5,4,1,0.8,2,1,3,1,181.52,188.52,185.02
2012-11-10,1610612745,1610612765,2012,96.0,82.0,178.0,98.55,99.6,92.55,94.85,5,2,3,0.4,6,0,6,0.0,0,2,0,0,197.08,188.28,192.68
2012-11-10,1610612749,1610612738,2012,92.0,96.0,188.0,97.15,97.6,92.8,96.55,4,3,1,0.75,5,2,3,0.4,1,2,1,1,201.48,179.28,190.38
2012-11-10,1610612762,1610612756,2012,94.0,81.0,175.0,96.65,95.25,98.4,101.5,6,2,4,0.333,6,3,3,0.5,2,0,2,1,198.08,199.16,198.62
2012-11-10,1610612757,1610612759,2012,109.0,112.0,221.0,97.0,100.8,100.05,98.4,5,2,3,0.4,6,5,1,0.833,1,1,3,2,199.4,201.04,200.22
2012-11-10,1610612744,1610612743,2012,101.0,107.0,208.0,95.7,96.4,96.35,94.85,6,3,3,0.5,6,3,3,0.5,1,2,2,1,201.4,202.4,201.9
2012-11-09,1610612764,1610612749,2012,91.0,101.0,192.0,96.2,94.8,97.7,97.95,3,0,3,0.0,3,2,1,0.667,0,0,1,1,193.52,201.48,197.5
2012-11-09,1610612753,1610612751,2012,68.0,107.0,175.0,93.75,98.0,93.1,100.25,4,2,2,0.5,3,1,2,0.333,2,0,1,0,193.08,197.64,195.36
2012-11-09,1610612738,1610612755,2012,100.0,106.0,206.0,92.05,95.0,89.9,88.4,4,2,2,0.5,4,2,2,0.5,1,1,1,1,177.6,180.72,179.16
2012-11-09,1610612752,1610612742,2012,104.0,94.0,198.0,95.15,94.0,99.65,99.15,3,3,0,1.0,5,4,1,0.8,2,1,3,1,188.28,194.08,191.18
2012-11-09,1610612737,1610612748,2012,89.0,95.0,184.0,95.35,91.4,100.1,95.55,3,2,1,0.667,5,4,1,0.8,1,1,4,0,191.4,192.0,191.7
2012-11-09,1610612763,1610612745,2012,93.0,85.0,178.0,97.1,94.55,99.0,99.4,4,3,1,0.75,4,2,2,0.5,1,2,0,2,193.32,197.08,195.2
2012-11-09,1610612740,1610612766,2012,107.0,99.0,206.0,87.6,89.4,88.0,100.9,4,2,2,0.5,3,1,2,0.333,1,1,1,0,179.92,187.52,183.72
2012-11-09,1610612760,1610612765,2012,105.0,94.0,199.0,100.2,98.15,92.05,95.4,5,3,2,0.6,5,0,5,0.0,2,1,0,0,195.4,188.28,191.84
2012-11-09,1610612750,1610612754,2012,96.0,94.0,190.0,92.9,94.25,90.15,91.35,4,3,1,0.75,5,2,3,0.4,2,1,1,1,188.56,191.96,190.26
2012-11-09,1610612756,1610612739,2012,107.0,105.0,212.0,99.3,101.6,92.25,101.9,5,2,3,0.4,5,2,3,0.4,1,1,1,1,198.36,192.28,195.32
2012-11-09,1610612758,1610612759,2012,86.0,97.0,183.0,98.3,100.45,100.0,98.4,5,2,3,0.4,5,4,1,0.8,2,0,3,1,207.84,201.04,204.44
2012-11-09,1610612743,1610612762,2012,104.0,84.0,188.0,96.8,96.0,97.0,95.35,5,2,3,0.4,5,2,3,0.4,1,1,2,0,202.92,198.08,200.5
2012-11-09,1610612747,1610612744,2012,101.0,77.0,178.0,89.8,100.9,96.65,96.3,5,1,4,0.2,5,3,2,0.6,1,0,1,2,196.08,201.4,198.74
2012-11-08,1610612741,1610612760,2012,91.0,97.0,188.0,89.80000000000003,85.65,100.25,98.65,4,3,1,0.75,4,2,2,0.5,2,1,2,0,182.32,195.4,188.86
2012-11-08,1610612757,1610612746,2012,90.0,103.0,193.0,97.35,100.75,96.1,95.65,4,2,2,0.5,5,3,2,0.6,1,1,2,1,200.4,192.24,196.32
2012-11-07,1610612766,1610612756,2012,110.0,117.0,227.0,85.85,98.8,98.1,101.3,2,1,1,0.5,4,1,3,0.25,1,0,1,0,186.04,198.36,192.2
2012-11-07,1610612738,1610612764,2012,100.0,94.0,194.0,92.1,94.55,95.8,94.0,3,1,2,0.333,2,0,2,0.0,0,1,0,0,177.44,193.52,185.48000000000002
2012-11-07,1610612737,1610612754,2012,89.0,86.0,175.0,96.5,92.75,90.15,91.65,2,1,1,0.5,4,2,2,0.5,0,1,1,1,191.08,191.96,191.52
2012-11-07,1610612748,1610612751,2012,103.0,73.0,176.0,100.15,96.8,93.65,99.75,4,3,1,0.75,2,1,1,0.5,3,0,1,0,191.68,197.64,194.66
2012-11-07,1610612749,1610612763,2012,90.0,108.0,198.0,98.55,98.1,95.95,94.05,2,2,0,1.0,3,2,1,0.667,1,1,1,1,200.8,193.32,197.06
2012-11-07,1610612740,1610612755,2012,62.0,77.0,139.0,89.05,90.2,91.5,89.9,3,2,1,0.667,3,1,2,0.333,1,1,1,0,182.04,180.72,181.38
2012-11-07,1610612745,1610612743,2012,87.0,93.0,180.0,99.2,99.9,97.25,96.6,3,2,1,0.667,4,1,3,0.25,0,2,1,0,197.52,202.92,200.22
2012-11-07,1610612750,1610612753,2012,90.0,75.0,165.0,92.9,96.2,93.7,98.55,3,2,1,0.667,3,2,1,0.667,1,1,2,0,190.28,193.08,191.68
2012-11-07,1610612742,1610612761,2012,109.0,104.0,213.0,100.05,99.45,92.35,92.45,4,3,1,0.75,4,1,3,0.25,2,1,1,0,193.0,187.08,190.04000000000002
2012-11-07,1610612762,1610612747,2012,95.0,86.0,181.0,98.4,97.1,90.35,102.2,4,1,3,0.25,4,1,3,0.25,1,0,1,0,198.16,196.08,197.12
2012-11-07,1610612758,1610612765,2012,105.0,103.0,208.0,97.3,99.95,92.35,94.4,4,1,3,0.25,4,0,4,0.0,1,0,0,0,207.48,188.28,197.88
2012-11-07,1610612746,1610612759,2012,106.0,84.0,190.0,95.1,96.25,100.15,97.15,4,2,2,0.5,4,4,0,1.0,1,1,3,1,192.08,201.04,196.56
2012-11-07,1610612744,1610612739,2012,106.0,96.0,202.0,96.35,96.6,91.6,101.7,4,2,2,0.5,4,2,2,0.5,0,2,1,1,200.64,192.28,196.45999999999998
2012-11-06,1610612741,1610612753,2012,99.0,93.0,192.0,89.45,86.45,94.4,99.45,3,2,1,0.667,2,2,0,1.0,1,1,2,0,182.76,193.08,187.92000000000002
2012-11-06,1610612760,1610612761,2012,108.0,88.0,196.0,100.3,99.4,92.9,90.95,3,1,2,0.333,3,1,2,0.333,1,0,1,0,199.12,187.08,193.10000000000002
2012-11-06,1610612743,1610612765,2012,109.0,97.0,206.0,97.95,95.95,91.95,94.9,3,0,3,0.0,3,0,3,0.0,0,0,0,0,203.08,188.28,195.68
2012-11-05,1610612755,1610612752,2012,88.0,110.0,198.0,91.55,88.5,94.85,93.8,2,1,1,0.5,2,2,0,1.0,1,0,2,0,180.0,188.28,184.14
2012-11-05,1610612751,1610612750,2012,96.0,107.0,203.0,93.25,99.75,92.85,97.35,1,1,0,1.0,2,1,1,0.5,1,0,1,0,197.72,190.28,194.0
2012-11-05,1610612748,1610612756,2012,124.0,99.0,223.0,98.5,96.1,98.85,99.6,3,2,1,0.667,3,1,2,0.333,2,0,1,0,190.24,198.36,194.3
2012-11-05,1610612763,1610612762,2012,103.0,94.0,197.0,95.45,93.8,99.3,96.5,2,1,1,0.5,3,1,2,0.333,0,1,1,0,193.64,198.16,195.89999999999998
2012-11-05,1610612742,1610612757,2012,114.0,91.0,205.0,99.85,99.9,98.15,101.3,3,2,1,0.667,3,2,1,0.667,1,1,1,1,192.32,200.4,196.36
2012-11-05,1610612759,1610612754,2012,101.0,79.0,180.0,100.5,97.8,91.25,91.55,3,3,0,1.0,3,2,1,0.667,2,1,1,1,203.16,191.96,197.56
2012-11-05,1610612758,1610612744,2012,94.0,92.0,186.0,97.6,100.8,96.45,97.1,3,0,3,0.0,3,2,1,0.667,0,0,0,2,207.32,200.64,203.98
2012-11-05,1610612746,1610612739,2012,101.0,108.0,209.0,94.45,95.35,92.05,102.75,3,2,1,0.667,3,1,2,0.333,1,1,1,0,190.84,192.28,191.56
2012-11-04,1610612752,1610612755,2012,100.0,84.0,184.0,95.25,93.9,91.9,88.65,1,1,0,1.0,1,1,0,1.0,1,0,1,0,188.56,180.0,184.28
2012-11-04,1610612761,1610612750,2012,105.0,86.0,191.0,91.65,90.85,92.95,96.25,2,0,2,0.0,1,1,0,1.0,0,0,1,0,188.2,190.28,189.24
2012-11-04,1610612753,1610612756,2012,115.0,94.0,209.0,92.7,100.2,99.1,99.1,1,1,0,1.0,2,1,1,0.5,1,0,1,0,192.36,198.36,195.36
2012-11-04,1610612760,1610612737,2012,95.0,104.0,199.0,100.65,98.3,95.6,92.4,2,1,1,0.5,1,0,1,0.0,1,0,0,0,199.36,191.08,195.22000000000003
2012-11-04,1610612747,1610612765,2012,108.0,79.0,187.0,89.95,103.4,91.75,94.4,3,0,3,0.0,2,0,2,0.0,0,0,0,0,196.52,188.28,192.4
2012-11-03,1610612764,1610612738,2012,86.0,89.0,175.0,95.35,93.5,93.0,94.8,1,0,1,0.0,2,0,2,0.0,0,0,0,0,194.28,177.44,185.86
2012-11-03,1610612754,1610612758,2012,106.0,98.0,204.0,90.3,91.25,97.5,100.75,2,1,1,0.5,2,0,2,0.0,0,1,0,0,192.0,207.32,199.66
2012-11-03,1610612751,1610612761,2012,107.0,100.0,207.0,94.0,100.6,91.7,90.6,0,0,0,0.0,1,0,1,0.0,0,0,0,0,197.12,188.2,192.66
2012-11-03,1610612748,1610612743,2012,119.0,116.0,235.0,97.6,94.7,97.15,95.2,2,1,1,0.5,2,0,2,0.0,1,0,0,0,189.72,203.08,196.4
2012-11-03,1610612741,1610612740,2012,82.0,89.0,171.0,90.5,86.55000000000003,88.35,89.45,2,2,0,1.0,2,1,1,0.5,1,1,1,0,184.24,182.04,183.14
2012-11-03,1610612745,1610612757,2012,85.0,95.0,180.0,100.05,100.35,98.55,102.25,2,2,0,1.0,2,1,1,0.5,0,2,1,0,197.52,200.4,198.96
2012-11-03,1610612749,1610612739,2012,105.0,102.0,207.0,97.75,98.45,91.15,101.5,1,1,0,1.0,2,1,1,0.5,0,1,1,0,200.92,192.28,196.6
2012-11-03,1610612742,1610612766,2012,126.0,99.0,225.0,98.4,99.9,85.55,98.5,2,1,1,0.5,1,1,0,1.0,0,1,1,0,190.96,186.04,188.5
2012-11-03,1610612759,1610612762,2012,110.0,100.0,210.0,100.7,96.95,99.2,96.15,2,2,0,1.0,2,1,1,0.5,1,1,1,0,203.12,198.16,200.64
2012-11-03,1610612746,1610612744,2012,110.0,114.0,224.0,94.0,94.5,95.95,97.2,2,2,0,1.0,2,1,1,0.5,1,1,0,1,189.0,200.64,194.82
2012-11-02,1610612766,1610612754,2012,90.0,89.0,179.0,85.15,98.75,90.7,90.45,0,0,0,0.0,1,1,0,1.0,0,0,0,1,186.36,192.0,189.18
2012-11-02,1610612753,1610612743,2012,102.0,89.0,191.0,93.55,100.2,97.1,95.25,0,0,0,0.0,1,0,1,0.0,0,0,0,0,191.76,203.08,197.42000000000002
2012-11-02,1610612738,1610612749,2012,88.0,99.0,187.0,92.65,93.95,98.85,98.25,1,0,1,0.0,0,0,0,0.0,0,0,0,0,177.52,200.92,189.22
2012-11-02,1610612737,1610612745,2012,102.0,109.0,211.0,95.35,91.55,99.8,99.6,0,0,0,0.0,1,1,0,1.0,0,0,0,1,189.08,197.52,193.3
2012-11-02,1610612739,1610612741,2012,86.0,115.0,201.0,91.75,100.95,88.65,86.85,1,1,0,1.0,1,1,0,1.0,1,0,1,0,192.16,184.24,188.2
2012-11-02,1610612752,1610612748,2012,104.0,84.0,188.0,94.5,93.7,98.45,94.15,0,0,0,0.0,1,1,0,1.0,0,0,1,0,189.32,189.72,189.51999999999998
2012-11-02,1610612740,1610612762,2012,88.0,86.0,174.0,88.9,89.65,99.15,96.55,1,0,1,0.0,1,1,0,1.0,0,0,1,0,184.0,198.16,191.07999999999998
2012-11-02,1610612760,1610612757,2012,106.0,92.0,198.0,100.65,98.2,98.65,102.75,1,0,1,0.0,1,1,0,1.0,0,0,1,0,199.68,200.4,200.04000000000002
2012-11-02,1610612750,1610612758,2012,92.0,80.0,172.0,93.05,97.1,98.5,101.65,0,0,0,0.0,1,0,1,0.0,0,0,0,0,191.68,207.32,199.5
2012-11-02,1610612756,1610612765,2012,92.0,89.0,181.0,100.75,99.9,92.1,94.85,1,0,1,0.0,1,0,1,0.0,0,0,0,0,199.12,188.28,193.7
2012-11-02,1610612747,1610612746,2012,95.0,105.0,200.0,90.15,102.95,93.4,94.7,2,0,2,0.0,1,1,0,1.0,0,0,1,0,196.48,189.0,192.74
2012-11-02,1610612744,1610612763,2012,94.0,104.0,198.0,95.6,97.1,94.8,93.3,1,1,0,1.0,1,0,1,0.0,0,1,0,0,201.88,193.64,197.76
2012-11-01,1610612759,1610612760,2012,86.0,84.0,170.0,101.7,97.3,101.6,98.9,1,1,0,1.0,0,0,0,0.0,0,1,0,0,205.44,199.68,202.56
2012-10-31,1610612761,1610612754,2012,88.0,90.0,178.0,91.9,90.45,91.3,90.9,0,0,0,0.0,0,0,0,0.0,0,0,0,0,188.16,192.0,190.07999999999998
2012-10-31,1610612755,1610612743,2012,84.0,75.0,159.0,91.65,88.6,99.9,96.15,0,0,0,0.0,0,0,0,0.0,0,0,0,0,179.92,203.08,191.5
2012-10-31,1610612765,1610612745,2012,96.0,105.0,201.0,92.15,95.25,100.15,100.15,0,0,0,0.0,0,0,0,0.0,0,0,0,0,187.28,197.52,192.4
2012-10-31,1610612741,1610612758,2012,93.0,87.0,180.0,89.35,86.25,98.85,102.45,0,0,0,0.0,0,0,0,0.0,0,0,0,0,184.76,207.32,196.04
2012-10-31,1610612740,1610612759,2012,95.0,99.0,194.0,88.85,89.30000000000003,101.85,97.05,0,0,0,0.0,0,0,0,0.0,0,0,0,0,182.88,205.44,194.16
2012-10-31,1610612762,1610612742,2012,113.0,94.0,207.0,98.05,96.05,98.55,98.95,0,0,0,0.0,1,1,0,1.0,0,0,0,1,198.36,190.96,194.66000000000003
2012-10-31,1610612756,1610612744,2012,85.0,87.0,172.0,101.1,99.3,96.75,98.75,0,0,0,0.0,0,0,0,0.0,0,0,0,0,199.64,201.88,200.76
2012-10-31,1610612746,1610612763,2012,101.0,92.0,193.0,92.7,94.4,93.95,92.65,0,0,0,0.0,0,0,0,0.0,0,0,0,0,188.44,193.64,191.04
2012-10-31,1610612757,1610612747,2012,116.0,106.0,222.0,98.8,102.75,89.8,101.5,0,0,0,0.0,1,0,1,0.0,0,0,0,0,200.08,196.48,198.28
2012-10-30,1610612739,1610612764,2012,94.0,84.0,178.0,92.2,101.25,95.5,93.0,7,3,4,0.429,8,3,5,0.375,2,1,0,3,192.44,194.28,193.36
2012-10-30,1610612748,1610612738,2012,120.0,107.0,227.0,96.95,93.5,91.6,92.3,8,4,4,0.5,8,3,5,0.375,2,2,1,2,187.56,177.52,182.54000000000002
2012-10-30,1610612747,1610612742,2012,91.0,99.0,190.0,90.05,100.9,99.2,99.55,8,0,8,0.0,8,4,4,0.5,0,0,3,1,196.96,190.96,193.96
2012-10-26,1610612753,1610612745,2012,92.0,108.0,200.0,92.95,99.6,99.7,100.2,7,2,5,0.28600000000000003,6,4,2,0.667,2,0,3,1,191.4,197.52,194.46
2012-10-26,1610612741,1610612754,2012,97.0,90.0,187.0,89.15,85.9,92.05,91.0,6,4,2,0.667,6,4,2,0.667,4,0,3,1,183.84,192.0,187.92000000000002
2012-10-26,1610612765,1610612737,2012,104.0,88.0,192.0,91.9,95.55,96.75,91.15,7,3,4,0.429,6,3,3,0.5,3,0,3,0,186.32,189.08,187.7
2012-10-26,1610612763,1610612761,2012,106.0,120.0,226.0,93.8,91.2,90.25,90.45,7,4,3,0.5710000000000001,6,5,1,0.833,3,1,5,0,191.64,188.16,189.89999999999998
2012-10-26,1610612749,1610612750,2012,76.0,100.0,176.0,100.85,97.95,92.35,97.95,7,3,4,0.429,6,4,2,0.667,1,2,4,0,201.6,191.68,196.64
2012-10-26,1610612748,1610612740,2012,89.0,96.0,185.0,98.25,94.25,89.2,91.25,7,4,3,0.5710000000000001,7,3,4,0.429,2,2,2,1,187.32,182.88,185.1
2012-10-26,1610612742,1610612766,2012,99.0,82.0,181.0,99.0,99.7,85.4,98.4,7,3,4,0.429,7,1,6,0.14300000000000002,2,1,1,0,191.12,186.36,188.74
2012-10-26,1610612759,1610612764,2012,100.0,85.0,185.0,103.05,97.25,94.5,93.15,6,3,3,0.5,7,3,4,0.429,2,1,0,3,206.96,194.28,200.62
2012-10-26,1610612756,1610612743,2012,88.0,72.0,160.0,101.7,101.05,101.6,96.8,6,3,3,0.5,6,3,3,0.5,2,1,1,2,200.6,203.08,201.84
2012-10-25,1610612766,1610612749,2012,90.0,100.0,190.0,85.15,98.85,99.85,97.9,6,1,5,0.16699999999999998,6,2,4,0.333,1,0,1,1,186.64,201.6,194.12
2012-10-25,1610612762,1610612757,2012,97.0,91.0,188.0,98.4,96.4,99.2,102.75,7,4,3,0.5710000000000001,6,3,3,0.5,2,2,2,1,198.12,200.08,199.10000000000002
2012-10-25,1610612747,1610612758,2012,82.0,94.0,176.0,90.9,101.3,99.35,103.5,7,0,7,0.0,6,4,2,0.667,0,0,2,2,197.48,207.32,202.39999999999998
2012-10-25,1610612743,1610612746,2012,94.0,106.0,200.0,102.15,96.45,92.5,95.15,5,3,2,0.6,7,4,3,0.5710000000000001,1,2,3,1,203.08,188.44,195.76
2012-10-24,1610612751,1610612752,2012,95.0,97.0,192.0,94.75,100.65,95.3,94.55,5,3,2,0.6,5,2,3,0.4,1,2,0,2,197.08,189.32,193.2
2012-10-24,1610612763,1610612753,2012,115.0,100.0,215.0,93.2,91.1,92.85,98.95,6,3,3,0.5,6,2,4,0.333,2,1,2,0,190.48,191.4,190.94
2012-10-24,1610612740,1610612745,2012,90.0,97.0,187.0,89.0,90.85,98.9,100.2,6,3,3,0.5,5,3,2,0.6,2,1,3,0,181.8,197.52,189.66000000000003
2012-10-24,1610612760,1610612742,2012,88.0,76.0,164.0,101.05,98.85,99.65,100.0,6,3,3,0.5,6,3,3,0.5,3,0,2,1,201.88,191.12,196.5
2012-10-24,1610612750,1610612765,2012,95.0,76.0,171.0,91.55,99.15,91.65,94.95,5,3,2,0.6,6,3,3,0.5,3,0,3,0,191.48,186.32,188.89999999999998
2012-10-24,1610612748,1610612764,2012,94.0,101.0,195.0,98.2,93.15,95.1,92.7,6,4,2,0.667,6,2,4,0.333,2,2,0,2,187.16,194.28,190.72
2012-10-24,1610612746,1610612747,2012,97.0,91.0,188.0,93.0,95.5,91.25,100.65,6,3,3,0.5,6,0,6,0.0,2,1,0,0,188.52,197.48,193.0
2012-10-23,1610612766,1610612748,2012,92.0,98.0,190.0,84.8,99.6,97.05,93.25,5,1,4,0.2,5,3,2,0.6,1,0,2,1,185.4,187.16,186.28
2012-10-23,1610612739,1610612754,2012,82.0,100.0,182.0,92.6,102.5,92.25,91.8,6,3,3,0.5,5,3,2,0.6,2,1,3,0,192.48,192.0,192.24
2012-10-23,1610612741,1610612760,2012,94.0,89.0,183.0,88.65,85.8,101.4,99.1,5,3,2,0.6,5,3,2,0.6,3,0,3,0,184.28,201.88,193.07999999999998
2012-10-23,1610612744,1610612756,2012,107.0,92.0,199.0,96.45,99.35,102.45,100.95,7,5,2,0.7140000000000001,5,3,2,0.6,2,3,2,1,201.68,200.6,201.14
2012-10-22,1610612761,1610612749,2012,104.0,95.0,199.0,90.0,90.3,100.7,97.3,5,4,1,0.8,5,2,3,0.4,4,0,1,1,187.64,201.6,194.62
2012-10-22,1610612755,1610612752,2012,98.0,90.0,188.0,91.6,89.19999999999997,95.3,94.55,6,5,1,0.833,4,2,2,0.5,2,3,0,2,178.6,189.32,183.95999999999998
2012-10-22,1610612742,1610612740,2012,87.0,74.0,161.0,99.05,101.0,89.05,91.1,5,2,3,0.4,5,3,2,0.6,1,1,2,1,191.92,181.8,186.86
2012-10-22,1610612756,1610612758,2012,103.0,88.0,191.0,102.25,100.85,100.25,104.0,4,2,2,0.5,5,4,1,0.8,1,1,2,2,201.8,207.32,204.56
2012-10-22,1610612757,1610612762,2012,120.0,114.0,234.0,98.15,101.7,97.85,94.95,5,2,3,0.4,6,4,2,0.667,1,1,2,2,197.92,198.12,198.01999999999998
2012-10-22,1610612746,1610612744,2012,88.0,71.0,159.0,93.2,95.8,97.1,101.1,5,2,3,0.4,6,5,1,0.833,1,1,2,3,190.4,201.68,196.04000000000002
2012-10-21,1610612753,1610612759,2012,104.0,100.0,204.0,92.7,99.15,103.4,97.1,5,1,4,0.2,5,3,2,0.6,1,0,2,1,191.6,206.96,199.28
2012-10-21,1610612738,1610612755,2012,79.0,88.0,167.0,92.25,92.45,91.5,90.65,7,3,4,0.429,5,4,1,0.8,1,2,2,2,179.88,178.6,179.24
2012-10-21,1610612760,1610612743,2012,108.0,101.0,209.0,101.95,98.55,103.0,96.4,4,2,2,0.5,4,3,1,0.75,2,0,1,2,201.8,203.08,202.44
2012-10-21,1610612747,1610612758,2012,92.0,99.0,191.0,91.85,100.7,100.7,104.95,5,0,5,0.0,4,3,1,0.75,0,0,2,1,197.48,207.32,202.39999999999998
2012-10-20,1610612748,1610612759,2012,104.0,101.0,205.0,97.6,92.35,103.85,97.2,4,2,2,0.5,4,3,1,0.75,1,1,2,1,186.64,206.96,196.8
2012-10-20,1610612737,1610612742,2012,110.0,94.0,204.0,97.05,90.65,99.35,100.4,5,2,3,0.4,4,2,2,0.5,2,0,1,1,188.68,191.92,190.3
2012-10-20,1610612754,1610612763,2012,83.0,80.0,163.0,93.25,92.65,94.05,92.3,4,2,2,0.5,5,3,2,0.6,2,0,2,1,192.16,190.48,191.32
2012-10-20,1610612738,1610612752,2012,109.0,98.0,207.0,90.95,91.55,95.6,93.85,6,2,4,0.333,3,2,1,0.667,0,2,0,2,179.64,189.32,184.48
2012-10-20,1610612765,1610612766,2012,85.0,80.0,165.0,92.5,95.7,86.15,100.85,5,2,3,0.4,4,1,3,0.25,2,0,1,0,188.04,185.4,186.72
2012-10-20,1610612749,1610612764,2012,94.0,102.0,196.0,100.75,96.7,94.9,93.5,4,2,2,0.5,5,1,4,0.2,1,1,0,1,202.24,194.28,198.26
2012-10-20,1610612762,1610612746,2012,99.0,91.0,190.0,98.15,95.75,93.15,95.5,5,3,2,0.6,4,2,2,0.5,1,2,1,1,198.08,190.4,194.24
2012-10-19,1610612761,1610612752,2012,107.0,88.0,195.0,89.7,91.55,96.75,93.85,4,3,1,0.75,2,2,0,1.0,3,0,0,2,186.24,189.32,187.78
2012-10-19,1610612753,1610612754,2012,112.0,96.0,208.0,92.0,99.35,93.9,91.85,4,0,4,0.0,3,2,1,0.667,0,0,2,0,191.12,192.16,191.64
2012-10-19,1610612751,1610612755,2012,96.0,106.0,202.0,94.95,99.55,90.7,90.1,4,3,1,0.75,4,3,1,0.75,1,2,2,1,196.8,178.6,187.7
2012-10-19,1610612741,1610612750,2012,92.0,81.0,173.0,88.85,86.05,94.5,102.0,4,2,2,0.5,4,3,1,0.75,2,0,3,0,185.4,191.48,188.44
2012-10-19,1610612760,1610612756,2012,107.0,97.0,204.0,101.7,98.65,102.85,100.5,3,1,2,0.333,3,2,1,0.667,1,0,1,1,202.32,201.8,202.06
2012-10-19,1610612747,1610612758,2012,98.0,103.0,201.0,92.1,99.95,101.35,106.0,4,0,4,0.0,3,2,1,0.667,0,0,2,0,196.48,207.32,201.89999999999998
2012-10-19,1610612757,1610612744,2012,97.0,101.0,198.0,98.05,102.1,96.95,101.45,4,2,2,0.5,5,4,1,0.8,1,1,2,2,197.2,201.68,199.44
2012-10-18,1610612737,1610612740,2012,97.0,68.0,165.0,96.5,92.35,89.9,90.65,4,1,3,0.25,4,3,1,0.75,1,0,2,1,189.44,181.8,185.62
2012-10-18,1610612748,1610612765,2012,105.0,78.0,183.0,96.1,92.35,92.95,94.2,3,1,2,0.333,4,2,2,0.5,0,1,2,0,186.96,188.04,187.5
2012-10-18,1610612749,1610612763,2012,94.0,97.0,191.0,101.4,96.75,94.05,91.7,3,2,1,0.667,4,2,2,0.5,1,1,2,0,202.72,190.48,196.6
2012-10-18,1610612751,1610612738,2012,85.0,115.0,200.0,94.9,99.05,89.55,91.3,3,3,0,1.0,5,1,4,0.2,1,2,0,1,197.32,179.64,188.48
2012-10-17,1610612761,1610612764,2012,104.0,101.0,205.0,89.75,91.3,94.55,93.25,3,2,1,0.667,4,1,3,0.25,2,0,0,1,186.2,194.28,190.24
2012-10-17,1610612755,1610612739,2012,113.0,99.0,212.0,89.5,89.9,92.55,102.2,3,2,1,0.667,5,3,2,0.6,1,1,2,1,177.72,192.48,185.1
2012-10-17,1610612745,1610612763,2012,109.0,102.0,211.0,98.35,99.55,93.2,91.0,4,2,2,0.5,3,2,1,0.667,2,0,2,0,198.2,190.48,194.33999999999997
2012-10-17,1610612742,1610612756,2012,94.0,100.0,194.0,99.15,99.45,102.15,100.95,3,2,1,0.667,2,1,1,0.5,1,1,1,0,192.2,201.8,197.0
2012-10-17,1610612758,1610612744,2012,88.0,98.0,186.0,102.75,106.5,96.9,101.75,2,2,0,1.0,4,3,1,0.75,2,0,2,1,208.16,201.68,204.92000000000002
2012-10-17,1610612757,1610612743,2012,97.0,80.0,177.0,97.7,102.45,104.25,96.65,3,1,2,0.333,3,3,0,1.0,0,1,1,2,197.36,203.08,200.22000000000003
2012-10-17,1610612746,1610612762,2012,96.0,94.0,190.0,93.95,96.0,98.65,96.65,3,1,2,0.333,4,3,1,0.75,0,1,1,2,190.72,198.08,194.4
2012-10-16,1610612754,1610612737,2012,102.0,98.0,200.0,94.1,92.4,96.1,92.0,2,1,1,0.5,3,1,2,0.333,1,0,1,0,192.04,189.44,190.74
2012-10-16,1610612738,1610612751,2012,96.0,97.0,193.0,89.8,90.4,93.55,98.55,4,1,3,0.25,2,2,0,1.0,0,1,1,1,179.84,197.32,188.57999999999998
2012-10-16,1610612765,1610612753,2012,112.0,86.0,198.0,92.85,95.25,92.7,97.95,3,1,2,0.333,3,0,3,0.0,1,0,0,0,188.08,191.12,189.60000000000002
2012-10-16,1610612741,1610612749,2012,100.0,94.0,194.0,88.75,85.65,102.5,96.1,3,1,2,0.333,2,2,0,1.0,1,0,1,1,184.4,202.72,193.56
2012-10-16,1610612760,1610612766,2012,120.0,98.0,218.0,100.65,98.65,85.69999999999997,99.95,2,0,2,0.0,3,1,2,0.333,0,0,1,0,201.04,185.4,193.22
2012-10-16,1610612747,1610612762,2012,80.0,114.0,194.0,93.8,99.55,98.05,97.5,3,0,3,0.0,3,2,1,0.667,0,0,1,1,197.6,198.08,197.84
2012-10-15,1610612755,1610612738,2012,107.0,75.0,182.0,88.25,90.55,89.75,89.2,2,1,1,0.5,3,1,2,0.333,0,1,0,1,177.84,179.84,178.84
2012-10-15,1610612739,1610612753,2012,114.0,111.0,225.0,91.05,102.7,91.4,96.9,4,2,2,0.5,2,0,2,0.0,1,1,0,0,192.48,191.12,191.8
2012-10-15,1610612751,1610612764,2012,98.0,88.0,186.0,93.75,98.6,94.75,93.3,1,1,0,1.0,3,1,2,0.333,0,1,0,1,197.68,194.28,195.98000000000002
2012-10-15,1610612742,1610612745,2012,123.0,104.0,227.0,97.65,99.7,97.45,98.35,2,1,1,0.5,3,2,1,0.667,0,1,2,0,191.8,198.2,195.0
2012-10-15,1610612743,1610612744,2012,104.0,98.0,202.0,104.85,97.5,96.7,101.45,2,2,0,1.0,3,3,0,1.0,0,2,2,1,202.56,201.68,202.12
2012-10-15,1610612758,1610612757,2012,117.0,100.0,217.0,101.85,107.05,97.55,101.5,1,1,0,1.0,2,1,1,0.5,1,0,0,1,208.28,197.36,202.82
2012-10-14,1610612748,1610612746,2012,89.0,99.0,188.0,96.4,91.7,94.2,96.45,2,1,1,0.5,2,0,2,0.0,0,1,0,0,187.2,190.72,188.95999999999998
2012-10-14,1610612745,1610612759,2012,107.0,116.0,223.0,97.75,97.85,104.4,96.95,2,2,0,1.0,3,2,1,0.667,2,0,2,0,196.52,206.96,201.74
2012-10-14,1610612763,1610612737,2012,110.0,102.0,212.0,92.9,90.55,96.05,91.9,2,1,1,0.5,2,1,1,0.5,1,0,1,0,189.6,189.44,189.51999999999998
2012-10-13,1610612755,1610612751,2012,105.0,108.0,213.0,86.9,90.1,92.5,97.05,1,1,0,1.0,0,0,0,0.0,0,1,0,0,176.44,197.68,187.06
2012-10-13,1610612738,1610612752,2012,95.0,98.0,193.0,89.5,88.5,96.15,94.0,2,1,1,0.5,1,1,0,1.0,0,1,0,1,179.56,189.32,184.44
2012-10-13,1610612739,1610612764,2012,95.0,99.0,194.0,90.05000000000003,102.1,94.25,93.2,3,2,1,0.667,2,0,2,0.0,1,1,0,0,192.36,194.28,193.32
2012-10-13,1610612750,1610612741,2012,82.0,75.0,157.0,96.25,103.25,89.9,85.4,2,1,1,0.5,2,1,1,0.5,1,0,1,0,193.16,184.4,188.78
2012-10-13,1610612749,1610612765,2012,108.0,91.0,199.0,101.85,96.5,92.25,93.7,1,1,0,1.0,2,1,1,0.5,0,1,1,0,202.84,188.08,195.46
2012-10-13,1610612747,1610612762,2012,86.0,99.0,185.0,94.05,100.2,97.9,98.45,2,0,2,0.0,2,1,1,0.5,0,0,1,0,197.76,198.08,197.92000000000002
2012-10-12,1610612761,1610612765,2012,82.0,75.0,157.0,90.7,93.4,92.45,94.65,2,1,1,0.5,1,1,0,1.0,1,0,1,0,187.72,188.08,187.9
2012-10-12,1610612754,1610612750,2012,96.0,91.0,187.0,95.2,93.3,96.7,104.25,1,0,1,0.0,1,1,0,1.0,0,0,1,0,191.76,193.16,192.45999999999998
2012-10-12,1610612741,1610612739,2012,83.0,86.0,169.0,90.4,85.4,89.5,102.5,1,1,0,1.0,2,1,1,0.5,1,0,1,0,184.92,192.36,188.64
2012-10-12,1610612745,1610612740,2012,95.0,75.0,170.0,97.95,99.15,90.8,90.85,1,1,0,1.0,3,3,0,1.0,1,0,2,1,196.88,181.8,189.34
2012-10-12,1610612759,1610612743,2012,91.0,97.0,188.0,105.55,97.0,104.85,98.1,2,2,0,1.0,1,1,0,1.0,2,0,0,1,207.16,202.56,204.86
2012-10-12,1610612762,1610612760,2012,97.0,81.0,178.0,98.2,99.6,101.75,98.65,1,0,1,0.0,1,0,1,0.0,0,0,0,0,199.64,201.04,200.33999999999997
2012-10-12,1610612756,1610612757,2012,104.0,93.0,197.0,102.4,101.35,97.7,101.45,1,0,1,0.0,1,1,0,1.0,0,0,0,1,200.72,197.36,199.04000000000002
2012-10-11,1610612746,1610612748,2012,80.0,94.0,174.0,95.65,96.45,96.05,92.15,1,0,1,0.0,1,0,1,0.0,0,0,0,0,191.88,187.2,189.54
2012-10-11,1610612764,1610612752,2012,101.0,108.0,209.0,93.8,92.55,95.55,92.95,1,0,1,0.0,0,0,0,0.0,0,0,0,0,194.4,189.32,191.86
2012-10-11,1610612753,1610612755,2012,95.0,102.0,197.0,91.3,95.8,87.05,89.69999999999997,1,0,1,0.0,0,0,0,0.0,0,0,0,0,191.72,176.44,184.07999999999998
2012-10-11,1610612766,1610612740,2012,87.0,90.0,177.0,86.15,101.25,91.4,90.85,2,1,1,0.5,2,2,0,1.0,1,0,2,0,186.36,181.8,184.08
2012-10-10,1610612765,1610612761,2012,101.0,99.0,200.0,91.05,94.1,90.9,93.7,0,0,0,0.0,1,1,0,1.0,0,0,1,0,187.48,187.72,187.6
2012-10-10,1610612745,1610612760,2012,107.0,105.0,212.0,98.05,98.05,101.25,97.25,0,0,0,0.0,0,0,0,0.0,0,0,0,0,196.56,201.04,198.8
2012-10-10,1610612750,1610612754,2012,84.0,70.0,154.0,96.95,105.5,96.9,94.2,0,0,0,0.0,0,0,0,0.0,0,0,0,0,194.12,191.76,192.94
2012-10-10,1610612759,1610612737,2012,101.0,99.0,200.0,106.55,96.9,95.85,91.45,1,1,0,1.0,1,1,0,1.0,1,0,1,0,206.12,189.44,197.78
2012-10-10,1610612758,1610612756,2012,102.0,96.0,198.0,102.35,108.1,103.0,100.4,0,0,0,0.0,0,0,0,0.0,0,0,0,0,207.84,200.72,204.28
2012-10-10,1610612747,1610612757,2012,75.0,93.0,168.0,95.9,100.95,97.8,103.25,1,0,1,0.0,0,0,0,0.0,0,0,0,0,198.84,197.36,198.10000000000002
2012-10-09,1610612739,1610612749,2012,80.0,97.0,177.0,89.65,103.05,103.0,97.4,1,1,0,1.0,0,0,0,0.0,1,0,0,0,192.44,202.84,197.64
2012-10-09,1610612741,1610612763,2012,92.0,88.0,180.0,90.45,85.94999999999997,93.2,90.35,0,0,0,0.0,1,1,0,1.0,0,0,1,0,184.48,189.6,187.04
2012-10-09,1610612740,1610612766,2012,97.0,82.0,179.0,91.4,91.25,86.85,101.45,1,1,0,1.0,1,1,0,1.0,1,0,1,0,182.88,186.36,184.62
2012-10-08,1610612744,1610612762,2012,83.0,80.0,163.0,98.1,102.85,98.3,100.15,1,1,0,1.0,0,0,0,0.0,0,1,0,0,202.4,199.64,201.01999999999998
2012-10-07,1610612766,1610612764,2012,100.0,88.0,188.0,86.25,102.0,93.2,91.95,0,0,0,0.0,0,0,0,0.0,0,0,0,0,186.4,194.4,190.4
2012-10-07,1610612737,1610612748,2012,92.0,79.0,171.0,96.3,92.3,96.45,91.05,0,0,0,0.0,0,0,0,0.0,0,0,0,0,190.16,187.2,188.68
2012-10-07,1610612740,1610612753,2012,85.0,80.0,165.0,91.75,92.3,91.7,95.65,0,0,0,0.0,0,0,0,0.0,0,0,0,0,182.84,191.72,187.28
2012-10-07,1610612747,1610612744,2012,83.0,110.0,193.0,96.9,100.3,98.2,104.7,0,0,0,0.0,0,0,0,0.0,0,0,0,0,199.52,202.4,200.96
2012-10-06,1610612746,1610612743,2012,104.0,106.0,210.0,95.85,96.8,104.4,98.5,0,0,0,0.0,0,0,0,0.0,0,0,0,0,190.92,202.56,196.74
2012-06-21,1610612748,1610612760,2011,121.0,106.0,227.0,95.7,90.45,101.25,96.9,66,46,20,0.6970000000000001,66,47,19,0.7120000000000001,28,18,26,21,185.0,201.04,193.01999999999998
2012-06-19,1610612748,1610612760,2011,104.0,98.0,202.0,95.7,90.25,101.5,96.3,66,46,20,0.6970000000000001,66,47,19,0.7120000000000001,28,18,26,21,184.28,201.04,192.66
2012-06-17,1610612748,1610612760,2011,91.0,85.0,176.0,96.15,89.35,102.7,96.6,66,46,20,0.6970000000000001,66,47,19,0.7120000000000001,28,18,26,21,184.24,201.04,192.64
2012-06-14,1610612760,1610612748,2011,96.0,100.0,196.0,102.95,96.9,94.65,89.75,66,47,19,0.7120000000000001,66,46,20,0.6970000000000001,26,21,28,18,201.96,184.24,193.10000000000002
2012-06-12,1610612760,1610612748,2011,105.0,94.0,199.0,103.6,97.7,93.25,88.4,66,47,19,0.7120000000000001,66,46,20,0.6970000000000001,26,21,28,18,201.44,184.24,192.84
2012-06-09,1610612748,1610612738,2011,101.0,88.0,189.0,93.05,88.4,89.69999999999997,88.3,66,46,20,0.6970000000000001,66,39,27,0.591,28,18,24,15,184.12,179.56,181.84
2012-06-07,1610612738,1610612748,2011,79.0,98.0,177.0,90.1,87.1,93.2,89.35,66,39,27,0.591,66,46,20,0.6970000000000001,24,15,28,18,179.92,184.12,182.01999999999998
2012-06-06,1610612760,1610612759,2011,107.0,99.0,206.0,104.0,97.2,107.2,96.1,66,47,19,0.7120000000000001,66,50,16,0.758,26,21,28,22,200.6,206.12,203.36
2012-06-05,1610612748,1610612738,2011,90.0,94.0,184.0,92.9,88.94999999999997,90.9,88.5,66,46,20,0.6970000000000001,66,39,27,0.591,28,18,24,15,184.36,179.92,182.14
2012-06-04,1610612759,1610612760,2011,103.0,108.0,211.0,107.3,95.25,102.45,96.65,66,50,16,0.758,66,47,19,0.7120000000000001,28,22,26,21,205.08,200.6,202.84
2012-06-03,1610612738,1610612748,2011,93.0,91.0,184.0,90.15,87.25,93.0,88.55,66,39,27,0.591,66,46,20,0.6970000000000001,24,15,28,18,179.56,184.36,181.96
2012-06-02,1610612760,1610612759,2011,109.0,103.0,212.0,101.9,96.5,108.15,94.75,66,47,19,0.7120000000000001,66,50,16,0.758,26,21,28,22,201.04,205.08,203.06
2012-06-01,1610612738,1610612748,2011,101.0,91.0,192.0,90.2,87.6,92.75,88.3,66,39,27,0.591,66,46,20,0.6970000000000001,24,15,28,18,179.0,184.36,181.68
2012-05-31,1610612760,1610612759,2011,102.0,82.0,184.0,101.35,96.15,108.25,94.2,66,47,19,0.7120000000000001,66,50,16,0.758,26,21,28,22,201.44,205.08,203.26
2012-05-30,1610612748,1610612738,2011,115.0,111.0,226.0,91.15,86.35,89.35,85.95,66,46,20,0.6970000000000001,66,39,27,0.591,28,18,24,15,184.44,179.0,181.72
2012-05-29,1610612759,1610612760,2011,120.0,111.0,231.0,107.6,93.5,101.55,95.65,66,50,16,0.758,66,47,19,0.7120000000000001,28,22,26,21,203.96,201.44,202.7
2012-05-28,1610612748,1610612738,2011,93.0,79.0,172.0,91.3,86.0,90.1,85.4,66,46,20,0.6970000000000001,66,39,27,0.591,28,18,24,15,184.28,179.0,181.64
2012-05-27,1610612759,1610612760,2011,101.0,98.0,199.0,106.75,93.5,102.1,95.05,66,50,16,0.758,66,47,19,0.7120000000000001,28,22,26,21,202.96,201.44,202.2
2012-05-26,1610612738,1610612755,2011,85.0,75.0,160.0,90.25,85.95,88.75,90.75,66,39,27,0.591,66,35,31,0.53,24,15,19,16,179.72,176.44,178.07999999999998
2012-05-24,1610612754,1610612748,2011,93.0,105.0,198.0,97.8,93.35,89.65,85.9,66,42,24,0.636,66,46,20,0.6970000000000001,23,19,28,18,192.84,184.28,188.56
2012-05-23,1610612755,1610612738,2011,82.0,75.0,157.0,89.4,91.5,90.45,86.05,66,35,31,0.53,66,39,27,0.591,19,16,24,15,177.36,179.72,178.54000000000002
2012-05-22,1610612748,1610612754,2011,115.0,83.0,198.0,89.15,85.85,98.8,93.2,66,46,20,0.6970000000000001,66,42,24,0.636,28,18,23,19,184.28,192.84,188.56
2012-05-21,1610612738,1610612755,2011,101.0,85.0,186.0,90.55,85.75,90.3,90.8,66,39,27,0.591,66,35,31,0.53,24,15,19,16,179.48,177.36,178.42000000000002
2012-05-21,1610612760,1610612747,2011,106.0,90.0,196.0,101.2,95.25,97.05,99.55,66,47,19,0.7120000000000001,66,41,25,0.621,26,21,26,15,203.28,199.52,201.4
2012-05-20,1610612754,1610612748,2011,93.0,101.0,194.0,99.25,92.3,89.75,86.25,66,42,24,0.636,66,46,20,0.6970000000000001,23,19,28,18,192.32,184.28,188.3
2012-05-20,1610612746,1610612759,2011,99.0,102.0,201.0,96.15,96.5,106.0,92.85,66,40,26,0.606,66,50,16,0.758,24,16,28,22,191.0,202.96,196.98000000000002
2012-05-19,1610612746,1610612759,2011,86.0,96.0,182.0,96.75,96.55,107.45,93.05,66,40,26,0.606,66,50,16,0.758,24,16,28,22,192.2,202.96,197.57999999999998
2012-05-19,1610612747,1610612760,2011,100.0,103.0,203.0,97.4,100.0,100.95,95.4,66,41,25,0.621,66,47,19,0.7120000000000001,26,15,26,21,197.96,203.28,200.62
2012-05-18,1610612755,1610612738,2011,92.0,83.0,175.0,90.85,90.9,92.15,86.5,66,35,31,0.53,66,39,27,0.591,19,16,24,15,176.08,179.48,177.78
2012-05-18,1610612747,1610612760,2011,99.0,96.0,195.0,97.0,99.55,100.8,95.35,66,41,25,0.621,66,47,19,0.7120000000000001,26,15,26,21,197.32,203.28,200.3
2012-05-17,1610612754,1610612748,2011,94.0,75.0,169.0,99.7,93.45,90.5,86.80000000000003,66,42,24,0.636,66,46,20,0.6970000000000001,23,19,28,18,192.8,184.28,188.54000000000002
2012-05-17,1610612759,1610612746,2011,105.0,88.0,193.0,107.9,93.85,97.1,95.4,66,50,16,0.758,66,40,26,0.606,28,22,24,16,202.84,192.2,197.51999999999998
2012-05-16,1610612755,1610612738,2011,91.0,107.0,198.0,91.25,89.85,91.1,85.55000000000003,66,35,31,0.53,66,39,27,0.591,19,16,24,15,174.92,179.48,177.2
2012-05-16,1610612760,1610612747,2011,77.0,75.0,152.0,101.55,95.5,98.5,101.95,66,47,19,0.7120000000000001,66,41,25,0.621,26,21,26,15,205.08,197.32,201.2
2012-05-15,1610612748,1610612754,2011,75.0,78.0,153.0,92.1,88.65,100.0,94.7,66,46,20,0.6970000000000001,66,42,24,0.636,28,18,23,19,185.52,192.8,189.16000000000003
2012-05-15,1610612759,1610612746,2011,108.0,92.0,200.0,108.9,94.4,97.5,94.9,66,50,16,0.758,66,40,26,0.606,28,22,24,16,202.36,192.2,197.28
2012-05-14,1610612738,1610612755,2011,81.0,82.0,163.0,91.35,85.80000000000003,92.15,91.45,66,39,27,0.591,66,35,31,0.53,24,15,19,16,179.52,174.92,177.22
2012-05-14,1610612760,1610612747,2011,119.0,90.0,209.0,100.75,95.35,99.65,101.4,66,47,19,0.7120000000000001,66,41,25,0.621,26,21,26,15,204.56,197.32,200.94
2012-05-13,1610612763,1610612746,2011,72.0,82.0,154.0,94.3,90.5,97.65,96.0,66,41,25,0.621,66,40,26,0.606,26,15,24,16,190.04,192.2,191.12
2012-05-13,1610612748,1610612754,2011,95.0,86.0,181.0,92.25,88.1,101.95,95.15,66,46,20,0.6970000000000001,66,42,24,0.636,28,18,23,19,186.44,192.8,189.62
2012-05-12,1610612738,1610612755,2011,92.0,91.0,183.0,91.3,84.85,92.25,90.6,66,39,27,0.591,66,35,31,0.53,24,15,19,16,179.2,174.92,177.06
2012-05-12,1610612747,1610612743,2011,96.0,87.0,183.0,100.85,102.65,104.65,98.4,66,41,25,0.621,66,38,28,0.5760000000000001,26,15,20,18,197.48,202.56,200.01999999999998
2012-05-11,1610612746,1610612763,2011,88.0,90.0,178.0,98.4,95.8,94.75,90.85,66,40,26,0.606,66,41,25,0.621,24,16,26,15,192.64,190.04,191.33999999999997
2012-05-10,1610612755,1610612741,2011,79.0,78.0,157.0,92.25,90.8,91.25,86.1,66,35,31,0.53,66,50,16,0.758,19,16,26,24,175.08,184.48,179.78
2012-05-10,1610612738,1610612737,2011,83.0,80.0,163.0,91.85,84.95,97.45,92.5,66,39,27,0.591,66,40,26,0.606,24,15,23,17,179.92,190.16,185.04
2012-05-10,1610612743,1610612747,2011,113.0,96.0,209.0,103.75,99.2,101.25,102.05,66,38,28,0.5760000000000001,66,41,25,0.621,20,18,26,15,201.48,197.48,199.48
2012-05-09,1610612748,1610612752,2011,106.0,94.0,200.0,91.05,88.25,96.05,93.25,66,46,20,0.6970000000000001,66,36,30,0.545,28,18,22,14,186.04,189.32,187.68
2012-05-09,1610612763,1610612746,2011,92.0,80.0,172.0,94.85,91.3,99.05,95.45,66,41,25,0.621,66,40,26,0.606,26,15,24,16,190.08,192.64,191.36
2012-05-08,1610612754,1610612753,2011,105.0,87.0,192.0,100.3,95.1,92.1,95.5,66,42,24,0.636,66,37,29,0.561,23,19,21,16,192.92,191.72,192.32
2012-05-08,1610612737,1610612738,2011,87.0,86.0,173.0,99.1,92.85,91.85,85.25,66,40,26,0.606,66,39,27,0.591,23,17,24,15,190.64,179.92,185.27999999999997
2012-05-08,1610612741,1610612755,2011,77.0,69.0,146.0,91.55,86.19999999999997,94.15,91.35,66,50,16,0.758,66,35,31,0.53,26,24,19,16,188.08,175.08,181.58
2012-05-08,1610612747,1610612743,2011,99.0,102.0,201.0,100.7,101.2,103.85,99.3,66,41,25,0.621,66,38,28,0.5760000000000001,26,15,20,18,197.2,201.48,199.33999999999997
2012-05-07,1610612762,1610612759,2011,81.0,87.0,168.0,100.3,100.9,110.4,95.95,66,36,30,0.545,66,50,16,0.758,25,11,28,22,201.16,202.36,201.76
2012-05-07,1610612746,1610612763,2011,101.0,97.0,198.0,98.85,94.85,94.45,91.15,66,40,26,0.606,66,41,25,0.621,24,16,26,15,192.48,190.08,191.28
2012-05-06,1610612755,1610612741,2011,89.0,82.0,171.0,93.6,91.45,91.7,84.69999999999997,66,35,31,0.53,66,50,16,0.758,19,16,26,24,175.72,188.08,181.9
2012-05-06,1610612752,1610612748,2011,89.0,87.0,176.0,96.65,92.85,91.05,88.94999999999997,66,36,30,0.545,66,46,20,0.6970000000000001,22,14,28,18,190.24,186.04,188.14
2012-05-06,1610612738,1610612737,2011,101.0,79.0,180.0,91.2,85.1,99.25,92.6,66,39,27,0.591,66,40,26,0.606,24,15,23,17,178.44,190.64,184.54
2012-05-06,1610612743,1610612747,2011,88.0,92.0,180.0,104.35,99.25,101.55,101.45,66,38,28,0.5760000000000001,66,41,25,0.621,20,18,26,15,202.84,197.2,200.01999999999998
2012-05-05,1610612753,1610612754,2011,99.0,101.0,200.0,92.3,95.1,99.5,94.3,66,37,29,0.561,66,42,24,0.636,21,16,23,19,191.36,192.92,192.14
2012-05-05,1610612746,1610612763,2011,87.0,86.0,173.0,99.55,94.8,95.25,91.6,66,40,26,0.606,66,41,25,0.621,24,16,26,15,193.52,190.08,191.8
2012-05-05,1610612742,1610612760,2011,97.0,103.0,200.0,98.1,99.5,100.7,95.15,66,36,30,0.545,66,47,19,0.7120000000000001,23,13,26,21,191.6,204.56,198.07999999999998
2012-05-05,1610612762,1610612759,2011,90.0,102.0,192.0,100.65,100.3,110.65,96.45,66,36,30,0.545,66,50,16,0.758,25,11,28,22,200.88,202.36,201.62
2012-05-04,1610612738,1610612737,2011,90.0,84.0,174.0,91.9,85.19999999999997,100.9,94.0,66,39,27,0.591,66,40,26,0.606,24,15,23,17,177.48,190.64,184.06
2012-05-04,1610612755,1610612741,2011,79.0,74.0,153.0,94.85,92.3,93.3,85.94999999999997,66,35,31,0.53,66,50,16,0.758,19,16,26,24,177.04,188.08,182.56
2012-05-04,1610612743,1610612747,2011,99.0,84.0,183.0,103.9,100.2,102.55,101.85,66,38,28,0.5760000000000001,66,41,25,0.621,20,18,26,15,202.6,197.2,199.89999999999998
2012-05-03,1610612752,1610612748,2011,70.0,87.0,157.0,98.45,92.85,91.1,89.1,66,36,30,0.545,66,46,20,0.6970000000000001,22,14,28,18,193.28,186.04,189.66
2012-05-03,1610612742,1610612760,2011,79.0,95.0,174.0,99.2,99.55,101.4,95.95,66,36,30,0.545,66,47,19,0.7120000000000001,23,13,26,21,191.84,204.56,198.2
2012-05-02,1610612759,1610612762,2011,114.0,83.0,197.0,110.55,97.45,101.75,98.8,66,50,16,0.758,66,36,30,0.545,28,22,25,11,201.44,200.88,201.16
2012-05-02,1610612753,1610612754,2011,74.0,97.0,171.0,91.55,94.5,99.65,96.35,66,37,29,0.561,66,42,24,0.636,21,16,23,19,191.48,192.92,192.2
2012-05-02,1610612763,1610612746,2011,105.0,98.0,203.0,94.9,91.4,99.35,93.3,66,41,25,0.621,66,40,26,0.606,26,15,24,16,189.84,193.52,191.68
2012-05-01,1610612737,1610612738,2011,80.0,87.0,167.0,101.9,94.15,92.55,85.15,66,40,26,0.606,66,39,27,0.591,23,17,24,15,190.88,177.48,184.18
2012-05-01,1610612741,1610612755,2011,92.0,109.0,201.0,93.25,85.9,93.35,92.85,66,50,16,0.758,66,35,31,0.53,26,24,19,16,188.32,177.04,182.68
2012-05-01,1610612747,1610612743,2011,104.0,100.0,204.0,102.0,101.95,103.85,99.4,66,41,25,0.621,66,38,28,0.5760000000000001,26,15,20,18,194.76,202.6,198.68
2012-04-30,1610612748,1610612752,2011,104.0,94.0,198.0,90.8,89.05000000000003,98.25,92.65,66,46,20,0.6970000000000001,66,36,30,0.545,28,18,22,14,185.64,193.28,189.45999999999998
2012-04-30,1610612754,1610612753,2011,93.0,78.0,171.0,100.15,97.35,91.95,95.25,66,42,24,0.636,66,37,29,0.561,23,19,21,16,194.96,191.48,193.22
2012-04-30,1610612760,1610612742,2011,102.0,99.0,201.0,103.75,98.0,98.5,99.75,66,47,19,0.7120000000000001,66,36,30,0.545,26,21,23,13,204.32,191.84,198.07999999999998
2012-04-29,1610612759,1610612762,2011,106.0,91.0,197.0,109.9,96.7,103.85,100.45,66,50,16,0.758,66,36,30,0.545,28,22,25,11,201.28,200.88,201.07999999999998
2012-04-29,1610612747,1610612743,2011,103.0,88.0,191.0,101.65,102.65,104.25,99.5,66,41,25,0.621,66,38,28,0.5760000000000001,26,15,20,18,194.68,202.6,198.64
2012-04-29,1610612737,1610612738,2011,83.0,74.0,157.0,101.6,95.35,93.95,85.75,66,40,26,0.606,66,39,27,0.591,23,17,24,15,193.2,177.48,185.33999999999997
2012-04-29,1610612763,1610612746,2011,98.0,99.0,197.0,94.65,90.75,98.9,93.25,66,41,25,0.621,66,40,26,0.606,26,15,24,16,188.2,193.52,190.86
2012-04-28,1610612741,1610612755,2011,103.0,91.0,194.0,93.2,86.4,93.45,92.65,66,50,16,0.758,66,35,31,0.53,26,24,19,16,187.96,177.04,182.5
2012-04-28,1610612748,1610612752,2011,100.0,67.0,167.0,90.75,90.35,98.85,92.45,66,46,20,0.6970000000000001,66,36,30,0.545,28,18,22,14,186.04,193.28,189.66
2012-04-28,1610612754,1610612753,2011,77.0,81.0,158.0,101.9,98.5,93.75,96.45,66,42,24,0.636,66,37,29,0.561,23,19,21,16,196.76,191.48,194.12
2012-04-28,1610612760,1610612742,2011,99.0,98.0,197.0,104.5,97.65,98.65,99.75,66,47,19,0.7120000000000001,66,36,30,0.545,26,21,23,13,204.12,191.84,197.98000000000002
2012-04-26,1610612761,1610612751,2011,98.0,67.0,165.0,90.8,94.3,93.05,97.55,65,22,43,0.338,65,22,43,0.338,12,10,9,13,188.2,197.68,192.94
2012-04-26,1610612765,1610612755,2011,108.0,86.0,194.0,90.9,94.1,92.95,92.1,65,24,41,0.369,65,35,30,0.5379999999999999,17,7,19,16,186.88,177.04,181.95999999999998
2012-04-26,1610612738,1610612749,2011,87.0,74.0,161.0,94.45,86.65,104.55,98.0,65,38,27,0.585,65,31,34,0.477,23,15,17,14,177.8,202.84,190.32
2012-04-26,1610612764,1610612748,2011,104.0,70.0,174.0,92.15,92.7,91.45,89.05,65,19,46,0.292,65,46,19,0.708,10,9,28,18,195.72,186.04,190.88
2012-04-26,1610612766,1610612752,2011,84.0,104.0,188.0,86.2,101.2,97.75,92.2,65,7,58,0.108,65,35,30,0.5379999999999999,4,3,22,13,186.72,193.28,190.0
2012-04-26,1610612737,1610612742,2011,106.0,89.0,195.0,103.25,97.55,98.55,99.65,65,39,26,0.6,65,36,29,0.5539999999999999,22,17,23,13,192.64,191.84,192.24
2012-04-26,1610612741,1610612739,2011,107.0,75.0,182.0,92.3,86.65,90.15,102.85,65,49,16,0.754,65,21,44,0.32299999999999995,25,24,11,10,188.88,192.44,190.66
2012-04-26,1610612763,1610612753,2011,88.0,76.0,164.0,95.1,91.55,94.0,96.6,65,40,25,0.615,65,37,28,0.569,25,15,21,16,190.56,191.48,191.01999999999998
2012-04-26,1610612745,1610612740,2011,84.0,77.0,161.0,99.2,99.4,92.15,92.95,65,33,32,0.508,65,21,44,0.32299999999999995,21,12,11,10,198.4,182.84,190.62
2012-04-26,1610612750,1610612743,2011,102.0,131.0,233.0,96.95,104.2,103.1,98.95,65,26,39,0.4,65,37,28,0.569,13,13,20,17,192.2,202.6,197.39999999999998
2012-04-26,1610612762,1610612757,2011,96.0,94.0,190.0,104.0,100.35,98.1,102.9,65,35,30,0.5379999999999999,65,28,37,0.431,24,11,20,8,200.76,197.36,199.06
2012-04-26,1610612758,1610612747,2011,113.0,96.0,209.0,101.8,108.45,102.2,102.05,65,21,44,0.32299999999999995,65,41,24,0.631,15,6,26,15,208.08,194.68,201.38
2012-04-26,1610612744,1610612759,2011,101.0,107.0,208.0,97.8,104.2,109.0,95.95,65,23,42,0.354,65,49,16,0.754,12,11,28,21,201.48,201.28,201.38
2012-04-25,1610612753,1610612766,2011,102.0,95.0,197.0,93.2,95.35,85.80000000000003,101.45,64,36,28,0.563,64,7,57,0.109,20,16,4,3,190.48,186.72,188.6
2012-04-25,1610612739,1610612764,2011,85.0,96.0,181.0,90.25,103.2,92.75,92.9,64,21,43,0.328,64,18,46,0.281,11,10,10,8,192.52,195.72,194.12
2012-04-25,1610612754,1610612741,2011,87.0,92.0,179.0,102.2,98.35,92.5,86.85,65,42,23,0.6459999999999999,64,48,16,0.75,23,19,25,23,196.24,188.88,192.56
2012-04-25,1610612752,1610612746,2011,99.0,93.0,192.0,98.55,92.55,98.8,94.0,64,34,30,0.531,65,40,25,0.615,21,13,24,16,193.04,193.52,193.28
2012-04-25,1610612749,1610612755,2011,85.0,90.0,175.0,105.7,98.55,92.25,92.5,64,31,33,0.484,64,34,30,0.531,17,14,19,15,203.24,177.04,190.14
2012-04-25,1610612760,1610612743,2011,101.0,106.0,207.0,105.0,97.1,102.8,99.75,65,47,18,0.723,64,36,28,0.563,26,21,20,16,202.96,202.6,202.78
2012-04-25,1610612756,1610612759,2011,106.0,110.0,216.0,103.7,100.45,108.45,95.95,65,33,32,0.508,64,48,16,0.75,19,14,28,20,199.88,201.28,200.57999999999998
2012-04-24,1610612737,1610612746,2011,109.0,102.0,211.0,102.45,96.65,98.15,93.65,64,38,26,0.594,64,40,24,0.625,21,17,24,16,191.28,193.52,192.4
2012-04-24,1610612738,1610612748,2011,78.0,66.0,144.0,96.3,88.9,93.25,90.45,64,37,27,0.578,64,46,18,0.7190000000000001,22,15,28,18,179.44,186.04,182.74
2012-04-24,1610612760,1610612758,2011,118.0,110.0,228.0,104.35,97.3,100.7,107.35,64,46,18,0.7190000000000001,64,21,43,0.328,25,21,15,6,201.68,208.08,204.88
2012-04-24,1610612762,1610612756,2011,100.0,88.0,188.0,104.55,101.2,104.95,101.0,64,34,30,0.531,64,33,31,0.516,23,11,19,14,201.28,199.88,200.57999999999998
2012-04-24,1610612744,1610612740,2011,81.0,83.0,164.0,98.65,106.05,93.1,93.6,64,23,41,0.359,64,20,44,0.313,12,11,11,9,203.96,182.84,193.4
2012-04-23,1610612764,1610612766,2011,101.0,73.0,174.0,92.65,94.75,85.80000000000003,99.95,63,17,46,0.27,63,7,56,0.111,9,8,4,3,197.56,186.72,192.14
2012-04-23,1610612754,1610612765,2011,103.0,97.0,200.0,102.3,98.0,91.8,94.75,64,41,23,0.6409999999999999,64,24,40,0.375,22,19,17,7,196.44,186.88,191.66
2012-04-23,1610612751,1610612755,2011,87.0,105.0,192.0,93.15,97.7,92.25,92.15,64,22,42,0.344,63,33,30,0.524,9,13,19,14,196.68,177.04,186.86
2012-04-23,1610612749,1610612761,2011,92.0,86.0,178.0,106.3,100.5,92.2,95.2,63,30,33,0.476,64,22,42,0.344,16,14,12,10,203.68,188.2,195.94
2012-04-23,1610612763,1610612739,2011,109.0,101.0,210.0,95.15,92.2,89.2,102.4,64,39,25,0.609,63,21,42,0.333,24,15,11,10,189.68,192.52,191.10000000000002
2012-04-23,1610612759,1610612757,2011,124.0,89.0,213.0,107.45,95.85,97.6,102.75,63,47,16,0.746,64,28,36,0.438,27,20,20,8,200.04,197.36,198.7
2012-04-22,1610612737,1610612752,2011,112.0,113.0,225.0,102.0,96.1,98.0,91.35,63,38,25,0.603,63,33,30,0.524,21,17,21,12,189.64,193.04,191.33999999999997
2012-04-22,1610612747,1610612760,2011,114.0,106.0,220.0,101.65,101.55,103.55,96.45,64,40,24,0.625,63,46,17,0.73,25,15,25,21,193.16,201.68,197.42000000000002
2012-04-22,1610612766,1610612758,2011,88.0,114.0,202.0,86.15,99.35,100.35,108.7,62,7,55,0.113,63,20,43,0.317,4,3,15,5,187.12,208.08,197.60000000000002
2012-04-22,1610612748,1610612745,2011,97.0,88.0,185.0,93.7,90.3,99.35,99.3,63,45,18,0.7140000000000001,64,33,31,0.516,27,18,21,12,185.56,198.4,191.98000000000002
2012-04-22,1610612765,1610612761,2011,76.0,73.0,149.0,92.3,95.35,92.75,96.3,63,23,40,0.365,63,22,41,0.349,16,7,12,10,188.52,188.2,188.36
2012-04-22,1610612759,1610612739,2011,114.0,98.0,212.0,107.55,95.95,89.4,101.85,62,46,16,0.742,62,21,41,0.339,26,20,11,10,199.4,192.52,195.96
2012-04-22,1610612750,1610612744,2011,88.0,93.0,181.0,97.85,104.25,98.35,106.15,64,26,38,0.406,63,22,41,0.349,13,13,12,10,193.4,203.96,198.68
2012-04-22,1610612743,1610612753,2011,101.0,74.0,175.0,103.65,101.9,95.05,96.4,63,35,28,0.556,63,36,27,0.5710000000000001,19,16,20,16,203.68,190.48,197.07999999999998
2012-04-22,1610612746,1610612740,2011,107.0,98.0,205.0,97.15,92.9,92.95,92.7,63,39,24,0.619,63,20,43,0.317,23,16,11,9,192.52,182.84,187.68
2012-04-21,1610612756,1610612743,2011,107.0,118.0,225.0,105.8,101.45,102.85,102.6,63,33,30,0.524,62,34,28,0.5479999999999999,19,14,19,15,199.4,203.68,201.54000000000002
2012-04-21,1610612754,1610612755,2011,106.0,109.0,215.0,102.55,98.2,90.8,91.3,63,41,22,0.6509999999999999,62,32,30,0.516,22,19,19,13,195.24,177.04,186.14
2012-04-21,1610612748,1610612764,2011,84.0,86.0,170.0,94.45,90.75,92.95,95.4,62,45,17,0.726,62,16,46,0.258,27,18,9,7,186.96,197.56,192.26
2012-04-21,1610612741,1610612742,2011,93.0,83.0,176.0,92.3,87.7,100.0,99.75,63,47,16,0.746,64,36,28,0.563,24,23,23,13,189.2,191.84,190.51999999999998
2012-04-21,1610612763,1610612757,2011,93.0,89.0,182.0,96.05,93.55,96.9,102.7,63,38,25,0.603,63,28,35,0.444,23,15,20,8,190.68,197.36,194.02
2012-04-21,1610612745,1610612744,2011,99.0,96.0,195.0,99.75,98.85,97.7,106.65,63,32,31,0.508,62,22,40,0.355,20,12,12,10,197.72,203.96,200.84
2012-04-21,1610612749,1610612751,2011,106.0,95.0,201.0,105.55,100.75,93.6,97.45,62,29,33,0.468,63,22,41,0.349,15,14,9,13,203.2,196.68,199.94
2012-04-21,1610612762,1610612753,2011,117.0,107.0,224.0,103.95,100.35,94.65,95.25,63,33,30,0.524,62,36,26,0.581,22,11,20,16,199.4,190.48,194.94
2012-04-20,1610612766,1610612763,2011,80.0,85.0,165.0,86.75,100.7,96.05,94.6,61,7,54,0.115,62,37,25,0.597,4,3,23,14,187.68,190.68,189.18
2012-04-20,1610612737,1610612738,2011,97.0,92.0,189.0,100.95,95.45,96.0,89.0,62,37,25,0.597,63,37,26,0.5870000000000001,20,17,22,15,189.76,179.44,184.6
2012-04-20,1610612739,1610612752,2011,98.0,90.0,188.0,88.9,102.15,98.45,91.65,61,20,41,0.328,62,33,29,0.532,10,10,21,12,192.8,193.04,192.92000000000002
2012-04-20,1610612742,1610612744,2011,104.0,94.0,198.0,100.15,99.95,98.05,106.05,63,35,28,0.556,61,22,39,0.361,22,13,12,10,190.28,203.96,197.12
2012-04-20,1610612759,1610612747,2011,121.0,97.0,218.0,107.6,96.65,102.6,101.05,61,45,16,0.738,63,40,23,0.635,25,20,25,15,200.2,193.16,196.68
2012-04-20,1610612758,1610612760,2011,92.0,103.0,195.0,101.7,109.05,103.55,96.35,62,20,42,0.32299999999999995,62,45,17,0.726,15,5,25,20,207.48,201.68,204.57999999999998
2012-04-19,1610612754,1610612749,2011,118.0,109.0,227.0,101.75,97.2,105.35,99.8,62,40,22,0.645,61,29,32,0.475,21,19,15,14,193.36,203.2,198.28
2012-04-19,1610612765,1610612750,2011,80.0,91.0,171.0,92.7,95.05,98.15,104.9,62,23,39,0.371,63,25,38,0.397,16,7,13,12,189.12,193.4,191.26
2012-04-19,1610612748,1610612741,2011,83.0,72.0,155.0,94.85,91.2,94.3,88.1,61,44,17,0.721,62,47,15,0.758,26,18,24,23,188.16,189.2,188.68
2012-04-19,1610612740,1610612745,2011,105.0,99.0,204.0,92.15,92.7,100.0,98.75,62,19,43,0.306,62,32,30,0.516,10,9,20,12,181.88,197.72,189.8
2012-04-19,1610612756,1610612746,2011,93.0,90.0,183.0,106.05,101.5,98.65,93.65,62,32,30,0.516,62,39,23,0.629,18,14,23,16,199.72,192.52,196.12
2012-04-18,1610612764,1610612749,2011,121.0,112.0,233.0,92.2,94.85,104.65,99.45,61,15,46,0.246,60,29,31,0.483,8,7,15,14,195.96,203.2,199.57999999999998
2012-04-18,1610612766,1610612741,2011,68.0,100.0,168.0,87.35,100.95,94.1,89.15,60,7,53,0.117,61,46,15,0.754,4,3,24,22,187.04,189.2,188.12
2012-04-18,1610612739,1610612755,2011,87.0,103.0,190.0,90.45,102.35,90.35,92.5,60,20,40,0.333,61,31,30,0.508,10,10,19,12,192.08,177.04,184.56
2012-04-18,1610612751,1610612752,2011,95.0,104.0,199.0,93.85,97.5,98.95,92.85,62,22,40,0.355,61,32,29,0.525,9,13,21,11,196.08,193.04,194.56
2012-04-18,1610612737,1610612765,2011,116.0,84.0,200.0,100.25,95.65,92.65,93.6,61,36,25,0.59,61,23,38,0.377,19,17,16,7,189.88,189.12,189.5
2012-04-18,1610612748,1610612761,2011,96.0,72.0,168.0,94.7,92.15,93.95,95.9,60,43,17,0.7170000000000001,62,22,40,0.355,25,18,12,10,190.16,188.2,189.18
2012-04-18,1610612738,1610612753,2011,102.0,98.0,200.0,96.25,88.8,93.95,95.15,62,36,26,0.581,61,36,25,0.59,21,15,20,16,178.12,190.48,184.3
2012-04-18,1610612763,1610612740,2011,103.0,91.0,194.0,95.9,94.2,92.45,93.05,61,36,25,0.59,61,19,42,0.311,22,14,10,9,190.0,181.88,185.94
2012-04-18,1610612742,1610612745,2011,117.0,110.0,227.0,99.05,98.7,99.85,98.8,62,34,28,0.5479999999999999,61,32,29,0.525,21,13,20,12,188.32,197.72,193.01999999999998
2012-04-18,1610612743,1610612746,2011,98.0,104.0,202.0,102.5,102.1,98.45,93.8,61,34,27,0.557,61,38,23,0.623,19,15,23,15,204.44,192.52,198.48000000000002
2012-04-18,1610612756,1610612760,2011,97.0,109.0,206.0,106.0,100.75,102.6,96.35,61,32,29,0.525,61,44,17,0.721,18,14,25,19,199.56,201.68,200.62
2012-04-18,1610612758,1610612759,2011,102.0,127.0,229.0,102.35,107.65,106.95,96.8,61,20,41,0.328,60,44,16,0.733,15,5,25,19,206.36,200.2,203.28
2012-04-18,1610612757,1610612762,2011,91.0,112.0,203.0,97.2,101.75,103.5,100.9,62,28,34,0.452,62,32,30,0.516,20,8,22,10,196.84,199.4,198.12
2012-04-18,1610612744,1610612747,2011,87.0,99.0,186.0,98.85,106.35,102.9,101.8,60,22,38,0.3670000000000001,62,39,23,0.629,12,10,25,14,205.2,193.16,199.18
2012-04-17,1610612755,1610612754,2011,97.0,102.0,199.0,90.65,90.95,101.35,97.7,60,31,29,0.517,61,39,22,0.639,19,12,21,18,175.72,193.36,184.54000000000002
2012-04-17,1610612765,1610612739,2011,116.0,77.0,193.0,92.3,94.45,91.85,101.55,60,22,38,0.3670000000000001,59,20,39,0.339,15,7,10,10,188.72,192.08,190.4
2012-04-17,1610612752,1610612738,2011,118.0,110.0,228.0,99.1,91.3,95.75,87.45,60,31,29,0.517,61,36,25,0.59,20,11,21,15,191.08,178.12,184.60000000000002
2012-04-17,1610612750,1610612763,2011,84.0,91.0,175.0,98.7,105.05,96.0,94.85,62,25,37,0.403,60,35,25,0.583,13,12,22,13,193.8,190.0,191.9
2012-04-17,1610612747,1610612759,2011,91.0,112.0,203.0,103.3,101.35,107.05,97.2,61,39,22,0.639,59,43,16,0.7290000000000001,25,14,25,18,191.92,200.2,196.06
2012-04-16,1610612761,1610612737,2011,87.0,109.0,196.0,93.7,95.15,100.1,96.25,61,22,39,0.361,60,35,25,0.583,12,10,19,16,187.48,189.88,188.68
2012-04-16,1610612766,1610612740,2011,67.0,75.0,142.0,89.35,102.35,93.6,94.65,59,7,52,0.119,60,18,42,0.3,4,3,10,8,189.28,181.88,185.57999999999998
2012-04-16,1610612753,1610612755,2011,113.0,100.0,213.0,93.5,95.05,90.95,90.0,60,35,25,0.583,59,31,28,0.525,19,16,19,12,188.68,175.72,182.2
2012-04-16,1610612754,1610612750,2011,111.0,88.0,199.0,100.2,98.4,99.25,105.25,60,38,22,0.633,61,25,36,0.41,20,18,13,12,192.6,193.8,193.2
2012-04-16,1610612751,1610612748,2011,98.0,101.0,199.0,93.65,97.55,94.55,92.45,61,22,39,0.361,59,42,17,0.7120000000000001,9,13,25,17,194.44,190.16,192.3
2012-04-16,1610612741,1610612764,2011,84.0,87.0,171.0,95.2,89.9,92.25,95.75,60,46,14,0.767,60,14,46,0.233,24,22,8,6,190.96,195.96,193.46
2012-04-16,1610612745,1610612743,2011,102.0,105.0,207.0,99.9,98.8,102.2,101.7,60,32,28,0.5329999999999999,60,33,27,0.55,20,12,19,14,196.52,204.44,200.48000000000002
2012-04-16,1610612762,1610612742,2011,123.0,121.0,244.0,102.3,99.75,97.35,98.1,61,31,30,0.508,61,34,27,0.557,21,10,21,13,198.36,188.32,193.34
2012-04-16,1610612756,1610612757,2011,125.0,107.0,232.0,104.55,99.8,97.35,100.45,60,31,29,0.517,61,28,33,0.459,17,14,20,8,197.44,196.84,197.14
2012-04-16,1610612746,1610612760,2011,92.0,77.0,169.0,98.6,94.5,104.0,96.85,60,37,23,0.617,60,44,16,0.733,22,15,25,19,193.44,201.68,197.56
2012-04-16,1610612744,1610612759,2011,99.0,120.0,219.0,99.45,104.7,105.9,99.1,59,22,37,0.373,58,42,16,0.7240000000000001,12,10,25,17,203.44,200.2,201.82
2012-04-15,1610612752,1610612748,2011,85.0,93.0,178.0,99.55,91.95,94.05,92.85,59,31,28,0.525,58,41,17,0.7070000000000001,20,11,25,16,191.76,190.16,190.95999999999998
2012-04-15,1610612747,1610612742,2011,112.0,108.0,220.0,102.55,100.55,96.8,98.0,60,38,22,0.633,60,34,26,0.5670000000000001,24,14,21,13,190.6,188.32,189.45999999999998
2012-04-15,1610612766,1610612738,2011,82.0,94.0,176.0,88.95,101.8,95.0,87.15,58,7,51,0.121,60,35,25,0.583,4,3,21,14,189.4,178.12,183.76
2012-04-15,1610612737,1610612761,2011,86.0,102.0,188.0,100.65,95.65,92.9,96.1,59,35,24,0.593,60,21,39,0.35,19,16,12,9,191.36,187.48,189.42000000000002
2012-04-15,1610612765,1610612741,2011,94.0,100.0,194.0,91.0,94.3,94.75,89.95,59,22,37,0.373,59,45,14,0.763,15,7,24,21,188.24,190.96,189.60000000000002
2012-04-15,1610612739,1610612753,2011,84.0,100.0,184.0,92.65,102.0,93.1,95.25,58,20,38,0.345,59,34,25,0.5760000000000001,10,10,19,15,192.28,188.68,190.48000000000002
2012-04-15,1610612758,1610612757,2011,104.0,103.0,207.0,103.15,107.25,96.5,100.45,60,19,41,0.317,60,28,32,0.467,14,5,20,8,206.2,196.84,201.51999999999998
2012-04-15,1610612740,1610612763,2011,88.0,75.0,163.0,94.25,96.25,97.75,96.4,59,17,42,0.28800000000000003,59,35,24,0.593,9,8,22,13,181.8,190.0,185.9
2012-04-15,1610612743,1610612745,2011,101.0,86.0,187.0,102.65,102.25,101.2,99.05,59,32,27,0.542,59,32,27,0.542,18,14,20,12,206.48,196.52,201.5
2012-04-14,1610612746,1610612744,2011,112.0,104.0,216.0,97.35,93.85,98.85,104.05,59,36,23,0.61,58,22,36,0.379,21,15,12,10,192.64,203.44,198.04
2012-04-14,1610612764,1610612739,2011,89.0,98.0,187.0,92.8,96.85,93.0,103.3,59,14,45,0.237,57,19,38,0.333,8,6,10,9,195.32,192.28,193.8
2012-04-14,1610612751,1610612738,2011,82.0,94.0,176.0,94.45,97.05,94.85,87.95,60,22,38,0.3670000000000001,59,34,25,0.5760000000000001,9,13,21,13,195.68,178.12,186.9
2012-04-14,1610612763,1610612762,2011,103.0,98.0,201.0,97.4,95.75,102.55,99.55,58,34,24,0.586,60,31,29,0.517,21,13,21,10,189.76,198.36,194.06
2012-04-14,1610612750,1610612760,2011,110.0,115.0,225.0,98.75,104.4,102.85,95.75,60,25,35,0.417,59,43,16,0.7290000000000001,13,12,25,18,191.84,201.68,196.76
2012-04-14,1610612749,1610612754,2011,99.0,105.0,204.0,105.45,99.45,99.5,98.1,59,29,30,0.4920000000000001,59,37,22,0.627,15,14,20,17,203.04,192.6,197.82
2012-04-14,1610612759,1610612756,2011,105.0,91.0,196.0,106.25,99.4,104.65,99.7,57,41,16,0.7190000000000001,59,31,28,0.525,24,17,17,14,198.92,197.44,198.18
2012-04-13,1610612761,1610612738,2011,84.0,79.0,163.0,93.65,97.4,95.65,89.75,59,20,39,0.339,58,34,24,0.586,11,9,21,13,188.36,178.12,183.24
2012-04-13,1610612755,1610612751,2011,89.0,95.0,184.0,91.05,90.05000000000003,94.4,97.95,58,31,27,0.534,59,21,38,0.35600000000000004,19,12,9,12,176.84,195.68,186.26
2012-04-13,1610612753,1610612737,2011,81.0,109.0,190.0,94.4,94.5,99.45,95.9,58,34,24,0.586,58,34,24,0.586,19,15,19,15,188.48,191.36,189.92000000000002
2012-04-13,1610612754,1610612739,2011,102.0,83.0,185.0,99.95,98.65,93.65,102.7,58,36,22,0.621,56,19,37,0.339,19,17,10,9,192.24,192.28,192.26
2012-04-13,1610612752,1610612764,2011,103.0,65.0,168.0,100.4,93.85,94.5,96.15,58,30,28,0.517,58,14,44,0.241,19,11,8,6,191.6,195.32,193.45999999999998
2012-04-13,1610612748,1610612766,2011,105.0,82.0,187.0,93.25,93.05,89.6,102.65,57,40,17,0.7020000000000001,57,7,50,0.123,24,16,4,3,190.72,189.4,190.06
2012-04-13,1610612765,1610612749,2011,97.0,113.0,210.0,90.95,92.7,104.5,99.55,58,22,36,0.379,58,28,30,0.483,15,7,15,13,186.52,203.04,194.78
2012-04-13,1610612740,1610612762,2011,96.0,85.0,181.0,93.0,95.65,103.85,100.75,58,16,42,0.276,59,31,28,0.525,8,8,21,10,181.24,198.36,189.8
2012-04-13,1610612745,1610612756,2011,105.0,112.0,217.0,101.2,99.3,103.8,99.4,58,32,26,0.552,58,30,28,0.517,20,12,17,13,196.32,197.44,196.88
2012-04-13,1610612760,1610612758,2011,115.0,89.0,204.0,102.25,96.5,104.45,106.85,58,42,16,0.7240000000000001,59,19,40,0.322,24,18,14,5,201.68,206.2,203.94
2012-04-13,1610612747,1610612743,2011,103.0,97.0,200.0,102.25,100.4,103.65,102.35,59,37,22,0.627,58,32,26,0.552,23,14,18,14,190.88,206.48,198.68
2012-04-13,1610612757,1610612742,2011,94.0,97.0,191.0,96.15,101.4,96.65,98.1,59,28,31,0.475,59,33,26,0.5589999999999999,20,8,21,12,197.64,188.32,192.98
2012-04-12,1610612766,1610612765,2011,85.0,109.0,194.0,90.0,102.15,90.55,93.9,56,7,49,0.125,57,21,36,0.368,4,3,15,6,189.28,186.52,187.9
2012-04-12,1610612741,1610612748,2011,96.0,86.0,182.0,95.15,90.6,93.85,93.2,58,44,14,0.759,56,40,16,0.7140000000000001,23,21,24,16,189.32,190.72,190.01999999999998
2012-04-12,1610612750,1610612746,2011,82.0,95.0,177.0,99.25,104.2,97.3,94.5,59,25,34,0.424,58,35,23,0.603,13,12,21,14,192.84,192.64,192.74
2012-04-12,1610612759,1610612763,2011,107.0,97.0,204.0,106.3,100.55,97.25,94.95,56,40,16,0.7140000000000001,57,34,23,0.596,23,17,21,13,198.6,189.76,194.18
2012-04-12,1610612744,1610612742,2011,103.0,112.0,215.0,98.3,103.95,95.6,97.7,57,22,35,0.386,58,32,26,0.552,12,10,21,11,202.28,188.32,195.3
2012-04-11,1610612761,1610612755,2011,75.0,93.0,168.0,95.7,97.65,91.05,91.15,58,20,38,0.345,57,30,27,0.526,11,9,19,11,189.2,176.84,183.01999999999998
2012-04-11,1610612739,1610612754,2011,98.0,104.0,202.0,93.3,103.1,98.35,98.35,55,19,36,0.345,57,35,22,0.614,10,9,19,16,192.2,192.24,192.22
2012-04-11,1610612738,1610612737,2011,88.0,86.0,174.0,96.35,90.25,99.45,95.95,57,33,24,0.579,57,34,23,0.596,20,13,19,15,178.16,191.36,184.76
2012-04-11,1610612749,1610612752,2011,107.0,111.0,218.0,105.1,99.7,100.1,94.4,57,28,29,0.491,57,29,28,0.509,15,13,19,10,202.12,191.6,196.86
2012-04-11,1610612763,1610612756,2011,104.0,93.0,197.0,96.5,94.1,103.7,98.55,56,33,23,0.589,57,30,27,0.526,20,13,17,13,190.24,197.44,193.84
2012-04-11,1610612740,1610612758,2011,105.0,96.0,201.0,91.95,95.95,105.05,107.6,57,15,42,0.263,58,19,39,0.328,7,8,14,5,180.4,206.2,193.3
2012-04-11,1610612745,1610612762,2011,91.0,103.0,194.0,101.05,98.4,103.55,101.75,57,32,25,0.561,58,30,28,0.517,20,12,21,9,196.24,198.36,197.3
2012-04-11,1610612760,1610612746,2011,98.0,100.0,198.0,103.45,96.25,97.55,94.75,57,42,15,0.737,57,34,23,0.596,24,18,21,13,201.88,192.64,197.26
2012-04-11,1610612759,1610612747,2011,84.0,98.0,182.0,108.0,100.9,102.4,101.5,55,40,15,0.727,58,36,22,0.621,23,17,23,13,199.04,190.88,194.95999999999998
2012-04-11,1610612743,1610612750,2011,113.0,107.0,220.0,102.95,102.0,98.5,103.4,57,31,26,0.544,58,25,33,0.431,17,14,13,12,204.68,192.84,198.76
2012-04-11,1610612757,1610612744,2011,118.0,110.0,228.0,94.55,99.6,98.55,102.5,58,27,31,0.466,56,22,34,0.393,19,8,12,10,196.6,202.28,199.44
2012-04-10,1610612764,1610612753,2011,93.0,85.0,178.0,94.9,96.8,95.25,94.6,57,13,44,0.228,57,34,23,0.596,7,6,19,15,194.8,188.48,191.64
2012-04-10,1610612748,1610612738,2011,107.0,115.0,222.0,93.9,91.35,95.85,90.05,55,40,15,0.727,56,32,24,0.5710000000000001,24,16,20,12,189.52,178.16,183.84
2012-04-10,1610612739,1610612766,2011,103.0,90.0,193.0,92.3,102.9,89.1,102.1,54,18,36,0.333,55,7,48,0.127,9,9,4,3,193.12,189.28,191.2
2012-04-10,1610612751,1610612755,2011,88.0,107.0,195.0,94.95,97.85,90.55,90.15,58,21,37,0.362,56,29,27,0.518,9,12,19,10,196.16,176.84,186.5
2012-04-10,1610612742,1610612758,2011,110.0,100.0,210.0,95.2,97.5,104.65,106.75,57,31,26,0.544,57,19,38,0.333,20,11,14,5,187.0,206.2,196.6
2012-04-10,1610612741,1610612752,2011,98.0,86.0,184.0,95.8,91.15,100.05,94.25,57,43,14,0.754,56,29,27,0.518,22,21,19,10,187.64,191.6,189.62
2012-04-09,1610612766,1610612764,2011,85.0,113.0,198.0,89.85,100.65,94.15,97.9,54,7,47,0.13,56,12,44,0.214,4,3,7,5,189.0,194.8,191.9
2012-04-09,1610612753,1610612765,2011,119.0,89.0,208.0,95.0,95.05,92.3,93.55,56,33,23,0.589,56,21,35,0.375,18,15,15,6,187.36,186.52,186.94
2012-04-09,1610612754,1610612761,2011,103.0,98.0,201.0,97.8,97.2,95.55,96.7,56,34,22,0.607,57,20,37,0.35100000000000003,18,16,11,9,191.76,189.2,190.48
2012-04-09,1610612749,1610612760,2011,89.0,109.0,198.0,105.85,99.55,102.75,96.6,56,28,28,0.5,56,41,15,0.732,15,13,24,17,202.56,201.88,202.22
2012-04-09,1610612763,1610612746,2011,94.0,85.0,179.0,97.0,95.0,97.2,94.1,55,32,23,0.5820000000000001,56,34,22,0.607,19,13,21,13,191.32,192.64,191.98
2012-04-09,1610612740,1610612747,2011,91.0,93.0,184.0,92.25,95.9,102.0,101.35,56,15,41,0.268,57,35,22,0.614,7,8,23,12,180.4,190.88,185.64
2012-04-09,1610612750,1610612756,2011,90.0,114.0,204.0,99.1,102.2,103.2,99.8,57,25,32,0.439,56,29,27,0.518,13,12,17,12,191.92,197.44,194.68
2012-04-09,1610612743,1610612744,2011,123.0,84.0,207.0,102.75,103.6,99.2,101.0,56,30,26,0.536,55,22,33,0.4,16,14,12,10,204.12,202.28,203.2
2012-04-09,1610612762,1610612759,2011,91.0,84.0,175.0,104.2,101.7,109.1,101.45,57,29,28,0.509,54,40,14,0.741,20,9,23,17,198.52,199.04,198.78
2012-04-09,1610612757,1610612745,2011,89.0,94.0,183.0,95.6,101.0,101.25,99.75,57,27,30,0.474,56,31,25,0.5539999999999999,19,8,20,11,196.32,196.24,196.28
2012-04-08,1610612752,1610612741,2011,100.0,99.0,199.0,100.0,93.4,95.6,89.35,55,28,27,0.509,56,43,13,0.768,18,10,22,21,190.76,187.64,189.2
2012-04-08,1610612738,1610612755,2011,103.0,79.0,182.0,95.1,91.0,90.95,89.65,55,31,24,0.564,55,29,26,0.527,19,12,19,10,177.32,176.84,177.07999999999998
2012-04-08,1610612751,1610612739,2011,122.0,117.0,239.0,94.15,97.6,91.45,101.75,57,20,37,0.35100000000000003,53,18,35,0.34,8,12,9,9,194.24,193.12,193.68
2012-04-08,1610612748,1610612765,2011,98.0,75.0,173.0,94.1,92.0,93.05,93.9,54,39,15,0.722,55,21,34,0.382,23,16,15,6,191.36,186.52,188.94
2012-04-08,1610612759,1610612762,2011,114.0,104.0,218.0,108.1,101.2,103.55,101.2,53,39,14,0.736,56,29,27,0.518,22,17,20,9,198.52,198.52,198.52
2012-04-08,1610612760,1610612761,2011,91.0,75.0,166.0,102.7,97.65,96.05,96.55,55,40,15,0.727,56,20,36,0.35700000000000004,23,17,11,9,203.08,189.2,196.14
2012-04-08,1610612758,1610612745,2011,87.0,104.0,191.0,105.9,107.75,100.65,100.25,56,19,37,0.339,55,30,25,0.545,14,5,20,10,205.6,196.24,200.92000000000002
2012-04-07,1610612754,1610612738,2011,72.0,86.0,158.0,99.0,97.95,95.5,91.65,55,34,21,0.618,54,30,24,0.556,18,16,19,11,192.24,177.32,184.78
2012-04-07,1610612766,1610612737,2011,96.0,116.0,212.0,90.1,100.05,98.7,95.95,53,7,46,0.132,56,33,23,0.589,4,3,19,14,186.76,191.36,189.06
2012-04-07,1610612755,1610612753,2011,82.0,88.0,170.0,92.1,89.4,94.5,95.1,54,29,25,0.537,55,32,23,0.5820000000000001,19,10,18,14,177.08,187.36,182.22000000000003
2012-04-07,1610612763,1610612742,2011,94.0,89.0,183.0,97.45,95.65,95.35,97.65,54,31,23,0.574,56,31,25,0.5539999999999999,18,13,20,11,191.72,187.0,189.36
2012-04-07,1610612740,1610612750,2011,99.0,90.0,189.0,91.5,96.15,99.85,102.8,55,14,41,0.255,56,25,31,0.446,6,8,13,12,180.6,191.92,186.26
2012-04-07,1610612749,1610612757,2011,116.0,94.0,210.0,104.9,99.5,95.6,100.5,55,27,28,0.491,56,27,29,0.482,14,13,19,8,201.48,196.32,198.89999999999998
2012-04-07,1610612756,1610612747,2011,125.0,105.0,230.0,101.0,98.45,101.0,100.1,55,28,27,0.509,56,35,21,0.625,16,12,23,12,195.96,190.88,193.42000000000002
2012-04-07,1610612746,1610612758,2011,109.0,94.0,203.0,96.55,93.5,106.6,108.0,55,33,22,0.6,55,19,36,0.345,20,13,14,5,191.88,205.6,198.74
2012-04-07,1610612744,1610612743,2011,112.0,97.0,209.0,98.8,101.0,102.65,103.15,54,21,33,0.389,55,30,25,0.545,11,10,16,14,200.72,204.12,202.42000000000002
2012-04-06,1610612754,1610612760,2011,103.0,98.0,201.0,98.95,96.95,102.85,96.85,54,33,21,0.611,54,40,14,0.741,17,16,23,17,191.44,203.08,197.26
2012-04-06,1610612761,1610612739,2011,80.0,84.0,164.0,96.45,96.95,92.15,102.8,55,20,35,0.364,52,17,35,0.327,11,9,9,8,190.0,193.12,191.56
2012-04-06,1610612751,1610612764,2011,110.0,98.0,208.0,93.7,97.7,94.1,98.0,56,19,37,0.339,55,12,43,0.218,7,12,7,5,194.0,194.8,194.4
2012-04-06,1610612737,1610612765,2011,101.0,96.0,197.0,98.6,95.85,92.4,93.85,55,32,23,0.5820000000000001,54,21,33,0.389,18,14,15,6,191.6,186.52,189.06
2012-04-06,1610612748,1610612763,2011,82.0,97.0,179.0,96.0,92.55,97.15,96.45,53,39,14,0.736,53,30,23,0.5660000000000001,23,16,18,12,193.08,191.72,192.4
2012-04-06,1610612749,1610612766,2011,95.0,90.0,185.0,106.1,100.9,90.3,100.75,54,26,28,0.481,52,7,45,0.135,13,13,4,3,201.8,186.76,194.28
2012-04-06,1610612742,1610612757,2011,97.0,99.0,196.0,95.1,97.35,95.4,100.85,55,31,24,0.564,55,26,29,0.473,20,11,19,7,186.64,196.32,191.48
2012-04-06,1610612759,1610612740,2011,128.0,103.0,231.0,106.8,99.65,90.05,94.05,52,38,14,0.731,54,14,40,0.259,21,17,6,8,196.36,180.6,188.48000000000002
2012-04-06,1610612743,1610612756,2011,105.0,99.0,204.0,102.6,102.95,101.0,98.75,54,29,25,0.537,54,28,26,0.519,15,14,16,12,203.04,195.96,199.5
2012-04-06,1610612762,1610612744,2011,104.0,98.0,202.0,103.45,101.6,99.9,100.8,55,28,27,0.509,53,21,32,0.396,19,9,11,10,196.76,200.72,198.74
2012-04-06,1610612747,1610612745,2011,107.0,112.0,219.0,100.3,98.65,99.2,100.1,55,35,20,0.636,54,29,25,0.537,23,12,20,9,189.36,196.24,192.8
2012-04-05,1610612753,1610612752,2011,80.0,96.0,176.0,95.6,95.55,100.75,95.15,54,32,22,0.593,54,27,27,0.5,18,14,18,9,187.84,190.76,189.3
2012-04-05,1610612765,1610612764,2011,99.0,94.0,193.0,93.15,94.55,95.3,99.0,53,20,33,0.377,54,12,42,0.222,14,6,7,5,186.16,194.8,190.48000000000002
2012-04-05,1610612741,1610612738,2011,93.0,86.0,179.0,95.65,90.0,95.9,91.85,55,42,13,0.764,53,30,23,0.5660000000000001,21,21,19,11,186.88,177.32,182.1
2012-04-05,1610612758,1610612746,2011,85.0,93.0,178.0,106.8,109.1,97.3,94.25,54,19,35,0.35200000000000004,54,32,22,0.593,14,5,20,12,206.72,191.88,199.3
2012-04-04,1610612755,1610612761,2011,78.0,99.0,177.0,92.6,89.05,96.9,98.6,53,29,24,0.547,54,19,35,0.35200000000000004,19,10,11,8,178.36,190.0,184.18
2012-04-04,1610612764,1610612754,2011,96.0,109.0,205.0,95.25,98.65,98.6,96.35,53,12,41,0.226,53,32,21,0.604,7,5,17,15,194.4,191.44,192.92000000000002
2012-04-04,1610612738,1610612759,2011,86.0,87.0,173.0,96.35,92.05,107.6,100.35,52,30,22,0.5770000000000001,51,37,14,0.725,19,11,21,16,176.76,196.36,186.56
2012-04-04,1610612737,1610612766,2011,120.0,93.0,213.0,96.7,95.45,89.3,100.15,54,31,23,0.574,51,7,44,0.13699999999999998,17,14,4,3,190.44,186.76,188.6
2012-04-04,1610612748,1610612760,2011,98.0,93.0,191.0,95.6,91.8,103.25,97.25,52,38,14,0.731,53,40,13,0.755,22,16,23,17,193.56,203.08,198.32
2012-04-04,1610612749,1610612739,2011,107.0,98.0,205.0,105.25,100.65,92.4,103.45,53,25,28,0.472,51,17,34,0.333,12,13,9,8,200.36,193.12,196.74
2012-04-04,1610612740,1610612743,2011,94.0,92.0,186.0,89.65,93.45,103.9,104.45,53,13,40,0.245,53,29,24,0.547,5,8,15,14,180.0,203.04,191.51999999999998
2012-04-04,1610612750,1610612744,2011,94.0,97.0,191.0,100.05,102.95,98.8,100.25,55,25,30,0.455,52,20,32,0.385,13,12,11,9,192.44,200.72,196.57999999999998
2012-04-04,1610612742,1610612763,2011,95.0,85.0,180.0,94.9,97.9,98.4,96.3,54,30,24,0.556,52,30,22,0.5770000000000001,19,11,18,12,186.92,191.72,189.32
2012-04-04,1610612762,1610612756,2011,105.0,107.0,212.0,103.9,101.25,100.25,98.95,54,28,26,0.519,53,27,26,0.509,19,9,16,11,195.64,195.96,195.8
2012-04-04,1610612757,1610612751,2011,101.0,88.0,189.0,95.0,101.8,93.95,97.25,54,25,29,0.463,55,19,36,0.345,18,7,7,12,196.88,194.0,195.44
2012-04-04,1610612746,1610612747,2011,108.0,113.0,221.0,96.15,93.3,99.45,97.8,53,32,21,0.604,54,34,20,0.63,20,12,23,11,190.16,189.36,189.76
2012-04-03,1610612761,1610612766,2011,92.0,87.0,179.0,96.45,98.0,89.85,100.1,53,18,35,0.34,50,7,43,0.14,10,8,4,3,190.12,186.76,188.44
2012-04-03,1610612739,1610612759,2011,90.0,125.0,215.0,92.1,101.65,107.0,101.15,50,17,33,0.34,50,36,14,0.72,9,8,21,15,191.72,196.36,194.04000000000002
2012-04-03,1610612754,1610612752,2011,112.0,104.0,216.0,98.85,96.55,99.95,94.65,52,31,21,0.596,53,27,26,0.509,16,15,18,9,196.13681318681319,190.76,193.4484065934066
2012-04-03,1610612748,1610612755,2011,99.0,93.0,192.0,96.0,91.7,91.75,88.55,51,37,14,0.725,52,29,23,0.5579999999999999,21,16,19,10,193.75949367088606,178.36,186.05974683544304
2012-04-03,1610612765,1610612753,2011,102.0,95.0,197.0,92.8,94.75,96.25,95.0,52,19,33,0.365,53,32,21,0.604,13,6,18,14,186.04,187.84,186.94
2012-04-03,1610612763,1610612744,2011,98.0,94.0,192.0,98.15,95.75,98.25,100.6,51,29,22,0.569,51,20,31,0.392,17,12,11,9,191.52,200.72,196.12
2012-04-03,1610612758,1610612756,2011,100.0,109.0,209.0,106.75,108.95,99.6,99.05,53,19,34,0.358,52,26,26,0.5,14,5,16,10,206.6,195.96,201.28
2012-04-03,1610612747,1610612751,2011,91.0,87.0,178.0,100.65,98.8,94.6,97.3,53,33,20,0.623,54,19,35,0.35200000000000004,22,11,7,12,189.48,194.0,191.74
2012-04-02,1610612764,1610612749,2011,98.0,112.0,210.0,95.7,98.8,104.45,100.85,52,12,40,0.231,52,24,28,0.462,7,5,12,12,193.2,200.36,196.78
2012-04-02,1610612741,1610612745,2011,93.0,99.0,192.0,95.6,88.65,98.4,100.1,54,42,12,0.778,53,28,25,0.528,21,21,20,8,185.2,196.24,190.72
2012-04-02,1610612760,1610612763,2011,88.0,94.0,182.0,104.6,97.75,98.55,96.3,52,40,12,0.769,50,28,22,0.56,23,17,17,11,203.96,191.52,197.74
2012-04-02,1610612742,1610612746,2011,75.0,94.0,169.0,95.6,96.85,96.3,94.75,53,30,23,0.5660000000000001,52,31,21,0.596,19,11,20,11,187.56,190.16,188.86
2012-04-02,1610612758,1610612750,2011,116.0,108.0,224.0,106.45,108.4,101.0,103.35,52,18,34,0.34600000000000003,54,25,29,0.463,13,5,13,12,205.28,192.44,198.86
2012-04-02,1610612757,1610612762,2011,97.0,102.0,199.0,97.0,101.55,103.75,101.05,53,25,28,0.472,53,27,26,0.509,18,7,19,8,197.44,195.64,196.54
2012-04-01,1610612760,1610612741,2011,92.0,78.0,170.0,104.75,98.4,96.2,87.4,51,39,12,0.765,53,42,11,0.792,22,17,21,21,205.4,185.2,195.3
2012-04-01,1610612738,1610612748,2011,91.0,72.0,163.0,96.15,92.85,97.75,91.8,51,29,22,0.569,50,37,13,0.74,18,11,21,16,177.92,193.94242050015436,185.93121025007719
2012-04-01,1610612761,1610612764,2011,99.0,92.0,191.0,96.45,98.5,95.5,99.05,52,17,35,0.327,51,12,39,0.235,9,8,7,5,189.24,193.2,191.22
2012-04-01,1610612753,1610612743,2011,101.0,104.0,205.0,95.9,94.05,103.8,104.55,52,32,20,0.615,52,28,24,0.5379999999999999,18,14,15,13,187.56,203.04,195.3
2012-04-01,1610612745,1610612754,2011,102.0,104.0,206.0,97.95,99.25,98.75,95.85,52,28,24,0.5379999999999999,51,30,21,0.588,20,8,16,14,195.72,196.0668831168831,195.89344155844157
2012-04-01,1610612756,1610612740,2011,92.0,75.0,167.0,100.2,100.05,90.65,93.8,51,25,26,0.49,52,13,39,0.25,15,10,5,8,196.72,180.0,188.36
2012-04-01,1610612757,1610612750,2011,119.0,106.0,225.0,95.9,100.1,101.8,102.9,52,24,28,0.462,53,25,28,0.472,17,7,13,12,195.64,192.44,194.04
2012-04-01,1610612747,1610612744,2011,120.0,112.0,232.0,99.85,97.45,96.9,98.7,52,32,20,0.615,50,20,30,0.4,21,11,11,9,186.88,200.72,193.8
2012-03-31,1610612747,1610612740,2011,88.0,85.0,173.0,100.6,97.8,90.85,93.6,51,31,20,0.608,51,13,38,0.255,20,11,5,8,186.96,180.0,183.48000000000002
2012-03-31,1610612752,1610612739,2011,91.0,75.0,166.0,100.0,95.9,92.9,102.45,52,26,26,0.5,49,17,32,0.34700000000000003,17,9,9,8,193.24,191.72,192.48000000000002
2012-03-31,1610612755,1610612737,2011,95.0,90.0,185.0,90.75,88.15,96.3,95.65,51,28,23,0.5489999999999999,53,31,22,0.585,18,10,17,14,178.84,190.44,184.64
2012-03-31,1610612765,1610612766,2011,110.0,107.0,217.0,91.15,94.3,89.0,99.7,51,18,33,0.353,49,7,42,0.14300000000000002,12,6,4,3,184.48,186.76,185.62
2012-03-31,1610612749,1610612763,2011,95.0,99.0,194.0,104.15,100.5,98.25,96.4,51,24,27,0.471,49,27,22,0.551,12,12,17,10,189.49049019607844,191.52,190.5052450980392
2012-03-31,1610612759,1610612754,2011,112.0,103.0,215.0,105.85,100.8,97.95,95.15,49,35,14,0.7140000000000001,50,30,20,0.6,20,15,16,14,195.44,195.9359022556391,195.68795112781953
2012-03-31,1610612758,1610612751,2011,99.0,111.0,210.0,106.45,107.75,93.9,96.6,51,18,33,0.353,53,18,35,0.34,13,5,7,11,204.32,194.0,199.16
2012-03-31,1610612746,1610612762,2011,105.0,96.0,201.0,95.7,94.8,104.4,100.8,51,30,21,0.588,52,27,25,0.519,19,11,19,8,190.36,195.64,193.0
2012-03-30,1610612761,1610612748,2011,101.0,113.0,214.0,96.55,97.5,97.65,91.1,51,17,34,0.333,49,36,13,0.735,9,8,21,15,187.68,193.81504922644163,190.74752461322083
2012-03-30,1610612764,1610612755,2011,97.0,76.0,173.0,95.1,100.55,91.5,87.9,50,11,39,0.22,50,28,22,0.56,6,5,18,10,193.24,178.84,186.04000000000002
2012-03-30,1610612766,1610612743,2011,88.0,99.0,187.0,89.0,99.85,103.05,105.25,48,7,41,0.146,51,27,24,0.529,4,3,15,12,188.5871606450296,203.04,195.81358032251478
2012-03-30,1610612737,1610612752,2011,100.0,90.0,190.0,95.45,95.05,100.0,95.25,52,30,22,0.5770000000000001,51,26,25,0.51,16,14,17,9,189.52,193.24,191.38
2012-03-30,1610612739,1610612749,2011,84.0,121.0,205.0,93.75,101.4,102.65,101.8,48,17,31,0.354,50,23,27,0.46,9,8,12,11,191.52,189.38652623211448,190.45326311605726
2012-03-30,1610612753,1610612742,2011,98.0,100.0,198.0,96.15,93.4,94.85,96.75,51,32,19,0.627,52,29,23,0.5579999999999999,18,14,19,10,186.52,187.56,187.04000000000002
2012-03-30,1610612741,1610612765,2011,83.0,71.0,154.0,97.0,88.6,92.25,95.3,52,41,11,0.7879999999999999,50,18,32,0.36,20,21,12,6,185.76,184.48,185.12
2012-03-30,1610612745,1610612763,2011,98.0,89.0,187.0,97.9,99.45,99.05,96.5,51,27,24,0.529,48,27,21,0.563,19,8,17,10,195.4,191.52,193.46
2012-03-30,1610612750,1610612738,2011,79.0,100.0,179.0,102.7,103.1,94.7,94.05,52,25,27,0.481,50,28,22,0.56,13,12,18,10,193.44,177.92,185.68
2012-03-30,1610612762,1610612758,2011,103.0,104.0,207.0,103.6,100.65,105.5,107.6,51,27,24,0.529,50,17,33,0.34,19,8,13,4,195.4,204.32,199.86
2012-03-30,1610612746,1610612757,2011,98.0,97.0,195.0,95.65,95.4,95.65,100.35,50,29,21,0.58,51,24,27,0.471,18,11,17,7,189.8,195.64,192.72
2012-03-30,1610612744,1610612751,2011,100.0,102.0,202.0,96.45,98.25,93.2,96.25,49,20,29,0.408,52,17,35,0.327,11,9,7,10,200.24,194.0,197.12
2012-03-29,1610612754,1610612764,2011,93.0,89.0,182.0,98.7,94.35,95.65,101.6,49,29,20,0.5920000000000001,49,11,38,0.224,15,14,6,5,196.0449084668192,193.24,194.6424542334096
2012-03-29,1610612748,1610612742,2011,106.0,85.0,191.0,97.1,91.3,95.45,96.65,48,35,13,0.7290000000000001,51,29,22,0.569,20,15,19,10,193.83760683760684,187.56,190.69880341880344
2012-03-29,1610612757,1610612740,2011,99.0,93.0,192.0,94.25,99.4,91.6,94.5,50,23,27,0.46,50,13,37,0.26,16,7,5,8,196.36,180.0,188.18
2012-03-29,1610612747,1610612760,2011,93.0,102.0,195.0,101.5,97.65,105.6,99.55,50,31,19,0.62,50,38,12,0.76,20,11,22,16,187.52,205.4,196.46
2012-03-28,1610612761,1610612743,2011,105.0,96.0,201.0,95.85,97.6,103.9,105.45,50,16,34,0.32,50,27,23,0.54,8,8,15,12,185.68,203.04,194.36
2012-03-28,1610612752,1610612753,2011,108.0,86.0,194.0,99.8,95.8,96.5,92.5,50,25,25,0.5,50,32,18,0.64,16,9,18,14,192.48,186.52,189.5
2012-03-28,1610612766,1610612750,2011,83.0,88.0,171.0,89.30000000000003,100.35,103.05,104.15,47,7,40,0.149,51,24,27,0.471,4,3,13,11,188.72825186412592,193.44,191.08412593206296
2012-03-28,1610612739,1610612765,2011,75.0,87.0,162.0,94.65,101.65,92.9,96.6,47,17,30,0.362,49,17,32,0.34700000000000003,9,8,12,5,192.2,184.48,188.33999999999997
2012-03-28,1610612738,1610612762,2011,94.0,82.0,176.0,94.7,94.15,104.3,101.05,49,27,22,0.551,50,27,23,0.54,17,10,19,8,178.12,195.4,186.76
2012-03-28,1610612751,1610612754,2011,100.0,84.0,184.0,92.75,97.45,99.1,94.25,51,16,35,0.314,48,29,19,0.604,6,10,15,14,193.68,196.11710144927537,194.8985507246377
2012-03-28,1610612737,1610612741,2011,77.0,98.0,175.0,95.95,95.5,97.5,89.1,51,30,21,0.588,51,40,11,0.784,16,14,20,20,188.1375,185.76,186.94875
2012-03-28,1610612758,1610612759,2011,112.0,117.0,229.0,104.9,107.15,104.95,99.95,49,17,32,0.34700000000000003,48,34,14,0.708,13,4,20,14,202.4595588235294,195.44,198.9497794117647
2012-03-28,1610612746,1610612756,2011,103.0,86.0,189.0,95.65,95.85,100.8,99.1,49,28,21,0.5710000000000001,50,25,25,0.5,17,11,15,10,190.84,196.72,193.78
2012-03-28,1610612744,1610612740,2011,87.0,102.0,189.0,97.2,97.95,91.15,95.2,48,20,28,0.417,49,12,37,0.245,11,9,5,7,200.32,180.0,190.16
2012-03-27,1610612755,1610612739,2011,103.0,85.0,188.0,90.2,87.55,95.1,101.6,49,27,22,0.551,46,17,29,0.37,17,10,9,8,178.6,192.2,185.39999999999998
2012-03-27,1610612749,1610612737,2011,108.0,101.0,209.0,102.05,102.45,94.85,94.6,49,22,27,0.449,50,30,20,0.6,11,11,16,14,189.24001613553853,187.99683544303798,188.61842578928827
2012-03-27,1610612763,1610612750,2011,93.0,86.0,179.0,98.8,97.1,103.0,104.7,47,26,21,0.5529999999999999,50,24,26,0.48,16,10,13,11,194.6455773955774,193.44,194.0427886977887
2012-03-27,1610612742,1610612745,2011,90.0,81.0,171.0,96.05,96.8,98.7,100.25,50,28,22,0.56,50,27,23,0.54,18,10,19,8,189.04,195.4,192.22
2012-03-27,1610612756,1610612759,2011,100.0,107.0,207.0,101.0,99.05,104.75,99.4,49,25,24,0.51,47,33,14,0.7020000000000001,15,10,20,13,195.2,195.44,195.32
2012-03-27,1610612757,1610612760,2011,95.0,109.0,204.0,94.95,100.15,105.7,100.15,49,23,26,0.469,49,37,12,0.755,16,7,22,15,196.2,205.4,200.8
2012-03-27,1610612744,1610612747,2011,101.0,104.0,205.0,97.45,97.6,100.8,97.7,47,20,27,0.426,49,30,19,0.612,11,9,20,10,200.24,187.52,193.88
2012-03-26,1610612761,1610612753,2011,101.0,117.0,218.0,96.1,97.4,94.55,91.95,49,16,33,0.327,49,31,18,0.633,8,8,18,13,197.6265593561368,186.52,192.0732796780684
2012-03-26,1610612764,1610612765,2011,77.0,79.0,156.0,96.45,103.0,93.85,97.15,48,11,37,0.229,48,16,32,0.333,6,5,12,4,194.24,184.48,189.36
2012-03-26,1610612766,1610612738,2011,95.0,102.0,197.0,88.85,100.8,93.9,93.55,46,7,39,0.152,48,26,22,0.542,4,3,17,9,188.679524910658,178.12,183.39976245532898
2012-03-26,1610612754,1610612748,2011,105.0,90.0,195.0,98.5,94.15,97.85,90.55,47,28,19,0.596,47,35,12,0.745,14,14,20,15,196.13372549019607,193.8258012820513,194.9797633861237
2012-03-26,1610612751,1610612762,2011,84.0,105.0,189.0,92.8,96.8,103.85,102.0,50,16,34,0.32,49,26,23,0.531,6,10,19,7,193.12,195.4,194.26
2012-03-26,1610612752,1610612749,2011,89.0,80.0,169.0,99.6,96.25,102.65,102.25,49,24,25,0.49,48,22,26,0.458,15,9,11,11,194.12,189.37977918626046,191.74988959313023
2012-03-26,1610612741,1610612743,2011,91.0,108.0,199.0,98.45,88.25,103.35,106.75,50,40,10,0.8,49,26,23,0.531,20,20,15,11,184.92,203.04,193.98
2012-03-26,1610612745,1610612758,2011,113.0,106.0,219.0,98.1,99.2,105.35,107.55,49,26,23,0.531,48,17,31,0.354,18,8,13,4,194.24,202.34600248550123,198.29300124275062
2012-03-26,1610612746,1610612740,2011,97.0,85.0,182.0,95.8,96.75,91.35,94.6,48,27,21,0.563,48,12,36,0.25,16,11,5,7,192.0,180.0,186.0
2012-03-25,1610612739,1610612756,2011,83.0,108.0,191.0,95.3,101.75,100.95,100.15,45,17,28,0.378,48,24,24,0.5,9,8,15,9,196.46709956709958,195.2,195.83354978354978
2012-03-25,1610612750,1610612743,2011,117.0,100.0,217.0,101.45,103.9,103.95,105.45,49,23,26,0.469,48,26,22,0.542,12,11,15,11,193.28,203.04,198.16
2012-03-25,1610612738,1610612764,2011,88.0,76.0,164.0,94.4,93.75,96.85,103.7,47,25,22,0.532,47,11,36,0.234,16,9,6,5,177.72,194.24,185.98000000000002
2012-03-25,1610612737,1610612762,2011,139.0,133.0,272.0,92.75,92.3,102.1,100.05,49,29,20,0.5920000000000001,48,26,22,0.542,15,14,19,7,187.43176694988728,195.4,191.41588347494366
2012-03-25,1610612759,1610612755,2011,93.0,76.0,169.0,105.45,100.4,90.75,88.05,46,32,14,0.696,48,27,21,0.563,19,13,17,10,199.26760563380282,178.6,188.9338028169014
2012-03-25,1610612760,1610612748,2011,103.0,87.0,190.0,105.55,100.05,99.2,90.2,48,36,12,0.75,46,35,11,0.7609999999999999,21,15,20,15,205.24,193.84534242129178,199.5426712106459
2012-03-25,1610612757,1610612744,2011,90.0,87.0,177.0,95.25,100.95,97.0,98.2,48,22,26,0.458,46,20,26,0.435,15,7,11,9,191.59950532724505,200.24,195.91975266362255
2012-03-25,1610612747,1610612763,2011,96.0,102.0,198.0,100.3,96.5,97.7,97.2,48,30,18,0.625,46,25,21,0.5429999999999999,20,10,16,9,193.84571016582552,194.6180654338549,194.2318877998402
2012-03-24,1610612746,1610612763,2011,101.0,85.0,186.0,95.85,96.7,98.15,97.2,47,26,21,0.5529999999999999,45,25,20,0.556,15,11,16,9,197.970082815735,194.66981981981982,196.3199513177774
2012-03-24,1610612764,1610612737,2011,92.0,95.0,187.0,97.8,104.35,91.85,92.55,46,11,35,0.239,48,28,20,0.583,6,5,15,13,198.7918976545842,187.42852125043905,193.11020945251164
2012-03-24,1610612751,1610612766,2011,102.0,89.0,191.0,92.7,97.6,88.6,100.4,49,15,34,0.306,45,7,38,0.156,5,10,4,3,193.0731209150327,188.65085287846483,190.86198689674876
2012-03-24,1610612752,1610612765,2011,101.0,79.0,180.0,99.55,96.55,94.85,96.7,48,23,25,0.479,47,16,31,0.34,14,9,12,4,193.72,184.48,189.1
2012-03-24,1610612741,1610612761,2011,102.0,101.0,203.0,97.85,87.15,95.5,97.05,49,39,10,0.7959999999999999,48,16,32,0.333,19,20,8,8,187.668776371308,197.5857142857143,192.62724532851115
2012-03-24,1610612740,1610612759,2011,86.0,89.0,175.0,91.35,94.85,106.0,100.6,47,12,35,0.255,45,31,14,0.6890000000000001,5,7,19,12,180.0,199.43762575452718,189.7188128772636
2012-03-24,1610612745,1610612742,2011,99.0,101.0,200.0,98.05,99.7,95.1,95.6,48,26,22,0.542,49,27,22,0.551,18,8,18,9,193.76,189.04,191.39999999999998
2012-03-24,1610612749,1610612754,2011,104.0,125.0,229.0,102.15,100.95,96.6,93.8,47,22,25,0.468,46,27,19,0.5870000000000001,11,11,14,13,189.07731423827315,195.90381558028616,192.49056490927967
2012-03-24,1610612744,1610612758,2011,111.0,108.0,219.0,97.25,98.75,104.15,106.3,45,19,26,0.422,47,17,30,0.362,10,9,13,4,204.70225916453538,202.22920168067225,203.46573042260383
2012-03-23,1610612761,1610612752,2011,96.0,79.0,175.0,95.05,97.6,100.6,96.65,47,15,32,0.319,47,23,24,0.489,7,8,14,9,197.75217391304346,193.72,195.73608695652172
2012-03-23,1610612766,1610612749,2011,92.0,112.0,204.0,87.2,99.55,100.8,101.05,44,7,37,0.159,46,21,25,0.457,4,3,11,10,188.54761904761904,188.97790404040404,188.76276154401154
2012-03-23,1610612753,1610612739,2011,93.0,80.0,173.0,95.0,92.4,95.7,101.45,48,30,18,0.625,44,17,27,0.386,17,13,9,8,187.56,196.66593406593407,192.11296703296705
2012-03-23,1610612754,1610612756,2011,111.0,113.0,224.0,95.55,93.4,100.25,99.1,45,27,18,0.6,47,23,24,0.489,14,13,15,8,195.70451795078662,195.2,195.4522589753933
2012-03-23,1610612737,1610612751,2011,93.0,84.0,177.0,91.7,93.3,93.1,98.4,47,27,20,0.574,48,15,33,0.313,14,13,5,10,187.50747863247864,193.18237365368682,190.34492614308272
2012-03-23,1610612765,1610612748,2011,73.0,88.0,161.0,96.65,96.9,100.15,90.9,46,16,30,0.348,45,34,11,0.7559999999999999,12,4,20,14,193.68004201680674,194.05128205128204,193.8656620340444
2012-03-23,1610612755,1610612738,2011,99.0,86.0,185.0,90.3,88.75,95.3,94.75,47,26,21,0.5529999999999999,46,25,21,0.5429999999999999,16,10,16,9,177.56,177.72,177.64
2012-03-23,1610612760,1610612750,2011,149.0,140.0,289.0,104.05,98.25,99.9,101.3,47,35,12,0.745,48,23,25,0.479,20,15,12,11,200.48,193.28,196.88
2012-03-23,1610612759,1610612742,2011,104.0,87.0,191.0,105.45,100.3,95.95,95.25,44,30,14,0.682,48,27,21,0.563,18,12,18,9,199.5,189.04,194.26999999999998
2012-03-23,1610612762,1610612743,2011,121.0,102.0,223.0,100.85,99.3,103.7,104.4,47,25,22,0.532,47,26,21,0.5529999999999999,18,7,15,11,193.72,203.04,198.38
2012-03-23,1610612747,1610612757,2011,103.0,96.0,199.0,100.45,95.35,95.1,100.35,47,29,18,0.617,47,22,25,0.468,19,10,15,7,193.81132420091325,191.53472222222223,192.67302321156774
2012-03-22,1610612764,1610612754,2011,83.0,85.0,168.0,97.7,105.45,96.2,93.6,45,11,34,0.244,44,26,18,0.591,6,5,14,12,199.01125541125543,195.8861173584134,197.44868638483442
2012-03-22,1610612749,1610612738,2011,91.0,100.0,191.0,101.5,101.4,93.95,94.65,45,21,24,0.467,45,24,21,0.5329999999999999,11,10,16,8,188.95844017094018,177.72,183.3392200854701
2012-03-22,1610612740,1610612746,2011,97.0,90.0,187.0,89.85,94.85,95.05,95.4,46,11,35,0.239,46,26,20,0.565,4,7,15,11,179.52,198.05797101449275,188.78898550724637
2012-03-22,1610612745,1610612744,2011,109.0,83.0,192.0,97.4,100.3,98.4,98.5,47,25,22,0.532,44,19,25,0.4320000000000001,17,8,10,9,203.60134575569356,204.79411764705884,204.1977317013762
2012-03-22,1610612758,1610612762,2011,102.0,103.0,205.0,104.2,105.95,99.95,99.25,46,17,29,0.37,46,24,22,0.522,13,4,18,6,202.20714285714286,193.72,197.9635714285714
2012-03-22,1610612757,1610612763,2011,97.0,93.0,190.0,95.6,101.25,98.3,96.2,46,21,25,0.457,44,25,19,0.568,14,7,16,9,191.55956572769952,194.69594594594594,193.12775583682273
2012-03-21,1610612761,1610612741,2011,82.0,94.0,176.0,95.55,97.6,98.8,87.55000000000003,46,15,31,0.326,48,38,10,0.792,7,8,19,19,197.91617647058823,187.74358974358972,192.82988310708896
2012-03-21,1610612755,1610612752,2011,79.0,82.0,161.0,91.1,89.15,101.85,97.35,46,26,20,0.565,46,22,24,0.478,16,10,14,8,177.88,193.72,185.8
2012-03-21,1610612753,1610612756,2011,103.0,93.0,196.0,94.2,92.2,99.65,98.9,47,29,18,0.617,46,23,23,0.5,16,13,15,8,187.88,195.2,191.54
2012-03-21,1610612751,1610612764,2011,89.0,108.0,197.0,93.1,98.15,98.5,106.45,47,15,32,0.319,44,10,34,0.227,5,10,6,4,193.157241959218,199.03754940711462,196.09739568316633
2012-03-21,1610612737,1610612739,2011,103.0,102.0,205.0,90.9,93.1,94.85,100.9,46,26,20,0.565,43,17,26,0.395,13,13,9,8,187.3914770675334,196.62098214285714,192.00622960519527
2012-03-21,1610612740,1610612744,2011,92.0,101.0,193.0,89.85,94.8,98.5,99.1,45,11,34,0.244,43,18,25,0.419,4,7,10,8,186.63879107981222,204.88125548726953,195.76002328354087
2012-03-21,1610612760,1610612746,2011,114.0,91.0,205.0,103.4,98.35,95.1,94.5,46,34,12,0.7390000000000001,45,26,19,0.578,19,15,15,11,203.30023923444975,198.01609121909632,200.65816522677304
2012-03-21,1610612759,1610612750,2011,116.0,100.0,216.0,104.6,99.85,99.95,100.65,43,29,14,0.674,47,23,24,0.489,17,12,12,11,199.38302277432712,193.28,196.33151138716357
2012-03-21,1610612743,1610612765,2011,116.0,115.0,231.0,102.85,104.35,95.7,96.05,46,25,21,0.5429999999999999,45,16,29,0.35600000000000004,14,11,12,4,201.36,193.382302771855,197.3711513859275
2012-03-21,1610612742,1610612747,2011,93.0,109.0,202.0,96.1,94.4,99.7,95.3,47,27,20,0.574,46,28,18,0.609,18,9,19,9,188.92,193.75472222222223,191.3373611111111
2012-03-20,1610612754,1610612746,2011,102.0,89.0,191.0,96.55,94.8,96.2,93.7,43,25,18,0.581,44,26,18,0.591,13,12,15,11,195.9307804068078,198.07743889249406,197.00410964965093
2012-03-20,1610612752,1610612761,2011,106.0,87.0,193.0,101.15,97.25,94.4,97.3,45,21,24,0.467,45,15,30,0.333,13,8,7,8,204.6357142857143,197.94661125319692,201.2911627694556
2012-03-20,1610612748,1610612756,2011,99.0,95.0,194.0,100.65,90.9,100.9,99.1,44,33,11,0.75,45,23,22,0.511,19,14,15,8,194.05494505494505,195.2,194.62747252747252
2012-03-20,1610612745,1610612747,2011,107.0,104.0,211.0,97.0,99.15,98.75,94.55,46,24,22,0.522,45,28,17,0.622,16,8,19,9,203.52898550724638,193.6331455399061,198.58106552357623
2012-03-20,1610612762,1610612760,2011,97.0,90.0,187.0,100.35,100.1,103.7,98.85,45,23,22,0.511,45,34,11,0.7559999999999999,17,6,19,15,198.31830775788575,203.4013157894737,200.85981177367972
2012-03-20,1610612758,1610612763,2011,119.0,110.0,229.0,102.45,105.35,97.0,94.55,45,16,29,0.35600000000000004,43,25,18,0.581,12,4,16,9,202.00259740259742,194.45566456867826,198.22913098563782
2012-03-20,1610612757,1610612749,2011,87.0,116.0,203.0,97.1,100.3,101.35,102.65,45,21,24,0.467,44,20,24,0.455,14,7,11,9,191.4922619047619,188.86327193932829,190.1777669220451
2012-03-19,1610612766,1610612755,2011,80.0,105.0,185.0,88.15,99.4,90.75,89.6,43,7,36,0.163,45,25,20,0.556,4,3,16,9,188.58736263736262,177.88,183.2336813186813
2012-03-19,1610612751,1610612739,2011,100.0,105.0,205.0,92.7,97.85,94.3,101.95,46,15,31,0.326,42,16,26,0.381,5,10,9,7,193.07074263764406,196.57460317460317,194.82267290612361
2012-03-19,1610612737,1610612738,2011,76.0,79.0,155.0,90.95,93.95,94.05,95.65,45,26,19,0.578,44,23,21,0.523,13,13,16,7,187.62930402930402,177.72,182.674652014652
2012-03-19,1610612753,1610612741,2011,59.0,85.0,144.0,96.35,92.4,99.8,89.7,46,29,17,0.63,47,37,10,0.787,16,13,19,18,189.65023474178403,188.02813852813853,188.83918663496127
2012-03-19,1610612743,1610612742,2011,95.0,112.0,207.0,103.25,103.8,95.75,94.4,45,25,20,0.556,46,26,20,0.565,14,11,18,8,201.76,188.92,195.33999999999997
2012-03-19,1610612744,1610612750,2011,93.0,97.0,190.0,99.8,99.3,100.65,100.9,42,18,24,0.429,46,22,24,0.478,10,8,12,10,204.99253731343282,193.28,199.13626865671642
2012-03-18,1610612739,1610612737,2011,87.0,103.0,190.0,94.85,101.15,90.85,94.55,41,16,25,0.39,44,25,19,0.568,9,7,13,12,196.60420979986196,187.6064935064935,192.10535165317773
2012-03-18,1610612746,1610612765,2011,87.0,83.0,170.0,96.4,95.15,95.85,97.35,43,25,18,0.581,44,16,28,0.364,14,11,12,4,198.27458296751536,193.53766233766234,195.90612265258886
2012-03-18,1610612763,1610612764,2011,97.0,92.0,189.0,97.05,94.55,98.8,105.45,42,24,18,0.5710000000000001,43,10,33,0.233,15,9,6,4,194.5,199.123440285205,196.8117201426025
2012-03-18,1610612758,1610612750,2011,115.0,99.0,214.0,102.0,105.45,100.15,100.25,44,15,29,0.341,45,22,23,0.489,11,4,12,10,201.90714285714284,193.28,197.5935714285714
2012-03-18,1610612748,1610612753,2011,91.0,81.0,172.0,100.95,91.5,97.25,92.55,43,32,11,0.7440000000000001,45,29,16,0.644,18,14,16,13,194.20344129554655,189.78333333333333,191.99338731443993
2012-03-18,1610612756,1610612745,2011,99.0,86.0,185.0,101.15,99.2,97.5,98.65,44,22,22,0.5,45,24,21,0.5329999999999999,14,8,16,8,195.6,203.68478260869566,199.64239130434783
2012-03-18,1610612760,1610612757,2011,111.0,95.0,206.0,104.35,100.0,97.05,99.6,44,33,11,0.75,44,21,23,0.477,18,15,14,7,203.38956140350876,191.37635814889336,197.38295977620106
2012-03-18,1610612747,1610612762,2011,99.0,103.0,202.0,98.6,93.95,99.45,100.7,44,28,16,0.636,44,22,22,0.5,19,9,17,5,193.57755995432052,198.29411764705884,195.93583880068968
2012-03-17,1610612746,1610612745,2011,95.0,91.0,186.0,97.25,95.6,98.1,98.7,42,24,18,0.5710000000000001,44,24,20,0.545,13,11,16,8,198.3582089552239,203.8377676833225,201.0979883192732
2012-03-17,1610612766,1610612761,2011,107.0,103.0,210.0,86.7,99.8,93.95,95.6,42,6,36,0.14300000000000002,44,15,29,0.341,3,3,7,8,188.43303571428572,197.85294117647058,193.14298844537814
2012-03-17,1610612754,1610612752,2011,88.0,102.0,190.0,97.35,94.65,100.5,97.4,42,25,17,0.595,44,20,24,0.455,13,12,13,7,195.9845100105374,204.7287784679089,200.35664423922316
2012-03-17,1610612751,1610612740,2011,94.0,102.0,196.0,92.35,98.15,89.35,94.55,45,15,30,0.333,44,10,34,0.227,5,10,4,6,193.050812567714,186.59154929577466,189.82118093174432
2012-03-17,1610612741,1610612755,2011,89.0,80.0,169.0,99.6,90.55,91.7,89.35,46,36,10,0.7829999999999999,44,25,19,0.568,18,18,16,9,188.14935064935065,177.88,183.01467532467532
2012-03-17,1610612742,1610612759,2011,106.0,99.0,205.0,95.3,94.15,104.1,98.75,45,25,20,0.556,42,29,13,0.69,17,8,17,12,188.64,199.34057971014494,193.99028985507246
2012-03-17,1610612743,1610612738,2011,98.0,91.0,189.0,103.8,103.85,93.5,95.2,44,24,20,0.545,43,23,20,0.535,13,11,16,7,203.68,177.72,190.7
2012-03-17,1610612762,1610612744,2011,99.0,92.0,191.0,99.15,100.55,99.55,99.85,43,21,22,0.488,41,18,23,0.439,16,5,10,8,198.34580772607552,205.0974672094075,201.72163746774152
2012-03-16,1610612755,1610612748,2011,78.0,84.0,162.0,91.75,90.1,102.05,92.05,43,25,18,0.581,42,31,11,0.738,16,9,18,13,179.2,194.4082365003418,186.8041182501709
2012-03-16,1610612753,1610612751,2011,86.0,70.0,156.0,98.05,94.4,93.45,98.8,44,28,16,0.636,44,15,29,0.341,15,13,5,10,190.01338028169016,193.3131868131868,191.66328354743848
2012-03-16,1610612752,1610612754,2011,115.0,100.0,215.0,99.7,96.8,97.8,93.85,43,19,24,0.442,41,25,16,0.61,12,7,13,12,204.66666666666669,195.84476495726494,200.2557158119658
2012-03-16,1610612737,1610612764,2011,102.0,88.0,190.0,91.8,94.85,98.85,105.65,43,24,19,0.5579999999999999,42,10,32,0.238,12,12,6,4,187.59759081498214,199.20443238353687,193.4010115992595
2012-03-16,1610612741,1610612757,2011,89.0,100.0,189.0,99.6,89.55,96.75,99.45,45,36,9,0.8,43,20,23,0.465,18,18,14,6,188.1421736158578,191.37857142857143,189.76037252221462
2012-03-16,1610612763,1610612761,2011,110.0,114.0,224.0,95.8,92.85,92.3,94.9,41,24,17,0.585,43,14,29,0.326,15,9,7,7,194.3025114155251,197.6519973661106,195.97725439081785
2012-03-16,1610612760,1610612759,2011,105.0,114.0,219.0,104.6,98.65,102.55,97.15,43,33,10,0.767,41,28,13,0.6829999999999999,18,15,17,11,203.28965149359885,199.19394714407503,201.24179931883694
2012-03-16,1610612756,1610612765,2011,109.0,101.0,210.0,100.8,98.65,94.9,97.05,43,21,22,0.488,43,16,27,0.3720000000000001,13,8,12,4,205.2379120879121,193.3901098901099,199.314010989011
2012-03-16,1610612758,1610612738,2011,120.0,95.0,215.0,101.7,106.0,92.45,93.5,43,14,29,0.326,42,23,19,0.5479999999999999,10,4,16,7,201.80089285714286,177.72,189.7604464285714
2012-03-16,1610612747,1610612750,2011,97.0,92.0,189.0,98.55,94.25,99.55,99.65,43,27,16,0.628,44,22,22,0.5,18,9,12,10,193.60949257186957,193.28,193.4447462859348
2012-03-16,1610612744,1610612749,2011,98.0,120.0,218.0,99.3,98.35,100.6,102.7,40,18,22,0.45,43,19,24,0.442,10,8,11,8,205.0,188.65824175824176,196.82912087912086
2012-03-15,1610612740,1610612764,2011,89.0,99.0,188.0,90.05,95.6,99.05,106.65,43,10,33,0.233,41,9,32,0.22,4,6,6,3,186.56287726358147,199.3030303030303,192.9329537833059
2012-03-15,1610612742,1610612766,2011,101.0,96.0,197.0,94.6,94.25,86.35,99.5,44,24,20,0.545,41,6,35,0.146,16,8,3,3,192.19074675324674,188.3600543478261,190.2754005505364
2012-03-15,1610612743,1610612760,2011,90.0,103.0,193.0,104.35,104.15,104.2,98.45,43,24,19,0.5579999999999999,42,32,10,0.762,13,11,18,14,208.65714285714284,203.3534234234234,206.00528314028313
2012-03-15,1610612762,1610612750,2011,111.0,105.0,216.0,98.4,99.95,99.7,99.35,42,20,22,0.476,43,22,21,0.512,15,5,12,10,198.20967023172904,193.28,195.74483511586453
2012-03-15,1610612746,1610612756,2011,87.0,91.0,178.0,97.8,95.6,99.8,99.75,41,24,17,0.585,42,20,22,0.476,13,11,13,7,198.50497512437812,205.45558035714288,201.9802777407605
2012-03-14,1610612754,1610612755,2011,111.0,94.0,205.0,96.3,93.4,91.95,88.9,40,24,16,0.6,42,25,17,0.595,12,12,16,9,195.78298611111111,179.2,187.49149305555557
2012-03-14,1610612751,1610612761,2011,98.0,84.0,182.0,93.8,100.0,93.65,95.3,43,14,29,0.326,42,14,28,0.333,4,10,7,7,193.40200892857143,197.76314616755792,195.58257754806468
2012-03-14,1610612752,1610612757,2011,121.0,79.0,200.0,98.6,97.45,97.4,98.15,42,18,24,0.429,42,20,22,0.476,11,7,14,6,204.71302216538788,191.3011387163561,198.007080440872
2012-03-14,1610612749,1610612739,2011,115.0,105.0,220.0,99.35,103.1,94.7,100.1,42,18,24,0.429,40,16,24,0.4,10,8,9,7,188.41160714285712,196.4353669939224,192.42348706838976
2012-03-14,1610612740,1610612747,2011,101.0,107.0,208.0,88.6,94.95,97.6,93.55,42,10,32,0.238,42,26,16,0.619,4,6,18,8,186.38844662175956,193.50587084148728,189.9471587316234
2012-03-14,1610612745,1610612766,2011,107.0,87.0,194.0,98.15,100.35,85.4,99.75,43,23,20,0.535,40,6,34,0.15,15,8,3,3,203.88827919227393,188.30698529411765,196.0976322431958
2012-03-14,1610612759,1610612753,2011,122.0,111.0,233.0,101.7,95.75,96.75,92.35,40,27,13,0.675,43,28,15,0.6509999999999999,16,11,15,13,198.9485294117647,189.70830781792205,194.32841861484337
2012-03-14,1610612741,1610612748,2011,106.0,102.0,208.0,100.35,90.2,101.4,91.85,44,35,9,0.795,41,31,10,0.7559999999999999,17,18,18,13,188.00813852813855,194.31578947368422,191.16196400091138
2012-03-14,1610612758,1610612765,2011,112.0,124.0,236.0,100.85,104.4,92.4,96.2,42,14,28,0.333,42,15,27,0.35700000000000004,10,4,12,3,201.52460317460316,193.03482142857143,197.2797123015873
2012-03-14,1610612756,1610612762,2011,120.0,111.0,231.0,98.75,99.25,96.85,98.25,41,19,22,0.463,41,20,21,0.488,12,7,15,5,205.2643795289855,197.96834011759384,201.61635982328966
2012-03-14,1610612746,1610612737,2011,96.0,82.0,178.0,98.15,96.05,91.6,94.35,40,23,17,0.575,42,24,18,0.5710000000000001,12,11,12,12,198.65625717566016,187.65312738367658,193.15469227966838
2012-03-14,1610612744,1610612738,2011,103.0,105.0,208.0,99.6,99.1,91.85,92.85,39,18,21,0.462,41,22,19,0.537,10,8,16,6,204.9764568764569,177.72,191.34822843822843
2012-03-13,1610612753,1610612748,2011,104.0,98.0,202.0,96.65,92.15,101.45,90.6,42,27,15,0.643,40,31,9,0.775,14,13,18,13,189.61635610766047,194.26087719298246,191.93861665032148
2012-03-13,1610612739,1610612761,2011,88.0,96.0,184.0,94.5,100.25,93.8,95.7,39,16,23,0.41,41,13,28,0.317,9,7,7,6,196.50996204933585,197.8623303167421,197.18614618303897
2012-03-13,1610612754,1610612757,2011,92.0,75.0,167.0,97.0,94.6,98.1,98.2,39,23,16,0.59,41,20,21,0.488,11,12,14,6,196.02083333333334,191.46407563025213,193.74245448179272
2012-03-13,1610612763,1610612747,2011,111.0,116.0,227.0,94.45,91.5,96.3,92.75,40,24,16,0.6,41,25,16,0.61,15,9,18,7,194.07833301176925,193.26156442326783,193.66994871751854
2012-03-13,1610612760,1610612745,2011,103.0,104.0,207.0,104.6,97.5,97.9,99.7,41,32,9,0.78,42,22,20,0.524,18,14,15,7,203.33296803652968,203.8868092691622,203.60988865284594
2012-03-13,1610612742,1610612764,2011,107.0,98.0,205.0,93.55,94.1,99.25,106.25,43,23,20,0.535,40,9,31,0.225,15,8,6,3,192.11400624691765,199.27389277389278,195.69394951040522
2012-03-13,1610612743,1610612737,2011,118.0,117.0,235.0,103.2,103.55,90.2,92.8,42,23,19,0.5479999999999999,41,24,17,0.585,12,11,12,12,208.47525879917185,187.33014492753625,197.90270186335405
2012-03-13,1610612758,1610612744,2011,89.0,115.0,204.0,101.05,104.75,99.3,99.7,41,14,27,0.341,38,17,21,0.447,10,4,10,7,201.49746543778804,204.98461538461538,203.2410404112017
2012-03-12,1610612751,1610612749,2011,99.0,105.0,204.0,93.8,99.55,98.1,102.55,42,14,28,0.333,41,17,24,0.415,4,10,10,7,193.31904761904764,188.30208333333331,190.81056547619048
2012-03-12,1610612741,1610612752,2011,104.0,99.0,203.0,100.5,90.25,97.85,97.1,43,34,9,0.7909999999999999,41,18,23,0.439,16,18,11,7,187.90426465426464,204.71323529411765,196.30874997419113
2012-03-12,1610612740,1610612766,2011,71.0,73.0,144.0,89.7,94.65,85.4,101.5,41,10,31,0.244,39,5,34,0.128,4,6,3,2,186.67947390223696,188.62546641791045,187.6524701600737
2012-03-12,1610612759,1610612764,2011,112.0,97.0,209.0,100.4,95.3,98.2,105.8,39,26,13,0.667,39,9,30,0.231,15,11,6,3,198.87489025460928,199.2125946969697,199.0437424757895
2012-03-12,1610612762,1610612765,2011,105.0,90.0,195.0,96.9,99.3,91.85,95.9,40,19,21,0.475,41,15,26,0.366,14,5,12,3,197.98955223880597,192.9936507936508,195.4916015162284
2012-03-12,1610612756,1610612750,2011,124.0,127.0,251.0,97.0,97.7,99.35,98.55,40,19,21,0.475,42,21,21,0.5,12,7,12,9,204.9204963235294,193.28,199.10024816176468
2012-03-12,1610612746,1610612738,2011,85.0,94.0,179.0,98.8,96.4,91.7,92.75,39,23,16,0.59,40,21,19,0.525,12,11,16,5,198.80445429104478,177.72,188.2622271455224
2012-03-11,1610612752,1610612755,2011,94.0,106.0,200.0,98.25,97.05,91.25,89.85,40,18,22,0.45,41,24,17,0.585,11,7,16,8,204.76097453906937,179.2,191.98048726953468
2012-03-11,1610612747,1610612738,2011,97.0,94.0,191.0,95.1,91.55,92.0,92.6,40,24,16,0.6,39,21,18,0.5379999999999999,17,7,16,5,193.28049516908214,177.72,185.50024758454106
2012-03-11,1610612761,1610612749,2011,99.0,105.0,204.0,93.15,94.15,97.85,102.95,40,13,27,0.325,40,16,24,0.4,7,6,10,6,197.8222732491389,188.18933823529412,193.00580574221652
2012-03-11,1610612753,1610612754,2011,107.0,94.0,201.0,96.75,92.6,97.6,93.5,41,26,15,0.634,38,23,15,0.605,13,13,11,12,189.52898550724638,195.9757433489828,192.7523644281146
2012-03-11,1610612739,1610612745,2011,118.0,107.0,225.0,94.2,100.55,97.1,98.8,38,15,23,0.395,41,22,19,0.537,8,7,15,7,196.28081367356765,203.74683257918554,200.0138231263766
2012-03-11,1610612743,1610612763,2011,91.0,94.0,185.0,103.15,103.8,94.3,91.85,41,23,18,0.561,39,23,16,0.59,12,11,15,8,208.65567226890755,194.13693270735524,201.3963024881314
2012-03-11,1610612758,1610612737,2011,99.0,106.0,205.0,100.7,103.85,89.9,91.7,40,14,26,0.35,40,23,17,0.575,10,4,12,11,201.4612412177986,187.20113591852723,194.33118856816293
2012-03-11,1610612746,1610612744,2011,93.0,97.0,190.0,98.7,96.0,99.75,100.75,38,23,15,0.605,37,16,21,0.4320000000000001,12,11,10,6,198.87005448945746,205.10240384615383,201.98622916780565
2012-03-10,1610612764,1610612757,2011,99.0,110.0,209.0,97.65,105.2,97.25,98.3,38,9,29,0.237,40,19,21,0.475,6,3,14,5,199.1233173076923,191.3184434968017,195.22088040224702
2012-03-10,1610612748,1610612754,2011,93.0,91.0,184.0,101.75,90.5,97.4,93.55,39,30,9,0.769,37,23,14,0.622,17,13,11,12,194.33333333333331,196.05079365079365,195.19206349206348
2012-03-10,1610612765,1610612761,2011,105.0,86.0,191.0,91.05,95.95,93.4,94.05,40,14,26,0.35,39,13,26,0.333,11,3,7,6,193.03174603174602,197.86986940298507,195.45080771736554
2012-03-10,1610612751,1610612745,2011,106.0,112.0,218.0,92.15,98.65,96.05,98.45,41,14,27,0.341,40,21,19,0.525,4,10,15,6,193.1205069124424,203.65716911764707,198.38883801504474
2012-03-10,1610612741,1610612762,2011,111.0,97.0,208.0,99.45,90.15,96.95,98.15,42,33,9,0.7859999999999999,39,19,20,0.487,15,18,14,5,187.7632983454901,197.91515151515154,192.83922493032082
2012-03-10,1610612760,1610612766,2011,122.0,95.0,217.0,103.55,97.45,84.25,99.85,40,31,9,0.775,38,5,33,0.132,17,14,3,2,203.2425,188.4005681818182,195.8215340909091
2012-03-10,1610612750,1610612740,2011,89.0,95.0,184.0,99.9,98.35,89.30000000000003,94.65,41,21,20,0.512,40,9,31,0.225,12,9,4,5,204.49659245797363,186.71659663865546,195.60659454831455
2012-03-10,1610612756,1610612763,2011,98.0,91.0,189.0,96.85,97.6,93.95,91.8,39,18,21,0.462,38,23,15,0.605,11,7,15,8,205.02903451492537,194.16901408450707,199.59902429971623
2012-03-10,1610612744,1610612742,2011,111.0,87.0,198.0,99.25,101.05,93.6,93.1,36,15,21,0.417,42,23,19,0.5479999999999999,9,6,15,8,205.15625,192.07128580946036,198.6137679047302
2012-03-09,1610612755,1610612762,2011,104.0,91.0,195.0,90.95,89.4,97.35,98.15,40,23,17,0.575,38,19,19,0.5,15,8,14,5,191.46190476190475,197.93846153846152,194.70018315018314
2012-03-09,1610612766,1610612751,2011,74.0,83.0,157.0,85.25,100.8,92.95,100.25,37,5,32,0.135,40,13,27,0.325,3,2,4,9,188.66197691197692,193.38323983169704,191.02260837183698
2012-03-09,1610612738,1610612757,2011,104.0,86.0,190.0,91.35,92.75,97.5,97.8,38,20,18,0.526,39,19,20,0.487,15,5,14,5,185.38231631382314,191.31233766233765,188.3473269880804
2012-03-09,1610612765,1610612737,2011,86.0,85.0,171.0,91.15,95.7,90.35,91.0,39,13,26,0.333,39,23,16,0.59,10,3,12,11,193.21802054154995,187.30146912844947,190.2597448349997
2012-03-09,1610612760,1610612739,2011,90.0,96.0,186.0,104.1,97.2,94.0,100.9,39,31,8,0.795,37,14,23,0.378,17,14,8,6,203.36779342723003,196.38512356251528,199.87645849487265
2012-03-09,1610612750,1610612747,2011,102.0,105.0,207.0,99.75,98.55,94.2,91.25,40,21,19,0.525,39,23,16,0.59,12,9,17,6,204.47073732718894,193.17606209150327,198.82339970934612
2012-03-09,1610612749,1610612752,2011,119.0,114.0,233.0,97.15,102.1,97.0,96.05,39,15,24,0.385,39,18,21,0.462,9,6,11,7,187.83169934640523,204.53731343283584,196.18450638962054
2012-03-09,1610612759,1610612746,2011,108.0,120.0,228.0,100.1,93.85,96.6,94.45,38,26,12,0.684,37,22,15,0.595,15,11,12,10,198.65508021390372,198.65295815295815,198.65401918343093
2012-03-09,1610612743,1610612740,2011,110.0,97.0,207.0,102.1,103.6,88.5,93.8,40,22,18,0.55,39,9,30,0.231,11,11,4,5,208.6772921108742,186.58812872975278,197.6327104203135
2012-03-09,1610612758,1610612742,2011,110.0,97.0,207.0,100.05,104.2,94.85,92.55,39,13,26,0.333,41,23,18,0.561,9,4,15,8,201.40714285714284,191.96742616033754,196.6872845087402
2012-03-08,1610612741,1610612753,2011,94.0,99.0,193.0,100.25,89.95,95.25,91.6,41,33,8,0.805,40,25,15,0.625,15,18,13,12,187.72258297258298,189.5090579710145,188.61582047179874
2012-03-08,1610612756,1610612742,2011,96.0,94.0,190.0,97.0,99.0,94.3,91.8,38,17,21,0.447,40,23,17,0.575,10,7,15,8,205.1332859848485,191.97562435853575,198.55445517169213
2012-03-07,1610612761,1610612745,2011,116.0,98.0,214.0,92.55,94.4,96.5,97.25,38,12,26,0.316,39,21,18,0.5379999999999999,6,6,15,6,197.7528409090909,203.59640522875816,200.67462306892452
2012-03-07,1610612755,1610612738,2011,103.0,71.0,174.0,89.5,89.3,91.95,92.45,39,22,17,0.564,37,20,17,0.541,14,8,15,5,191.57608695652175,185.47112750263435,188.52360722957803
2012-03-07,1610612764,1610612747,2011,106.0,101.0,207.0,96.95,103.9,93.8,90.4,37,8,29,0.21600000000000005,38,23,15,0.605,5,3,17,6,199.046875,193.06851160862357,196.05769330431178
2012-03-07,1610612766,1610612762,2011,93.0,99.0,192.0,86.19999999999997,100.85,96.8,98.45,36,5,31,0.139,37,18,19,0.486,3,2,14,4,188.64956011730206,197.9859375,193.31774880865103
2012-03-07,1610612748,1610612737,2011,89.0,86.0,175.0,101.9,90.45,91.4,91.6,38,29,9,0.763,38,23,15,0.605,16,13,12,11,194.46855855855856,187.3768115942029,190.92268507638073
2012-03-07,1610612751,1610612746,2011,101.0,100.0,201.0,92.75,99.6,96.2,94.35,39,12,27,0.308,36,22,14,0.611,3,9,12,10,193.3175338560228,198.63687423687423,195.97720404644852
2012-03-07,1610612749,1610612741,2011,104.0,106.0,210.0,97.1,100.9,99.05,89.65,38,15,23,0.395,40,32,8,0.8,9,6,15,17,187.6480075901328,187.58040935672514,187.61420847342896
2012-03-07,1610612760,1610612756,2011,115.0,104.0,219.0,103.3,95.95,96.15,97.9,38,30,8,0.789,37,17,20,0.459,16,14,10,7,203.26095238095238,205.03246753246754,204.14670995670997
2012-03-07,1610612750,1610612757,2011,106.0,94.0,200.0,99.5,99.15,97.5,96.7,39,20,19,0.513,38,19,19,0.5,11,9,14,5,204.49485741000467,191.2291208791209,197.86198914456278
2012-03-07,1610612759,1610612752,2011,118.0,105.0,223.0,99.15,92.75,95.8,94.7,37,25,12,0.6759999999999999,38,18,20,0.474,14,11,11,7,198.46696832579187,204.38263229308006,201.42480030943597
2012-03-07,1610612743,1610612739,2011,99.0,100.0,199.0,102.4,104.05,94.05,100.45,39,22,17,0.564,36,13,23,0.361,11,11,8,5,208.76017316017317,196.38457711442786,202.57237513730053
2012-03-07,1610612758,1610612740,2011,99.0,98.0,197.0,100.25,104.3,88.35,94.3,38,12,26,0.316,38,9,29,0.237,8,4,4,5,201.43595641646488,186.52941176470588,193.9826840905854
2012-03-07,1610612744,1610612763,2011,92.0,110.0,202.0,99.15,100.1,93.0,91.7,35,15,20,0.429,37,22,15,0.595,9,6,15,7,205.18005952380952,194.10915492957747,199.6446072266935
2012-03-06,1610612766,1610612753,2011,100.0,84.0,184.0,85.25,101.55,94.4,91.25,35,4,31,0.114,39,25,14,0.6409999999999999,2,2,13,12,188.70230998509686,189.55569976205928,189.12900487357808
2012-03-06,1610612754,1610612737,2011,96.0,101.0,197.0,96.75,93.6,90.5,92.05,36,23,13,0.639,37,22,15,0.595,11,12,12,10,196.05437788018432,187.29934680547052,191.6768623428274
2012-03-06,1610612738,1610612745,2011,97.0,92.0,189.0,92.1,91.05,97.6,97.7,36,19,17,0.528,38,21,17,0.5529999999999999,14,5,15,6,185.4448717948718,203.73529411764707,194.59008295625944
2012-03-06,1610612748,1610612751,2011,108.0,78.0,186.0,100.6,91.1,93.8,99.0,37,28,9,0.757,38,12,26,0.316,15,13,3,9,194.53214611872147,193.37475891996144,193.95345251934145
2012-03-06,1610612765,1610612747,2011,88.0,85.0,173.0,91.8,96.8,94.85,91.05,38,12,26,0.316,37,23,14,0.622,9,3,17,6,193.394930111348,193.21527777777777,193.3051039445629
2012-03-06,1610612742,1610612752,2011,95.0,85.0,180.0,94.6,92.55,97.1,93.85,39,22,17,0.564,37,18,19,0.486,14,8,11,7,192.05717255717258,204.55396096440873,198.30556676079067
2012-03-05,1610612761,1610612753,2011,88.0,92.0,180.0,93.45,94.25,94.9,91.0,37,12,25,0.324,38,24,14,0.632,6,6,13,11,197.89375,189.6340579710145,193.76390398550726
2012-03-05,1610612764,1610612744,2011,100.0,120.0,220.0,96.65,102.9,98.15,100.45,36,8,28,0.222,34,14,20,0.412,5,3,9,5,198.86483134920636,205.06349206349205,201.96416170634922
2012-03-05,1610612739,1610612762,2011,100.0,109.0,209.0,94.0,99.6,96.4,99.4,35,13,22,0.371,36,17,19,0.472,8,5,14,3,196.26969696969695,197.9,197.08484848484846
2012-03-05,1610612741,1610612754,2011,92.0,72.0,164.0,99.2,90.5,97.9,93.5,39,31,8,0.795,35,23,12,0.657,14,17,11,12,187.7427724240178,196.27653108929405,192.00965175665593
2012-03-05,1610612749,1610612755,2011,97.0,93.0,190.0,97.25,100.7,90.0,88.94999999999997,37,14,23,0.378,38,22,16,0.579,8,6,14,8,187.6222275795564,191.6004459308807,189.61133675521856
2012-03-05,1610612760,1610612742,2011,95.0,91.0,186.0,103.75,96.0,94.75,92.35,37,29,8,0.784,38,22,16,0.579,15,14,14,8,203.39014492753623,192.09299262381455,197.74156877567538
2012-03-05,1610612750,1610612746,2011,95.0,94.0,189.0,99.1,98.4,96.85,94.7,38,19,19,0.5,35,22,13,0.629,10,9,12,10,204.60056925996207,198.7140376984127,201.6573034791874
2012-03-05,1610612743,1610612758,2011,119.0,116.0,235.0,101.25,102.3,99.45,102.95,38,21,17,0.5529999999999999,37,12,25,0.324,10,11,8,4,208.5686813186813,201.19982805207565,204.8842546853785
2012-03-05,1610612757,1610612740,2011,86.0,74.0,160.0,98.8,96.4,89.2,95.05,37,18,19,0.486,37,9,28,0.243,13,5,4,5,191.47146042363434,186.74506145741879,189.10826094052658
2012-03-04,1610612738,1610612752,2011,115.0,111.0,226.0,90.7,89.9,96.15,93.3,35,18,17,0.514,36,18,18,0.5,13,5,11,7,185.1573131094258,204.37126865671644,194.7642908830711
2012-03-04,1610612747,1610612748,2011,93.0,83.0,176.0,95.05,91.5,101.3,91.7,36,22,14,0.611,36,28,8,0.778,16,6,15,13,193.34037558685446,194.65142539800075,193.9959004924276
2012-03-04,1610612761,1610612744,2011,83.0,75.0,158.0,93.15,95.5,99.65,101.05,36,11,25,0.306,33,14,19,0.424,5,6,9,5,198.2109375,205.4431643625192,201.8270509312596
2012-03-04,1610612766,1610612751,2011,101.0,104.0,205.0,83.69999999999997,100.45,93.45,98.45,34,4,30,0.118,37,11,26,0.297,2,2,3,8,188.5818181818182,193.29190114998778,190.936859665903
2012-03-04,1610612755,1610612741,2011,91.0,96.0,187.0,90.2,87.85,99.3,90.35,37,22,15,0.595,38,30,8,0.789,14,8,14,16,191.62239819004526,187.7501408450704,189.68626951755783
2012-03-04,1610612745,1610612746,2011,103.0,105.0,208.0,97.3,96.65,96.95,93.6,37,21,16,0.568,34,21,13,0.618,15,6,12,9,203.68283582089552,198.64285714285714,201.16284648187633
2012-03-04,1610612756,1610612758,2011,96.0,88.0,184.0,95.65,97.7,99.55,102.8,36,16,20,0.444,36,12,24,0.333,9,7,8,4,205.1860805860806,201.33175473579263,203.25891766093662
2012-03-04,1610612759,1610612743,2011,94.0,99.0,193.0,99.5,92.55,102.4,102.25,36,25,11,0.6940000000000001,37,20,17,0.541,14,11,10,10,198.50735294117646,208.673132664437,203.59024280280673
2012-03-03,1610612764,1610612739,2011,101.0,98.0,199.0,96.8,103.4,94.35,100.2,35,7,28,0.2,34,13,21,0.382,4,3,8,5,198.8462701612903,196.26913199794555,197.5577010796179
2012-03-03,1610612737,1610612760,2011,97.0,90.0,187.0,90.25,92.0,104.25,96.75,36,21,15,0.583,36,29,7,0.8059999999999999,11,10,15,14,187.31224109362054,203.49618096357227,195.40421102859642
2012-03-03,1610612753,1610612749,2011,114.0,98.0,212.0,93.45,91.4,97.6,99.95,37,23,14,0.622,36,14,22,0.389,12,11,8,6,189.46323529411765,187.4464154636653,188.45482537889148
2012-03-03,1610612763,1610612765,2011,100.0,83.0,183.0,93.0,92.4,91.9,96.45,36,21,15,0.583,37,12,25,0.324,14,7,9,3,194.19285714285712,193.44920558497833,193.8210313639177
2012-03-03,1610612740,1610612754,2011,84.0,102.0,186.0,90.1,95.15,97.7,94.1,36,9,27,0.25,34,22,12,0.647,4,5,11,11,186.73134328358208,196.34345351043643,191.53739839700927
2012-03-03,1610612742,1610612762,2011,102.0,96.0,198.0,95.45,92.6,96.65,100.1,37,21,16,0.568,35,17,18,0.486,13,8,14,3,192.05977584059775,197.9,194.9798879202989
2012-03-03,1610612757,1610612750,2011,110.0,122.0,232.0,98.75,93.85,98.25,97.4,36,18,18,0.5,37,18,19,0.486,13,5,10,8,191.19151583710408,204.38428158148506,197.78789870929455
2012-03-02,1610612761,1610612763,2011,99.0,102.0,201.0,92.4,95.1,92.8,91.5,35,11,24,0.314,35,20,15,0.5710000000000001,5,6,14,6,198.1969246031746,194.13850931677018,196.16771695997238
2012-03-02,1610612738,1610612751,2011,107.0,94.0,201.0,90.05,89.55,93.5,98.6,34,17,17,0.5,36,11,25,0.306,12,5,3,8,185.04010989010987,193.2368355688028,189.13847272945634
2012-03-02,1610612737,1610612749,2011,99.0,94.0,193.0,89.95,91.5,97.45,99.1,35,20,15,0.5710000000000001,35,14,21,0.4,10,10,8,6,187.2807441664915,187.40921510183804,187.34497963416476
2012-03-02,1610612739,1610612741,2011,91.0,112.0,203.0,94.35,99.0,98.35,90.65,33,13,20,0.394,37,29,8,0.784,8,5,14,15,196.1968709256845,187.64960030452988,191.9232356151072
2012-03-02,1610612755,1610612744,2011,105.0,83.0,188.0,89.4,87.3,100.45,100.35,36,21,15,0.583,32,14,18,0.438,13,8,9,5,191.63754305396094,205.58938329430134,198.61346317413114
2012-03-02,1610612740,1610612742,2011,97.0,92.0,189.0,89.3,94.7,95.3,92.3,35,8,27,0.229,36,21,15,0.583,3,5,13,8,186.69448213478063,192.07575757575756,189.3851198552691
2012-03-02,1610612745,1610612743,2011,105.0,117.0,222.0,97.2,94.6,102.5,102.7,36,21,15,0.583,36,19,17,0.528,15,6,10,9,203.52272727272725,208.56742081447965,206.04507404360345
2012-03-02,1610612759,1610612766,2011,102.0,72.0,174.0,100.45,94.8,83.85,99.95,35,24,11,0.6859999999999999,33,4,29,0.121,13,11,2,2,198.69981325863677,188.68076923076924,193.69029124470302
2012-03-02,1610612762,1610612748,2011,99.0,98.0,197.0,97.1,100.1,101.45,91.65,34,16,18,0.471,35,28,7,0.8,13,3,15,13,197.90625,194.63013698630135,196.26819349315068
2012-03-02,1610612756,1610612746,2011,81.0,78.0,159.0,96.4,98.75,98.4,94.8,35,15,20,0.429,33,21,12,0.636,8,7,12,9,205.53980654761904,198.96454173067076,202.2521741391449
2012-03-02,1610612747,1610612758,2011,115.0,107.0,222.0,94.25,90.3,98.85,101.85,35,21,14,0.6,35,12,23,0.343,15,6,8,4,193.1404761904762,201.18403743991905,197.16225681519762
2012-03-01,1610612753,1610612760,2011,102.0,105.0,207.0,92.5,90.7,105.0,97.1,36,23,13,0.639,35,28,7,0.8,12,11,15,13,189.32462686567163,203.46813579511615,196.3963813303939
2012-03-01,1610612756,1610612750,2011,104.0,95.0,199.0,96.35,99.5,98.4,97.6,34,14,20,0.412,36,18,18,0.5,7,7,10,8,205.5873015873016,204.4357843137255,205.01154295051356
2012-03-01,1610612758,1610612746,2011,100.0,108.0,208.0,98.65,100.45,98.45,95.05,34,12,22,0.353,32,20,12,0.625,8,4,12,8,201.1190169840453,198.89513400988812,200.0070754969667
2012-03-01,1610612757,1610612748,2011,93.0,107.0,200.0,98.95,92.7,101.3,92.85,35,18,17,0.514,34,27,7,0.794,13,5,15,12,191.14202066590127,194.58742389649922,192.86472228120024
2012-02-29,1610612755,1610612760,2011,88.0,92.0,180.0,89.5,87.55,104.6,96.4,35,21,14,0.6,34,27,7,0.794,13,8,15,12,191.7137529137529,203.62681159420288,197.6702822539779
2012-02-29,1610612764,1610612753,2011,95.0,102.0,197.0,97.3,103.4,90.2,90.3,34,7,27,0.206,35,22,13,0.629,4,3,12,10,198.843493852459,189.27462686567165,194.0590603590653
2012-02-29,1610612738,1610612749,2011,102.0,96.0,198.0,89.3,87.55,97.65,98.3,33,16,17,0.485,34,14,20,0.412,11,5,8,6,184.941248606466,187.33240857503154,186.13682859074876
2012-02-29,1610612752,1610612739,2011,120.0,103.0,223.0,95.8,92.45,93.1,97.9,35,17,18,0.486,32,13,19,0.406,10,7,8,5,204.24621212121212,195.9893899204244,200.11780102081826
2012-02-29,1610612737,1610612744,2011,82.0,85.0,167.0,90.5,91.8,101.2,101.85,34,20,14,0.588,31,13,18,0.419,10,10,9,4,187.44526248399487,205.91547619047617,196.6803693372355
2012-02-29,1610612765,1610612766,2011,109.0,94.0,203.0,91.35,96.8,83.5,99.35,36,11,25,0.306,32,4,28,0.125,8,3,2,2,193.40420332355816,188.55625,190.98022666177908
2012-02-29,1610612763,1610612742,2011,96.0,85.0,181.0,91.65,91.4,94.55,91.15,34,19,15,0.5589999999999999,35,21,14,0.6,13,6,13,8,194.23913043478262,192.1485275288092,193.19382898179592
2012-02-29,1610612740,1610612761,2011,84.0,95.0,179.0,89.45,94.6,91.3,95.7,34,8,26,0.235,34,10,24,0.294,3,5,5,5,186.73340987370838,198.34126984126985,192.53733985748912
2012-02-29,1610612759,1610612741,2011,89.0,96.0,185.0,100.65,93.55,99.25,89.94999999999997,34,24,10,0.706,36,28,8,0.778,13,11,14,14,198.80977229601518,187.66959289986494,193.23968259794006
2012-02-29,1610612743,1610612757,2011,104.0,95.0,199.0,102.1,103.25,98.65,92.1,35,18,17,0.514,34,18,16,0.529,9,9,13,5,208.65119485294116,191.06401585820896,199.85760535557506
2012-02-29,1610612762,1610612745,2011,104.0,83.0,187.0,96.45,100.65,97.8,94.45,33,15,18,0.455,35,21,14,0.6,12,3,15,6,197.9920634920635,203.68256333830104,200.83731341518228
2012-02-29,1610612747,1610612750,2011,104.0,85.0,189.0,93.55,90.15,99.2,97.3,34,20,14,0.588,35,18,17,0.514,14,6,10,8,193.17391304347825,204.573778664008,198.87384585374312
2012-02-28,1610612739,1610612738,2011,83.0,86.0,169.0,93.45,98.25,89.69999999999997,87.7,31,13,18,0.419,32,15,17,0.469,8,5,11,4,196.18049568965517,185.07189764492753,190.62619666729137
2012-02-28,1610612754,1610612744,2011,102.0,78.0,180.0,97.45,94.35,101.8,101.6,33,21,12,0.636,30,13,17,0.433,10,11,9,4,196.48649951783995,206.1424535916061,201.31447655472303
2012-02-28,1610612765,1610612755,2011,68.0,97.0,165.0,92.65,96.5,88.6,88.4,35,11,24,0.314,34,20,14,0.588,8,3,13,7,193.65012406947892,191.93418560606062,192.79215483776977
2012-02-28,1610612741,1610612740,2011,99.0,95.0,194.0,100.2,90.05,89.1,94.15,35,27,8,0.7709999999999999,33,8,25,0.242,13,14,3,5,187.62230919765165,186.69801864801866,187.16016392283515
2012-02-28,1610612749,1610612764,2011,119.0,118.0,237.0,96.3,97.25,95.55,102.6,33,13,20,0.394,33,7,26,0.212,7,6,4,3,186.91410256410256,198.55802758261774,192.73606507336015
2012-02-28,1610612745,1610612761,2011,88.0,85.0,173.0,98.35,95.45,91.25,95.95,34,20,14,0.588,33,10,23,0.303,14,6,5,5,203.89445145018914,198.53865847414235,201.21655496216573
2012-02-28,1610612742,1610612751,2011,92.0,93.0,185.0,94.45,91.75,93.4,99.05,34,21,13,0.618,35,10,25,0.28600000000000003,13,8,3,7,192.19996293550778,193.3031525851198,192.7515577603138
2012-02-28,1610612758,1610612762,2011,103.0,96.0,199.0,98.1,101.35,96.95,100.3,33,11,22,0.333,32,15,17,0.469,7,4,12,3,201.13066247708826,197.983866770752,199.55726462392013
2012-02-28,1610612746,1610612750,2011,97.0,109.0,206.0,98.65,94.15,98.3,97.1,31,20,11,0.645,34,17,17,0.5,12,8,10,7,198.83381808566895,204.56997971602436,201.70189890084666
2012-02-23,1610612748,1610612752,2011,102.0,88.0,190.0,101.85,93.05,95.55,92.05,33,26,7,0.7879999999999999,34,17,17,0.5,14,12,10,7,194.625,204.34343434343435,199.48421717171718
2012-02-23,1610612737,1610612753,2011,83.0,78.0,161.0,91.9,91.95,91.4,90.8,33,19,14,0.5760000000000001,34,22,12,0.647,9,10,12,10,187.66099674972912,189.50431436567163,188.58265555770038
2012-02-23,1610612743,1610612759,2011,99.0,114.0,213.0,103.0,102.75,99.95,93.65,34,18,16,0.529,33,23,10,0.6970000000000001,9,9,13,10,208.6265172735761,198.70353875782376,203.66502801569993
2012-02-23,1610612760,1610612747,2011,100.0,85.0,185.0,105.0,96.95,93.75,90.15,33,26,7,0.7879999999999999,33,20,13,0.606,14,12,14,6,203.76715686274508,193.2328874024526,198.50002213259884
2012-02-22,1610612761,1610612765,2011,103.0,93.0,196.0,90.6,96.05,92.0,96.2,32,9,23,0.281,34,11,23,0.324,4,5,8,3,198.56451612903226,193.59962168978564,196.08206890940895
2012-02-22,1610612764,1610612758,2011,107.0,115.0,222.0,95.5,102.55,96.8,101.05,32,7,25,0.219,32,10,22,0.313,4,3,7,3,198.3468253968254,200.97846889952154,199.66264714817348
2012-02-22,1610612766,1610612754,2011,88.0,102.0,190.0,83.9,99.35,97.05,94.5,31,4,27,0.129,32,20,12,0.625,2,2,10,10,188.55879237288136,196.52556887692685,192.54218062490412
2012-02-22,1610612739,1610612740,2011,84.0,89.0,173.0,94.05,98.75,89.6,95.35,30,13,17,0.433,32,7,25,0.219,8,5,3,4,196.34592227695674,186.82307692307694,191.58449960001684
2012-02-22,1610612760,1610612738,2011,119.0,104.0,223.0,104.5,96.45,88.4,86.6,32,25,7,0.7809999999999999,31,15,16,0.484,13,12,11,4,203.6281094527363,184.7781228433402,194.20311614803825
2012-02-22,1610612751,1610612753,2011,91.0,108.0,199.0,92.55,97.85,91.85,91.7,34,10,24,0.294,33,21,12,0.636,3,7,12,9,193.25192307692308,189.43970623075103,191.34581465383707
2012-02-22,1610612752,1610612737,2011,99.0,82.0,181.0,96.3,93.9,92.65,91.6,33,16,17,0.485,32,19,13,0.594,9,7,9,10,204.53760683760686,187.6956043956044,196.11660561660563
2012-02-22,1610612741,1610612749,2011,110.0,91.0,201.0,98.55,88.69999999999997,95.85,96.45,34,26,8,0.765,32,13,19,0.406,12,14,7,6,187.5229303156641,186.81145833333335,187.16719432449872
2012-02-22,1610612745,1610612755,2011,93.0,87.0,180.0,98.95,96.2,89.30000000000003,88.4,33,19,14,0.5760000000000001,33,20,13,0.606,13,6,13,7,204.05827356557376,192.04256854256855,198.05042105407114
2012-02-22,1610612750,1610612762,2011,100.0,98.0,198.0,97.9,97.55,96.45,99.65,33,16,17,0.485,31,15,16,0.484,9,7,12,3,204.6116829644879,197.98373015873017,201.29770656160903
2012-02-22,1610612756,1610612744,2011,104.0,106.0,210.0,95.65,99.25,101.25,101.45,33,14,19,0.424,29,12,17,0.414,7,7,9,3,205.54761904761904,206.1186371100164,205.8331280788177
2012-02-22,1610612742,1610612747,2011,91.0,96.0,187.0,94.55,91.3,92.95,90.2,33,21,12,0.636,32,19,13,0.594,13,8,14,5,192.2394366197183,193.27807971014494,192.75875816493163
2012-02-22,1610612746,1610612743,2011,103.0,95.0,198.0,98.6,94.1,103.65,102.8,30,19,11,0.633,33,18,15,0.545,11,8,9,9,198.8360655737705,208.69675432361998,203.76640994869524
2012-02-21,1610612739,1610612765,2011,101.0,100.0,201.0,93.55,97.8,91.9,95.2,29,12,17,0.414,33,11,22,0.333,7,5,8,3,196.2908787541713,193.50576923076923,194.89832399247027
2012-02-21,1610612754,1610612740,2011,117.0,108.0,225.0,96.0,93.3,88.9,93.55,31,19,12,0.613,31,7,24,0.226,9,10,3,4,196.2983830845771,186.54579326923078,191.42208817690394
2012-02-21,1610612748,1610612758,2011,120.0,108.0,228.0,100.75,92.0,96.15,101.45,32,25,7,0.7809999999999999,31,10,21,0.32299999999999995,13,12,7,3,194.3960289514867,200.77543859649123,197.58573377398898
2012-02-21,1610612763,1610612755,2011,89.0,76.0,165.0,93.6,92.35,90.85,87.9,33,18,15,0.545,32,20,12,0.625,12,6,13,7,194.460358056266,192.2754154447703,193.36788675051815
2012-02-21,1610612757,1610612759,2011,137.0,97.0,234.0,96.85,91.7,99.05,91.15,33,17,16,0.515,32,23,9,0.7190000000000001,12,5,13,10,190.75544507575756,198.43499511241447,194.59522009408602
2012-02-20,1610612741,1610612737,2011,90.0,79.0,169.0,97.95,87.94999999999997,92.5,91.6,33,25,8,0.758,31,19,12,0.613,11,14,9,10,187.6559226430298,187.81817168338907,187.73704716320944
2012-02-20,1610612752,1610612751,2011,92.0,100.0,192.0,96.0,93.9,92.25,98.6,32,16,16,0.5,33,9,24,0.273,9,7,3,6,204.65190972222223,193.265625,198.95876736111111
2012-02-20,1610612749,1610612753,2011,90.0,93.0,183.0,96.1,97.05,92.55,92.4,31,13,18,0.419,32,20,12,0.625,7,6,12,8,186.83659957627117,189.50204622051035,188.16932289839076
2012-02-20,1610612745,1610612763,2011,97.0,93.0,190.0,98.6,95.95,93.6,91.85,32,18,14,0.563,32,18,14,0.563,12,6,12,6,204.147931303669,194.48529411764707,199.31661271065803
2012-02-20,1610612742,1610612738,2011,89.0,73.0,162.0,95.05,90.65,90.1,87.9,32,20,12,0.625,30,15,15,0.5,12,8,11,4,192.44889607917776,184.9668069191211,188.70785149914943
2012-02-20,1610612760,1610612740,2011,101.0,93.0,194.0,104.1,96.95,88.30000000000003,93.3,31,24,7,0.774,30,7,23,0.233,12,12,3,4,203.70454545454544,186.5057387057387,195.10514208014206
2012-02-20,1610612743,1610612750,2011,103.0,101.0,204.0,104.65,103.5,97.2,96.4,32,17,15,0.531,32,16,16,0.5,8,9,9,7,208.74386133846895,204.6252945797329,206.68457795910092
2012-02-20,1610612762,1610612759,2011,102.0,106.0,208.0,96.75,98.3,98.95,91.15,30,15,15,0.5,31,22,9,0.71,12,3,13,9,197.9029569892473,198.35818858560793,198.1305727874276
2012-02-20,1610612756,1610612764,2011,104.0,88.0,192.0,95.9,99.5,95.55,103.35,32,13,19,0.406,31,7,24,0.226,6,7,4,3,205.65417642466824,198.41505376344085,202.03461509405454
2012-02-20,1610612747,1610612757,2011,103.0,92.0,195.0,92.65,90.1,96.45,90.4,31,18,13,0.581,32,17,15,0.531,13,5,12,5,193.26838235294116,190.70670995670997,191.98754615482557
2012-02-20,1610612744,1610612746,2011,104.0,97.0,201.0,100.6,101.3,98.3,93.7,28,11,17,0.393,29,19,10,0.655,8,3,11,8,206.15127919911012,198.82267759562842,202.48697839736928
2012-02-19,1610612752,1610612742,2011,104.0,97.0,201.0,95.2,93.6,94.7,89.69999999999997,31,15,16,0.484,31,20,11,0.645,8,7,12,8,204.6984126984127,192.38088803088803,198.53965036465036
2012-02-19,1610612748,1610612753,2011,90.0,78.0,168.0,102.25,93.0,93.85,92.75,31,24,7,0.774,31,20,11,0.645,12,12,12,8,194.5890873015873,189.6893809640323,192.1392341328098
2012-02-19,1610612765,1610612738,2011,96.0,81.0,177.0,91.15,96.05,91.25,88.4,32,10,22,0.313,29,15,14,0.517,7,3,11,4,193.665625,185.03872653837016,189.35217576918507
2012-02-19,1610612739,1610612758,2011,93.0,92.0,185.0,92.65,98.9,95.95,101.1,28,11,17,0.393,30,10,20,0.333,6,5,7,3,196.36517806670435,200.90200109649123,198.6335895815978
2012-02-19,1610612754,1610612766,2011,108.0,73.0,181.0,95.55,93.5,84.7,98.7,30,18,12,0.6,30,4,26,0.133,8,10,2,2,196.4363774348596,188.6049233252623,192.52065038006094
2012-02-19,1610612751,1610612749,2011,85.0,92.0,177.0,93.35,99.0,95.3,97.9,32,9,23,0.281,30,12,18,0.4,3,6,7,5,193.39909957627117,186.9211729889696,190.16013628262039
2012-02-19,1610612745,1610612762,2011,101.0,85.0,186.0,98.4,95.7,96.95,98.45,31,17,14,0.5479999999999999,29,15,14,0.517,11,6,12,3,204.27273929138022,198.0045106615637,201.13862497647196
2012-02-19,1610612750,1610612755,2011,92.0,91.0,183.0,97.25,96.1,91.25,88.4,31,15,16,0.484,31,20,11,0.645,8,7,13,7,204.78189792663477,192.3683556880278,198.5751268073313
2012-02-19,1610612760,1610612743,2011,124.0,118.0,242.0,103.25,95.9,104.15,102.5,30,23,7,0.767,31,17,14,0.5479999999999999,11,12,8,9,203.41410256410256,208.4828934506354,205.94849800736898
2012-02-19,1610612756,1610612747,2011,102.0,90.0,192.0,95.9,98.85,92.5,89.9,31,12,19,0.387,30,18,12,0.6,5,7,13,5,205.76428571428573,193.27532679738562,199.51980625583568
2012-02-18,1610612746,1610612759,2011,100.0,103.0,203.0,98.05,93.0,98.9,91.4,28,19,9,0.679,30,21,9,0.7,11,8,13,8,198.78333333333333,198.31804435483872,198.55068884408604
2012-02-18,1610612741,1610612751,2011,85.0,97.0,182.0,98.3,86.5,94.0,99.9,32,25,7,0.7809999999999999,31,8,23,0.258,11,14,3,5,187.69586996524228,193.49260156039816,190.59423576282023
2012-02-18,1610612763,1610612744,2011,104.0,103.0,207.0,93.5,91.0,100.0,101.2,31,17,14,0.5479999999999999,27,11,16,0.407,11,6,8,3,194.39969271290607,206.15294284097342,200.27631777693975
2012-02-18,1610612757,1610612737,2011,97.0,77.0,174.0,96.8,91.9,92.85,91.55,31,16,15,0.516,30,19,11,0.633,11,5,9,10,190.85018315018314,187.90757918552038,189.37888116785177
2012-02-17,1610612761,1610612766,2011,91.0,98.0,189.0,90.6,96.05,84.25,98.95,31,9,22,0.29,29,3,26,0.103,4,5,2,1,198.64859862506609,188.5880262438491,193.6183124344576
2012-02-17,1610612753,1610612749,2011,94.0,85.0,179.0,93.75,92.5,95.7,98.65,30,19,11,0.633,29,12,17,0.414,11,8,7,5,189.75869349230004,186.99234554401312,188.37551951815658
2012-02-17,1610612765,1610612758,2011,114.0,108.0,222.0,90.0,95.6,94.85,100.35,31,9,22,0.29,29,10,19,0.345,6,3,7,3,193.4734126984127,200.73893065998328,197.10617167919798
2012-02-17,1610612739,1610612748,2011,87.0,111.0,198.0,93.05,98.6,101.15,93.4,27,11,16,0.407,30,23,7,0.767,6,5,12,11,196.33362068965516,194.55925553319918,195.44643811142717
2012-02-17,1610612755,1610612742,2011,75.0,82.0,157.0,92.65,88.45,95.6,90.25,30,20,10,0.667,30,19,11,0.633,13,7,12,7,192.62383354350567,192.62974931453192,192.6267914290188
2012-02-17,1610612752,1610612740,2011,85.0,89.0,174.0,95.6,94.25,88.35,93.75,30,15,15,0.5,29,6,23,0.207,8,7,3,3,204.9641577060932,186.62568238213402,195.7949200441136
2012-02-17,1610612763,1610612743,2011,103.0,102.0,205.0,93.75,90.85,104.3,102.1,30,16,14,0.5329999999999999,30,17,13,0.5670000000000001,10,6,8,9,194.3266488413547,208.4985111662531,201.4125800038039
2012-02-17,1610612745,1610612750,2011,98.0,111.0,209.0,98.85,95.4,96.05,96.05,30,17,13,0.5670000000000001,30,14,16,0.467,11,6,8,6,204.21311475409834,204.7513528138528,204.48223378397557
2012-02-17,1610612760,1610612744,2011,110.0,87.0,197.0,102.95,96.65,100.2,100.45,29,22,7,0.759,26,11,15,0.423,10,12,8,3,203.46614583333331,206.24395161290323,204.85504872311827
2012-02-17,1610612762,1610612764,2011,114.0,100.0,214.0,96.6,98.15,93.75,101.55,28,14,14,0.5,30,7,23,0.233,11,3,4,3,197.8719088635732,198.3051912568306,198.0885500602019
2012-02-17,1610612747,1610612756,2011,111.0,99.0,210.0,92.35,89.9,94.9,96.85,29,17,12,0.586,30,12,18,0.4,12,5,5,7,193.15339966832505,205.73279569892475,199.4430976836249
2012-02-16,1610612754,1610612751,2011,93.0,88.0,181.0,95.8,93.65,95.35,101.4,29,17,12,0.586,30,8,22,0.267,7,10,3,5,196.57913021101388,193.59718425369056,195.08815723235222
2012-02-16,1610612741,1610612738,2011,89.0,80.0,169.0,97.65,86.19999999999997,91.05,87.7,31,24,7,0.774,28,15,13,0.536,10,14,11,4,187.83551266085513,185.17971014492753,186.5076114028913
2012-02-16,1610612757,1610612746,2011,71.0,74.0,145.0,98.5,93.05,98.3,94.85,30,16,14,0.5329999999999999,27,18,9,0.667,11,5,11,7,191.22470238095238,199.24406779661018,195.23438508878127
2012-02-15,1610612761,1610612759,2011,106.0,113.0,219.0,90.15,94.75,97.5,90.25,30,9,21,0.3,29,20,9,0.69,4,5,13,7,198.48548387096776,198.14964157706095,198.31756272401435
2012-02-15,1610612753,1610612755,2011,103.0,87.0,190.0,92.75,92.4,93.45,87.45,29,18,11,0.621,29,20,9,0.69,10,8,13,7,189.74552332912987,192.66153846153844,191.20353089533415
2012-02-15,1610612738,1610612765,2011,88.0,98.0,186.0,90.2,86.75,89.75,96.3,27,15,12,0.556,30,8,22,0.267,11,4,6,2,185.16617647058823,193.50349744417542,189.3348369573818
2012-02-15,1610612751,1610612763,2011,100.0,105.0,205.0,95.4,101.45,92.6,90.35,29,8,21,0.276,29,15,14,0.517,3,5,10,5,193.49388209121247,194.24038896426958,193.86713552774103
2012-02-15,1610612752,1610612758,2011,100.0,85.0,185.0,94.85,93.95,93.6,100.3,29,14,15,0.483,28,10,18,0.35700000000000004,7,7,7,3,205.14845173041897,200.868986983588,203.00871935700349
2012-02-15,1610612739,1610612754,2011,98.0,87.0,185.0,93.9,99.3,95.85,93.35,26,10,16,0.385,28,17,11,0.607,5,5,7,10,196.41116306253653,196.65726227795193,196.53421267024424
2012-02-15,1610612749,1610612740,2011,89.0,92.0,181.0,96.35,98.7,87.75,94.1,28,12,16,0.429,28,5,23,0.179,7,5,3,2,187.03559510567297,186.69218158890288,186.8638883472879
2012-02-15,1610612745,1610612760,2011,96.0,95.0,191.0,99.2,95.1,103.3,97.1,29,16,13,0.552,28,22,6,0.7859999999999999,10,6,10,12,204.30150273224044,203.55182658450704,203.92666465837374
2012-02-15,1610612750,1610612766,2011,102.0,90.0,192.0,95.9,95.85,83.80000000000003,99.4,29,13,16,0.448,28,3,25,0.107,7,6,2,1,204.84354395604396,188.54598499583216,196.69476447593806
2012-02-15,1610612742,1610612743,2011,102.0,84.0,186.0,95.6,89.85,105.95,103.05,29,18,11,0.621,29,17,12,0.586,11,7,8,9,192.6805638276752,208.66305443548387,200.67180913157955
2012-02-15,1610612756,1610612737,2011,99.0,101.0,200.0,95.05,96.35,93.1,91.65,29,12,17,0.414,29,18,11,0.621,5,7,9,9,205.77884089666486,187.80562571756602,196.79223330711545
2012-02-15,1610612744,1610612757,2011,91.0,93.0,184.0,101.1,101.65,99.1,93.85,25,11,14,0.44,29,15,14,0.517,8,3,11,4,206.41700819672133,191.2631048387097,198.8400565177155
2012-02-15,1610612746,1610612764,2011,102.0,84.0,186.0,97.8,94.95,93.8,101.6,26,17,9,0.654,29,7,22,0.241,10,7,4,3,199.34745762711864,198.425,198.88622881355934
2012-02-14,1610612761,1610612752,2011,87.0,90.0,177.0,90.05000000000003,95.1,95.5,93.6,29,9,20,0.31,28,13,15,0.464,4,5,7,6,198.67277200656096,205.35364886303543,202.0132104347982
2012-02-14,1610612754,1610612748,2011,90.0,105.0,195.0,95.9,92.05,101.2,94.45,27,17,10,0.63,29,22,7,0.759,7,10,12,10,196.6822169059011,194.55,195.61610845295056
2012-02-14,1610612765,1610612759,2011,95.0,99.0,194.0,89.30000000000003,96.35,97.45,91.5,29,8,21,0.276,28,19,9,0.679,6,2,13,6,193.5308911973756,198.17741935483872,195.85415527610718
2012-02-14,1610612741,1610612758,2011,121.0,115.0,236.0,96.8,83.65,92.3,99.4,30,23,7,0.767,27,10,17,0.37,9,14,7,3,187.46406743940992,200.585274662065,194.02467105073745
2012-02-14,1610612763,1610612745,2011,93.0,83.0,176.0,92.65,90.35,99.15,93.95,28,14,14,0.5,28,16,12,0.5710000000000001,9,5,10,6,194.38817451205512,204.55833333333334,199.47325392269423
2012-02-14,1610612760,1610612762,2011,111.0,85.0,196.0,102.6,97.3,97.35,98.45,27,21,6,0.778,27,14,13,0.519,9,12,11,3,203.61345852895147,197.8907574901074,200.75210800952942
2012-02-14,1610612743,1610612756,2011,109.0,92.0,201.0,104.55,103.15,95.0,95.3,28,16,12,0.5710000000000001,28,12,16,0.429,7,9,5,7,208.73629610655738,205.8200889135871,207.27819251007224
2012-02-14,1610612757,1610612764,2011,109.0,124.0,233.0,98.55,91.55,92.2,101.15,28,15,13,0.536,28,6,22,0.214,11,4,4,2,190.95110087045572,198.1505649717514,194.55083292110356
2012-02-14,1610612747,1610612737,2011,86.0,78.0,164.0,92.65,90.45,94.3,92.15,28,16,12,0.5710000000000001,28,18,10,0.643,11,5,9,9,193.37626262626264,187.97331002331003,190.67478632478634
2012-02-13,1610612766,1610612755,2011,89.0,98.0,187.0,83.30000000000003,99.5,93.7,88.35,27,3,24,0.111,28,19,9,0.679,2,1,13,6,188.57447710570943,192.72594524119947,190.65021117345447
2012-02-13,1610612753,1610612750,2011,102.0,89.0,191.0,92.45,92.4,96.1,94.35,28,17,11,0.607,28,13,15,0.464,9,8,7,6,189.72412909836066,204.97552447552448,197.34982678694257
2012-02-13,1610612749,1610612748,2011,96.0,114.0,210.0,96.85,98.15,100.55,94.15,27,12,15,0.444,28,21,7,0.75,7,5,12,9,186.8259762308998,194.4317805383023,190.62887838460105
2012-02-13,1610612740,1610612762,2011,86.0,80.0,166.0,87.3,94.3,96.9,98.95,27,4,23,0.14800000000000002,26,14,12,0.5379999999999999,2,2,11,3,186.83388831967213,198.17342536669543,192.50365684318376
2012-02-13,1610612742,1610612746,2011,96.0,92.0,188.0,95.6,89.30000000000003,98.05,95.4,28,17,11,0.607,25,17,8,0.68,10,7,10,7,192.71890096618358,199.45338983050846,196.08614539834602
2012-02-13,1610612744,1610612756,2011,102.0,96.0,198.0,101.55,102.15,95.05,96.1,24,10,14,0.417,27,12,15,0.444,7,3,5,7,206.47916666666669,205.88771186440678,206.18343926553672
2012-02-12,1610612761,1610612747,2011,92.0,94.0,186.0,90.05000000000003,94.25,92.65,90.95,28,9,19,0.321,27,15,12,0.556,4,5,11,4,198.7889321468298,193.4318181818182,196.110375164324
2012-02-12,1610612738,1610612741,2011,95.0,91.0,186.0,90.25,85.85,96.55,84.0,26,14,12,0.5379999999999999,29,23,6,0.7929999999999999,10,4,9,14,185.15223880597014,187.47767094017092,186.31495487307052
2012-02-12,1610612765,1610612764,2011,77.0,98.0,175.0,89.45,96.6,91.35,102.4,28,8,20,0.28600000000000003,27,5,22,0.185,6,2,4,1,193.71492081133647,198.36666666666667,196.04079373900157
2012-02-12,1610612737,1610612748,2011,87.0,107.0,194.0,95.4,91.5,101.0,95.25,27,18,9,0.667,27,20,7,0.741,9,9,12,8,187.9379734848485,194.42773109243697,191.18285228864272
2012-02-12,1610612744,1610612745,2011,106.0,97.0,203.0,100.6,101.7,99.0,94.1,23,9,14,0.391,27,16,11,0.593,6,3,10,6,206.50105932203388,204.59505649717514,205.5480579096045
2012-02-12,1610612763,1610612762,2011,88.0,98.0,186.0,93.0,90.45,96.5,100.05,27,14,13,0.519,25,13,12,0.52,9,5,11,2,194.46245335820896,198.28761709601872,196.37503522711384
2012-02-11,1610612766,1610612746,2011,86.0,111.0,197.0,83.75,98.75,97.0,96.85,26,3,23,0.115,24,16,8,0.667,2,1,10,6,188.51624964049466,199.48409158489443,194.00017061269455
2012-02-11,1610612754,1610612743,2011,109.0,113.0,222.0,94.75,91.15,103.7,102.1,26,17,9,0.654,27,15,12,0.556,7,10,7,8,196.46699134199133,208.62034868592247,202.5436700139569
2012-02-11,1610612739,1610612755,2011,84.0,99.0,183.0,94.6,98.45,93.9,88.05000000000003,25,10,15,0.4,27,18,9,0.667,5,5,13,5,196.50862068965517,192.8270557029178,194.66783819628648
2012-02-11,1610612751,1610612759,2011,89.0,103.0,192.0,95.45,101.35,97.45,92.35,28,8,20,0.28600000000000003,27,18,9,0.667,3,5,13,5,193.50099037917374,198.2225013220518,195.86174585061278
2012-02-11,1610612750,1610612752,2011,98.0,100.0,198.0,96.2,94.9,95.45,93.5,27,13,14,0.481,27,12,15,0.444,7,6,7,5,205.02372159090908,205.39344262295083,205.20858210692995
2012-02-11,1610612742,1610612757,2011,97.0,94.0,191.0,95.65,89.05000000000003,98.0,91.65,27,16,11,0.593,27,15,12,0.556,9,7,11,4,192.7371912635232,190.93338537600835,191.83528831976577
2012-02-11,1610612749,1610612753,2011,94.0,99.0,193.0,97.25,97.25,91.4,92.15,26,12,14,0.462,27,16,11,0.593,7,5,9,7,186.76065668202764,189.709375,188.23501584101382
2012-02-11,1610612758,1610612756,2011,84.0,98.0,182.0,93.0,99.9,94.7,97.0,26,10,16,0.385,26,11,15,0.423,7,3,5,6,200.74912177985948,206.09322033898306,203.42117105942128
2012-02-10,1610612761,1610612738,2011,86.0,74.0,160.0,90.0,95.05,90.9,86.4,27,8,19,0.29600000000000004,25,14,11,0.56,3,5,10,4,199.13723825693268,185.37427270427523,192.25575548060397
2012-02-10,1610612755,1610612746,2011,77.0,78.0,155.0,94.55,87.95,98.35,97.3,26,18,8,0.6920000000000001,23,15,8,0.652,13,5,10,5,193.1061422413793,199.89088983050846,196.49851603594388
2012-02-10,1610612764,1610612748,2011,89.0,106.0,195.0,91.4,102.25,100.85,95.85,26,5,21,0.192,26,19,7,0.731,4,1,12,7,198.3771186440678,194.41609808102345,196.39660836254563
2012-02-10,1610612766,1610612741,2011,64.0,95.0,159.0,85.35,98.75,96.2,84.75,25,3,22,0.12,28,22,6,0.7859999999999999,2,1,9,13,188.79522833723652,187.68179848320693,188.23851341022174
2012-02-10,1610612753,1610612737,2011,87.0,89.0,176.0,91.2,92.55,94.65,90.95,26,16,10,0.615,26,17,9,0.654,9,7,9,8,189.80634920634918,188.01850961538463,188.9124294108669
2012-02-10,1610612765,1610612751,2011,109.0,92.0,201.0,88.15,96.95,95.7,100.15,27,7,20,0.259,27,8,19,0.29600000000000004,5,2,3,5,193.68841807909604,193.44506758700027,193.56674283304815
2012-02-10,1610612739,1610612749,2011,112.0,113.0,225.0,93.8,98.0,95.9,96.25,24,10,14,0.417,25,11,14,0.44,5,5,7,4,196.24107683000605,186.45711358313815,191.3490952065721
2012-02-10,1610612752,1610612747,2011,92.0,85.0,177.0,95.4,93.6,92.9,90.7,26,11,15,0.423,26,15,11,0.5770000000000001,6,5,11,4,205.65054644808743,193.56296572280178,199.6067560854446
2012-02-10,1610612763,1610612754,2011,98.0,92.0,190.0,93.75,90.65,94.9,90.75,26,13,13,0.5,25,17,8,0.68,8,5,7,10,194.50734423122483,196.50906593406594,195.5082050826454
2012-02-10,1610612740,1610612757,2011,86.0,94.0,180.0,87.0,93.95,97.15,92.45,26,4,22,0.154,26,14,12,0.5379999999999999,2,2,11,3,186.86898256570387,191.00674603174605,188.93786429872495
2012-02-10,1610612750,1610612742,2011,97.0,104.0,201.0,95.7,94.6,94.0,88.85,26,13,13,0.5,26,15,11,0.5770000000000001,7,6,9,6,205.04963924963926,192.6698425849213,198.85974091728028
2012-02-10,1610612762,1610612760,2011,87.0,101.0,188.0,96.5,99.5,102.4,97.35,24,13,11,0.542,26,20,6,0.769,11,2,9,11,198.3672619047619,203.72301587301587,201.04513888888889
2012-02-09,1610612738,1610612747,2011,87.0,88.0,175.0,90.95,86.85,93.3,91.7,24,14,10,0.583,25,14,11,0.56,10,4,11,3,185.4432460195172,193.71515151515152,189.57919876733436
2012-02-09,1610612743,1610612744,2011,101.0,109.0,210.0,104.15,100.8,100.7,103.35,26,15,11,0.5770000000000001,22,8,14,0.364,7,8,6,2,208.62103174603175,206.47719568567027,207.549113715851
2012-02-09,1610612756,1610612745,2011,89.0,96.0,185.0,94.4,97.35,98.65,95.5,25,11,14,0.44,26,15,11,0.5770000000000001,5,6,10,5,206.27016364699006,204.78821839080462,205.52919101889734
2012-02-09,1610612758,1610612760,2011,106.0,101.0,207.0,92.7,99.4,102.1,96.3,25,9,16,0.36,25,20,5,0.8,6,3,9,11,200.69165424739197,203.69806763285024,202.1948609401211
2012-02-08,1610612761,1610612749,2011,99.0,105.0,204.0,88.80000000000003,93.6,95.65,96.45,26,8,18,0.308,24,10,14,0.417,3,5,7,3,199.1051267281106,186.31845238095238,192.7117895545315
2012-02-08,1610612755,1610612759,2011,90.0,100.0,190.0,95.25,88.35,97.25,93.25,25,18,7,0.72,26,17,9,0.654,13,5,13,4,193.11631089217298,198.28575268817204,195.70103179017252
2012-02-08,1610612764,1610612752,2011,93.0,107.0,200.0,91.4,100.8,95.75,93.55,25,5,20,0.2,25,10,15,0.4,4,1,6,4,198.3448275862069,205.675,202.00991379310346
2012-02-08,1610612753,1610612748,2011,102.0,89.0,191.0,91.25,92.35,101.2,95.5,25,15,10,0.6,25,19,6,0.76,8,7,12,7,189.78548387096774,194.4344155844156,192.10994972769168
2012-02-08,1610612739,1610612746,2011,99.0,92.0,191.0,93.3,97.9,99.45,97.1,23,9,14,0.391,22,15,7,0.682,4,5,10,5,196.26754926108373,199.98520801232667,198.1263786367052
2012-02-08,1610612751,1610612765,2011,92.0,99.0,191.0,95.8,100.6,86.6,96.95,26,8,18,0.308,26,6,20,0.231,3,5,5,1,193.46135831381733,193.6764367816092,193.56889754771328
2012-02-08,1610612737,1610612754,2011,97.0,87.0,184.0,95.25,92.4,94.85,90.7,25,16,9,0.64,24,17,7,0.708,8,8,7,10,188.06141636141638,196.59933035714286,192.33037335927963
2012-02-08,1610612763,1610612750,2011,85.0,80.0,165.0,95.15,91.3,96.45,95.25,25,12,13,0.48,25,13,12,0.52,7,5,7,6,194.75529610014445,205.42724867724868,200.09127238869655
2012-02-08,1610612740,1610612741,2011,67.0,90.0,157.0,87.9,94.2,97.25,86.4,25,4,21,0.16,27,21,6,0.778,2,2,9,12,187.090692755156,187.90604395604396,187.49836835559998
2012-02-08,1610612743,1610612742,2011,95.0,105.0,200.0,103.95,99.85,92.85,89.05000000000003,25,15,10,0.6,25,14,11,0.56,7,8,9,5,208.70648372343288,192.6079461845701,200.6572149540015
2012-02-08,1610612757,1610612745,2011,96.0,103.0,199.0,97.7,92.1,98.45,96.1,25,14,11,0.56,25,14,11,0.56,11,3,10,4,190.95887096774192,204.86535087719298,197.91211092246743
2012-02-07,1610612754,1610612762,2011,104.0,99.0,203.0,94.1,89.95,96.05,98.2,23,16,7,0.696,23,13,10,0.565,6,10,11,2,196.5490056818182,198.3310606060606,197.4400331439394
2012-02-07,1610612738,1610612766,2011,94.0,84.0,178.0,90.2,87.05,85.5,98.6,23,13,10,0.565,24,3,21,0.125,9,4,2,1,185.49126466753586,188.86845238095236,187.1798585242441
2012-02-07,1610612748,1610612739,2011,107.0,91.0,198.0,101.75,95.1,93.65,96.9,24,18,6,0.75,22,9,13,0.409,11,7,4,5,194.4156785243742,196.2720864661654,195.34388249526978
2012-02-07,1610612749,1610612756,2011,105.0,107.0,212.0,95.3,95.85,93.2,97.05,23,10,13,0.435,24,10,14,0.417,7,3,5,5,186.0780303030303,206.22413793103448,196.15108411703238
2012-02-07,1610612750,1610612758,2011,86.0,84.0,170.0,96.45,95.55,93.4,99.65,24,12,12,0.5,24,9,15,0.375,6,6,6,3,205.70400238948628,200.94848484848484,203.32624361898556
2012-02-07,1610612744,1610612760,2011,116.0,119.0,235.0,98.85,102.75,101.15,95.25,21,8,13,0.381,24,19,5,0.792,6,2,9,10,206.22398119122255,203.46650326797385,204.8452422295982
2012-02-06,1610612755,1610612747,2011,95.0,90.0,185.0,95.2,87.95,93.3,91.9,24,17,7,0.708,24,14,10,0.583,12,5,11,3,193.16713014460512,193.78775038520803,193.4774402649066
2012-02-06,1610612764,1610612761,2011,111.0,108.0,219.0,89.45,100.05,86.6,91.9,24,4,20,0.16699999999999998,25,8,17,0.32,3,1,3,5,198.14473684210526,198.93193793911007,198.53833739060767
2012-02-06,1610612753,1610612746,2011,102.0,107.0,209.0,91.25,91.8,98.0,96.95,24,15,9,0.625,21,14,7,0.667,8,7,10,4,189.61639344262295,199.91635279347145,194.7663731180472
2012-02-06,1610612751,1610612741,2011,87.0,108.0,195.0,94.95,100.5,96.55,87.5,25,8,17,0.32,26,20,6,0.769,3,5,9,11,193.4418777943368,187.8614269788183,190.65165238657755
2012-02-06,1610612752,1610612762,2011,99.0,88.0,187.0,96.3,95.05,96.75,98.8,24,9,15,0.375,22,13,9,0.591,5,4,11,2,205.85607344632768,198.44166666666666,202.14887005649717
2012-02-06,1610612737,1610612756,2011,90.0,99.0,189.0,96.0,92.35,92.7,97.45,24,16,8,0.667,23,9,14,0.391,8,8,5,4,188.06538461538463,206.37825166364186,197.22181813951323
2012-02-06,1610612763,1610612759,2011,84.0,89.0,173.0,95.7,91.75,97.6,94.35,24,12,12,0.5,25,16,9,0.64,7,5,13,3,194.94580376804504,198.49521596500819,196.7205098665266
2012-02-06,1610612740,1610612758,2011,92.0,100.0,192.0,87.69999999999997,94.0,92.65,100.65,24,4,20,0.16699999999999998,23,8,15,0.348,2,2,6,2,187.0327868852459,201.02758089368257,194.03018388946424
2012-02-06,1610612743,1610612745,2011,90.0,99.0,189.0,104.4,99.4,98.15,97.25,24,15,9,0.625,24,13,11,0.542,7,8,10,3,208.88970990695128,205.03452380952382,206.96211685823755
2012-02-06,1610612757,1610612760,2011,107.0,111.0,218.0,97.9,91.65,100.5,94.65,24,14,10,0.583,23,18,5,0.7829999999999999,11,3,9,9,190.75368852459016,203.35489220563846,197.0542903651143
2012-02-05,1610612738,1610612763,2011,98.0,80.0,178.0,89.55,87.55,95.95,91.55,22,12,10,0.545,23,12,11,0.522,8,4,7,5,185.54078389830508,195.06147540983608,190.30112965407056
2012-02-05,1610612748,1610612761,2011,95.0,89.0,184.0,101.6,95.65,86.05000000000003,91.8,23,17,6,0.7390000000000001,24,8,16,0.333,10,7,3,5,194.49933155080214,199.04464285714286,196.77198720397251
2012-02-04,1610612764,1610612746,2011,81.0,107.0,188.0,90.2,99.65,97.45,98.25,23,4,19,0.174,20,13,7,0.65,3,1,10,3,198.21428571428572,200.0430124720179,199.1286490931518
2012-02-04,1610612737,1610612755,2011,87.0,98.0,185.0,96.7,91.6,94.85,88.45,23,16,7,0.696,23,16,7,0.696,8,8,12,4,188.10226986128626,193.2542444821732,190.67825717172974
2012-02-04,1610612754,1610612753,2011,81.0,85.0,166.0,94.25,90.1,92.0,91.7,22,16,6,0.727,23,14,9,0.609,6,10,8,6,196.83940972222223,189.82995276465687,193.33468124343955
2012-02-04,1610612752,1610612751,2011,99.0,92.0,191.0,95.6,94.95,93.85,100.0,23,8,15,0.348,24,8,16,0.333,4,4,3,5,206.00890804597702,193.46742424242424,199.73816614420065
2012-02-04,1610612765,1610612740,2011,89.0,87.0,176.0,86.6,96.5,87.6,93.75,25,5,20,0.2,23,4,19,0.174,4,1,2,2,193.86090005844534,187.1431693989071,190.50203472867622
2012-02-04,1610612739,1610612742,2011,91.0,88.0,179.0,94.1,97.15,93.55,89.7,21,8,13,0.381,24,14,10,0.583,3,5,9,5,196.40861244019138,192.70326504481434,194.55593874250286
2012-02-04,1610612750,1610612745,2011,100.0,91.0,191.0,96.75,95.8,98.35,97.45,23,11,12,0.478,23,13,10,0.565,5,6,10,3,205.81769884638737,205.19166666666666,205.50468275652702
2012-02-04,1610612749,1610612741,2011,90.0,113.0,203.0,95.0,94.45,95.75,87.15,22,10,12,0.455,25,19,6,0.76,7,3,9,10,185.91203703703704,187.75667420814477,186.83435562259092
2012-02-04,1610612759,1610612760,2011,107.0,96.0,203.0,97.3,94.3,100.05,94.3,24,15,9,0.625,22,18,4,0.818,12,3,9,9,198.4612392331203,203.35353535353534,200.90738729332782
2012-02-04,1610612762,1610612747,2011,96.0,87.0,183.0,97.6,99.7,93.5,92.1,21,12,9,0.5710000000000001,23,14,9,0.609,10,2,11,3,198.56638418079098,193.88009404388714,196.22323911233906
2012-02-04,1610612756,1610612766,2011,95.0,89.0,184.0,92.15,97.25,84.9,98.8,22,8,14,0.364,23,3,20,0.13,4,4,2,1,206.5701754385965,188.89331113801452,197.7317432883055
2012-02-04,1610612758,1610612744,2011,114.0,106.0,220.0,91.7,99.9,98.95,101.4,22,7,15,0.318,20,8,12,0.4,5,2,6,2,200.84761456371626,206.1066411238825,203.4771278437994
2012-02-04,1610612757,1610612743,2011,117.0,97.0,214.0,97.1,90.75,104.0,98.15,23,13,10,0.565,23,15,8,0.652,10,3,7,8,190.575,208.8345383759733,199.70476918798664
2012-02-03,1610612761,1610612764,2011,106.0,89.0,195.0,84.7,92.2,89.9,99.4,23,7,16,0.304,22,4,18,0.182,2,5,3,1,199.09318181818182,198.2625313283208,198.6778565732513
2012-02-03,1610612755,1610612748,2011,79.0,99.0,178.0,96.9,87.95,101.9,96.4,22,16,6,0.727,22,16,6,0.727,12,4,10,6,193.36410698878342,194.61821266968326,193.99115982923334
2012-02-03,1610612753,1610612739,2011,102.0,94.0,196.0,91.6,90.9,93.25,96.65,22,13,9,0.591,20,8,12,0.4,7,6,3,5,189.7635593220339,196.43116883116883,193.09736407660137
2012-02-03,1610612751,1610612750,2011,105.0,108.0,213.0,92.75,99.2,95.6,94.75,23,8,15,0.348,22,10,12,0.455,3,5,5,5,193.28055555555557,205.75672749768017,199.51864152661787
2012-02-03,1610612765,1610612749,2011,88.0,80.0,168.0,87.0,96.9,94.65,94.3,24,4,20,0.16699999999999998,21,10,11,0.476,3,1,7,3,194.1206896551724,186.07376020087884,190.09722492802564
2012-02-03,1610612738,1610612752,2011,91.0,89.0,180.0,88.69999999999997,87.45,95.25,95.35,21,11,10,0.524,22,8,14,0.364,7,4,4,4,185.57600215227333,206.20368205727647,195.8898421047749
2012-02-03,1610612745,1610612756,2011,99.0,81.0,180.0,98.15,98.3,92.95,97.65,22,12,10,0.545,21,8,13,0.381,9,3,4,4,205.37627118644068,206.81015037593986,206.09321078119027
2012-02-03,1610612760,1610612763,2011,101.0,94.0,195.0,99.35,93.75,95.75,90.8,21,17,4,0.81,22,12,10,0.545,8,9,7,5,203.42521994134898,195.0499369482976,199.2375784448233
2012-02-03,1610612742,1610612754,2011,87.0,98.0,185.0,94.2,89.15,93.7,89.45,23,14,9,0.609,21,15,6,0.7140000000000001,9,5,6,9,192.76493506493506,196.9246031746032,194.84476911976913
2012-02-03,1610612743,1610612747,2011,89.0,93.0,182.0,105.4,98.5,94.0,93.05,22,15,7,0.682,22,13,9,0.591,7,8,11,2,209.08559705715902,193.98444976076556,201.53502340896227
2012-02-02,1610612737,1610612763,2011,77.0,96.0,173.0,97.45,90.55,94.15,92.15,22,16,6,0.727,21,11,10,0.524,8,8,7,4,188.2403846153846,195.20991290983608,191.72514876261033
2012-02-02,1610612752,1610612741,2011,102.0,105.0,207.0,95.45,95.3,95.45,86.2,21,8,13,0.381,24,18,6,0.75,4,4,9,9,206.22152839726436,187.61894374282434,196.92023607004435
2012-02-02,1610612759,1610612740,2011,93.0,81.0,174.0,97.85,94.7,88.4,93.6,23,14,9,0.609,22,4,18,0.182,11,3,2,2,198.6677966101695,187.27424284523477,192.97101972770213
2012-02-02,1610612758,1610612757,2011,95.0,92.0,187.0,92.35,101.1,97.65,90.65,21,6,15,0.28600000000000003,22,13,9,0.591,4,2,10,3,200.97217780620403,190.5915254237288,195.7818516149664
2012-02-02,1610612746,1610612743,2011,91.0,112.0,203.0,98.75,97.1,104.9,99.5,19,13,6,0.684,21,14,7,0.667,10,3,7,7,200.0034157449577,209.11878055795228,204.56109815145498
2012-02-02,1610612744,1610612762,2011,119.0,101.0,220.0,97.6,100.25,96.85,98.0,19,7,12,0.368,20,12,8,0.6,5,2,10,2,205.9761208576998,198.3698433002878,202.1729820789938
2012-02-01,1610612755,1610612741,2011,98.0,82.0,180.0,97.6,88.1,97.05,86.35,21,15,6,0.7140000000000001,23,18,5,0.7829999999999999,11,4,9,9,193.4609649122807,187.68158508158507,190.57127499693289
2012-02-01,1610612753,1610612764,2011,109.0,103.0,212.0,91.35,90.5,89.45,99.0,21,12,9,0.5710000000000001,21,4,17,0.19,6,6,3,1,189.5593220338983,198.16071428571428,193.8600181598063
2012-02-01,1610612738,1610612761,2011,100.0,64.0,164.0,88.15,87.75,84.6,92.05,20,10,10,0.5,22,7,15,0.318,6,4,2,5,185.74138873701474,199.37919876733434,192.56029375217454
2012-02-01,1610612751,1610612765,2011,99.0,96.0,195.0,92.95,99.65,85.85,96.75,22,7,15,0.318,23,4,19,0.174,2,5,3,1,193.25644654088052,194.0732002419843,193.6648233914324
2012-02-01,1610612749,1610612748,2011,105.0,97.0,202.0,94.05,93.75,102.05,96.35,20,9,11,0.45,21,16,5,0.762,6,3,10,6,185.9109370003198,194.5533088235294,190.2321229119246
2012-02-01,1610612740,1610612756,2011,103.0,120.0,223.0,87.9,92.65,91.6,96.4,21,4,17,0.19,20,7,13,0.35,2,2,4,3,186.95607344632768,206.66794258373204,196.81200801502985
2012-02-01,1610612742,1610612760,2011,86.0,95.0,181.0,94.85,88.7,99.5,94.2,22,14,8,0.636,20,16,4,0.8,9,5,8,8,192.85737812911725,203.59305210918114,198.2252151191492
2012-02-01,1610612750,1610612754,2011,99.0,109.0,208.0,95.6,93.4,92.4,90.4,21,10,11,0.476,20,14,6,0.7,5,5,6,8,205.7325471698113,196.82706093189967,201.2798040508555
2012-02-01,1610612759,1610612745,2011,99.0,91.0,190.0,98.65,94.65,98.35,98.2,22,13,9,0.591,21,12,9,0.5710000000000001,10,3,9,3,198.74576271186442,205.54849340866292,202.14712806026367
2012-02-01,1610612757,1610612766,2011,112.0,68.0,180.0,97.4,92.4,87.4,98.7,21,12,9,0.5710000000000001,22,3,19,0.136,9,3,2,1,190.6949152542373,188.95350985221674,189.82421255322703
2012-02-01,1610612762,1610612746,2011,105.0,107.0,212.0,96.3,96.9,98.8,97.45,19,12,7,0.632,18,12,6,0.667,10,2,10,2,198.24886141834742,199.9041777188329,199.07651956859016
2012-01-31,1610612761,1610612737,2011,77.0,100.0,177.0,85.7,91.65,97.45,91.3,21,7,14,0.333,21,15,6,0.7140000000000001,2,5,8,7,199.59620213433772,188.315625,193.95591356716886
2012-01-31,1610612739,1610612738,2011,90.0,93.0,183.0,92.85,96.65,88.05,88.35,19,8,11,0.421,19,9,10,0.474,3,5,6,3,196.53571428571428,185.77280311457173,191.154258700143
2012-01-31,1610612754,1610612751,2011,106.0,99.0,205.0,92.55,90.95,92.1,99.25,19,13,6,0.684,21,7,14,0.333,5,8,2,5,196.7604990870359,193.16421490246242,194.96235699474914
2012-01-31,1610612752,1610612765,2011,113.0,86.0,199.0,94.2,95.1,85.80000000000003,95.9,20,7,13,0.35,22,4,18,0.182,3,4,3,1,206.31144067796612,193.98830049261085,200.14987058528848
2012-01-31,1610612763,1610612743,2011,100.0,97.0,197.0,93.65,92.15,105.8,99.15,20,10,10,0.5,20,14,6,0.7,6,4,7,7,195.20677083333334,209.2030701754386,202.20492050438597
2012-01-31,1610612747,1610612766,2011,106.0,73.0,179.0,93.65,93.5,88.8,99.15,21,12,9,0.5710000000000001,21,3,18,0.14300000000000002,10,2,2,1,194.0987854251012,189.02459273182956,191.56168907846538
2012-01-31,1610612744,1610612758,2011,93.0,90.0,183.0,97.9,100.3,92.0,101.95,18,6,12,0.333,20,6,14,0.3,4,2,4,2,206.1712962962963,201.13158750813272,203.65144190221451
2012-01-30,1610612755,1610612753,2011,74.0,69.0,143.0,98.7,88.95,92.35,91.65,20,14,6,0.7,20,12,8,0.6,10,4,6,6,193.87466547725245,189.97852133255407,191.92659340490326
2012-01-30,1610612764,1610612741,2011,88.0,98.0,186.0,89.35,98.8,97.55,86.85,20,4,16,0.2,22,17,5,0.773,3,1,9,8,198.25097402597402,187.7,192.975487012987
2012-01-30,1610612748,1610612740,2011,109.0,95.0,204.0,103.05,96.1,87.65,92.5,20,15,5,0.75,20,4,16,0.2,9,6,2,2,194.4902052238806,186.8330459770115,190.66162560044603
2012-01-30,1610612749,1610612765,2011,103.0,82.0,185.0,94.3,94.7,85.65,95.3,19,8,11,0.421,21,4,17,0.19,5,3,3,1,185.90531290743155,194.02758620689656,189.96644955716405
2012-01-30,1610612763,1610612759,2011,73.0,83.0,156.0,94.75,92.15,98.75,96.25,19,10,9,0.526,21,12,9,0.5710000000000001,6,4,10,2,195.55097987288136,199.10900058445355,197.32999022866744
2012-01-30,1610612745,1610612750,2011,108.0,120.0,228.0,97.7,96.4,95.95,94.75,20,12,8,0.6,20,9,11,0.45,9,3,5,4,205.3256704980843,205.525,205.42533524904215
2012-01-30,1610612762,1610612757,2011,93.0,89.0,182.0,95.9,96.1,97.35,92.4,18,11,7,0.611,20,12,8,0.6,9,2,9,3,198.3867924528302,190.7551139684395,194.57095321063485
2012-01-30,1610612756,1610612742,2011,99.0,122.0,221.0,90.9,95.8,92.9,88.1,19,7,12,0.368,21,13,8,0.619,4,3,9,4,206.53636363636363,192.63255295429207,199.58445829532786
2012-01-30,1610612746,1610612760,2011,112.0,100.0,212.0,97.85,96.85,99.7,93.6,17,11,6,0.647,19,16,3,0.8420000000000001,9,2,8,8,199.78424426450744,203.52394153225805,201.65409289838274
2012-01-29,1610612748,1610612741,2011,97.0,93.0,190.0,103.95,96.8,97.45,86.95,19,14,5,0.737,21,17,4,0.81,8,6,9,8,194.53125,187.68774038461538,191.1094951923077
2012-01-29,1610612738,1610612739,2011,87.0,88.0,175.0,88.69999999999997,88.55000000000003,93.0,97.2,18,9,9,0.5,18,7,11,0.389,6,3,3,4,185.85344827586206,196.75,191.30172413793105
2012-01-29,1610612751,1610612761,2011,73.0,94.0,167.0,93.1,100.35,85.5,92.25,20,7,13,0.35,20,6,14,0.3,2,5,2,4,193.40840938722295,199.86621966794382,196.63731452758338
2012-01-29,1610612753,1610612754,2011,85.0,106.0,191.0,93.3,91.35,92.65,91.4,19,12,7,0.632,18,12,6,0.667,6,6,5,7,189.94827586206895,196.7991030003093,193.37368943118912
2012-01-29,1610612742,1610612759,2011,101.0,100.0,201.0,92.5,88.85,98.1,96.25,20,12,8,0.6,20,12,8,0.6,8,4,10,2,192.58065610859728,199.0902468034493,195.8354514560233
2012-01-29,1610612740,1610612737,2011,72.0,94.0,166.0,87.95,92.45,96.95,92.45,19,4,15,0.211,20,14,6,0.7,2,2,8,6,186.98714202220924,188.48055555555555,187.7338487888824
2012-01-29,1610612750,1610612747,2011,101.0,106.0,207.0,95.95,94.6,92.65,94.55,19,9,10,0.474,20,11,9,0.55,5,4,10,1,205.50847457627117,193.98365384615386,199.7460642112125
2012-01-29,1610612743,1610612746,2011,105.0,109.0,214.0,106.9,99.2,96.5,95.65,19,14,5,0.737,16,10,6,0.625,7,7,9,1,209.17738095238096,199.66150670794633,204.41944383016363
2012-01-28,1610612755,1610612765,2011,95.0,74.0,169.0,98.8,88.35,86.45,95.0,19,13,6,0.684,20,4,16,0.2,9,4,3,1,194.0784936479129,194.21647509578543,194.14748437184915
2012-01-28,1610612766,1610612764,2011,99.0,102.0,201.0,87.8,97.9,88.9,98.85,20,3,17,0.15,19,3,16,0.158,2,1,3,0,188.93189792663478,198.24545454545455,193.58867623604465
2012-01-28,1610612745,1610612752,2011,97.0,84.0,181.0,98.1,96.45,93.9,94.85,19,11,8,0.579,19,7,12,0.368,8,3,3,4,205.50730994152048,206.5043103448276,206.00581014317402
2012-01-28,1610612749,1610612747,2011,100.0,89.0,189.0,93.95,94.6,92.8,94.45,18,7,11,0.389,19,11,8,0.579,4,3,10,1,185.86025257560652,194.02797202797203,189.9441123017893
2012-01-28,1610612762,1610612758,2011,96.0,93.0,189.0,95.8,95.95,92.15,102.8,17,10,7,0.588,19,6,13,0.316,8,2,4,2,198.46714959568732,201.24395895398874,199.85555427483803
2012-01-28,1610612756,1610612763,2011,86.0,84.0,170.0,91.9,96.75,94.65,92.6,18,6,12,0.333,18,10,8,0.556,3,3,6,4,206.86363636363637,195.73984396018295,201.30174016190966
2012-01-27,1610612755,1610612766,2011,89.0,72.0,161.0,99.15,88.4,88.7,99.9,18,12,6,0.667,19,3,16,0.158,8,4,2,1,194.359649122807,189.16623376623377,191.76294144452038
2012-01-27,1610612738,1610612754,2011,94.0,87.0,181.0,88.8,88.45,92.7,91.5,17,8,9,0.471,17,12,5,0.706,5,3,5,7,185.8867816091954,196.92232704402517,191.40455432661028
2012-01-27,1610612765,1610612737,2011,101.0,107.0,208.0,85.85,94.9,96.9,90.9,19,4,15,0.211,19,13,6,0.684,3,1,8,5,194.1345029239766,188.31209677419355,191.2232998490851
2012-01-27,1610612739,1610612751,2011,96.0,99.0,195.0,93.15,96.7,93.05,100.8,17,7,10,0.412,19,6,13,0.316,3,4,2,4,196.74528301886792,193.39920424403184,195.07224363144988
2012-01-27,1610612748,1610612752,2011,99.0,89.0,188.0,104.9,96.6,94.05,94.05,18,13,5,0.722,18,7,11,0.389,7,6,3,4,194.58894230769232,206.64254385964912,200.61574308367074
2012-01-27,1610612741,1610612749,2011,107.0,100.0,207.0,96.75,86.2,93.25,93.8,20,16,4,0.8,17,7,10,0.412,8,8,4,3,187.53125,185.6913455037187,186.61129775185935
2012-01-27,1610612740,1610612753,2011,93.0,67.0,160.0,88.15,93.0,94.2,92.6,18,3,15,0.16699999999999998,18,12,6,0.667,1,2,6,6,187.19827586206895,190.23306110102845,188.7156684815487
2012-01-27,1610612745,1610612764,2011,103.0,76.0,179.0,98.0,97.0,89.5,98.9,18,10,8,0.556,18,3,15,0.16699999999999998,7,3,3,0,205.71329365079367,198.44343434343432,202.078363997114
2012-01-27,1610612750,1610612759,2011,87.0,79.0,166.0,96.6,95.85,98.7,96.85,18,8,10,0.444,19,12,7,0.632,4,4,10,2,205.8448275862069,199.38332324455206,202.6140754153795
2012-01-27,1610612742,1610612762,2011,116.0,101.0,217.0,91.4,89.05,95.6,95.45,19,11,8,0.579,16,10,6,0.625,7,4,8,2,192.40780711825488,198.29189560439562,195.34985136132525
2012-01-27,1610612743,1610612761,2011,96.0,81.0,177.0,107.3,100.2,86.25,92.55,18,13,5,0.722,19,6,13,0.316,6,7,2,4,209.48712121212122,200.05799220272905,204.77255670742514
2012-01-27,1610612757,1610612756,2011,109.0,71.0,180.0,97.4,93.35,93.85,97.65,19,11,8,0.579,17,6,11,0.353,8,3,3,3,190.86206896551724,207.11430976430978,198.98818936491352
2012-01-27,1610612744,1610612760,2011,109.0,120.0,229.0,96.75,99.55,99.0,92.75,17,6,11,0.353,18,15,3,0.833,4,2,8,7,205.95538720538718,203.31771633384537,204.6365517696163
2012-01-26,1610612753,1610612738,2011,83.0,91.0,174.0,95.1,91.85,88.75,89.25,17,12,5,0.706,16,7,9,0.438,6,6,5,2,190.35087719298247,185.99824561403508,188.1745614035088
2012-01-26,1610612746,1610612763,2011,98.0,91.0,189.0,96.65,96.8,94.1,92.45,15,9,6,0.6,17,10,7,0.588,8,1,6,4,199.74264705882354,195.78157463094587,197.76211084488472
2012-01-25,1610612755,1610612751,2011,90.0,97.0,187.0,99.7,88.25,92.1,101.0,17,12,5,0.706,18,5,13,0.278,8,4,2,3,194.4187030075188,193.45985155195683,193.9392772797378
2012-01-25,1610612764,1610612766,2011,92.0,75.0,167.0,89.1,99.65,88.7,99.9,17,2,15,0.118,18,3,15,0.16699999999999998,2,0,2,1,198.71296296296296,189.35454545454547,194.0337542087542
2012-01-25,1610612739,1610612752,2011,91.0,81.0,172.0,93.7,97.15,94.65,94.3,16,6,10,0.375,17,7,10,0.412,2,4,3,4,196.96153846153845,206.92857142857144,201.94505494505495
2012-01-25,1610612765,1610612748,2011,98.0,101.0,199.0,85.3,94.4,105.0,97.3,18,4,14,0.222,17,12,5,0.706,3,1,7,5,194.1299603174603,194.54578754578756,194.33787393162393
2012-01-25,1610612741,1610612754,2011,90.0,95.0,185.0,96.25,85.6,92.45,91.25,19,16,3,0.8420000000000001,16,11,5,0.688,8,8,5,6,187.54439484126982,197.0158298688839,192.28011235507688
2012-01-25,1610612745,1610612749,2011,99.0,105.0,204.0,97.6,96.65,92.75,93.65,17,10,7,0.588,16,6,10,0.375,7,3,4,2,205.69949494949498,185.54282765737872,195.62116130343685
2012-01-25,1610612760,1610612740,2011,101.0,91.0,192.0,99.2,93.8,87.5,92.3,17,14,3,0.8240000000000001,17,3,14,0.17600000000000002,7,7,1,2,203.41634139994795,187.17619479733818,195.29626809864305
2012-01-25,1610612742,1610612750,2011,90.0,105.0,195.0,91.5,89.1,96.65,97.85,18,11,7,0.611,17,7,10,0.412,7,4,4,3,192.39638694638694,205.95267072346178,199.17452883492436
2012-01-25,1610612759,1610612737,2011,105.0,83.0,188.0,98.2,96.8,96.6,89.6,18,11,7,0.611,18,13,5,0.722,9,2,8,5,199.48121921182266,188.30204918032786,193.89163419607524
2012-01-25,1610612762,1610612761,2011,106.0,111.0,217.0,95.4,94.85,85.0,92.2,15,10,5,0.667,18,5,13,0.278,8,2,2,3,198.1206293706294,199.89947089947088,199.01005013505014
2012-01-25,1610612758,1610612743,2011,93.0,122.0,215.0,93.1,102.7,106.7,99.8,18,6,12,0.333,17,12,5,0.706,4,2,6,6,201.1040823211876,209.4217257318952,205.2629040265414
2012-01-25,1610612747,1610612746,2011,96.0,91.0,187.0,92.8,93.45,97.0,97.55,18,10,8,0.556,14,9,5,0.643,9,1,8,1,194.0833806818182,199.885,196.9841903409091
2012-01-25,1610612744,1610612757,2011,101.0,93.0,194.0,97.05,99.7,97.2,92.9,16,5,11,0.313,18,11,7,0.611,3,2,8,3,206.05555555555554,190.81911675741077,198.43733615648316
2012-01-24,1610612766,1610612752,2011,78.0,111.0,189.0,89.6,98.6,93.35,94.75,17,3,14,0.17600000000000002,16,6,10,0.375,2,1,3,3,189.36952861952864,207.07045454545454,198.2199915824916
2012-01-24,1610612754,1610612753,2011,83.0,102.0,185.0,94.0,91.25,94.05,91.9,15,11,4,0.733,16,11,5,0.688,5,6,6,5,197.1390156453716,190.42261904761904,193.78081734649533
2012-01-24,1610612748,1610612739,2011,92.0,85.0,177.0,105.15,98.3,94.7,97.0,16,11,5,0.688,15,6,9,0.4,6,5,2,4,194.69122023809524,197.16524216524218,195.92823120166872
2012-01-24,1610612756,1610612761,2011,96.0,99.0,195.0,95.8,99.05,85.25,92.2,16,6,10,0.375,17,4,13,0.235,3,3,2,2,207.22222222222223,199.9351851851852,203.5787037037037
2012-01-24,1610612757,1610612763,2011,97.0,84.0,181.0,97.15,93.85,94.4,92.85,17,10,7,0.588,16,10,6,0.625,7,3,6,4,190.92105263157896,195.89024729091415,193.40564996124655
2012-01-23,1610612755,1610612764,2011,103.0,83.0,186.0,98.85,88.2,90.55,101.3,16,11,5,0.688,16,2,14,0.125,7,4,2,0,194.488995215311,198.85237596086654,196.67068558808876
2012-01-23,1610612738,1610612753,2011,87.0,56.0,143.0,88.45,90.1,95.5,91.95,15,6,9,0.4,15,11,4,0.733,4,2,6,5,186.35474278917633,190.87878787878788,188.6167653339821
2012-01-23,1610612741,1610612751,2011,110.0,95.0,205.0,94.5,85.1,91.85,99.7,18,15,3,0.833,17,5,12,0.294,7,8,2,3,187.39667338709677,193.36195054945057,190.37931196827367
2012-01-23,1610612749,1610612737,2011,92.0,97.0,189.0,92.5,93.55,95.9,89.75,15,6,9,0.4,17,12,5,0.706,4,2,8,4,185.4959649122807,188.28333333333333,186.88964912280701
2012-01-23,1610612740,1610612759,2011,102.0,104.0,206.0,87.15,91.1,97.3,96.9,16,3,13,0.188,17,10,7,0.588,1,2,9,1,186.99122807017545,199.42131661442005,193.20627234229775
2012-01-23,1610612760,1610612765,2011,99.0,79.0,178.0,98.6,94.5,86.55,94.45,16,13,3,0.813,17,4,13,0.235,6,7,3,1,203.63492063492063,194.24107142857144,198.93799603174602
2012-01-23,1610612750,1610612745,2011,92.0,107.0,199.0,97.9,97.3,98.3,97.15,16,7,9,0.438,16,9,7,0.563,4,3,7,2,206.01135190918473,205.79331046312177,205.90233118615325
2012-01-23,1610612742,1610612756,2011,93.0,87.0,180.0,92.45,89.9,95.95,100.15,17,10,7,0.588,15,6,9,0.4,6,4,3,3,192.5,207.48235499650593,199.99117749825297
2012-01-23,1610612757,1610612758,2011,101.0,89.0,190.0,96.3,93.5,92.6,102.7,16,9,7,0.563,17,6,11,0.353,6,3,4,2,190.94627192982455,201.21153846153845,196.0789051956815
2012-01-23,1610612744,1610612763,2011,90.0,91.0,181.0,98.05,99.45,93.45,93.3,15,5,10,0.333,15,9,6,0.6,3,2,6,3,206.28214535290005,196.00254237288135,201.1423438628907
2012-01-22,1610612764,1610612738,2011,94.0,100.0,194.0,89.75,101.45,88.5,89.85,15,2,13,0.133,14,5,9,0.35700000000000004,2,0,4,1,198.87735849056605,186.2916162227603,192.58448735666317
2012-01-22,1610612746,1610612761,2011,103.0,91.0,194.0,97.25,98.15,84.35,91.1,13,8,5,0.615,16,4,12,0.25,7,1,2,2,199.92363636363638,199.98148148148147,199.95255892255892
2012-01-22,1610612751,1610612766,2011,97.0,87.0,184.0,92.35,100.6,90.5,98.9,16,4,12,0.25,16,3,13,0.188,1,3,2,1,193.44905462184875,189.4074074074074,191.42823101462807
2012-01-22,1610612748,1610612749,2011,82.0,91.0,173.0,105.7,98.5,92.75,95.3,15,11,4,0.733,14,5,9,0.35700000000000004,6,5,4,1,194.87301587301587,185.61892857142857,190.24597222222224
2012-01-22,1610612747,1610612754,2011,96.0,98.0,194.0,92.35,92.95,93.35,91.1,17,10,7,0.588,14,10,4,0.7140000000000001,9,1,5,5,194.08499278499278,197.15815649867375,195.62157464183326
2012-01-21,1610612737,1610612739,2011,121.0,94.0,215.0,93.5,89.7,94.55,95.3,16,11,5,0.688,14,6,8,0.429,7,4,2,4,188.070197740113,197.01814223512338,192.5441699876182
2012-01-21,1610612752,1610612743,2011,114.0,119.0,233.0,92.1,93.85,105.6,99.1,15,6,9,0.4,16,11,5,0.688,3,3,6,5,206.85454545454547,209.1989028213166,208.02672413793104
2012-01-21,1610612748,1610612755,2011,113.0,92.0,205.0,104.65,98.1,97.9,87.25,14,10,4,0.7140000000000001,15,11,4,0.733,5,5,7,4,194.8026113671275,194.40064935064936,194.60163035888843
2012-01-21,1610612765,1610612757,2011,94.0,91.0,185.0,86.9,95.4,95.85,93.45,16,3,13,0.188,15,9,6,0.6,2,1,6,3,194.36363636363637,190.98214285714286,192.67288961038963
2012-01-21,1610612751,1610612760,2011,74.0,84.0,158.0,93.35,101.8,99.2,95.8,15,4,11,0.267,15,12,3,0.8,1,3,6,6,193.79964285714286,203.99462365591398,198.89713325652843
2012-01-21,1610612741,1610612766,2011,95.0,89.0,184.0,94.9,84.75,91.2,99.75,17,14,3,0.8240000000000001,15,3,12,0.2,6,8,2,1,187.41623975409834,189.44671558350802,188.43147766880318
2012-01-21,1610612763,1610612758,2011,128.0,95.0,223.0,93.2,95.2,92.65,101.65,14,8,6,0.5710000000000001,16,6,10,0.375,5,3,4,2,195.78103448275863,201.0229020979021,198.40196829033036
2012-01-21,1610612740,1610612742,2011,81.0,83.0,164.0,87.1,91.85,93.55,90.6,15,3,12,0.2,16,9,7,0.563,1,2,6,3,187.1746553884712,192.71346153846156,189.94405846346638
2012-01-21,1610612745,1610612759,2011,105.0,102.0,207.0,98.0,95.95,96.6,96.2,15,8,7,0.5329999999999999,16,10,6,0.625,6,2,9,1,205.75122292103424,199.3499361430396,202.55057953203692
2012-01-21,1610612762,1610612750,2011,108.0,98.0,206.0,94.6,94.4,98.25,97.25,14,9,5,0.643,15,7,8,0.467,7,2,4,3,198.0448717948718,206.01350877192982,202.0291902834008
2012-01-20,1610612761,1610612757,2011,84.0,94.0,178.0,84.95,91.6,95.6,94.3,15,4,11,0.267,14,8,6,0.5710000000000001,2,2,6,2,200.19723969252271,191.08295454545453,195.64009711898862
2012-01-20,1610612755,1610612737,2011,90.0,76.0,166.0,98.1,88.44999999999997,93.35,89.5,14,10,4,0.7140000000000001,15,11,4,0.733,6,4,7,4,194.65873015873015,188.24576271186442,191.4522464352973
2012-01-20,1610612764,1610612743,2011,104.0,108.0,212.0,89.3,100.75,104.65,99.2,14,2,12,0.14300000000000002,15,10,5,0.667,2,0,6,4,198.73022496371553,209.1524720893142,203.94134852651484
2012-01-20,1610612738,1610612756,2011,71.0,79.0,150.0,89.44999999999997,90.8,96.85,102.05,13,5,8,0.385,14,5,9,0.35700000000000004,4,1,3,2,186.60006157635468,208.04095441595442,197.32050799615456
2012-01-20,1610612752,1610612749,2011,86.0,100.0,186.0,92.6,94.5,93.25,96.3,14,6,8,0.429,13,4,9,0.308,3,3,4,0,207.06582491582492,185.62818181818182,196.34700336700337
2012-01-20,1610612765,1610612763,2011,81.0,98.0,179.0,88.35,95.5,93.4,96.7,15,3,12,0.2,13,7,6,0.5379999999999999,2,1,5,2,194.5462962962963,195.91408533021627,195.23019081325629
2012-01-20,1610612739,1610612741,2011,75.0,114.0,189.0,94.95,94.55,93.6,85.35,13,6,7,0.462,16,13,3,0.813,2,4,6,7,197.07621161672216,187.41152745251105,192.2438695346166
2012-01-20,1610612753,1610612747,2011,92.0,80.0,172.0,95.3,92.05,93.25,92.35,14,10,4,0.7140000000000001,16,10,6,0.625,5,5,9,1,191.01866883116884,194.2883597883598,192.65351430976432
2012-01-20,1610612759,1610612758,2011,86.0,88.0,174.0,97.15,96.55,93.45,102.5,15,10,5,0.667,15,5,10,0.333,9,1,4,1,199.57407407407408,201.2809829059829,200.4275284900285
2012-01-20,1610612746,1610612750,2011,98.0,101.0,199.0,97.85,98.25,97.65,97.65,12,8,4,0.667,14,6,8,0.429,7,1,4,2,199.9174074074074,206.08718224131758,203.00229482436248
2012-01-20,1610612744,1610612754,2011,91.0,94.0,185.0,98.65,99.95,93.1,92.35,14,5,9,0.35700000000000004,13,9,4,0.6920000000000001,3,2,5,4,206.4789886039886,197.25691632928476,201.86795246663667
2012-01-19,1610612748,1610612747,2011,98.0,87.0,185.0,104.8,98.4,93.3,92.1,13,9,4,0.6920000000000001,15,10,5,0.667,4,5,9,1,194.89383294301328,194.376759508835,194.63529622592415
2012-01-19,1610612745,1610612740,2011,90.0,88.0,178.0,98.55,96.75,88.15,92.35,14,7,7,0.5,14,3,11,0.214,5,2,1,2,205.9811320754717,187.27678571428572,196.6289588948787
2012-01-19,1610612762,1610612742,2011,91.0,94.0,185.0,95.4,94.85,93.6,90.7,13,9,4,0.6920000000000001,15,8,7,0.5329999999999999,7,2,6,2,198.1643686502177,192.76703296703297,195.46570080862534
2012-01-18,1610612755,1610612743,2011,104.0,108.0,212.0,97.9,88.25,104.4,99.35,13,10,3,0.769,14,9,5,0.643,6,4,6,3,194.49258760107816,209.10438311688313,201.79848535898066
2012-01-18,1610612764,1610612760,2011,105.0,102.0,207.0,89.8,99.8,99.4,95.55,13,1,12,0.077,14,12,2,0.857,1,0,6,6,198.6263411024787,203.96448087431693,201.2954109883978
2012-01-18,1610612753,1610612759,2011,83.0,85.0,168.0,95.8,92.95,98.05,97.7,13,10,3,0.769,14,9,5,0.643,5,5,9,0,191.2,199.8679245283019,195.53396226415094
2012-01-18,1610612738,1610612761,2011,96.0,73.0,169.0,89.5,91.2,85.6,91.45,12,4,8,0.333,14,4,10,0.28600000000000003,3,1,2,2,186.75266290726816,200.4811320754717,193.6168974913699
2012-01-18,1610612751,1610612744,2011,107.0,100.0,207.0,92.35,102.4,98.2,100.1,14,3,11,0.214,13,5,8,0.385,0,3,3,2,193.66454081632654,206.47986211901306,200.0722014676698
2012-01-18,1610612752,1610612756,2011,88.0,91.0,179.0,92.7,95.1,97.7,102.55,13,6,7,0.462,13,4,9,0.308,3,3,3,1,207.35111492281305,208.33714596949892,207.844130446156
2012-01-18,1610612737,1610612757,2011,92.0,89.0,181.0,93.75,89.44999999999997,95.2,94.15,14,10,4,0.7140000000000001,13,8,5,0.615,6,4,6,2,188.31838106370543,191.15972222222223,189.73905164296383
2012-01-18,1610612740,1610612763,2011,87.0,93.0,180.0,88.44999999999997,92.1,94.45,97.4,13,3,10,0.231,12,6,6,0.5,1,2,5,1,187.32142857142856,196.04310344827587,191.6822660098522
2012-01-18,1610612750,1610612765,2011,93.0,85.0,178.0,98.1,99.45,89.7,95.9,13,5,8,0.385,14,3,11,0.214,3,2,2,1,206.33545918367346,194.6616809116809,200.49857004767716
2012-01-18,1610612758,1610612754,2011,92.0,88.0,180.0,94.15,102.95,93.2,92.55,14,4,10,0.28600000000000003,12,9,3,0.75,3,1,5,4,201.47875816993462,197.40384615384616,199.4413021618904
2012-01-18,1610612746,1610612742,2011,91.0,89.0,180.0,98.2,98.4,93.35,90.75,11,7,4,0.636,14,8,6,0.5710000000000001,6,1,6,2,200.09018867924527,192.86265508684863,196.47642188304695
2012-01-17,1610612753,1610612766,2011,96.0,89.0,185.0,95.6,92.2,91.2,99.9,12,9,3,0.75,14,3,11,0.214,4,5,2,1,191.23063973063972,189.47792022792024,190.35427997927997
2012-01-17,1610612739,1610612744,2011,95.0,105.0,200.0,95.05,93.85,98.65,101.1,12,6,6,0.5,12,4,8,0.333,2,4,3,1,197.0266037735849,206.5480769230769,201.7873403483309
2012-01-17,1610612748,1610612759,2011,120.0,98.0,218.0,103.6,97.75,97.8,96.8,12,8,4,0.667,13,9,4,0.6920000000000001,3,5,9,0,194.71309523809524,199.69230769230768,197.20270146520147
2012-01-17,1610612741,1610612756,2011,118.0,97.0,215.0,92.45,84.65,97.55,101.5,15,12,3,0.8,12,4,8,0.333,5,7,3,1,187.17341269841268,208.28518518518518,197.72929894179893
2012-01-17,1610612749,1610612743,2011,95.0,105.0,200.0,93.0,95.9,104.3,99.95,12,4,8,0.333,13,8,5,0.615,4,0,6,2,185.46716141001855,209.16363636363636,197.31539888682744
2012-01-17,1610612745,1610612765,2011,97.0,80.0,177.0,99.4,98.2,90.95,96.4,13,6,7,0.462,13,3,10,0.231,4,2,2,1,206.22949927431057,194.791394335512,200.51044680491128
2012-01-17,1610612762,1610612746,2011,108.0,79.0,187.0,94.35,95.8,99.45,98.6,12,8,4,0.667,10,7,3,0.7,6,2,6,1,198.26923076923077,200.23835194455143,199.2537913568911
2012-01-16,1610612752,1610612753,2011,93.0,102.0,195.0,94.6,95.9,94.7,91.95,12,6,6,0.5,11,8,3,0.727,3,3,4,4,207.49353146853147,191.22222222222223,199.35787684537684
2012-01-16,1610612763,1610612741,2011,102.0,86.0,188.0,94.4,97.75,92.9,83.85,11,5,6,0.455,14,12,2,0.857,4,1,5,7,196.12084089534181,187.17661290322582,191.64872689928382
2012-01-16,1610612755,1610612749,2011,94.0,82.0,176.0,97.45,88.9,93.9,96.7,12,9,3,0.75,11,4,7,0.364,5,4,4,0,194.6662087912088,185.5693499622071,190.11777937670794
2012-01-16,1610612764,1610612745,2011,106.0,114.0,220.0,89.85,99.35,98.35,97.95,12,1,11,0.083,12,5,7,0.417,1,0,4,1,198.38830188679245,206.125,202.2566509433962
2012-01-16,1610612766,1610612739,2011,94.0,102.0,196.0,91.55,100.4,95.45,94.2,13,3,10,0.231,11,5,6,0.455,2,1,2,3,189.42743105950655,197.05653846153848,193.2419847605225
2012-01-16,1610612740,1610612757,2011,77.0,84.0,161.0,88.9,92.9,95.3,95.8,12,3,9,0.25,12,7,5,0.583,1,2,6,1,187.54365079365078,191.42806603773585,189.48585841569331
2012-01-16,1610612746,1610612751,2011,101.0,91.0,192.0,99.4,99.35,91.9,101.75,9,6,3,0.667,13,3,10,0.231,5,1,0,3,200.30239403453692,193.6812615955473,196.99182781504211
2012-01-16,1610612737,1610612761,2011,93.0,84.0,177.0,93.2,90.2,86.05000000000003,91.7,13,9,4,0.6920000000000001,13,4,9,0.308,5,4,2,2,188.42863514719,200.69902031930332,194.56382773324665
2012-01-16,1610612738,1610612760,2011,88.0,97.0,185.0,89.9,91.0,100.15,97.2,11,4,7,0.364,13,11,2,0.846,3,1,6,5,186.76785714285714,204.11666666666667,195.4422619047619
2012-01-16,1610612750,1610612758,2011,99.0,86.0,185.0,98.05,100.55,94.65,103.05,12,4,8,0.333,13,4,9,0.308,2,2,3,1,206.52912801484229,201.6428042915279,204.0859661531851
2012-01-16,1610612747,1610612742,2011,73.0,70.0,143.0,94.4,94.3,95.45,92.35,14,9,5,0.643,13,8,5,0.615,8,1,6,2,194.78971393791844,193.26469104665827,194.02720249228835
2012-01-15,1610612765,1610612744,2011,91.0,99.0,190.0,92.2,96.9,99.3,103.1,12,3,9,0.25,11,3,8,0.273,2,1,3,0,194.8771735109138,206.71700603318249,200.79708977204814
2012-01-15,1610612743,1610612762,2011,96.0,106.0,202.0,104.2,99.5,93.75,96.3,12,8,4,0.667,11,7,4,0.636,6,2,6,1,209.253367003367,198.2341628959276,203.7437649496473
2012-01-15,1610612759,1610612756,2011,102.0,91.0,193.0,98.2,97.4,97.85,102.1,12,8,4,0.667,11,4,7,0.364,8,0,3,1,199.75480769230768,208.4555933484505,204.10520052037907
2012-01-14,1610612764,1610612755,2011,90.0,103.0,193.0,91.1,99.55,96.75,89.25,11,1,10,0.091,11,8,3,0.727,1,0,5,3,198.41605698883325,194.68374125874126,196.54989912378727
2012-01-14,1610612766,1610612744,2011,112.0,100.0,212.0,91.05,100.95,99.1,103.05,12,2,10,0.16699999999999998,10,3,7,0.3,1,1,3,0,189.22115384615387,206.6726923076923,197.9469230769231
2012-01-14,1610612737,1610612750,2011,93.0,91.0,184.0,92.75,89.69999999999997,98.65,101.45,12,8,4,0.667,11,4,7,0.364,4,4,2,2,188.48032687651332,206.7621212121212,197.62122404431727
2012-01-14,1610612754,1610612738,2011,97.0,83.0,180.0,95.15,94.0,91.4,90.95,11,8,3,0.727,10,4,6,0.4,4,4,3,1,197.58088235294116,186.82970779220778,192.20529507257447
2012-01-14,1610612741,1610612761,2011,77.0,64.0,141.0,93.35,84.3,88.75,94.4,13,11,2,0.846,12,4,8,0.333,4,7,2,2,187.55754510661563,201.27839437661856,194.4179697416171
2012-01-14,1610612763,1610612740,2011,108.0,99.0,207.0,93.95,97.35,88.4,93.55,10,4,6,0.4,11,3,8,0.273,3,1,1,2,196.0317118226601,187.38585858585859,191.70878520425936
2012-01-14,1610612745,1610612757,2011,107.0,105.0,212.0,98.95,98.4,94.95,94.8,11,4,7,0.364,11,7,4,0.636,3,1,6,1,206.0399698340875,191.21634615384616,198.62815799396682
2012-01-14,1610612760,1610612752,2011,104.0,92.0,196.0,100.2,97.1,95.1,96.3,12,10,2,0.833,11,6,5,0.545,5,5,3,3,204.19011299435027,207.57585470085468,205.88298384760247
2012-01-14,1610612742,1610612758,2011,99.0,60.0,159.0,94.8,93.5,96.25,104.3,12,7,5,0.583,12,4,8,0.333,5,2,3,1,193.53560450819674,202.06315987933635,197.79938219376655
2012-01-14,1610612762,1610612751,2011,107.0,94.0,201.0,92.65,96.4,91.8,101.25,10,6,4,0.6,12,3,9,0.25,5,1,0,3,198.20588235294116,193.61526832955406,195.9105753412476
2012-01-14,1610612746,1610612747,2011,102.0,94.0,196.0,99.0,99.15,94.7,93.5,8,5,3,0.625,13,9,4,0.6920000000000001,4,1,8,1,200.3297318927571,194.77574441687347,197.5527381548153
2012-01-13,1610612761,1610612754,2011,90.0,95.0,185.0,89.35,94.55,95.35,94.7,11,4,7,0.364,10,7,3,0.7,2,2,4,3,201.43514328808448,197.68770053475936,199.56142191142192
2012-01-13,1610612755,1610612764,2011,120.0,89.0,209.0,95.65,89.45,91.5,98.1,10,7,3,0.7,10,1,9,0.1,4,3,1,0,194.54064171122997,198.33967817896388,196.44015994509692
2012-01-13,1610612766,1610612765,2011,81.0,98.0,179.0,91.55,100.9,91.8,97.9,11,2,9,0.182,11,2,9,0.182,1,1,2,0,189.33031674208144,194.99207547169812,192.16119610688978
2012-01-13,1610612738,1610612741,2011,79.0,88.0,167.0,91.8,90.8,93.6,85.4,9,4,5,0.444,12,10,2,0.833,3,1,4,6,187.0090909090909,187.73298138371769,187.3710361464043
2012-01-13,1610612740,1610612750,2011,80.0,87.0,167.0,88.3,93.7,99.1,102.65,10,3,7,0.3,10,3,7,0.3,1,2,2,1,187.5598627787307,207.18588007736943,197.37287142805008
2012-01-13,1610612745,1610612758,2011,103.0,89.0,192.0,100.35,99.55,97.0,104.2,10,3,7,0.3,11,4,7,0.364,2,1,3,1,206.15153846153845,202.1764705882353,204.16400452488688
2012-01-13,1610612742,1610612749,2011,102.0,76.0,178.0,94.0,94.1,94.6,95.85,11,6,5,0.545,10,4,6,0.4,4,2,4,0,193.66432474629198,185.65652676164805,189.66042575397
2012-01-13,1610612759,1610612757,2011,99.0,83.0,182.0,97.9,97.6,95.35,94.6,11,7,4,0.636,10,7,3,0.7,7,0,6,1,199.91958041958043,191.2904411764706,195.60501079802552
2012-01-13,1610612756,1610612751,2011,103.0,110.0,213.0,98.25,101.5,90.9,101.05,10,4,6,0.4,11,2,9,0.182,3,1,0,2,208.39776665383135,193.4335772044667,200.91567192914903
2012-01-13,1610612743,1610612748,2011,117.0,104.0,221.0,105.05,99.85,102.55,96.2,11,7,4,0.636,11,8,3,0.727,5,2,3,5,209.1672384219554,194.49112903225807,201.82918372710674
2012-01-13,1610612747,1610612739,2011,97.0,92.0,189.0,93.9,93.55,95.9,94.75,12,8,4,0.667,10,5,5,0.5,7,1,2,3,194.82518915510718,197.15627450980392,195.99073183245554
2012-01-12,1610612737,1610612766,2011,111.0,81.0,192.0,91.6,89.9,91.35,99.8,11,7,4,0.636,10,2,8,0.2,3,4,1,1,188.46117103235747,189.29411764705884,188.87764433970816
2012-01-12,1610612749,1610612765,2011,102.0,93.0,195.0,94.5,95.95,92.2,98.35,9,3,6,0.333,10,2,8,0.2,3,0,2,0,185.54088050314465,194.94840200231036,190.2446412527275
2012-01-12,1610612763,1610612752,2011,94.0,83.0,177.0,94.45,97.5,96.45,97.05,9,3,6,0.333,10,6,4,0.6,2,1,3,3,196.21206896551723,207.8405297532656,202.02629935939143
2012-01-12,1610612756,1610612739,2011,90.0,101.0,191.0,98.65,102.25,96.05,95.05,9,4,5,0.444,9,4,5,0.444,3,1,2,2,208.54925431711146,197.24,202.89462715855575
2012-01-12,1610612744,1610612753,2011,109.0,117.0,226.0,98.4,101.55,93.6,90.75,9,3,6,0.333,10,7,3,0.7,3,0,4,3,206.47529411764705,190.92103424178896,198.698164179718
2012-01-11,1610612761,1610612758,2011,91.0,98.0,189.0,89.69999999999997,94.85,96.6,104.85,10,4,6,0.4,10,3,7,0.3,2,2,3,0,201.55882352941177,202.32431372549019,201.94156862745098
2012-01-11,1610612754,1610612737,2011,96.0,84.0,180.0,95.0,94.9,92.55,89.85,9,6,3,0.667,10,7,3,0.7,3,3,3,4,197.87181818181818,188.5221003134796,193.1969592476489
2012-01-11,1610612752,1610612755,2011,85.0,79.0,164.0,98.35,98.45,95.8,90.15,9,5,4,0.556,9,7,2,0.778,2,3,4,3,208.29245283018867,194.8273420479303,201.55989743905948
2012-01-11,1610612738,1610612742,2011,85.0,90.0,175.0,93.15,91.4,94.15,94.2,8,4,4,0.5,10,5,5,0.5,3,1,4,1,187.1210437710438,193.81309523809523,190.4670695045695
2012-01-11,1610612741,1610612764,2011,78.0,64.0,142.0,94.45,87.35,93.3,98.95,11,9,2,0.818,9,1,8,0.111,3,6,1,0,188.1184284906727,198.9171668667467,193.5177976787097
2012-01-11,1610612740,1610612760,2011,85.0,95.0,180.0,89.5,93.8,99.6,97.6,9,3,6,0.333,11,9,2,0.818,1,2,5,4,187.61555944055942,204.38983050847457,196.002694974517
2012-01-11,1610612759,1610612745,2011,101.0,95.0,196.0,97.75,97.9,100.45,99.9,10,6,4,0.6,9,3,6,0.333,6,0,2,1,199.9608262108262,206.27823529411765,203.11953075247192
2012-01-11,1610612743,1610612751,2011,123.0,115.0,238.0,105.4,99.4,90.6,100.7,10,6,4,0.6,10,2,8,0.2,4,2,0,2,208.91433566433565,193.00451334379906,200.95942450406736
2012-01-11,1610612762,1610612747,2011,87.0,90.0,177.0,93.05,96.9,95.2,94.6,9,6,3,0.667,11,7,4,0.636,5,1,7,0,198.41647058823528,194.99694631951144,196.70670845387338
2012-01-11,1610612757,1610612753,2011,104.0,107.0,211.0,95.0,93.85,93.8,90.65,9,7,2,0.778,9,6,3,0.667,6,1,4,2,191.12566844919786,190.7524928774929,190.93908066334538
2012-01-11,1610612746,1610612748,2011,95.0,89.0,184.0,100.6,100.65,102.5,95.75,7,4,3,0.5710000000000001,10,8,2,0.8,3,1,3,5,200.47816326530614,194.5651639344262,197.52166359986617
2012-01-10,1610612755,1610612758,2011,112.0,85.0,197.0,94.8,90.75,98.05,104.8,8,6,2,0.75,9,3,6,0.333,3,3,3,0,194.7985185185185,202.39655862344938,198.59753857098394
2012-01-10,1610612764,1610612761,2011,93.0,78.0,171.0,94.0,101.2,91.1,95.85,8,0,8,0.0,9,4,5,0.444,0,0,2,2,199.17524509803923,201.86137254901962,200.51830882352942
2012-01-10,1610612766,1610612745,2011,70.0,82.0,152.0,92.75,100.55,101.95,100.75,9,2,7,0.222,8,2,6,0.25,1,1,2,0,189.67764705882354,206.85,198.26382352941175
2012-01-10,1610612765,1610612742,2011,86.0,100.0,186.0,92.7,98.4,93.8,93.95,9,2,7,0.222,9,4,5,0.444,2,0,4,0,195.07594191522765,193.87368845843423,194.47481518683094
2012-01-10,1610612749,1610612759,2011,106.0,103.0,209.0,94.7,95.55,97.45,97.1,8,2,6,0.25,9,6,3,0.667,2,0,6,0,185.27137695704536,199.86655773420478,192.56896734562508
2012-01-10,1610612763,1610612760,2011,95.0,100.0,195.0,94.25,96.9,101.25,99.0,8,3,5,0.375,10,8,2,0.8,2,1,5,3,196.2324393358876,204.46712448860316,200.34978191224536
2012-01-10,1610612750,1610612741,2011,100.0,111.0,211.0,98.7,102.65,93.15,87.15,9,3,6,0.333,10,8,2,0.8,2,1,3,5,207.14598108747043,187.9330459770115,197.53951353224096
2012-01-10,1610612762,1610612739,2011,113.0,105.0,218.0,91.25,96.35,96.15,95.55,8,5,3,0.625,8,4,4,0.5,4,1,2,2,198.2172869147659,197.05163265306123,197.63445978391357
2012-01-10,1610612757,1610612746,2011,105.0,97.0,202.0,94.85,93.45,99.85,100.65,8,6,2,0.75,6,4,2,0.667,5,1,3,1,191.03812636165577,200.47625,195.75718818082788
2012-01-10,1610612747,1610612756,2011,99.0,83.0,182.0,94.95,95.25,100.15,103.1,10,6,4,0.6,8,4,4,0.5,6,0,3,1,195.10637254901962,208.84134615384616,201.9738593514329
2012-01-10,1610612744,1610612748,2011,111.0,106.0,217.0,97.8,100.85,101.35,94.2,8,2,6,0.25,9,8,1,0.889,2,0,3,5,206.36,194.36666666666667,200.36333333333334
2012-01-09,1610612761,1610612750,2011,97.0,87.0,184.0,92.05,96.85,99.25,103.1,8,3,5,0.375,8,3,5,0.375,1,2,2,1,202.04000000000002,207.40338164251207,204.72169082125606
2012-01-09,1610612755,1610612754,2011,96.0,86.0,182.0,95.75,90.95,94.4,94.7,7,5,2,0.7140000000000001,8,6,2,0.75,2,3,3,3,194.9215797430083,198.01037037037037,196.46597505668933
2012-01-09,1610612751,1610612737,2011,101.0,106.0,207.0,90.45,100.5,91.05,89.85,9,2,7,0.222,9,6,3,0.667,0,2,3,3,192.86378205128204,188.34832535885167,190.60605370506687
2012-01-09,1610612752,1610612766,2011,91.0,87.0,178.0,99.8,99.9,92.55,100.05,8,4,4,0.5,8,2,6,0.25,1,3,1,1,208.62245283018868,189.78,199.20122641509434
2012-01-09,1610612741,1610612765,2011,92.0,68.0,160.0,94.35,88.19999999999997,93.85,98.65,9,7,2,0.778,8,2,6,0.25,2,5,2,0,188.17412280701754,195.39503205128204,191.7845774291498
2012-01-09,1610612743,1610612740,2011,81.0,94.0,175.0,106.05,99.75,89.25,95.3,9,6,3,0.667,8,2,6,0.25,4,2,1,1,209.26916221033866,187.74821937321937,198.50869079177903
2012-01-08,1610612764,1610612750,2011,72.0,93.0,165.0,95.3,101.15,99.8,105.45,7,0,7,0.0,7,2,5,0.28600000000000003,0,0,2,0,199.5081351689612,207.88333333333333,203.69573425114726
2012-01-08,1610612758,1610612753,2011,97.0,104.0,201.0,97.7,104.55,93.5,90.9,8,3,5,0.375,8,5,3,0.625,3,0,4,1,202.3922448979592,190.67538126361654,196.53381308078787
2012-01-08,1610612760,1610612759,2011,108.0,96.0,204.0,100.8,97.8,98.35,97.65,9,7,2,0.778,8,6,2,0.75,4,3,6,0,204.47413793103448,199.81851851851852,202.14632822477648
2012-01-08,1610612756,1610612749,2011,109.0,93.0,202.0,98.85,103.0,93.65,94.0,7,3,4,0.429,7,2,5,0.28600000000000003,2,1,2,0,208.890931372549,185.13113747954174,197.01103442604537
2012-01-08,1610612757,1610612739,2011,98.0,78.0,176.0,94.6,93.85,97.6,96.4,7,5,2,0.7140000000000001,7,4,3,0.5710000000000001,4,1,2,2,191.19256381798004,197.29291666666666,194.24274024232335
2012-01-08,1610612747,1610612763,2011,90.0,82.0,172.0,95.75,95.65,95.3,97.9,9,5,4,0.556,7,3,4,0.429,5,0,2,1,195.30425390495182,196.43615984405457,195.8702068745032
2012-01-07,1610612737,1610612741,2011,109.0,94.0,203.0,90.0,89.35,94.3,86.4,8,5,3,0.625,8,7,1,0.875,2,3,2,5,188.2266081871345,188.05025275052037,188.13843046882744
2012-01-07,1610612754,1610612766,2011,99.0,77.0,176.0,95.0,95.9,93.6,100.55,7,5,2,0.7140000000000001,7,2,5,0.28600000000000003,2,3,1,1,198.2428193499622,189.9069387755102,194.07487906273622
2012-01-07,1610612751,1610612748,2011,90.0,101.0,191.0,89.6,99.65,100.55,93.45,8,2,6,0.25,8,7,1,0.875,0,2,3,4,192.88727495908347,194.38177966101694,193.6345273100502
2012-01-07,1610612765,1610612752,2011,80.0,103.0,183.0,94.85,97.9,100.45,100.55,7,2,5,0.28600000000000003,7,3,4,0.429,2,0,1,2,195.55698529411765,208.8396153846154,202.19830033936654
2012-01-07,1610612755,1610612761,2011,97.0,62.0,159.0,96.3,92.7,93.45,96.7,6,4,2,0.667,7,3,4,0.429,1,3,1,2,195.28935185185185,202.4773469387755,198.88334939531367
2012-01-07,1610612745,1610612760,2011,95.0,98.0,193.0,102.7,101.25,100.55,98.1,7,2,5,0.28600000000000003,8,6,2,0.75,2,0,4,2,206.95591836734695,204.5716878402904,205.76380310381867
2012-01-07,1610612759,1610612743,2011,121.0,117.0,238.0,97.85,96.9,104.65,98.9,7,5,2,0.7140000000000001,8,6,2,0.75,5,0,4,2,199.46509433962262,208.97875816993462,204.22192625477862
2012-01-07,1610612742,1610612740,2011,96.0,81.0,177.0,94.0,94.7,89.4,95.6,8,3,5,0.375,7,2,5,0.28600000000000003,3,0,1,1,194.0146254784035,187.8670174165457,190.9408214474746
2012-01-07,1610612746,1610612749,2011,92.0,86.0,178.0,100.2,101.75,93.75,93.85,5,3,2,0.6,6,2,4,0.333,2,1,2,0,200.69196428571428,185.22069253233207,192.95632840902317
2012-01-07,1610612744,1610612762,2011,87.0,88.0,175.0,99.15,101.65,91.1,97.15,7,2,5,0.28600000000000003,7,4,3,0.5710000000000001,2,0,4,0,206.66857142857143,198.45081632653063,202.559693877551
2012-01-06,1610612761,1610612751,2011,85.0,97.0,182.0,93.7,96.6,89.25,101.15,6,3,3,0.5,7,1,6,0.14300000000000002,1,2,0,1,202.68367346938777,192.99040467250728,197.83703907094753
2012-01-06,1610612755,1610612765,2011,96.0,73.0,169.0,97.05,94.75,96.0,98.3,5,3,2,0.6,6,2,4,0.333,0,3,2,0,195.56639085894403,195.79390905298288,195.68014995596346
2012-01-06,1610612764,1610612752,2011,96.0,99.0,195.0,94.95,102.0,100.35,100.35,6,0,6,0.0,6,2,4,0.333,0,0,1,1,199.52941176470588,208.94764705882352,204.23852941176472
2012-01-06,1610612766,1610612737,2011,96.0,102.0,198.0,93.15,99.75,89.0,88.95,6,2,4,0.333,7,4,3,0.5710000000000001,1,1,2,2,189.83673469387756,188.12698412698413,188.98185941043084
2012-01-06,1610612738,1610612754,2011,74.0,87.0,161.0,94.65,91.45,95.45,97.6,7,4,3,0.5710000000000001,6,4,2,0.667,3,1,2,2,187.36929674099486,198.58471313053525,192.97700493576505
2012-01-06,1610612753,1610612741,2011,83.0,97.0,180.0,94.3,91.15,93.85,87.25,7,5,2,0.7140000000000001,7,6,1,0.857,4,1,2,4,190.75434702182758,188.12038717483364,189.4373670983306
2012-01-06,1610612740,1610612743,2011,88.0,96.0,184.0,90.05,95.45,105.05,99.3,6,2,4,0.333,7,5,2,0.7140000000000001,1,1,4,1,187.88568257491676,209.18682944876065,198.5362560118387
2012-01-06,1610612760,1610612745,2011,109.0,94.0,203.0,100.65,98.5,103.95,102.05,7,5,2,0.7140000000000001,6,2,4,0.333,3,2,2,0,204.58771929824562,207.03061224489795,205.80916577157177
2012-01-06,1610612750,1610612739,2011,87.0,98.0,185.0,100.0,105.95,97.55,96.95,6,2,4,0.333,6,3,3,0.5,2,0,2,1,208.08721174004194,197.4487234042553,202.76796757214862
2012-01-06,1610612762,1610612763,2011,94.0,85.0,179.0,92.25,98.95,95.4,97.85,6,3,3,0.5,6,3,3,0.5,3,0,2,1,198.64958333333334,196.58465608465607,197.61711970899472
2012-01-06,1610612756,1610612757,2011,102.0,77.0,179.0,98.75,104.45,95.75,93.35,6,2,4,0.333,6,5,1,0.833,1,1,4,1,209.1725,191.29962264150942,200.23606132075471
2012-01-06,1610612747,1610612744,2011,97.0,90.0,187.0,95.25,95.05,98.3,101.85,8,4,4,0.5,6,2,4,0.333,4,0,2,0,195.37964841108857,206.87755102040816,201.12859971574835
2012-01-05,1610612737,1610612748,2011,109.0,116.0,225.0,88.05,88.05000000000003,98.85,93.15,6,4,2,0.667,7,6,1,0.857,2,2,3,3,187.79312668463612,194.10431034482758,190.94871851473187
2012-01-05,1610612759,1610612742,2011,93.0,71.0,164.0,99.4,97.95,95.25,94.75,6,4,2,0.667,7,3,4,0.429,4,0,3,0,199.80961538461537,194.26696329254727,197.0382893385813
2012-01-05,1610612758,1610612749,2011,103.0,100.0,203.0,98.35,105.2,93.95,93.6,7,2,5,0.28600000000000003,5,2,3,0.4,2,0,2,0,202.3673469387755,185.06382978723406,193.71558836300477
2012-01-05,1610612757,1610612747,2011,107.0,96.0,203.0,94.75,93.95,94.75,94.35,5,4,1,0.8,7,4,3,0.5710000000000001,3,1,4,0,191.20038461538462,195.29827586206898,193.2493302387268
2012-01-04,1610612761,1610612739,2011,92.0,77.0,169.0,94.5,97.65,98.3,97.35,5,2,3,0.4,5,3,2,0.6,0,2,2,1,203.03401360544217,197.78521739130434,200.40961549837326
2012-01-04,1610612753,1610612764,2011,103.0,85.0,188.0,93.05,90.5,95.9,102.55,6,4,2,0.667,5,0,5,0.0,3,1,0,0,190.75942684766216,199.67000000000002,195.21471342383109
2012-01-04,1610612738,1610612751,2011,89.0,70.0,159.0,95.15,92.05,91.55,102.7,6,3,3,0.5,6,1,5,0.16699999999999998,2,1,0,1,187.64632867132866,193.3276595744681,190.48699412289838
2012-01-04,1610612752,1610612766,2011,110.0,118.0,228.0,100.5,99.75,91.35,99.2,5,2,3,0.4,5,1,4,0.2,1,1,1,0,208.780912364946,189.42729591836735,199.10410414165668
2012-01-04,1610612748,1610612754,2011,118.0,83.0,201.0,97.8,93.35,95.7,96.7,6,5,1,0.833,5,4,1,0.8,2,3,2,2,194.0615137346581,198.55514128728413,196.3083275109711
2012-01-04,1610612765,1610612741,2011,83.0,99.0,182.0,96.55,98.35,93.85,87.19999999999997,5,2,3,0.4,6,5,1,0.833,2,0,2,3,195.9723404255319,188.17543859649123,192.07388951101157
2012-01-04,1610612740,1610612755,2011,93.0,101.0,194.0,90.8,95.2,96.35,94.75,5,2,3,0.4,4,2,2,0.5,1,1,0,2,187.80509433962266,195.58089120835007,191.69299277398636
2012-01-04,1610612750,1610612763,2011,86.0,90.0,176.0,99.8,105.7,95.95,98.45,5,2,3,0.4,5,2,3,0.4,2,0,2,0,208.3854700854701,196.7658249158249,202.5756475006475
2012-01-04,1610612742,1610612756,2011,98.0,89.0,187.0,95.35,95.6,101.15,106.5,6,2,4,0.333,5,2,3,0.4,2,0,1,1,194.33055398530243,209.42382978723404,201.87719188626824
2012-01-04,1610612759,1610612744,2011,101.0,95.0,196.0,100.05,98.05,98.4,102.2,5,3,2,0.6,5,2,3,0.4,3,0,2,0,199.85392156862744,207.0014880952381,203.42770483193277
2012-01-04,1610612743,1610612758,2011,110.0,83.0,193.0,104.75,99.65,99.7,104.35,6,4,2,0.667,6,2,4,0.333,3,1,2,0,209.37584905660378,202.484268707483,205.9300588820434
2012-01-04,1610612746,1610612745,2011,117.0,89.0,206.0,99.35,101.9,105.0,101.85,4,2,2,0.5,5,2,3,0.4,1,1,2,0,200.625,207.07716836734693,203.85108418367346
2012-01-03,1610612739,1610612766,2011,115.0,101.0,216.0,97.25,97.2,90.2,98.15,4,2,2,0.5,4,1,3,0.25,1,1,1,0,197.57031943212067,189.1280937907078,193.34920661141422
2012-01-03,1610612741,1610612737,2011,76.0,74.0,150.0,94.85,88.0,89.5,88.9,5,4,1,0.8,5,4,1,0.8,1,3,2,2,188.51441102756894,188.12624356775302,188.32032729766098
2012-01-03,1610612763,1610612758,2011,113.0,96.0,209.0,95.85,98.1,99.75,103.2,4,1,3,0.25,5,2,3,0.4,1,0,2,0,196.65488850771868,202.4359531046461,199.5454208061824
2012-01-03,1610612760,1610612757,2011,93.0,103.0,196.0,101.05,99.05,94.1,94.25,6,5,1,0.833,4,3,1,0.75,3,2,3,0,204.6668233082707,191.13834379905808,197.90258355366439
2012-01-03,1610612762,1610612749,2011,85.0,73.0,158.0,93.95,100.5,94.6,93.7,5,2,3,0.4,4,2,2,0.5,2,0,2,0,199.08021276595744,185.35974815458098,192.2199804602692
2012-01-03,1610612747,1610612745,2011,108.0,99.0,207.0,94.35,94.85,106.2,101.5,6,3,3,0.5,4,2,2,0.5,3,0,2,0,195.20087719298243,207.11506730351715,201.1579722482498
2012-01-02,1610612756,1610612744,2011,102.0,91.0,193.0,101.75,107.25,99.8,103.55,4,1,3,0.25,4,2,2,0.5,0,1,2,0,209.5740338688667,207.16261398176292,208.36832392531483
2012-01-02,1610612738,1610612764,2011,100.0,92.0,192.0,95.2,91.95,96.0,103.25,5,2,3,0.4,4,0,4,0.0,1,1,0,0,187.6106951871658,199.77551020408163,193.6931026956237
2012-01-02,1610612751,1610612754,2011,94.0,108.0,202.0,91.25,101.25,95.85,96.4,5,1,4,0.2,4,3,1,0.75,0,1,2,1,193.23260869565217,198.51460584233695,195.87360726899456
2012-01-02,1610612752,1610612761,2011,85.0,90.0,175.0,101.05,100.35,95.0,100.3,4,2,2,0.5,4,1,3,0.25,1,1,0,1,209.15931372549022,203.32291666666669,206.24111519607845
2012-01-02,1610612748,1610612737,2011,92.0,100.0,192.0,98.3,92.9,88.75,89.1,5,5,0,1.0,4,3,1,0.75,2,3,2,1,194.09482758620692,188.08280922431868,191.0888184052628
2012-01-02,1610612765,1610612753,2011,89.0,78.0,167.0,97.05,99.2,93.25,90.3,4,1,3,0.25,5,4,1,0.8,1,0,3,1,196.31111593573598,191.01923076923077,193.66517335248338
2012-01-02,1610612750,1610612759,2011,106.0,96.0,202.0,99.25,107.25,100.45,98.3,4,1,3,0.25,4,3,1,0.75,1,0,3,0,208.440522875817,199.82432973189276,204.13242630385488
2012-01-02,1610612742,1610612760,2011,100.0,87.0,187.0,96.4,96.85,101.75,99.25,5,1,4,0.2,5,5,0,1.0,1,0,3,2,194.39626436781612,204.82142857142856,199.60884646962234
2012-01-02,1610612743,1610612749,2011,91.0,86.0,177.0,105.9,100.05,95.4,93.95,5,3,2,0.6,3,2,1,0.667,2,1,2,0,209.73584905660377,185.47007978723406,197.6029644219189
2012-01-02,1610612762,1610612740,2011,94.0,90.0,184.0,94.85,101.35,91.6,95.5,4,1,3,0.25,4,2,2,0.5,1,0,1,1,199.24695652173912,187.86115384615385,193.5540551839465
2012-01-01,1610612764,1610612738,2011,86.0,94.0,180.0,96.75,104.65,95.2,92.4,3,0,3,0.0,4,1,3,0.25,0,0,1,0,199.9643990929705,187.67483660130716,193.81961784713883
2012-01-01,1610612753,1610612761,2011,102.0,96.0,198.0,92.6,89.35,95.5,100.9,4,3,1,0.75,3,1,2,0.333,2,1,0,1,190.9264705882353,203.37943262411346,197.15295160617438
2012-01-01,1610612748,1610612766,2011,129.0,90.0,219.0,96.8,92.9,90.45,96.2,4,4,0,1.0,3,1,2,0.333,1,3,1,0,193.89246823956444,188.7832741792369,191.33787120940067
2012-01-01,1610612739,1610612751,2011,98.0,82.0,180.0,96.65,97.95,91.5,101.25,3,1,2,0.333,4,1,3,0.25,0,1,0,1,197.72146739130434,193.36934338952972,195.54540539041705
2012-01-01,1610612750,1610612742,2011,99.0,82.0,181.0,100.4,108.2,97.45,96.7,3,0,3,0.0,4,1,3,0.25,0,0,1,0,208.70777777777778,194.50833333333333,201.60805555555555
2012-01-01,1610612741,1610612763,2011,104.0,64.0,168.0,94.85,89.75,97.8,98.4,4,3,1,0.75,3,1,2,0.333,0,3,1,0,188.70207336523129,196.91684136967154,192.80945736745142
2012-01-01,1610612743,1610612747,2011,99.0,90.0,189.0,106.7,101.15,94.2,94.65,4,2,2,0.5,5,3,2,0.6,1,1,3,0,209.98584905660377,195.25904045828858,202.62244475744617
2012-01-01,1610612758,1610612740,2011,96.0,80.0,176.0,98.95,104.3,93.65,96.55,4,1,3,0.25,3,2,1,0.667,1,0,1,1,202.69126773049646,187.9978431372549,195.34455543387568
2012-01-01,1610612746,1610612757,2011,93.0,88.0,181.0,99.4,102.7,93.7,93.8,3,1,2,0.333,3,3,0,1.0,0,1,3,0,200.82114361702128,191.22996794871796,196.02555578286962
2011-12-31,1610612747,1610612743,2011,92.0,89.0,181.0,94.7,94.85,107.0,101.05,4,2,2,0.5,3,2,1,0.667,2,0,1,1,195.39030612244898,210.23076923076923,202.8105376766091
2011-12-31,1610612765,1610612754,2011,96.0,88.0,184.0,97.6,99.45,96.55,96.5,3,0,3,0.0,3,3,0,1.0,0,0,2,1,196.48692375886526,198.65244897959184,197.56968636922855
2011-12-31,1610612745,1610612737,2011,95.0,84.0,179.0,106.1,101.15,88.69999999999997,90.1,3,1,2,0.333,3,3,0,1.0,1,0,2,1,207.37123226950354,188.16037735849056,197.76580481399705
2011-12-31,1610612760,1610612756,2011,107.0,97.0,204.0,101.4,99.25,102.3,106.85,4,4,0,1.0,3,1,2,0.333,2,2,0,1,204.8306818181818,209.65150842945874,207.2410951238203
2011-12-31,1610612758,1610612752,2011,92.0,114.0,206.0,99.0,103.45,100.65,101.45,3,1,2,0.333,3,1,2,0.333,1,0,1,0,202.63829787234044,209.1616666666667,205.89998226950357
2011-12-31,1610612759,1610612762,2011,104.0,89.0,193.0,100.1,99.2,95.8,101.65,3,2,1,0.667,3,1,2,0.333,2,0,1,0,199.9004081632653,199.30634427684117,199.60337622005324
2011-12-31,1610612744,1610612755,2011,79.0,107.0,186.0,102.75,103.2,95.85,95.05,3,2,1,0.667,3,1,2,0.333,2,0,0,1,207.36945921985816,195.67287234042553,201.52116578014184
2011-12-30,1610612766,1610612753,2011,79.0,100.0,179.0,92.2,96.5,92.9,91.05,2,1,1,0.5,3,2,1,0.667,1,0,2,0,188.90806159420288,191.07442977190874,189.9912456830558
2011-12-30,1610612754,1610612739,2011,98.0,91.0,189.0,97.0,96.95,95.6,98.6,2,2,0,1.0,2,1,1,0.5,1,1,0,1,198.75916666666666,197.85069444444446,198.30493055555556
2011-12-30,1610612738,1610612765,2011,96.0,85.0,181.0,94.45,92.3,98.4,101.2,3,0,3,0.0,2,0,2,0.0,0,0,0,0,187.74777777777777,196.60371376811594,192.17574577294687
2011-12-30,1610612737,1610612751,2011,105.0,98.0,203.0,87.94999999999997,90.05,90.85,100.75,2,2,0,1.0,3,1,2,0.333,1,1,0,1,188.02521770682148,193.2721920289855,190.6487048679035
2011-12-30,1610612763,1610612745,2011,113.0,93.0,206.0,97.2,98.55,106.6,100.8,2,0,2,0.0,2,1,1,0.5,0,0,1,0,196.83048433048432,207.42164855072463,202.12606644060446
2011-12-30,1610612740,1610612756,2011,78.0,93.0,171.0,93.8,96.55,102.4,107.95,2,2,0,1.0,2,0,2,0.0,1,1,0,0,188.14865946378552,210.09909297052155,199.12387621715354
2011-12-30,1610612750,1610612748,2011,101.0,103.0,204.0,100.4,106.8,96.55,92.35,2,0,2,0.0,3,3,0,1.0,0,0,1,2,208.7512471655329,193.78947368421052,201.2703604248717
2011-12-30,1610612749,1610612764,2011,102.0,81.0,183.0,94.75,94.55,98.65,105.9,2,1,1,0.5,2,0,2,0.0,1,0,0,0,185.47146739130434,200.16805555555555,192.81976147342993
2011-12-30,1610612742,1610612761,2011,99.0,86.0,185.0,98.6,96.7,95.7,102.1,3,0,3,0.0,2,1,1,0.5,0,0,0,1,194.59322033898303,203.57971014492756,199.0864652419553
2011-12-30,1610612762,1610612755,2011,102.0,99.0,201.0,96.15,101.8,95.85,95.5,2,0,2,0.0,2,1,1,0.5,0,0,0,1,199.29160997732427,195.62140175219025,197.45650586475728
2011-12-30,1610612746,1610612741,2011,101.0,114.0,215.0,99.35,101.7,93.35,89.15,2,1,1,0.5,3,2,1,0.667,0,1,0,2,200.65625,188.46444805194807,194.56034902597403
2011-12-29,1610612753,1610612751,2011,94.0,78.0,172.0,92.95,91.4,91.85,100.75,2,1,1,0.5,2,1,1,0.5,1,0,0,1,191.23795918367347,193.50069380203513,192.3693264928543
2011-12-29,1610612745,1610612759,2011,105.0,85.0,190.0,106.05,100.45,100.65,98.85,1,0,1,0.0,2,2,0,1.0,0,0,2,0,207.57169287696576,199.9945833333333,203.78313810514953
2011-12-29,1610612760,1610612742,2011,104.0,102.0,206.0,101.5,98.6,97.6,95.7,3,3,0,1.0,2,0,2,0.0,1,2,0,0,204.82175925925924,194.4860774818402,199.65391837054972
2011-12-29,1610612758,1610612741,2011,98.0,108.0,206.0,100.55,104.0,92.35,88.45,2,1,1,0.5,2,1,1,0.5,1,0,0,1,202.58302497687328,188.3,195.44151248843664
2011-12-29,1610612757,1610612743,2011,111.0,102.0,213.0,93.35,93.5,106.85,100.0,2,2,0,1.0,2,2,0,1.0,2,0,1,1,191.02879901960785,210.171568627451,200.60018382352942
2011-12-29,1610612747,1610612752,2011,99.0,82.0,181.0,95.05,96.75,101.3,101.5,3,1,2,0.333,2,1,1,0.5,1,0,1,0,195.52634508348797,209.41921768707482,202.4727813852814
2011-12-28,1610612761,1610612754,2011,85.0,90.0,175.0,96.15,102.4,96.4,97.65,1,1,0,1.0,1,1,0,1.0,0,1,1,0,203.88112858464385,198.99447278911566,201.43780068687977
2011-12-28,1610612766,1610612748,2011,95.0,96.0,191.0,91.85,97.25,95.8,92.45,1,1,0,1.0,2,2,0,1.0,1,0,1,1,188.9104995374653,193.79887218045113,191.35468585895822
2011-12-28,1610612737,1610612764,2011,101.0,83.0,184.0,87.3,90.05,98.3,106.4,1,1,0,1.0,1,0,1,0.0,0,1,0,0,188.0710321864595,200.36973995271867,194.2203860695891
2011-12-28,1610612765,1610612739,2011,89.0,105.0,194.0,99.6,101.05,95.2,98.8,1,0,1,0.0,1,0,1,0.0,0,0,0,0,196.68061979648473,197.92897727272725,197.304798534606
2011-12-28,1610612763,1610612760,2011,95.0,98.0,193.0,96.5,97.75,101.45,98.55,1,0,1,0.0,2,2,0,1.0,0,0,1,1,196.8681917211329,204.92744107744107,200.89781639928697
2011-12-28,1610612740,1610612738,2011,97.0,78.0,175.0,93.7,97.2,94.4,92.45,1,1,0,1.0,2,0,2,0.0,0,1,0,0,188.26409313725492,187.86150943396228,188.0628012856086
2011-12-28,1610612759,1610612746,2011,115.0,90.0,205.0,99.5,99.35,100.95,101.0,1,1,0,1.0,1,1,0,1.0,1,0,0,1,199.95131802721087,200.62234042553192,200.2868292263714
2011-12-28,1610612743,1610612762,2011,117.0,100.0,217.0,107.15,99.5,96.15,101.85,1,1,0,1.0,1,0,1,0.0,0,1,0,0,210.13433458489777,199.10347222222222,204.61890340356
2011-12-28,1610612756,1610612755,2011,83.0,103.0,186.0,103.65,107.65,95.75,96.85,1,0,1,0.0,1,0,1,0.0,0,0,0,0,210.32847222222222,195.71787234042552,203.02317228132387
2011-12-28,1610612744,1610612752,2011,92.0,78.0,170.0,103.45,104.9,102.15,101.85,2,1,1,0.5,1,1,0,1.0,1,0,1,0,207.75531914893617,209.80208333333334,208.77870124113474
2011-12-27,1610612751,1610612737,2011,70.0,106.0,176.0,93.45,100.35,87.1,92.25,1,1,0,1.0,0,0,0,0.0,0,1,0,0,193.6903073286052,188.18042986425337,190.93536859642927
2011-12-27,1610612748,1610612738,2011,115.0,107.0,222.0,94.9,91.65,93.1,91.55,1,1,0,1.0,1,0,1,0.0,0,1,0,0,193.5625,187.5276923076923,190.54509615384615
2011-12-27,1610612749,1610612750,2011,98.0,95.0,193.0,94.95,93.5,99.5,106.9,1,0,1,0.0,1,0,1,0.0,0,0,0,0,185.36180555555555,208.93483302411875,197.14831928983716
2011-12-27,1610612757,1610612758,2011,101.0,79.0,180.0,93.2,94.1,101.2,105.55,1,1,0,1.0,1,1,0,1.0,1,0,1,0,191.14958333333334,202.84782608695653,196.99870471014492
2011-12-27,1610612747,1610612762,2011,96.0,71.0,167.0,94.5,97.5,97.65,103.15,2,0,2,0.0,0,0,0,0.0,0,0,0,0,195.797052154195,199.43924349881797,197.6181478265065
2011-12-26,1610612764,1610612751,2011,84.0,90.0,174.0,97.9,106.65,93.55,101.05,0,0,0,0.0,0,0,0,0.0,0,0,0,0,200.63539651837525,193.90700483091788,197.27120067464656
2011-12-26,1610612766,1610612749,2011,96.0,95.0,191.0,91.9,97.1,94.45,94.2,0,0,0,0.0,0,0,0,0.0,0,0,0,0,188.91304347826087,185.32789598108747,187.12046972967417
2011-12-26,1610612753,1610612745,2011,104.0,95.0,199.0,92.0,90.75,106.45,99.6,1,0,1,0.0,0,0,0,0.0,0,0,0,0,191.1326530612245,207.70212765957447,199.41739036039948
2011-12-26,1610612739,1610612761,2011,96.0,104.0,200.0,94.15,98.35,95.7,102.25,0,0,0,0.0,0,0,0,0.0,0,0,0,0,197.8737911025145,203.92364066193852,200.8987158822265
2011-12-26,1610612754,1610612765,2011,91.0,79.0,170.0,96.5,99.2,100.35,101.7,0,0,0,0.0,0,0,0,0.0,0,0,0,0,199.30785931393834,196.92482269503546,198.1163410044869
2011-12-26,1610612750,1610612760,2011,100.0,104.0,204.0,99.75,107.1,102.25,99.15,0,0,0,0.0,1,1,0,1.0,0,0,1,0,208.98011363636363,204.93518518518516,206.9576494107744
2011-12-26,1610612742,1610612743,2011,93.0,115.0,208.0,97.85,94.55,106.3,100.0,1,0,1,0.0,0,0,0,0.0,0,0,0,0,194.3756157635468,210.1227659574468,202.2491908604968
2011-12-26,1610612759,1610612763,2011,95.0,82.0,177.0,100.3,100.05,96.85,98.1,0,0,0,0.0,0,0,0,0.0,0,0,0,0,200.19791666666666,197.055123936367,198.62652030151685
2011-12-26,1610612756,1610612740,2011,84.0,85.0,169.0,103.85,108.95,93.3,97.25,0,0,0,0.0,0,0,0,0.0,0,0,0,0,210.748463356974,188.47625,199.612356678487
2011-12-26,1610612758,1610612747,2011,100.0,91.0,191.0,101.3,106.3,94.75,96.75,0,0,0,0.0,1,0,1,0.0,0,0,0,0,202.95676328502415,195.83680555555554,199.39678442028986
2011-12-26,1610612757,1610612755,2011,107.0,103.0,210.0,92.75,93.75,95.7,95.5,0,0,0,0.0,0,0,0,0.0,0,0,0,0,190.969175170068,195.57338254450715,193.2712788572876
2011-12-26,1610612744,1610612741,2011,99.0,91.0,190.0,103.5,104.2,92.95,88.0,1,0,1,0.0,1,1,0,1.0,0,0,0,1,207.94056429232194,188.27760942760943,198.1090868599657
2011-12-25,1610612752,1610612738,2011,106.0,104.0,210.0,101.8,102.2,92.05,90.65,2,2,0,1.0,2,2,0,1.0,1,1,1,1,209.8242464539007,187.29843137254903,198.56133891322486
2011-12-25,1610612742,1610612748,2011,94.0,105.0,199.0,97.8,93.4,93.75,91.25,2,0,2,0.0,2,1,1,0.5,0,0,1,0,194.34022556390977,193.49951298701296,193.91986927546137
2011-12-25,1610612747,1610612741,2011,87.0,88.0,175.0,94.9,97.1,93.65,88.6,2,0,2,0.0,2,2,0,1.0,0,0,1,1,196.04225628930817,188.3958833619211,192.21906982561464
2011-12-25,1610612760,1610612753,2011,97.0,89.0,186.0,102.75,99.85,93.1,90.85,2,2,0,1.0,2,1,1,0.5,1,1,1,0,205.11460517120895,191.2138605442177,198.16423285771333
2011-12-25,1610612744,1610612746,2011,86.0,105.0,191.0,105.35,104.95,100.6,101.8,2,1,1,0.5,2,2,0,1.0,1,0,1,1,208.12293144208036,200.73913043478262,204.4310309384315
2011-12-22,1610612737,1610612766,2011,92.0,75.0,167.0,86.75,92.6,91.6,97.15,1,0,1,0.0,1,1,0,1.0,0,0,1,0,188.39807692307693,189.1306763285024,188.76437662578968
2011-12-22,1610612756,1610612743,2011,85.0,110.0,195.0,104.45,109.25,104.9,100.0,1,0,1,0.0,1,1,0,1.0,0,0,1,0,210.90410628019322,210.24337820234476,210.57374224126897
2011-12-21,1610612753,1610612748,2011,104.0,100.0,204.0,92.15,90.3,93.75,90.75,1,0,1,0.0,1,1,0,1.0,0,0,1,0,191.05208333333334,193.3878968253968,192.21999007936506
2011-12-21,1610612738,1610612761,2011,81.0,73.0,154.0,92.35,91.5,96.7,103.55,1,1,0,1.0,1,0,1,0.0,0,1,0,0,187.6498599439776,204.49081237911025,196.07033616154393
2011-12-21,1610612752,1610612751,2011,88.0,82.0,170.0,101.7,102.9,94.2,102.15,1,1,0,1.0,1,0,1,0.0,0,1,0,0,210.28215579710144,194.17777777777778,202.2299667874396
2011-12-21,1610612740,1610612763,2011,95.0,80.0,175.0,92.8,97.7,97.5,97.4,1,1,0,1.0,1,0,1,0.0,0,1,0,0,188.59659574468083,197.2684766214178,192.9325361830493
2011-12-21,1610612749,1610612750,2011,84.0,85.0,169.0,95.75,94.45,100.3,108.05,1,0,1,0.0,1,1,0,1.0,0,0,1,0,185.48597678916826,209.4513081395349,197.46864246435157
2011-12-21,1610612759,1610612745,2011,97.0,95.0,192.0,100.9,100.2,106.25,99.2,1,0,1,0.0,1,1,0,1.0,0,0,1,0,200.29543439716312,207.91803675048357,204.10673557382336
2011-12-21,1610612762,1610612757,2011,92.0,89.0,181.0,98.1,103.85,92.4,93.7,1,0,1,0.0,1,1,0,1.0,0,0,1,0,199.65111218568666,191.06469821971342,195.35790520270004
2011-12-21,1610612746,1610612747,2011,108.0,103.0,211.0,100.5,101.8,94.55,96.25,1,1,0,1.0,1,0,1,0.0,0,1,0,0,200.61135265700483,195.87093536732237,198.2411440121636
2011-12-20,1610612755,1610612764,2011,101.0,94.0,195.0,95.9,95.8,98.55,107.4,1,1,0,1.0,1,0,1,0.0,0,1,0,0,195.57985803016857,200.72628458498025,198.1530713075744
2011-12-20,1610612739,1610612765,2011,89.0,90.0,179.0,93.95,98.6,101.05,102.8,1,1,0,1.0,1,0,1,0.0,0,1,0,0,198.04446640316206,197.07785299806577,197.56115970061393
2011-12-20,1610612741,1610612754,2011,93.0,85.0,178.0,93.85,88.95,96.25,99.15,1,1,0,1.0,1,0,1,0.0,0,1,0,0,188.4979035639413,199.52171985815602,194.00981171104866
2011-12-20,1610612760,1610612742,2011,87.0,83.0,170.0,103.7,101.2,98.25,93.9,1,1,0,1.0,1,0,1,0.0,0,1,0,0,205.45477207977208,194.55645933014353,200.0056157049578
2011-12-20,1610612743,1610612756,2011,127.0,110.0,237.0,105.1,99.55,103.6,107.65,0,0,0,0.0,0,0,0,0.0,0,0,0,0,209.9871339840284,210.62203557312253,210.30458477857547
2011-12-20,1610612758,1610612744,2011,95.0,91.0,186.0,101.6,107.9,105.3,104.9,1,0,1,0.0,1,1,0,1.0,0,0,1,0,203.12747035573125,208.3671497584541,205.74731005709268
2011-12-19,1610612766,1610612737,2011,79.0,77.0,156.0,91.85,98.35,88.35,94.35,0,0,0,0.0,0,0,0,0.0,0,0,0,0,189.5222222222222,188.70784313725488,189.11503267973853
2011-12-19,1610612757,1610612762,2011,110.0,90.0,200.0,92.45,93.0,98.4,103.05,0,0,0,0.0,0,0,0,0.0,0,0,0,0,190.98093971631204,199.6427865612648,195.31186313878842
2011-12-19,1610612747,1610612746,2011,95.0,114.0,209.0,95.3,94.65,100.2,102.2,0,0,0,0.0,0,0,0,0.0,0,0,0,0,195.75736497545006,200.53333333333333,198.14534915439168
2011-12-18,1610612761,1610612738,2011,75.0,76.0,151.0,97.75,104.25,93.9,92.6,0,0,0,0.0,0,0,0,0.0,0,0,0,0,205.06620553359681,188.00142857142856,196.5338170525127
2011-12-18,1610612748,1610612753,2011,118.0,85.0,203.0,92.55,90.15,92.75,88.7,0,0,0,0.0,0,0,0,0.0,0,0,0,0,193.31565656565658,190.9558953900709,192.13577597786374
2011-12-18,1610612742,1610612760,2011,92.0,106.0,198.0,98.7,93.05,104.4,101.9,0,0,0,0.0,0,0,0,0.0,0,0,0,0,194.52873376623376,205.519412191582,200.0240729789079
2011-12-17,1610612751,1610612752,2011,83.0,92.0,175.0,94.75,102.05,102.95,104.7,0,0,0,0.0,0,0,0,0.0,0,0,0,0,194.38737373737374,210.6281221091582,202.50774792326598
2011-12-17,1610612745,1610612759,2011,101.0,87.0,188.0,105.95,99.5,102.15,100.9,0,0,0,0.0,0,0,0,0.0,0,0,0,0,208.0963438735178,200.41489361702128,204.25561874526954
2011-12-17,1610612750,1610612749,2011,117.0,96.0,213.0,98.4,107.75,93.75,92.95,0,0,0,0.0,0,0,0,0.0,0,0,0,0,209.40277090549233,185.21146245059288,197.3071166780426
2011-12-17,1610612744,1610612758,2011,107.0,96.0,203.0,103.9,104.85,103.15,107.3,0,0,0,0.0,0,0,0,0.0,0,0,0,0,208.42144268774703,203.14848484848486,205.78496376811594
2011-12-16,1610612754,1610612741,2011,86.0,95.0,181.0,97.7,99.8,93.75,88.75,0,0,0,0.0,0,0,0,0.0,0,0,0,0,199.72916666666669,188.56303418803418,194.14610042735043
2011-12-16,1610612764,1610612755,2011,78.0,103.0,181.0,99.8,107.05,95.95,96.6,0,0,0,0.0,0,0,0,0.0,0,0,0,0,200.92290192113245,195.73143115942028,198.32716654027638
2011-12-16,1610612765,1610612739,2011,87.0,91.0,178.0,101.95,104.05,93.9,99.75,0,0,0,0.0,0,0,0,0.0,0,0,0,0,197.3320158102767,198.3124368048534,197.82222630756505
2011-12-16,1610612763,1610612740,2011,90.0,97.0,187.0,98.3,97.0,92.75,97.25,0,0,0,0.0,0,0,0,0.0,0,0,0,0,197.36769230769232,188.63373860182372,193.00071545475802
2019-12-02,1610612766,1610612756,2019,104.0,109.0,213.0,99.45,97.7,106.25,103.85,21,8,13,0.381,18,8,10,0.444,4,4,5,3,194.96,212.88,203.92000000000002
2019-12-02,1610612755,1610612762,2019,103.0,94.0,197.0,97.85,106.0,95.55,106.55,20,14,6,0.7,20,12,8,0.6,9,5,8,4,207.68,200.2,203.94
2019-12-02,1610612737,1610612744,2019,104.0,79.0,183.0,96.35,95.7,107.5,105.85,20,4,16,0.2,21,4,17,0.19,2,2,2,2,199.44,199.04,199.24
2019-12-02,1610612763,1610612754,2019,104.0,117.0,221.0,98.25,97.5,92.05,92.25,19,6,13,0.316,19,12,7,0.632,3,3,9,3,193.96,187.28,190.62
2019-12-02,1610612749,1610612752,2019,132.0,88.0,220.0,99.8,108.15,101.2,97.2,20,17,3,0.85,20,4,16,0.2,8,9,3,1,200.48,200.28,200.38
2019-12-02,1610612758,1610612741,2019,106.0,113.0,219.0,97.75,101.5,94.0,91.0,18,8,10,0.444,20,6,14,0.3,5,3,3,3,207.08,185.44,196.26
2019-12-01,1610612751,1610612748,2019,106.0,109.0,215.0,96.7,98.4,97.25,95.5,19,10,9,0.526,18,13,5,0.722,6,4,8,5,196.96,195.0,195.98000000000002
2019-12-01,1610612752,1610612738,2019,104.0,113.0,217.0,101.2,97.2,99.65,105.5,19,4,15,0.211,18,13,5,0.722,3,1,7,6,200.28,195.08,197.68
2019-12-01,1610612750,1610612763,2019,107.0,115.0,222.0,110.05,111.2,98.25,97.5,18,10,8,0.556,18,5,13,0.278,3,7,3,2,209.4,193.96,201.68
2019-12-01,1610612747,1610612742,2019,100.0,114.0,214.0,107.3,114.65,104.45,102.7,19,17,2,0.895,18,12,6,0.667,9,8,6,6,219.28,213.0,216.14
2019-12-01,1610612765,1610612759,2019,132.0,98.0,230.0,100.85,105.95,107.75,96.55,19,6,13,0.316,20,7,13,0.35,5,1,5,2,206.0,204.12,205.06
2019-12-01,1610612740,1610612760,2019,104.0,107.0,211.0,100.45,104.8,101.8,103.4,19,6,13,0.316,18,7,11,0.389,4,2,6,1,200.8,210.36,205.58
2019-12-01,1610612753,1610612744,2019,100.0,96.0,196.0,96.55,103.5,107.5,105.85,18,7,11,0.389,20,4,16,0.2,6,1,2,2,203.64,199.04,201.33999999999997
2019-12-01,1610612761,1610612762,2019,130.0,110.0,240.0,100.6,99.2,95.55,106.55,18,14,4,0.778,19,12,7,0.632,8,6,8,4,206.0,200.2,203.1
2019-12-01,1610612746,1610612764,2019,150.0,125.0,275.0,109.85,106.5,94.7,91.35,20,14,6,0.7,17,6,11,0.353,11,3,3,3,214.36,193.0,203.68
2019-11-30,1610612758,1610612743,2019,100.0,97.0,197.0,97.75,101.5,109.2,110.3,17,7,10,0.412,16,13,3,0.813,4,3,8,5,207.08,217.04,212.06
2019-11-30,1610612755,1610612754,2019,119.0,116.0,235.0,97.85,106.0,92.05,92.25,19,13,6,0.684,18,12,6,0.667,8,5,9,3,207.68,187.28,197.48000000000002
2019-11-30,1610612745,1610612737,2019,158.0,111.0,269.0,112.7,109.85,96.35,95.7,18,12,6,0.667,19,4,15,0.211,7,5,2,2,216.24,199.44,207.84
2019-11-30,1610612749,1610612766,2019,137.0,96.0,233.0,99.8,108.15,99.45,97.7,19,16,3,0.8420000000000001,20,8,12,0.4,7,9,4,4,200.48,194.96,197.72
2019-11-29,1610612751,1610612738,2019,112.0,107.0,219.0,96.7,98.4,99.65,105.5,18,9,9,0.5,17,13,4,0.765,5,4,7,6,196.96,195.08,196.02
2019-11-29,1610612765,1610612766,2019,107.0,110.0,217.0,100.85,105.95,99.45,97.7,18,6,12,0.333,19,7,12,0.368,5,1,4,3,206.0,194.96,200.48000000000002
2019-11-29,1610612753,1610612761,2019,83.0,90.0,173.0,96.55,103.5,100.6,99.2,17,7,10,0.412,17,13,4,0.765,6,1,8,5,203.64,206.0,204.82
2019-11-29,1610612739,1610612749,2019,110.0,119.0,229.0,101.9,101.55,99.8,108.15,18,5,13,0.278,18,15,3,0.833,3,2,7,8,195.48,200.48,197.98
2019-11-29,1610612752,1610612755,2019,95.0,101.0,196.0,101.2,97.2,97.85,106.0,18,4,14,0.222,18,12,6,0.667,3,1,8,4,200.28,207.68,203.98000000000002
2019-11-29,1610612754,1610612737,2019,105.0,104.0,209.0,92.05,92.25,96.35,95.7,17,11,6,0.647,18,4,14,0.222,8,3,2,2,187.28,199.44,193.36
2019-11-29,1610612748,1610612744,2019,122.0,105.0,227.0,97.25,95.5,107.5,105.85,17,12,5,0.706,19,4,15,0.211,7,5,2,2,195.0,199.04,197.01999999999998
2019-11-29,1610612763,1610612762,2019,94.0,103.0,197.0,98.25,97.5,95.55,106.55,17,5,12,0.294,18,11,7,0.611,3,2,8,3,193.96,200.2,197.07999999999998
2019-11-29,1610612760,1610612740,2019,109.0,104.0,213.0,101.8,103.4,100.45,104.8,17,6,11,0.353,18,6,12,0.333,5,1,4,2,210.36,200.8,205.58
2019-11-29,1610612759,1610612746,2019,107.0,97.0,204.0,107.75,96.55,109.85,106.5,19,6,13,0.316,19,14,5,0.737,4,2,11,3,204.12,214.36,209.24
2019-11-29,1610612756,1610612742,2019,113.0,120.0,233.0,106.25,103.85,104.45,102.7,17,8,9,0.471,17,11,6,0.647,5,3,6,5,212.88,213.0,212.94
2019-11-29,1610612757,1610612741,2019,107.0,103.0,210.0,104.75,105.45,94.0,91.0,19,7,12,0.368,19,6,13,0.316,2,5,3,3,209.44,185.44,197.44
2019-11-29,1610612747,1610612764,2019,125.0,103.0,228.0,107.3,114.65,94.7,91.35,18,16,2,0.889,16,6,10,0.375,8,8,3,3,219.28,193.0,206.14
2019-11-27,1610612738,1610612751,2019,121.0,110.0,231.0,99.65,105.5,96.7,98.4,16,12,4,0.75,17,9,8,0.529,6,6,5,4,195.08,196.96,196.02
2019-11-27,1610612766,1610612765,2019,102.0,101.0,203.0,99.45,97.7,100.85,105.95,18,6,12,0.333,17,6,11,0.353,3,3,5,1,194.96,206.0,200.48000000000002
2019-11-27,1610612739,1610612753,2019,104.0,116.0,220.0,101.9,101.55,96.55,103.5,17,5,12,0.294,16,6,10,0.375,3,2,6,0,195.48,203.64,199.56
2019-11-27,1610612754,1610612762,2019,121.0,102.0,223.0,92.05,92.25,95.55,106.55,16,10,6,0.625,17,11,6,0.647,7,3,8,3,187.28,200.2,193.74
2019-11-27,1610612755,1610612758,2019,97.0,91.0,188.0,97.85,106.0,97.75,101.5,17,11,6,0.647,16,7,9,0.438,7,4,4,3,207.68,207.08,207.38
2019-11-27,1610612761,1610612752,2019,126.0,98.0,224.0,100.6,99.2,101.2,97.2,16,12,4,0.75,17,4,13,0.235,7,5,3,1,206.0,200.28,203.14
2019-11-27,1610612745,1610612748,2019,117.0,108.0,225.0,112.7,109.85,97.25,95.5,17,11,6,0.647,16,12,4,0.75,6,5,7,5,216.24,195.0,205.62
2019-11-27,1610612763,1610612746,2019,119.0,121.0,240.0,98.25,97.5,109.85,106.5,16,5,11,0.313,18,13,5,0.722,3,2,11,2,193.96,214.36,204.16000000000003
2019-11-27,1610612749,1610612737,2019,111.0,102.0,213.0,99.8,108.15,96.35,95.7,17,14,3,0.8240000000000001,17,4,13,0.235,6,8,2,2,200.48,199.44,199.95999999999998
2019-11-27,1610612759,1610612750,2019,101.0,113.0,214.0,107.75,96.55,110.05,111.2,18,6,12,0.333,17,9,8,0.529,4,2,3,6,204.12,209.4,206.76
2019-11-27,1610612756,1610612764,2019,132.0,140.0,272.0,106.25,103.85,94.7,91.35,16,8,8,0.5,15,5,10,0.333,5,3,3,2,212.88,193.0,202.94
2019-11-27,1610612740,1610612747,2019,110.0,114.0,224.0,100.45,104.8,107.3,114.65,17,6,11,0.353,17,15,2,0.882,4,2,8,7,200.8,219.28,210.04000000000002
2019-11-27,1610612757,1610612760,2019,136.0,119.0,255.0,104.75,105.45,101.8,103.4,18,6,12,0.333,16,6,10,0.375,1,5,5,1,209.44,210.36,209.9
2019-11-27,1610612744,1610612741,2019,104.0,90.0,194.0,107.5,105.85,94.0,91.0,18,3,15,0.16699999999999998,18,6,12,0.333,1,2,3,3,199.04,185.44,192.24
2019-11-26,1610612742,1610612746,2019,99.0,114.0,213.0,104.45,102.7,109.85,106.5,16,11,5,0.688,17,12,5,0.706,6,5,11,1,213.0,214.36,213.68
2019-11-26,1610612743,1610612764,2019,117.0,104.0,221.0,109.2,110.3,94.7,91.35,15,12,3,0.8,14,5,9,0.35700000000000004,7,5,3,2,217.04,193.0,205.01999999999998
2019-11-25,1610612739,1610612751,2019,106.0,108.0,214.0,101.9,101.55,96.7,98.4,16,5,11,0.313,16,8,8,0.5,3,2,5,3,195.48,196.96,196.22
2019-11-25,1610612765,1610612753,2019,103.0,88.0,191.0,100.85,105.95,96.55,103.5,16,5,11,0.313,15,6,9,0.4,4,1,6,0,206.0,203.64,204.82
2019-11-25,1610612754,1610612763,2019,126.0,114.0,240.0,92.05,92.25,98.25,97.5,15,9,6,0.6,15,5,10,0.333,6,3,3,2,187.28,193.96,190.62
2019-11-25,1610612737,1610612750,2019,113.0,125.0,238.0,96.35,95.7,110.05,111.2,16,4,12,0.25,16,8,8,0.5,2,2,3,5,199.44,209.4,204.42000000000002
2019-11-25,1610612738,1610612758,2019,103.0,102.0,205.0,99.65,105.5,97.75,101.5,15,11,4,0.733,15,7,8,0.467,5,6,4,3,195.08,207.08,201.08
2019-11-25,1610612748,1610612766,2019,117.0,100.0,217.0,97.25,95.5,99.45,97.7,15,11,4,0.733,17,6,11,0.353,6,5,3,3,195.0,194.96,194.98000000000002
2019-11-25,1610612761,1610612755,2019,101.0,96.0,197.0,100.6,99.2,97.85,106.0,15,11,4,0.733,16,11,5,0.688,6,5,7,4,206.0,207.68,206.84
2019-11-25,1610612741,1610612757,2019,94.0,117.0,211.0,94.0,91.0,104.75,105.45,17,6,11,0.353,17,5,12,0.294,3,3,1,4,185.44,209.44,197.44
2019-11-25,1610612749,1610612762,2019,122.0,118.0,240.0,99.8,108.15,95.55,106.55,16,13,3,0.813,16,11,5,0.688,5,8,8,3,200.48,200.2,200.33999999999997
2019-11-25,1610612759,1610612747,2019,104.0,114.0,218.0,107.75,96.55,107.3,114.65,17,6,11,0.353,16,14,2,0.875,4,2,8,6,204.12,219.28,211.7
2019-11-25,1610612744,1610612760,2019,97.0,100.0,197.0,107.5,105.85,101.8,103.4,17,3,14,0.17600000000000002,15,5,10,0.333,1,2,5,0,199.04,210.36,204.7
2019-11-24,1610612745,1610612742,2019,123.0,137.0,260.0,112.7,109.85,104.45,102.7,16,11,5,0.688,15,10,5,0.667,6,5,6,4,216.24,213.0,214.62
2019-11-24,1610612752,1610612751,2019,101.0,103.0,204.0,101.2,97.2,96.7,98.4,16,4,12,0.25,15,7,8,0.467,3,1,5,2,200.28,196.96,198.62
2019-11-24,1610612764,1610612758,2019,106.0,113.0,219.0,94.7,91.35,97.75,101.5,13,5,8,0.385,14,6,8,0.429,3,2,4,2,193.0,207.08,200.04000000000002
2019-11-24,1610612743,1610612756,2019,116.0,104.0,220.0,109.2,110.3,106.25,103.85,14,11,3,0.7859999999999999,15,8,7,0.5329999999999999,6,5,5,3,217.04,212.88,214.95999999999998
2019-11-24,1610612746,1610612740,2019,134.0,109.0,243.0,109.85,106.5,100.45,104.8,16,11,5,0.688,16,6,10,0.375,10,1,4,2,214.36,200.8,207.58
2019-11-23,1610612750,1610612756,2019,98.0,100.0,198.0,110.05,111.2,106.25,103.85,15,8,7,0.5329999999999999,14,7,7,0.5,3,5,5,2,209.4,212.88,211.14
2019-11-23,1610612766,1610612741,2019,115.0,116.0,231.0,99.45,97.7,94.0,91.0,16,6,10,0.375,16,5,11,0.313,3,3,3,2,194.96,185.44,190.2
2019-11-23,1610612754,1610612753,2019,111.0,106.0,217.0,92.05,92.25,96.55,103.5,14,8,6,0.5710000000000001,14,6,8,0.429,5,3,6,0,187.28,203.64,195.45999999999998
2019-11-23,1610612737,1610612761,2019,116.0,119.0,235.0,96.35,95.7,100.6,99.2,15,4,11,0.267,14,10,4,0.7140000000000001,2,2,6,4,199.44,206.0,202.72
2019-11-23,1610612752,1610612759,2019,104.0,111.0,215.0,101.2,97.2,107.75,96.55,15,4,11,0.267,16,5,11,0.313,3,1,4,1,200.28,204.12,202.2
2019-11-23,1610612755,1610612748,2019,113.0,86.0,199.0,97.85,106.0,97.25,95.5,15,10,5,0.667,14,11,3,0.7859999999999999,6,4,6,5,207.68,195.0,201.34
2019-11-23,1610612739,1610612757,2019,110.0,104.0,214.0,101.9,101.55,104.75,105.45,15,4,11,0.267,16,5,11,0.313,2,2,1,4,195.48,209.44,202.45999999999998
2019-11-23,1610612763,1610612747,2019,108.0,109.0,217.0,98.25,97.5,107.3,114.65,14,5,9,0.35700000000000004,15,13,2,0.867,3,2,8,5,193.96,219.28,206.62
2019-11-23,1610612749,1610612765,2019,104.0,90.0,194.0,99.8,108.15,100.85,105.95,15,12,3,0.8,15,5,10,0.333,4,8,4,1,200.48,206.0,203.24
2019-11-23,1610612762,1610612740,2019,128.0,120.0,248.0,95.55,106.55,100.45,104.8,15,10,5,0.667,15,6,9,0.4,7,3,4,2,200.2,200.8,200.5
2019-11-22,1610612765,1610612737,2019,128.0,103.0,231.0,100.85,105.95,96.35,95.7,14,4,10,0.28600000000000003,14,4,10,0.28600000000000003,3,1,2,2,206.0,199.44,202.72
2019-11-22,1610612764,1610612766,2019,125.0,118.0,243.0,94.7,91.35,99.45,97.7,12,4,8,0.333,15,6,9,0.4,2,2,3,3,193.0,194.96,193.98000000000002
2019-11-22,1610612751,1610612758,2019,116.0,97.0,213.0,96.7,98.4,97.75,101.5,14,6,8,0.429,13,6,7,0.462,4,2,4,2,196.96,207.08,202.02
2019-11-22,1610612755,1610612759,2019,115.0,104.0,219.0,97.85,106.0,107.75,96.55,14,9,5,0.643,15,5,10,0.333,5,4,4,1,207.68,204.12,205.9
2019-11-22,1610612741,1610612748,2019,108.0,116.0,224.0,94.0,91.0,97.25,95.5,15,5,10,0.333,13,10,3,0.769,3,2,6,4,185.44,195.0,190.22
2019-11-22,1610612760,1610612747,2019,127.0,130.0,257.0,101.8,103.4,107.3,114.65,14,5,9,0.35700000000000004,14,12,2,0.857,5,0,8,4,210.36,219.28,214.82
2019-11-22,1610612742,1610612739,2019,143.0,101.0,244.0,104.45,102.7,101.9,101.55,14,9,5,0.643,14,4,10,0.28600000000000003,5,4,2,2,213.0,195.48,204.24
2019-11-22,1610612743,1610612738,2019,96.0,92.0,188.0,109.2,110.3,99.65,105.5,13,10,3,0.769,14,11,3,0.7859999999999999,5,5,5,6,217.04,195.08,206.06
2019-11-22,1610612762,1610612744,2019,113.0,109.0,222.0,95.55,106.55,107.5,105.85,14,9,5,0.643,16,3,13,0.188,6,3,1,2,200.2,199.04,199.62
2019-11-22,1610612746,1610612745,2019,122.0,119.0,241.0,109.85,106.5,112.7,109.85,15,10,5,0.667,15,11,4,0.733,9,1,6,5,214.36,216.24,215.3
2019-11-21,1610612749,1610612757,2019,137.0,129.0,266.0,99.8,108.15,104.75,105.45,14,11,3,0.7859999999999999,15,5,10,0.333,3,8,1,4,200.48,209.44,204.95999999999998
2019-11-21,1610612756,1610612740,2019,121.0,124.0,245.0,106.25,103.85,100.45,104.8,13,7,6,0.5379999999999999,14,5,9,0.35700000000000004,5,2,4,1,212.88,200.8,206.84
2019-11-20,1610612755,1610612752,2019,109.0,104.0,213.0,97.85,106.0,101.2,97.2,13,8,5,0.615,14,4,10,0.28600000000000003,4,4,3,1,207.68,200.28,203.98000000000002
2019-11-20,1610612764,1610612759,2019,138.0,132.0,270.0,94.7,91.35,107.75,96.55,11,3,8,0.273,14,5,9,0.35700000000000004,1,2,4,1,193.0,204.12,198.56
2019-11-20,1610612737,1610612749,2019,127.0,135.0,262.0,96.35,95.7,99.8,108.15,13,4,9,0.308,13,10,3,0.769,2,2,3,7,199.44,200.48,199.95999999999998
2019-11-20,1610612751,1610612766,2019,101.0,91.0,192.0,96.7,98.4,99.45,97.7,13,5,8,0.385,14,6,8,0.429,3,2,3,3,196.96,194.96,195.96
2019-11-20,1610612748,1610612739,2019,124.0,100.0,224.0,97.25,95.5,101.9,101.55,12,9,3,0.75,13,4,9,0.308,5,4,2,2,195.0,195.48,195.24
2019-11-20,1610612761,1610612753,2019,113.0,97.0,210.0,100.6,99.2,96.55,103.5,13,9,4,0.6920000000000001,13,6,7,0.462,5,4,6,0,206.0,203.64,204.82
2019-11-20,1610612742,1610612744,2019,142.0,94.0,236.0,104.45,102.7,107.5,105.85,13,8,5,0.615,15,3,12,0.2,4,4,1,2,213.0,199.04,206.01999999999998
2019-11-20,1610612741,1610612765,2019,109.0,89.0,198.0,94.0,91.0,100.85,105.95,14,4,10,0.28600000000000003,13,4,9,0.308,2,2,3,1,185.44,206.0,195.72
2019-11-20,1610612750,1610612762,2019,95.0,103.0,198.0,110.05,111.2,95.55,106.55,14,8,6,0.5710000000000001,13,8,5,0.615,3,5,6,2,209.4,200.2,204.8
2019-11-20,1610612743,1610612745,2019,105.0,95.0,200.0,109.2,110.3,112.7,109.85,12,9,3,0.75,14,11,3,0.7859999999999999,4,5,6,5,217.04,216.24,216.64
2019-11-20,1610612746,1610612738,2019,107.0,104.0,211.0,109.85,106.5,99.65,105.5,14,9,5,0.643,13,11,2,0.846,8,1,5,6,214.36,195.08,204.72000000000003
2019-11-19,1610612763,1610612744,2019,95.0,114.0,209.0,98.25,97.5,107.5,105.85,13,5,8,0.385,14,2,12,0.14300000000000002,3,2,1,1,193.96,199.04,196.5
2019-11-19,1610612740,1610612757,2019,115.0,104.0,219.0,100.45,104.8,104.75,105.45,13,4,9,0.308,14,5,9,0.35700000000000004,3,1,1,4,200.8,209.44,205.12
2019-11-19,1610612758,1610612756,2019,120.0,116.0,236.0,97.75,101.5,106.25,103.85,12,5,7,0.417,12,7,5,0.583,3,2,5,2,207.08,212.88,209.98000000000002
2019-11-19,1610612747,1610612760,2019,112.0,107.0,219.0,107.3,114.65,101.8,103.4,13,11,2,0.846,13,5,8,0.385,7,4,5,0,219.28,210.36,214.82
2019-11-18,1610612752,1610612739,2019,123.0,105.0,228.0,101.2,97.2,101.9,101.55,13,3,10,0.231,12,4,8,0.333,2,1,2,2,200.28,195.48,197.88
2019-11-18,1610612751,1610612754,2019,86.0,115.0,201.0,96.7,98.4,92.05,92.25,12,5,7,0.417,13,7,6,0.5379999999999999,3,2,5,2,196.96,187.28,192.12
2019-11-18,1610612761,1610612766,2019,132.0,96.0,228.0,100.6,99.2,99.45,97.7,12,8,4,0.667,13,6,7,0.462,4,4,3,3,206.0,194.96,200.48000000000002
2019-11-18,1610612741,1610612749,2019,101.0,115.0,216.0,94.0,91.0,99.8,108.15,13,4,9,0.308,12,9,3,0.75,2,2,3,6,185.44,200.48,192.95999999999998
2019-11-18,1610612745,1610612757,2019,132.0,108.0,240.0,112.7,109.85,104.75,105.45,13,10,3,0.769,13,5,8,0.385,5,5,1,4,216.24,209.44,212.84
2019-11-18,1610612742,1610612759,2019,117.0,110.0,227.0,104.45,102.7,107.75,96.55,12,7,5,0.583,13,5,8,0.385,3,4,4,1,213.0,204.12,208.56
2019-11-18,1610612756,1610612738,2019,85.0,99.0,184.0,106.25,103.85,99.65,105.5,11,7,4,0.636,12,10,2,0.833,5,2,5,5,212.88,195.08,203.98000000000002
2019-11-18,1610612762,1610612750,2019,102.0,112.0,214.0,95.55,106.55,110.05,111.2,12,8,4,0.667,13,7,6,0.5379999999999999,6,2,3,4,200.2,209.4,204.8
2019-11-18,1610612746,1610612760,2019,90.0,88.0,178.0,109.85,106.5,101.8,103.4,13,8,5,0.615,12,5,7,0.417,7,1,5,0,214.36,210.36,212.36
2019-11-17,1610612739,1610612755,2019,95.0,114.0,209.0,101.9,101.55,97.85,106.0,11,4,7,0.364,12,7,5,0.583,2,2,4,3,195.48,207.68,201.57999999999998
2019-11-17,1610612758,1610612738,2019,100.0,99.0,199.0,97.75,101.5,99.65,105.5,11,4,7,0.364,11,10,1,0.909,2,2,5,5,207.08,195.08,201.08
2019-11-17,1610612753,1610612764,2019,125.0,121.0,246.0,96.55,103.5,94.7,91.35,12,5,7,0.417,10,3,7,0.3,5,0,1,2,203.64,193.0,198.32
2019-11-17,1610612763,1610612743,2019,114.0,131.0,245.0,98.25,97.5,109.2,110.3,12,5,7,0.417,11,8,3,0.727,3,2,4,4,193.96,217.04,205.5
2019-11-17,1610612740,1610612744,2019,108.0,100.0,208.0,100.45,104.8,107.5,105.85,12,3,9,0.25,13,2,11,0.154,2,1,1,1,200.8,199.04,199.92000000000002
2019-11-17,1610612747,1610612737,2019,122.0,101.0,223.0,107.3,114.65,96.35,95.7,12,10,2,0.833,12,4,8,0.333,6,4,2,2,219.28,199.44,209.36
2019-11-16,1610612741,1610612751,2019,111.0,117.0,228.0,94.0,91.0,96.7,98.4,12,4,8,0.333,11,4,7,0.364,2,2,3,1,185.44,196.96,191.2
2019-11-16,1610612754,1610612749,2019,83.0,102.0,185.0,92.05,92.25,99.8,108.15,12,7,5,0.583,11,8,3,0.727,5,2,3,5,187.28,200.48,193.88
2019-11-16,1610612752,1610612766,2019,102.0,103.0,205.0,101.2,97.2,99.45,97.7,12,3,9,0.25,12,5,7,0.417,2,1,3,2,200.28,194.96,197.62
2019-11-16,1610612748,1610612740,2019,109.0,94.0,203.0,97.25,95.5,100.45,104.8,11,8,3,0.727,11,3,8,0.273,4,4,2,1,195.0,200.8,197.9
2019-11-16,1610612750,1610612745,2019,105.0,125.0,230.0,110.05,111.2,112.7,109.85,12,7,5,0.583,12,9,3,0.75,3,4,5,4,209.4,216.24,212.82
2019-11-16,1610612742,1610612761,2019,110.0,102.0,212.0,104.45,102.7,100.6,99.2,11,6,5,0.545,11,8,3,0.727,2,4,4,4,213.0,206.0,209.5
2019-11-16,1610612759,1610612757,2019,116.0,121.0,237.0,107.75,96.55,104.75,105.45,12,5,7,0.417,12,4,8,0.333,4,1,1,3,204.12,209.44,206.78
2019-11-16,1610612746,1610612737,2019,150.0,101.0,251.0,109.85,106.5,96.35,95.7,12,7,5,0.583,11,4,7,0.364,6,1,2,2,214.36,199.44,206.9
2019-11-15,1610612766,1610612765,2019,109.0,106.0,215.0,99.45,97.7,100.85,105.95,11,4,7,0.364,12,4,8,0.333,2,2,3,1,194.96,206.0,200.48000000000002
2019-11-15,1610612753,1610612759,2019,111.0,109.0,220.0,96.55,103.5,107.75,96.55,11,4,7,0.364,11,5,6,0.455,4,0,4,1,203.64,204.12,203.88
2019-11-15,1610612745,1610612754,2019,111.0,102.0,213.0,112.7,109.85,92.05,92.25,11,8,3,0.727,11,7,4,0.636,4,4,5,2,216.24,187.28,201.76
2019-11-15,1610612763,1610612762,2019,107.0,106.0,213.0,98.25,97.5,95.55,106.55,11,4,7,0.364,11,8,3,0.727,2,2,6,2,193.96,200.2,197.07999999999998
2019-11-15,1610612750,1610612764,2019,116.0,137.0,253.0,110.05,111.2,94.7,91.35,11,7,4,0.636,9,2,7,0.222,3,4,1,1,209.4,193.0,201.2
2019-11-15,1610612760,1610612755,2019,127.0,119.0,246.0,101.8,103.4,97.85,106.0,11,4,7,0.364,11,7,4,0.636,4,0,4,3,210.36,207.68,209.02
2019-11-15,1610612744,1610612738,2019,100.0,105.0,205.0,107.5,105.85,99.65,105.5,12,2,10,0.16699999999999998,10,9,1,0.9,1,1,5,4,199.04,195.08,197.06
2019-11-15,1610612747,1610612758,2019,99.0,97.0,196.0,107.3,114.65,97.75,101.5,11,9,2,0.818,10,4,6,0.4,5,4,2,2,219.28,207.08,213.18
2019-11-14,1610612739,1610612748,2019,97.0,108.0,205.0,101.9,101.55,97.25,95.5,10,4,6,0.4,10,7,3,0.7,2,2,4,3,195.48,195.0,195.24
2019-11-14,1610612752,1610612742,2019,106.0,103.0,209.0,101.2,97.2,104.45,102.7,11,2,9,0.182,10,6,4,0.6,1,1,2,4,200.28,213.0,206.64
2019-11-14,1610612749,1610612741,2019,124.0,115.0,239.0,99.8,108.15,94.0,91.0,10,7,3,0.7,11,4,7,0.364,2,5,2,2,200.48,185.44,192.95999999999998
2019-11-14,1610612740,1610612746,2019,132.0,127.0,259.0,100.45,104.8,109.85,106.5,10,2,8,0.2,11,7,4,0.636,1,1,6,1,200.8,214.36,207.58
2019-11-14,1610612756,1610612737,2019,128.0,112.0,240.0,106.25,103.85,96.35,95.7,10,6,4,0.6,10,4,6,0.4,4,2,2,2,212.88,199.44,206.16
2019-11-14,1610612743,1610612751,2019,101.0,93.0,194.0,109.2,110.3,96.7,98.4,10,7,3,0.7,10,4,6,0.4,3,4,3,1,217.04,196.96,207.0
2019-11-13,1610612766,1610612763,2019,117.0,119.0,236.0,99.45,97.7,98.25,97.5,10,4,6,0.4,10,3,7,0.3,2,2,2,1,194.96,193.96,194.46
2019-11-13,1610612753,1610612755,2019,112.0,97.0,209.0,96.55,103.5,97.85,106.0,10,3,7,0.3,10,7,3,0.7,3,0,4,3,203.64,207.68,205.66
2019-11-13,1610612738,1610612764,2019,140.0,133.0,273.0,99.65,105.5,94.7,91.35,9,8,1,0.889,8,2,6,0.25,4,4,1,1,195.08,193.0,194.04000000000002
2019-11-13,1610612745,1610612746,2019,102.0,93.0,195.0,112.7,109.85,109.85,106.5,10,7,3,0.7,10,7,3,0.7,3,4,6,1,216.24,214.36,215.3
2019-11-13,1610612750,1610612759,2019,129.0,114.0,243.0,110.05,111.2,107.75,96.55,10,6,4,0.6,10,5,5,0.5,2,4,4,1,209.4,204.12,206.76
2019-11-13,1610612747,1610612744,2019,120.0,94.0,214.0,107.3,114.65,107.5,105.85,10,8,2,0.8,11,2,9,0.182,4,4,1,1,219.28,199.04,209.16
2019-11-13,1610612757,1610612761,2019,106.0,114.0,220.0,104.75,105.45,100.6,99.2,11,4,7,0.364,10,7,3,0.7,1,3,4,3,209.44,206.0,207.72
2019-11-12,1610612754,1610612760,2019,111.0,85.0,196.0,92.05,92.25,101.8,103.4,10,6,4,0.6,10,4,6,0.4,4,2,4,0,187.28,210.36,198.82
2019-11-12,1610612755,1610612739,2019,98.0,97.0,195.0,97.85,106.0,101.9,101.55,9,6,3,0.667,9,4,5,0.444,3,3,2,2,207.68,195.48,201.57999999999998
2019-11-12,1610612748,1610612765,2019,117.0,108.0,225.0,97.25,95.5,100.85,105.95,9,6,3,0.667,11,4,7,0.364,3,3,3,1,195.0,206.0,200.5
2019-11-12,1610612741,1610612752,2019,120.0,102.0,222.0,94.0,91.0,101.2,97.2,10,3,7,0.3,10,2,8,0.2,1,2,1,1,185.44,200.28,192.86
2019-11-12,1610612743,1610612737,2019,121.0,125.0,246.0,109.2,110.3,96.35,95.7,9,7,2,0.778,9,3,6,0.333,3,4,2,1,217.04,199.44,208.24
2019-11-12,1610612756,1610612747,2019,115.0,123.0,238.0,106.25,103.85,107.3,114.65,9,6,3,0.667,9,7,2,0.778,4,2,4,3,212.88,219.28,216.07999999999998
2019-11-12,1610612762,1610612751,2019,119.0,114.0,233.0,95.55,106.55,96.7,98.4,10,7,3,0.7,9,4,5,0.444,5,2,3,1,200.2,196.96,198.57999999999998
2019-11-12,1610612758,1610612757,2019,107.0,99.0,206.0,97.75,101.5,104.75,105.45,9,3,6,0.333,10,4,6,0.4,1,2,1,3,207.08,209.44,208.26
2019-11-11,1610612765,1610612750,2019,114.0,120.0,234.0,100.85,105.95,110.05,111.2,10,4,6,0.4,9,5,4,0.556,3,1,2,3,206.0,209.4,207.7
2019-11-11,1610612738,1610612742,2019,116.0,106.0,222.0,99.65,105.5,104.45,102.7,8,7,1,0.875,9,6,3,0.667,3,4,2,4,195.08,213.0,204.04000000000002
2019-11-11,1610612759,1610612763,2019,109.0,113.0,222.0,107.75,96.55,98.25,97.5,9,5,4,0.556,9,2,7,0.222,4,1,2,0,204.12,193.96,199.04000000000002
2019-11-11,1610612740,1610612745,2019,116.0,122.0,238.0,100.45,104.8,112.7,109.85,9,2,7,0.222,9,6,3,0.667,1,1,3,3,200.8,216.24,208.52
2019-11-11,1610612744,1610612762,2019,108.0,122.0,230.0,107.5,105.85,95.55,106.55,10,2,8,0.2,9,6,3,0.667,1,1,5,1,199.04,200.2,199.62
2019-11-11,1610612746,1610612761,2019,98.0,88.0,186.0,109.85,106.5,100.6,99.2,9,6,3,0.667,9,7,2,0.778,5,1,4,3,214.36,206.0,210.18
2019-11-10,1610612750,1610612743,2019,98.0,100.0,198.0,110.05,111.2,109.2,110.3,8,5,3,0.625,8,6,2,0.75,2,3,3,3,209.4,217.04,213.22
2019-11-10,1610612753,1610612754,2019,102.0,109.0,211.0,96.55,103.5,92.05,92.25,9,3,6,0.333,9,5,4,0.556,3,0,4,1,203.64,187.28,195.45999999999998
2019-11-10,1610612755,1610612766,2019,114.0,106.0,220.0,97.85,106.0,99.45,97.7,8,5,3,0.625,9,4,5,0.444,2,3,2,2,207.68,194.96,201.32
2019-11-10,1610612760,1610612749,2019,119.0,121.0,240.0,101.8,103.4,99.8,108.15,9,4,5,0.444,9,6,3,0.667,4,0,2,4,210.36,200.48,205.42000000000002
2019-11-10,1610612752,1610612739,2019,87.0,108.0,195.0,101.2,97.2,101.9,101.55,9,2,7,0.222,8,3,5,0.375,1,1,2,1,200.28,195.48,197.88
2019-11-10,1610612756,1610612751,2019,138.0,112.0,250.0,106.25,103.85,96.7,98.4,8,5,3,0.625,8,4,4,0.5,3,2,3,1,212.88,196.96,204.92000000000002
2019-11-10,1610612757,1610612737,2019,124.0,113.0,237.0,104.75,105.45,96.35,95.7,9,3,6,0.333,8,3,5,0.375,0,3,2,1,209.44,199.44,204.44
2019-11-10,1610612747,1610612761,2019,104.0,113.0,217.0,107.3,114.65,100.6,99.2,8,7,1,0.875,8,6,2,0.75,4,3,4,2,219.28,206.0,212.64
2019-11-09,1610612759,1610612738,2019,115.0,135.0,250.0,107.75,96.55,99.65,105.5,8,5,3,0.625,7,6,1,0.857,4,1,3,3,204.12,195.08,199.60000000000002
2019-11-09,1610612766,1610612740,2019,110.0,115.0,225.0,99.45,97.7,100.45,104.8,8,4,4,0.5,8,1,7,0.125,2,2,1,0,194.96,200.8,197.88
2019-11-09,1610612741,1610612745,2019,94.0,117.0,211.0,94.0,91.0,112.7,109.85,9,3,6,0.333,8,5,3,0.625,1,2,3,2,185.44,216.24,200.84
2019-11-09,1610612763,1610612742,2019,122.0,138.0,260.0,98.25,97.5,104.45,102.7,8,2,6,0.25,8,5,3,0.625,2,0,2,3,193.96,213.0,203.48000000000002
2019-11-09,1610612760,1610612744,2019,114.0,108.0,222.0,101.8,103.4,107.5,105.85,8,3,5,0.375,9,2,7,0.222,3,0,1,1,210.36,199.04,204.7
2019-11-08,1610612754,1610612765,2019,112.0,106.0,218.0,92.05,92.25,100.85,105.95,8,4,4,0.5,9,4,5,0.444,3,1,3,1,187.28,206.0,196.64
2019-11-08,1610612753,1610612763,2019,118.0,86.0,204.0,96.55,103.5,98.25,97.5,8,2,6,0.25,7,2,5,0.28600000000000003,2,0,2,0,203.64,193.96,198.8
2019-11-08,1610612764,1610612739,2019,100.0,113.0,213.0,94.7,91.35,101.9,101.55,7,2,5,0.28600000000000003,7,2,5,0.28600000000000003,1,1,2,0,193.0,195.48,194.24
2019-11-08,1610612737,1610612758,2019,109.0,121.0,230.0,96.35,95.7,97.75,101.5,7,3,4,0.429,8,2,6,0.25,2,1,1,1,199.44,207.08,203.26
2019-11-08,1610612750,1610612744,2019,125.0,119.0,244.0,110.05,111.2,107.5,105.85,7,4,3,0.5710000000000001,8,2,6,0.25,1,3,1,1,209.4,199.04,204.22
2019-11-08,1610612740,1610612761,2019,104.0,122.0,226.0,100.45,104.8,100.6,99.2,7,1,6,0.14300000000000002,7,5,2,0.7140000000000001,1,0,4,1,200.8,206.0,203.4
2019-11-08,1610612742,1610612752,2019,102.0,106.0,208.0,104.45,102.7,101.2,97.2,7,5,2,0.7140000000000001,8,1,7,0.125,2,3,1,0,213.0,200.28,206.64
2019-11-08,1610612743,1610612755,2019,100.0,97.0,197.0,109.2,110.3,97.85,106.0,7,5,2,0.7140000000000001,7,5,2,0.7140000000000001,2,3,2,3,217.04,207.68,212.36
2019-11-08,1610612762,1610612749,2019,103.0,100.0,203.0,95.55,106.55,99.8,108.15,8,5,3,0.625,8,6,2,0.75,4,1,2,4,200.2,200.48,200.33999999999997
2019-11-08,1610612757,1610612751,2019,115.0,119.0,234.0,104.75,105.45,96.7,98.4,8,3,5,0.375,7,3,4,0.429,0,3,3,0,209.44,196.96,203.2
2019-11-08,1610612747,1610612748,2019,95.0,80.0,175.0,107.3,114.65,97.25,95.5,7,6,1,0.857,8,6,2,0.75,3,3,3,3,219.28,195.0,207.14
2019-11-07,1610612766,1610612738,2019,87.0,108.0,195.0,99.45,97.7,99.65,105.5,7,4,3,0.5710000000000001,6,5,1,0.833,2,2,3,2,194.96,195.08,195.02
2019-11-07,1610612759,1610612760,2019,121.0,112.0,233.0,107.75,96.55,101.8,103.4,7,4,3,0.5710000000000001,7,3,4,0.429,3,1,3,0,204.12,210.36,207.24
2019-11-07,1610612756,1610612748,2019,108.0,124.0,232.0,106.25,103.85,97.25,95.5,7,5,2,0.7140000000000001,7,5,2,0.7140000000000001,3,2,3,2,212.88,195.0,203.94
2019-11-07,1610612746,1610612757,2019,107.0,101.0,208.0,109.85,106.5,104.75,105.45,8,5,3,0.625,7,3,4,0.429,4,1,0,3,214.36,209.44,211.9
2019-11-06,1610612765,1610612752,2019,122.0,102.0,224.0,100.85,105.95,101.2,97.2,8,3,5,0.375,7,1,6,0.14300000000000002,2,1,1,0,206.0,200.28,203.14
2019-11-06,1610612754,1610612764,2019,121.0,106.0,227.0,92.05,92.25,94.7,91.35,7,3,4,0.429,6,2,4,0.333,2,1,1,1,187.28,193.0,190.14
2019-11-06,1610612737,1610612741,2019,93.0,113.0,206.0,96.35,95.7,94.0,91.0,6,3,3,0.5,8,2,6,0.25,2,1,1,1,199.44,185.44,192.44
2019-11-06,1610612761,1610612758,2019,124.0,120.0,244.0,100.6,99.2,97.75,101.5,6,4,2,0.667,7,2,5,0.28600000000000003,3,1,1,1,206.0,207.08,206.54000000000002
2019-11-06,1610612745,1610612744,2019,129.0,112.0,241.0,112.7,109.85,107.5,105.85,7,4,3,0.5710000000000001,7,2,5,0.28600000000000003,2,2,1,1,216.24,199.04,207.64
2019-11-06,1610612763,1610612750,2019,137.0,121.0,258.0,98.25,97.5,110.05,111.2,6,1,5,0.16699999999999998,6,4,2,0.667,1,0,1,3,193.96,209.4,201.68
2019-11-06,1610612742,1610612753,2019,107.0,106.0,213.0,104.45,102.7,96.55,103.5,6,4,2,0.667,7,2,5,0.28600000000000003,1,3,2,0,213.0,203.64,208.32
2019-11-06,1610612762,1610612755,2019,106.0,104.0,210.0,95.55,106.55,97.85,106.0,7,4,3,0.5710000000000001,6,5,1,0.833,3,1,2,3,200.2,207.68,203.94
2019-11-06,1610612746,1610612749,2019,124.0,129.0,253.0,109.85,106.5,99.8,108.15,7,5,2,0.7140000000000001,7,5,2,0.7140000000000001,4,1,2,3,214.36,200.48,207.42000000000002
2019-11-05,1610612766,1610612754,2019,122.0,120.0,242.0,99.45,97.7,92.05,92.25,6,3,3,0.5,6,3,3,0.5,1,2,2,1,194.96,187.28,191.12
2019-11-05,1610612739,1610612738,2019,113.0,119.0,232.0,101.9,101.55,99.65,105.5,6,2,4,0.333,5,4,1,0.8,2,0,3,1,195.48,195.08,195.28
2019-11-05,1610612737,1610612759,2019,108.0,100.0,208.0,96.35,95.7,107.75,96.55,5,2,3,0.4,6,4,2,0.667,1,1,3,1,199.44,204.12,201.78
2019-11-05,1610612741,1610612747,2019,112.0,118.0,230.0,94.0,91.0,107.3,114.65,7,2,5,0.28600000000000003,6,5,1,0.833,1,1,3,2,185.44,219.28,202.36
2019-11-05,1610612760,1610612753,2019,102.0,94.0,196.0,101.8,103.4,96.55,103.5,6,2,4,0.333,6,2,4,0.333,2,0,2,0,210.36,203.64,207.0
2019-11-05,1610612743,1610612748,2019,109.0,89.0,198.0,109.2,110.3,97.25,95.5,6,4,2,0.667,6,5,1,0.833,1,3,3,2,217.04,195.0,206.01999999999998
2019-11-04,1610612764,1610612765,2019,115.0,99.0,214.0,94.7,91.35,100.85,105.95,5,1,4,0.2,7,3,4,0.429,0,1,2,1,193.0,206.0,199.5
2019-11-04,1610612751,1610612740,2019,135.0,125.0,260.0,96.7,98.4,100.45,104.8,6,2,4,0.333,6,1,5,0.16699999999999998,2,0,1,0,196.96,200.8,198.88
2019-11-04,1610612763,1610612745,2019,100.0,107.0,207.0,98.25,97.5,112.7,109.85,5,1,4,0.2,6,3,3,0.5,1,0,2,1,193.96,216.24,205.10000000000002
2019-11-04,1610612750,1610612749,2019,106.0,134.0,240.0,110.05,111.2,99.8,108.15,5,4,1,0.8,6,4,2,0.667,1,3,2,2,209.4,200.48,204.94
2019-11-04,1610612756,1610612755,2019,114.0,109.0,223.0,106.25,103.85,97.85,106.0,6,4,2,0.667,5,5,0,1.0,2,2,2,3,212.88,207.68,210.28
2019-11-04,1610612744,1610612757,2019,127.0,118.0,245.0,107.5,105.85,104.75,105.45,6,1,5,0.16699999999999998,6,3,3,0.5,0,1,0,3,199.04,209.44,204.24
2019-11-03,1610612754,1610612741,2019,108.0,95.0,203.0,92.05,92.25,94.0,91.0,5,2,3,0.4,6,2,4,0.333,1,1,1,1,187.28,185.44,186.36
2019-11-03,1610612748,1610612745,2019,129.0,100.0,229.0,97.25,95.5,112.7,109.85,5,4,1,0.8,5,3,2,0.6,2,2,2,1,195.0,216.24,205.62
2019-11-03,1610612752,1610612758,2019,92.0,113.0,205.0,101.2,97.2,97.75,101.5,6,1,5,0.16699999999999998,6,1,5,0.16699999999999998,1,0,1,0,200.28,207.08,203.68
2019-11-03,1610612759,1610612747,2019,96.0,103.0,199.0,107.75,96.55,107.3,114.65,5,4,1,0.8,5,4,1,0.8,3,1,3,1,204.12,219.28,211.7
2019-11-03,1610612739,1610612742,2019,111.0,131.0,242.0,101.9,101.55,104.45,102.7,5,2,3,0.4,5,3,2,0.6,2,0,1,2,195.48,213.0,204.24
2019-11-03,1610612746,1610612762,2019,105.0,94.0,199.0,109.85,106.5,95.55,106.55,6,4,2,0.667,6,4,2,0.667,3,1,3,1,214.36,200.2,207.28
2019-11-02,1610612760,1610612740,2019,115.0,104.0,219.0,101.8,103.4,100.45,104.8,5,1,4,0.2,5,1,4,0.2,1,0,1,0,210.36,200.8,205.58
2019-11-02,1610612765,1610612751,2019,113.0,109.0,222.0,100.85,105.95,96.7,98.4,6,2,4,0.333,5,2,3,0.4,1,1,2,0,206.0,196.96,201.48000000000002
2019-11-02,1610612753,1610612743,2019,87.0,91.0,178.0,96.55,103.5,109.2,110.3,5,2,3,0.4,5,3,2,0.6,2,0,1,2,203.64,217.04,210.33999999999997
2019-11-02,1610612764,1610612750,2019,109.0,131.0,240.0,94.7,91.35,110.05,111.2,4,1,3,0.25,4,3,1,0.75,0,1,1,2,193.0,209.4,201.2
2019-11-02,1610612763,1610612756,2019,105.0,114.0,219.0,98.25,97.5,106.25,103.85,4,1,3,0.25,5,3,2,0.6,1,0,2,1,193.96,212.88,203.42000000000002
2019-11-02,1610612749,1610612761,2019,115.0,105.0,220.0,99.8,108.15,100.6,99.2,5,3,2,0.6,5,4,1,0.8,1,2,3,1,200.48,206.0,203.24
2019-11-02,1610612744,1610612766,2019,87.0,93.0,180.0,107.5,105.85,99.45,97.7,5,1,4,0.2,5,2,3,0.4,0,1,1,1,199.04,194.96,197.0
2019-11-02,1610612757,1610612755,2019,128.0,129.0,257.0,104.75,105.45,97.85,106.0,5,3,2,0.6,4,4,0,1.0,0,3,2,2,209.44,207.68,208.56
2019-11-01,1610612751,1610612745,2019,123.0,116.0,239.0,96.7,98.4,112.7,109.85,4,1,3,0.25,4,3,1,0.75,1,0,2,1,196.96,216.24,206.60000000000002
2019-11-01,1610612754,1610612739,2019,102.0,95.0,197.0,92.05,92.25,101.9,101.55,4,1,3,0.25,4,2,2,0.5,0,1,2,0,187.28,195.48,191.38
2019-11-01,1610612753,1610612749,2019,91.0,123.0,214.0,96.55,103.5,99.8,108.15,4,2,2,0.5,4,2,2,0.5,2,0,1,1,203.64,200.48,202.06
2019-11-01,1610612738,1610612752,2019,104.0,102.0,206.0,99.65,105.5,101.2,97.2,4,3,1,0.75,5,1,4,0.2,2,1,1,0,195.08,200.28,197.68
2019-11-01,1610612741,1610612765,2019,112.0,106.0,218.0,94.0,91.0,100.85,105.95,5,1,4,0.2,5,2,3,0.4,0,1,1,1,185.44,206.0,195.72
2019-11-01,1610612742,1610612747,2019,110.0,119.0,229.0,104.45,102.7,107.3,114.65,4,3,1,0.75,4,3,1,0.75,1,2,3,0,213.0,219.28,216.14
2019-11-01,1610612758,1610612762,2019,102.0,101.0,203.0,97.75,101.5,95.55,106.55,5,0,5,0.0,5,4,1,0.8,0,0,3,1,207.08,200.2,203.64
2019-11-01,1610612744,1610612759,2019,110.0,127.0,237.0,107.5,105.85,107.75,96.55,4,1,3,0.25,4,3,1,0.75,0,1,3,0,199.04,204.12,201.57999999999998
2019-10-31,1610612737,1610612748,2019,97.0,106.0,203.0,96.35,95.7,97.25,95.5,4,2,2,0.5,4,3,1,0.75,1,1,2,1,199.44,195.0,197.22
2019-10-31,1610612740,1610612743,2019,122.0,107.0,229.0,100.45,104.8,109.2,110.3,4,0,4,0.0,4,3,1,0.75,0,0,1,2,200.8,217.04,208.92000000000002
2019-10-31,1610612746,1610612759,2019,103.0,97.0,200.0,109.85,106.5,107.75,96.55,5,3,2,0.6,3,3,0,1.0,2,1,3,0,214.36,204.12,209.24
2019-10-30,1610612739,1610612741,2019,117.0,111.0,228.0,101.9,101.55,94.0,91.0,3,1,2,0.333,4,1,3,0.25,1,0,0,1,195.48,185.44,190.45999999999998
2019-10-30,1610612753,1610612752,2019,95.0,83.0,178.0,96.55,103.5,101.2,97.2,3,1,2,0.333,4,1,3,0.25,1,0,1,0,203.64,200.28,201.95999999999998
2019-10-30,1610612755,1610612750,2019,117.0,95.0,212.0,97.85,106.0,110.05,111.2,3,3,0,1.0,3,3,0,1.0,1,2,1,2,207.68,209.4,208.54000000000002
2019-10-30,1610612738,1610612749,2019,116.0,105.0,221.0,99.65,105.5,99.8,108.15,3,2,1,0.667,3,2,1,0.667,1,1,1,1,195.08,200.48,197.78
2019-10-30,1610612751,1610612754,2019,108.0,118.0,226.0,96.7,98.4,92.05,92.25,3,1,2,0.333,3,0,3,0.0,1,0,0,0,196.96,187.28,192.12
2019-10-30,1610612761,1610612765,2019,125.0,113.0,238.0,100.6,99.2,100.85,105.95,4,3,1,0.75,4,2,2,0.5,2,1,1,1,206.0,206.0,206.0
2019-10-30,1610612764,1610612745,2019,158.0,159.0,317.0,94.7,91.35,112.7,109.85,3,1,2,0.333,3,2,1,0.667,0,1,2,0,193.0,216.24,204.62
2019-10-30,1610612760,1610612757,2019,99.0,102.0,201.0,101.8,103.4,104.75,105.45,4,1,3,0.25,4,2,2,0.5,1,0,0,2,210.36,209.44,209.9
2019-10-30,1610612762,1610612746,2019,110.0,96.0,206.0,95.55,106.55,109.85,106.5,4,3,1,0.75,4,3,1,0.75,2,1,2,1,200.2,214.36,207.28
2019-10-30,1610612758,1610612766,2019,111.0,118.0,229.0,97.75,101.5,99.45,97.7,4,0,4,0.0,4,1,3,0.25,0,0,1,0,207.08,194.96,201.02
2019-10-30,1610612744,1610612756,2019,110.0,121.0,231.0,107.5,105.85,106.25,103.85,3,1,2,0.333,4,2,2,0.5,0,1,2,0,199.04,212.88,205.95999999999998
2019-10-29,1610612748,1610612737,2019,112.0,97.0,209.0,97.25,95.5,96.35,95.7,3,2,1,0.667,3,2,1,0.667,1,1,1,1,195.0,199.44,197.22
2019-10-29,1610612743,1610612742,2019,106.0,109.0,215.0,109.2,110.3,104.45,102.7,3,3,0,1.0,3,2,1,0.667,1,2,1,1,217.04,213.0,215.01999999999998
2019-10-29,1610612747,1610612763,2019,120.0,91.0,211.0,107.3,114.65,98.25,97.5,3,2,1,0.667,3,1,2,0.333,2,0,1,0,219.28,193.96,206.62
2019-10-28,1610612765,1610612754,2019,96.0,94.0,190.0,100.85,105.95,92.05,92.25,3,1,2,0.333,2,0,2,0.0,0,1,0,0,206.0,187.28,196.64
2019-10-28,1610612752,1610612741,2019,105.0,98.0,203.0,101.2,97.2,94.0,91.0,3,0,3,0.0,3,1,2,0.333,0,0,0,1,200.28,185.44,192.86
2019-10-28,1610612737,1610612755,2019,103.0,105.0,208.0,96.35,95.7,97.85,106.0,2,2,0,1.0,2,2,0,1.0,1,1,1,1,199.44,207.68,203.56
2019-10-28,1610612761,1610612753,2019,104.0,95.0,199.0,100.6,99.2,96.55,103.5,3,2,1,0.667,2,1,1,0.5,1,1,1,0,206.0,203.64,204.82
2019-10-28,1610612745,1610612760,2019,116.0,112.0,228.0,112.7,109.85,101.8,103.4,2,1,1,0.5,3,1,2,0.333,1,0,1,0,216.24,210.36,213.3
2019-10-28,1610612749,1610612739,2019,129.0,112.0,241.0,99.8,108.15,101.9,101.55,2,1,1,0.5,2,1,1,0.5,0,1,1,0,200.48,195.48,197.98
2019-10-28,1610612740,1610612744,2019,123.0,134.0,257.0,100.45,104.8,107.5,105.85,3,0,3,0.0,2,0,2,0.0,0,0,0,0,200.8,199.04,199.92000000000002
2019-10-28,1610612759,1610612757,2019,113.0,110.0,223.0,107.75,96.55,104.75,105.45,2,2,0,1.0,3,2,1,0.667,2,0,0,2,204.12,209.44,206.78
2019-10-28,1610612756,1610612762,2019,95.0,96.0,191.0,106.25,103.85,95.55,106.55,3,2,1,0.667,3,2,1,0.667,2,0,2,0,212.88,200.2,206.54
2019-10-28,1610612758,1610612743,2019,94.0,101.0,195.0,97.75,101.5,109.2,110.3,3,0,3,0.0,2,2,0,1.0,0,0,1,1,207.08,217.04,212.06
2019-10-28,1610612746,1610612766,2019,111.0,96.0,207.0,109.85,106.5,99.45,97.7,3,2,1,0.667,3,1,2,0.333,1,1,1,0,214.36,194.96,204.66000000000003
2019-10-27,1610612760,1610612744,2019,120.0,92.0,212.0,101.8,103.4,107.5,105.85,2,0,2,0.0,1,0,1,0.0,0,0,0,0,210.36,199.04,204.7
2019-10-27,1610612763,1610612751,2019,134.0,133.0,267.0,98.25,97.5,96.7,98.4,2,0,2,0.0,2,1,1,0.5,0,0,1,0,193.96,196.96,195.46
2019-10-27,1610612742,1610612757,2019,119.0,121.0,240.0,104.45,102.7,104.75,105.45,2,2,0,1.0,2,1,1,0.5,1,1,0,1,213.0,209.44,211.22
2019-10-27,1610612750,1610612748,2019,116.0,109.0,225.0,110.05,111.2,97.25,95.5,2,2,0,1.0,2,2,0,1.0,0,2,1,1,209.4,195.0,202.2
2019-10-27,1610612747,1610612766,2019,120.0,101.0,221.0,107.3,114.65,99.45,97.7,2,1,1,0.5,2,1,1,0.5,1,0,1,0,219.28,194.96,207.12
2019-10-26,1610612749,1610612748,2019,126.0,131.0,257.0,99.8,108.15,97.25,95.5,1,1,0,1.0,1,1,0,1.0,0,1,1,0,200.48,195.0,197.74
2019-10-26,1610612765,1610612755,2019,111.0,117.0,228.0,100.85,105.95,97.85,106.0,2,1,1,0.5,1,1,0,1.0,0,1,1,0,206.0,207.68,206.84
2019-10-26,1610612737,1610612753,2019,103.0,99.0,202.0,96.35,95.7,96.55,103.5,1,1,0,1.0,1,1,0,1.0,0,1,1,0,199.44,203.64,201.54
2019-10-26,1610612752,1610612738,2019,95.0,118.0,213.0,101.2,97.2,99.65,105.5,2,0,2,0.0,2,1,1,0.5,0,0,1,0,200.28,195.08,197.68
2019-10-26,1610612739,1610612754,2019,110.0,99.0,209.0,101.9,101.55,92.05,92.25,1,0,1,0.0,1,0,1,0.0,0,0,0,0,195.48,187.28,191.38
2019-10-26,1610612741,1610612761,2019,84.0,108.0,192.0,94.0,91.0,100.6,99.2,2,1,1,0.5,2,1,1,0.5,0,1,1,0,185.44,206.0,195.72
2019-10-26,1610612745,1610612740,2019,126.0,123.0,249.0,112.7,109.85,100.45,104.8,1,0,1,0.0,2,0,2,0.0,0,0,0,0,216.24,200.8,208.52
2019-10-26,1610612759,1610612764,2019,124.0,122.0,246.0,107.75,96.55,94.7,91.35,1,1,0,1.0,2,1,1,0.5,1,0,0,1,204.12,193.0,198.56
2019-10-26,1610612762,1610612758,2019,113.0,81.0,194.0,95.55,106.55,97.75,101.5,2,1,1,0.5,2,0,2,0.0,1,0,0,0,200.2,207.08,203.64
2019-10-26,1610612756,1610612746,2019,130.0,122.0,252.0,106.25,103.85,109.85,106.5,2,1,1,0.5,2,2,0,1.0,1,0,1,1,212.88,214.36,213.62
2019-10-25,1610612738,1610612761,2019,112.0,106.0,218.0,99.65,105.5,100.6,99.2,1,0,1,0.0,1,1,0,1.0,0,0,1,0,195.08,206.0,200.54000000000002
2019-10-25,1610612766,1610612750,2019,99.0,121.0,220.0,99.45,97.7,110.05,111.2,1,1,0,1.0,1,1,0,1.0,1,0,0,1,194.96,209.4,202.18
2019-10-25,1610612751,1610612752,2019,113.0,109.0,222.0,96.7,98.4,101.2,97.2,1,0,1,0.0,1,0,1,0.0,0,0,0,0,196.96,200.28,198.62
2019-10-25,1610612763,1610612741,2019,102.0,110.0,212.0,98.25,97.5,94.0,91.0,1,0,1,0.0,1,0,1,0.0,0,0,0,0,193.96,185.44,189.7
2019-10-25,1610612740,1610612742,2019,116.0,123.0,239.0,100.45,104.8,104.45,102.7,1,0,1,0.0,1,1,0,1.0,0,0,1,0,200.8,213.0,206.9
2019-10-25,1610612760,1610612764,2019,85.0,97.0,182.0,101.8,103.4,94.7,91.35,1,0,1,0.0,1,0,1,0.0,0,0,0,0,210.36,193.0,201.68
2019-10-25,1610612743,1610612756,2019,108.0,107.0,215.0,109.2,110.3,106.25,103.85,1,1,0,1.0,1,1,0,1.0,0,1,1,0,217.04,212.88,214.95999999999998
2019-10-25,1610612758,1610612757,2019,112.0,122.0,234.0,97.75,101.5,104.75,105.45,1,0,1,0.0,1,0,1,0.0,0,0,0,0,207.08,209.44,208.26
2019-10-25,1610612747,1610612762,2019,95.0,86.0,181.0,107.3,114.65,95.55,106.55,1,0,1,0.0,1,1,0,1.0,0,0,1,0,219.28,200.2,209.74
2019-10-24,1610612765,1610612737,2019,100.0,117.0,217.0,100.85,105.95,96.35,95.7,1,1,0,1.0,0,0,0,0.0,0,1,0,0,206.0,199.44,202.72
2019-10-24,1610612745,1610612749,2019,111.0,117.0,228.0,112.7,109.85,99.8,108.15,0,0,0,0.0,0,0,0,0.0,0,0,0,0,216.24,200.48,208.36
2019-10-24,1610612744,1610612746,2019,122.0,141.0,263.0,107.5,105.85,109.85,106.5,0,0,0,0.0,1,1,0,1.0,0,0,1,0,199.04,214.36,206.7
2019-10-23,1610612766,1610612741,2019,126.0,125.0,251.0,99.45,97.7,94.0,91.0,0,0,0,0.0,0,0,0,0.0,0,0,0,0,194.96,185.44,190.2
2019-10-23,1610612754,1610612765,2019,110.0,119.0,229.0,92.05,92.25,100.85,105.95,0,0,0,0.0,0,0,0,0.0,0,0,0,0,187.28,206.0,196.64
2019-10-23,1610612753,1610612739,2019,94.0,85.0,179.0,96.55,103.5,101.9,101.55,0,0,0,0.0,0,0,0,0.0,0,0,0,0,203.64,195.48,199.56
2019-10-23,1610612751,1610612750,2019,126.0,127.0,253.0,96.7,98.4,110.05,111.2,0,0,0,0.0,0,0,0,0.0,0,0,0,0,196.96,209.4,203.18
2019-10-23,1610612748,1610612763,2019,120.0,101.0,221.0,97.25,95.5,98.25,97.5,0,0,0,0.0,0,0,0,0.0,0,0,0,0,195.0,193.96,194.48000000000002
2019-10-23,1610612755,1610612738,2019,107.0,93.0,200.0,97.85,106.0,99.65,105.5,0,0,0,0.0,0,0,0,0.0,0,0,0,0,207.68,195.08,201.38
2019-10-23,1610612742,1610612764,2019,108.0,100.0,208.0,104.45,102.7,94.7,91.35,0,0,0,0.0,0,0,0,0.0,0,0,0,0,213.0,193.0,203.0
2019-10-23,1610612759,1610612752,2019,120.0,111.0,231.0,107.75,96.55,101.2,97.2,0,0,0,0.0,0,0,0,0.0,0,0,0,0,204.12,200.28,202.2
2019-10-23,1610612762,1610612760,2019,100.0,95.0,195.0,95.55,106.55,101.8,103.4,0,0,0,0.0,0,0,0,0.0,0,0,0,0,200.2,210.36,205.28
2019-10-23,1610612756,1610612758,2019,124.0,95.0,219.0,106.25,103.85,97.75,101.5,0,0,0,0.0,0,0,0,0.0,0,0,0,0,212.88,207.08,209.98000000000002
2019-10-23,1610612757,1610612743,2019,100.0,108.0,208.0,104.75,105.45,109.2,110.3,0,0,0,0.0,0,0,0,0.0,0,0,0,0,209.44,217.04,213.24
2019-10-22,1610612761,1610612740,2019,130.0,122.0,252.0,100.6,99.2,100.45,104.8,4,2,2,0.5,5,5,0,1.0,1,1,1,4,206.0,200.8,203.4
2019-10-22,1610612746,1610612747,2019,112.0,102.0,214.0,109.85,106.5,107.3,114.65,5,2,3,0.4,6,3,3,0.5,2,0,2,1,214.36,219.28,216.82
2019-10-18,1610612755,1610612764,2019,93.0,112.0,205.0,97.85,106.0,94.7,91.35,4,4,0,1.0,4,2,2,0.5,2,2,1,1,207.68,193.0,200.34
2019-10-18,1610612751,1610612761,2019,107.0,123.0,230.0,96.7,98.4,100.6,99.2,3,3,0,1.0,3,1,2,0.333,2,1,1,0,196.96,206.0,201.48000000000002
2019-10-18,1610612748,1610612745,2019,133.0,144.0,277.0,97.25,95.5,112.7,109.85,4,4,0,1.0,5,3,2,0.6,2,2,2,1,195.0,216.24,205.62
2019-10-18,1610612752,1610612740,2019,116.0,117.0,233.0,101.2,97.2,100.45,104.8,3,1,2,0.333,4,4,0,1.0,0,1,1,3,200.28,200.8,200.54000000000002
2019-10-18,1610612759,1610612763,2019,104.0,91.0,195.0,107.75,96.55,98.25,97.5,4,1,3,0.25,4,3,1,0.75,0,1,2,1,204.12,193.96,199.04000000000002
2019-10-18,1610612744,1610612747,2019,124.0,103.0,227.0,107.5,105.85,107.3,114.65,4,1,3,0.25,5,3,2,0.6,1,0,2,1,199.04,219.28,209.16
2019-10-17,1610612753,1610612748,2019,98.0,107.0,205.0,96.55,103.5,97.25,95.5,5,3,2,0.6,3,3,0,1.0,0,3,2,1,203.64,195.0,199.32
2019-10-17,1610612741,1610612737,2019,111.0,93.0,204.0,94.0,91.0,96.35,95.7,4,1,3,0.25,4,1,3,0.25,0,1,0,1,185.44,199.44,192.44
2019-10-17,1610612749,1610612750,2019,118.0,96.0,214.0,99.8,108.15,110.05,111.2,4,4,0,1.0,4,2,2,0.5,1,3,1,1,200.48,209.4,204.94
2019-10-17,1610612743,1610612757,2019,110.0,104.0,214.0,109.2,110.3,104.75,105.45,3,3,0,1.0,4,2,2,0.5,0,3,1,1,217.04,209.44,213.24
2019-10-17,1610612746,1610612742,2019,87.0,102.0,189.0,109.85,106.5,104.45,102.7,4,2,2,0.5,4,1,3,0.25,2,0,1,0,214.36,213.0,213.68
2019-10-16,1610612766,1610612765,2019,110.0,116.0,226.0,99.45,97.7,100.85,105.95,4,1,3,0.25,4,2,2,0.5,0,1,2,0,194.96,206.0,200.48000000000002
2019-10-16,1610612752,1610612737,2019,96.0,100.0,196.0,101.2,97.2,96.35,95.7,2,1,1,0.5,3,0,3,0.0,0,1,0,0,200.28,199.44,199.86
2019-10-16,1610612745,1610612759,2019,114.0,128.0,242.0,112.7,109.85,107.75,96.55,4,3,1,0.75,3,0,3,0.0,2,1,0,0,216.24,204.12,210.18
2019-10-16,1610612760,1610612763,2019,119.0,124.0,243.0,101.8,103.4,98.25,97.5,3,2,1,0.667,3,2,1,0.667,2,0,2,0,210.36,193.96,202.16000000000003
2019-10-16,1610612762,1610612757,2019,118.0,126.0,244.0,95.55,106.55,104.75,105.45,4,1,3,0.25,3,1,2,0.333,1,0,1,0,200.2,209.44,204.82
2019-10-16,1610612747,1610612744,2019,126.0,93.0,219.0,107.3,114.65,107.5,105.85,4,2,2,0.5,3,1,2,0.333,1,1,1,0,219.28,199.04,209.16
2019-10-15,1610612739,1610612738,2019,95.0,118.0,213.0,101.9,101.55,99.65,105.5,3,1,2,0.333,3,3,0,1.0,1,0,2,1,195.48,195.08,195.28
2019-10-15,1610612754,1610612750,2019,111.0,119.0,230.0,92.05,92.25,110.05,111.2,3,3,0,1.0,3,1,2,0.333,2,1,1,0,187.28,209.4,198.34
2019-10-15,1610612755,1610612765,2019,106.0,86.0,192.0,97.85,106.0,100.85,105.95,3,3,0,1.0,3,2,1,0.667,1,2,2,0,207.68,206.0,206.84
2019-10-14,1610612748,1610612737,2019,120.0,87.0,207.0,97.25,95.5,96.35,95.7,2,2,0,1.0,2,0,2,0.0,1,1,0,0,195.0,199.44,197.22
2019-10-14,1610612763,1610612766,2019,99.0,120.0,219.0,98.25,97.5,99.45,97.7,2,2,0,1.0,3,0,3,0.0,2,0,0,0,193.96,194.96,194.46
2019-10-14,1610612742,1610612760,2019,107.0,70.0,177.0,104.45,102.7,101.8,103.4,3,0,3,0.0,2,2,0,1.0,0,0,2,0,213.0,210.36,211.68
2019-10-14,1610612762,1610612758,2019,115.0,128.0,243.0,95.55,106.55,97.75,101.5,3,1,2,0.333,3,1,2,0.333,1,0,1,0,200.2,207.08,203.64
2019-10-14,1610612756,1610612743,2019,102.0,107.0,209.0,106.25,103.85,109.2,110.3,3,2,1,0.667,2,2,0,1.0,1,1,0,2,212.88,217.04,214.95999999999998
2019-10-14,1610612747,1610612744,2019,104.0,98.0,202.0,107.3,114.65,107.5,105.85,3,1,2,0.333,2,1,1,0.5,0,1,1,0,219.28,199.04,209.16
2019-10-13,1610612738,1610612739,2019,118.0,72.0,190.0,99.65,105.5,101.9,101.55,2,2,0,1.0,2,1,1,0.5,1,1,1,0,195.08,195.48,195.28
2019-10-13,1610612759,1610612740,2019,114.0,123.0,237.0,107.75,96.55,100.45,104.8,2,0,2,0.0,3,3,0,1.0,0,0,1,2,204.12,200.8,202.46
2019-10-13,1610612753,1610612755,2019,94.0,126.0,220.0,96.55,103.5,97.85,106.0,4,3,1,0.75,2,2,0,1.0,0,3,1,1,203.64,207.68,205.66
2019-10-13,1610612761,1610612741,2019,91.0,105.0,196.0,100.6,99.2,94.0,91.0,2,1,1,0.5,3,0,3,0.0,1,0,0,0,206.0,185.44,195.72
2019-10-13,1610612764,1610612749,2019,108.0,115.0,223.0,94.7,91.35,99.8,108.15,3,2,1,0.667,3,3,0,1.0,1,1,1,2,193.0,200.48,196.74
2019-10-12,1610612751,1610612747,2019,91.0,77.0,168.0,96.7,98.4,107.3,114.65,2,2,0,1.0,2,1,1,0.5,1,1,0,1,196.96,219.28,208.12
2019-10-12,1610612757,1610612756,2019,118.0,134.0,252.0,104.75,105.45,106.25,103.85,2,1,1,0.5,2,1,1,0.5,1,0,1,0,209.44,212.88,211.16
2019-10-11,1610612765,1610612739,2019,109.0,105.0,214.0,100.85,105.95,101.9,101.55,2,1,1,0.5,1,1,0,1.0,1,0,1,0,206.0,195.48,200.74
2019-10-11,1610612754,1610612741,2019,105.0,87.0,192.0,92.05,92.25,94.0,91.0,2,2,0,1.0,2,0,2,0.0,1,1,0,0,187.28,185.44,186.36
2019-10-11,1610612753,1610612738,2019,75.0,100.0,175.0,96.55,103.5,99.65,105.5,3,3,0,1.0,1,1,0,1.0,0,3,1,0,203.64,195.08,199.36
2019-10-11,1610612766,1610612755,2019,87.0,100.0,187.0,99.45,97.7,97.85,106.0,2,0,2,0.0,1,1,0,1.0,0,0,1,0,194.96,207.68,201.32
2019-10-11,1610612752,1610612764,2019,99.0,115.0,214.0,101.2,97.2,94.7,91.35,1,1,0,1.0,2,1,1,0.5,0,1,1,0,200.28,193.0,196.64
2019-10-11,1610612740,1610612762,2019,128.0,127.0,255.0,100.45,104.8,95.55,106.55,2,2,0,1.0,2,1,1,0.5,0,2,1,0,200.8,200.2,200.5
2019-10-11,1610612742,1610612749,2019,111.0,118.0,229.0,104.45,102.7,99.8,108.15,2,0,2,0.0,2,2,0,1.0,0,0,1,1,213.0,200.48,206.74
2019-10-10,1610612745,1610612761,2019,118.0,111.0,229.0,112.7,109.85,100.6,99.2,3,2,1,0.667,1,1,0,1.0,1,1,1,0,216.24,206.0,211.12
2019-10-10,1610612747,1610612751,2019,111.0,114.0,225.0,107.3,114.65,96.7,98.4,1,1,0,1.0,1,1,0,1.0,0,1,1,0,219.28,196.96,208.12
2019-10-10,1610612758,1610612756,2019,105.0,88.0,193.0,97.75,101.5,106.25,103.85,2,0,2,0.0,1,1,0,1.0,0,0,1,0,207.08,212.88,209.98000000000002
2019-10-10,1610612744,1610612750,2019,143.0,123.0,266.0,107.5,105.85,110.05,111.2,1,0,1,0.0,1,0,1,0.0,0,0,0,0,199.04,209.4,204.22
2019-10-10,1610612746,1610612743,2019,91.0,111.0,202.0,109.85,106.5,109.2,110.3,2,1,1,0.5,1,1,0,1.0,1,0,0,1,214.36,217.04,215.7
2019-10-09,1610612765,1610612742,2019,124.0,117.0,241.0,100.85,105.95,104.45,102.7,1,0,1,0.0,1,0,1,0.0,0,0,0,0,206.0,213.0,209.5
2019-10-09,1610612737,1610612753,2019,88.0,97.0,185.0,96.35,95.7,96.55,103.5,1,0,1,0.0,2,2,0,1.0,0,0,0,2,199.44,203.64,201.54
2019-10-09,1610612766,1610612748,2019,94.0,108.0,202.0,99.45,97.7,97.25,95.5,1,0,1,0.0,1,1,0,1.0,0,0,1,0,194.96,195.0,194.98000000000002
2019-10-09,1610612741,1610612740,2019,125.0,127.0,252.0,94.0,91.0,100.45,104.8,1,0,1,0.0,1,1,0,1.0,0,0,0,1,185.44,200.8,193.12
2019-10-09,1610612749,1610612762,2019,133.0,99.0,232.0,99.8,108.15,95.55,106.55,1,1,0,1.0,1,1,0,1.0,0,1,1,0,200.48,200.2,200.33999999999997
2019-10-08,1610612761,1610612745,2019,134.0,129.0,263.0,100.6,99.2,112.7,109.85,0,0,0,0.0,2,2,0,1.0,0,0,1,1,206.0,216.24,211.12
2019-10-08,1610612748,1610612759,2019,107.0,89.0,196.0,97.25,95.5,107.75,96.55,0,0,0,0.0,1,0,1,0.0,0,0,0,0,195.0,204.12,199.56
2019-10-08,1610612760,1610612742,2019,119.0,104.0,223.0,101.8,103.4,104.45,102.7,0,0,0,0.0,0,0,0,0.0,0,0,0,0,210.36,213.0,211.68
2019-10-08,1610612756,1610612750,2019,111.0,106.0,217.0,106.25,103.85,110.05,111.2,0,0,0,0.0,0,0,0,0.0,0,0,0,0,212.88,209.4,211.14
2019-10-08,1610612757,1610612743,2019,94.0,105.0,199.0,104.75,105.45,109.2,110.3,0,0,0,0.0,0,0,0,0.0,0,0,0,0,209.44,217.04,213.24
2019-10-07,1610612765,1610612753,2019,91.0,115.0,206.0,100.85,105.95,96.55,103.5,0,0,0,0.0,1,1,0,1.0,0,0,0,1,206.0,203.64,204.82
2019-10-07,1610612764,1610612752,2019,99.0,104.0,203.0,94.7,91.35,101.2,97.2,0,0,0,0.0,0,0,0,0.0,0,0,0,0,193.0,200.28,196.64
2019-10-07,1610612737,1610612740,2019,109.0,133.0,242.0,96.35,95.7,100.45,104.8,0,0,0,0.0,0,0,0,0.0,0,0,0,0,199.44,200.8,200.12
2019-10-07,1610612741,1610612749,2019,112.0,122.0,234.0,94.0,91.0,99.8,108.15,0,0,0,0.0,0,0,0,0.0,0,0,0,0,185.44,200.48,192.95999999999998
2019-10-06,1610612738,1610612766,2019,107.0,106.0,213.0,99.65,105.5,99.45,97.7,0,0,0,0.0,0,0,0,0.0,0,0,0,0,195.08,194.96,195.02
2019-10-05,1610612754,1610612758,2019,130.0,106.0,236.0,92.05,92.25,97.75,101.5,1,1,0,1.0,1,0,1,0.0,0,1,0,0,187.28,207.08,197.18
2019-10-05,1610612744,1610612747,2019,101.0,123.0,224.0,107.5,105.85,107.3,114.65,0,0,0,0.0,0,0,0,0.0,0,0,0,0,199.04,219.28,209.16
2019-10-05,1610612759,1610612753,2019,89.0,125.0,214.0,107.75,96.55,96.55,103.5,0,0,0,0.0,0,0,0,0.0,0,0,0,0,204.12,203.64,203.88
2019-10-04,1610612746,1610612745,2019,96.0,109.0,205.0,109.85,106.5,112.7,109.85,0,0,0,0.0,1,1,0,1.0,0,0,1,0,214.36,216.24,215.3
2019-10-04,1610612758,1610612754,2019,131.0,132.0,263.0,97.75,101.5,92.05,92.25,0,0,0,0.0,0,0,0,0.0,0,0,0,0,207.08,187.28,197.18
2019-06-13,1610612744,1610612761,2018,110.0,114.0,224.0,107.5,105.85,100.6,99.2,82,57,25,0.695,82,58,24,0.7070000000000001,30,27,32,26,199.04,206.0,202.51999999999998
2019-06-10,1610612761,1610612744,2018,105.0,106.0,211.0,100.6,99.2,107.5,105.85,82,58,24,0.7070000000000001,82,57,25,0.695,32,26,30,27,206.0,199.04,202.51999999999998
2019-06-07,1610612744,1610612761,2018,92.0,105.0,197.0,107.5,105.85,100.6,99.2,82,57,25,0.695,82,58,24,0.7070000000000001,30,27,32,26,199.04,206.0,202.51999999999998
2019-06-05,1610612744,1610612761,2018,109.0,123.0,232.0,107.5,105.85,100.6,99.2,82,57,25,0.695,82,58,24,0.7070000000000001,30,27,32,26,199.04,206.0,202.51999999999998
2019-06-02,1610612761,1610612744,2018,104.0,109.0,213.0,100.6,99.2,107.5,105.85,82,58,24,0.7070000000000001,82,57,25,0.695,32,26,30,27,206.0,199.04,202.51999999999998
2019-05-30,1610612761,1610612744,2018,118.0,109.0,227.0,100.6,99.2,107.5,105.85,82,58,24,0.7070000000000001,82,57,25,0.695,32,26,30,27,206.0,199.04,202.51999999999998
2019-05-25,1610612761,1610612749,2018,100.0,94.0,194.0,100.6,99.2,99.8,108.15,82,58,24,0.7070000000000001,82,60,22,0.732,32,26,33,27,206.0,200.48,203.24
2019-05-23,1610612749,1610612761,2018,99.0,105.0,204.0,99.8,108.15,100.6,99.2,82,60,22,0.732,82,58,24,0.7070000000000001,33,27,32,26,200.48,206.0,203.24
2019-05-21,1610612761,1610612749,2018,120.0,102.0,222.0,100.6,99.2,99.8,108.15,82,58,24,0.7070000000000001,82,60,22,0.732,32,26,33,27,206.0,200.48,203.24
2019-05-20,1610612757,1610612744,2018,117.0,119.0,236.0,104.75,105.45,107.5,105.85,82,53,29,0.6459999999999999,82,57,25,0.695,32,21,30,27,209.44,199.04,204.24
2019-05-19,1610612761,1610612749,2018,118.0,112.0,230.0,100.6,99.2,99.8,108.15,82,58,24,0.7070000000000001,82,60,22,0.732,32,26,33,27,206.0,200.48,203.24
2019-05-18,1610612757,1610612744,2018,99.0,110.0,209.0,104.75,105.45,107.5,105.85,82,53,29,0.6459999999999999,82,57,25,0.695,32,21,30,27,209.44,199.04,204.24
2019-05-17,1610612749,1610612761,2018,125.0,103.0,228.0,99.8,108.15,100.6,99.2,82,60,22,0.732,82,58,24,0.7070000000000001,33,27,32,26,200.48,206.0,203.24
2019-05-16,1610612744,1610612757,2018,114.0,111.0,225.0,107.5,105.85,104.75,105.45,82,57,25,0.695,82,53,29,0.6459999999999999,30,27,32,21,199.04,209.44,204.24
2019-05-15,1610612749,1610612761,2018,108.0,100.0,208.0,99.8,108.15,100.6,99.2,82,60,22,0.732,82,58,24,0.7070000000000001,33,27,32,26,200.48,206.0,203.24
2019-05-14,1610612744,1610612757,2018,116.0,94.0,210.0,107.5,105.85,104.75,105.45,82,57,25,0.695,82,53,29,0.6459999999999999,30,27,32,21,199.04,209.44,204.24
2019-05-12,1610612743,1610612757,2018,96.0,100.0,196.0,109.2,110.3,104.75,105.45,82,54,28,0.659,82,53,29,0.6459999999999999,34,20,32,21,217.04,209.44,213.24
2019-05-12,1610612761,1610612755,2018,92.0,90.0,182.0,100.6,99.2,97.85,106.0,82,58,24,0.7070000000000001,82,51,31,0.622,32,26,31,20,206.0,207.68,206.84
2019-05-10,1610612745,1610612744,2018,113.0,118.0,231.0,112.7,109.85,107.5,105.85,82,53,29,0.6459999999999999,82,57,25,0.695,31,22,30,27,216.24,199.04,207.64
2019-05-09,1610612755,1610612761,2018,112.0,101.0,213.0,97.85,106.0,100.6,99.2,82,51,31,0.622,82,58,24,0.7070000000000001,31,20,32,26,207.68,206.0,206.84
2019-05-09,1610612757,1610612743,2018,119.0,108.0,227.0,104.75,105.45,109.2,110.3,82,53,29,0.6459999999999999,82,54,28,0.659,32,21,34,20,209.44,217.04,213.24
2019-05-08,1610612749,1610612738,2018,116.0,91.0,207.0,99.8,108.15,99.65,105.5,82,60,22,0.732,82,49,33,0.598,33,27,28,21,200.48,195.08,197.78
2019-05-08,1610612744,1610612745,2018,104.0,99.0,203.0,107.5,105.85,112.7,109.85,82,57,25,0.695,82,53,29,0.6459999999999999,30,27,31,22,199.04,216.24,207.64
2019-05-07,1610612761,1610612755,2018,125.0,89.0,214.0,100.6,99.2,97.85,106.0,82,58,24,0.7070000000000001,82,51,31,0.622,32,26,31,20,206.0,207.68,206.84
2019-05-07,1610612743,1610612757,2018,124.0,98.0,222.0,109.2,110.3,104.75,105.45,82,54,28,0.659,82,53,29,0.6459999999999999,34,20,32,21,217.04,209.44,213.24
2019-05-06,1610612738,1610612749,2018,101.0,113.0,214.0,99.65,105.5,99.8,108.15,82,49,33,0.598,82,60,22,0.732,28,21,33,27,195.08,200.48,197.78
2019-05-06,1610612745,1610612744,2018,112.0,108.0,220.0,112.7,109.85,107.5,105.85,82,53,29,0.6459999999999999,82,57,25,0.695,31,22,30,27,216.24,199.04,207.64
2019-05-05,1610612755,1610612761,2018,96.0,101.0,197.0,97.85,106.0,100.6,99.2,82,51,31,0.622,82,58,24,0.7070000000000001,31,20,32,26,207.68,206.0,206.84
2019-05-05,1610612757,1610612743,2018,112.0,116.0,228.0,104.75,105.45,109.2,110.3,82,53,29,0.6459999999999999,82,54,28,0.659,32,21,34,20,209.44,217.04,213.24
2019-05-04,1610612745,1610612744,2018,126.0,121.0,247.0,112.7,109.85,107.5,105.85,82,53,29,0.6459999999999999,82,57,25,0.695,31,22,30,27,216.24,199.04,207.64
2019-05-03,1610612738,1610612749,2018,116.0,123.0,239.0,99.65,105.5,99.8,108.15,82,49,33,0.598,82,60,22,0.732,28,21,33,27,195.08,200.48,197.78
2019-05-03,1610612757,1610612743,2018,140.0,137.0,277.0,104.75,105.45,109.2,110.3,82,53,29,0.6459999999999999,82,54,28,0.659,32,21,34,20,209.44,217.04,213.24
2019-05-02,1610612755,1610612761,2018,116.0,95.0,211.0,97.85,106.0,100.6,99.2,82,51,31,0.622,82,58,24,0.7070000000000001,31,20,32,26,207.68,206.0,206.84
2019-05-01,1610612743,1610612757,2018,90.0,97.0,187.0,109.2,110.3,104.75,105.45,82,54,28,0.659,82,53,29,0.6459999999999999,34,20,32,21,217.04,209.44,213.24
2019-04-30,1610612749,1610612738,2018,123.0,102.0,225.0,99.8,108.15,99.65,105.5,82,60,22,0.732,82,49,33,0.598,33,27,28,21,200.48,195.08,197.78
2019-04-30,1610612744,1610612745,2018,115.0,109.0,224.0,107.5,105.85,112.7,109.85,82,57,25,0.695,82,53,29,0.6459999999999999,30,27,31,22,199.04,216.24,207.64
2019-04-29,1610612761,1610612755,2018,89.0,94.0,183.0,100.6,99.2,97.85,106.0,82,58,24,0.7070000000000001,82,51,31,0.622,32,26,31,20,206.0,207.68,206.84
2019-04-29,1610612743,1610612757,2018,121.0,113.0,234.0,109.2,110.3,104.75,105.45,82,54,28,0.659,82,53,29,0.6459999999999999,34,20,32,21,217.04,209.44,213.24
2019-04-28,1610612749,1610612738,2018,90.0,112.0,202.0,99.8,108.15,99.65,105.5,82,60,22,0.732,82,49,33,0.598,33,27,28,21,200.48,195.08,197.78
2019-04-28,1610612744,1610612745,2018,104.0,100.0,204.0,107.5,105.85,112.7,109.85,82,57,25,0.695,82,53,29,0.6459999999999999,30,27,31,22,199.04,216.24,207.64
2019-04-27,1610612761,1610612755,2018,108.0,95.0,203.0,100.6,99.2,97.85,106.0,82,58,24,0.7070000000000001,82,51,31,0.622,32,26,31,20,206.0,207.68,206.84
2019-04-27,1610612743,1610612759,2018,90.0,86.0,176.0,109.2,110.3,107.75,96.55,82,54,28,0.659,82,48,34,0.585,34,20,32,16,217.04,204.12,210.57999999999998
2019-04-26,1610612746,1610612744,2018,110.0,129.0,239.0,109.85,106.5,107.5,105.85,82,48,34,0.585,82,57,25,0.695,26,22,30,27,214.36,199.04,206.7
2019-04-25,1610612759,1610612743,2018,120.0,103.0,223.0,107.75,96.55,109.2,110.3,82,48,34,0.585,82,54,28,0.659,32,16,34,20,204.12,217.04,210.57999999999998
2019-04-24,1610612745,1610612762,2018,100.0,93.0,193.0,112.7,109.85,95.55,106.55,82,53,29,0.6459999999999999,82,50,32,0.61,31,22,29,21,216.24,200.2,208.22
2019-04-24,1610612744,1610612746,2018,121.0,129.0,250.0,107.5,105.85,109.85,106.5,82,57,25,0.695,82,48,34,0.585,30,27,26,22,199.04,214.36,206.7
2019-04-23,1610612761,1610612753,2018,115.0,96.0,211.0,100.6,99.2,96.55,103.5,82,58,24,0.7070000000000001,82,42,40,0.512,32,26,25,17,206.0,203.64,204.82
2019-04-23,1610612755,1610612751,2018,122.0,100.0,222.0,97.85,106.0,96.7,98.4,82,51,31,0.622,82,42,40,0.512,31,20,23,19,207.68,196.96,202.32
2019-04-23,1610612743,1610612759,2018,108.0,90.0,198.0,109.2,110.3,107.75,96.55,82,54,28,0.659,82,48,34,0.585,34,20,32,16,217.04,204.12,210.57999999999998
2019-04-23,1610612757,1610612760,2018,118.0,115.0,233.0,104.75,105.45,101.8,103.4,82,53,29,0.6459999999999999,82,49,33,0.598,32,21,27,22,209.44,210.36,209.9
2019-04-22,1610612765,1610612749,2018,104.0,127.0,231.0,100.85,105.95,99.8,108.15,82,41,41,0.5,82,60,22,0.732,26,15,33,27,206.0,200.48,203.24
2019-04-22,1610612762,1610612745,2018,107.0,91.0,198.0,95.55,106.55,112.7,109.85,82,50,32,0.61,82,53,29,0.6459999999999999,29,21,31,22,200.2,216.24,208.22
2019-04-21,1610612754,1610612738,2018,106.0,110.0,216.0,92.05,92.25,99.65,105.5,82,48,34,0.585,82,49,33,0.598,29,19,28,21,187.28,195.08,191.18
2019-04-21,1610612746,1610612744,2018,105.0,113.0,218.0,109.85,106.5,107.5,105.85,82,48,34,0.585,82,57,25,0.695,26,22,30,27,214.36,199.04,206.7
2019-04-21,1610612753,1610612761,2018,85.0,107.0,192.0,96.55,103.5,100.6,99.2,82,42,40,0.512,82,58,24,0.7070000000000001,25,17,32,26,203.64,206.0,204.82
2019-04-21,1610612760,1610612757,2018,98.0,111.0,209.0,101.8,103.4,104.75,105.45,82,49,33,0.598,82,53,29,0.6459999999999999,27,22,32,21,210.36,209.44,209.9
2019-04-20,1610612751,1610612755,2018,108.0,112.0,220.0,96.7,98.4,97.85,106.0,82,42,40,0.512,82,51,31,0.622,23,19,31,20,196.96,207.68,202.32
2019-04-20,1610612759,1610612743,2018,103.0,117.0,220.0,107.75,96.55,109.2,110.3,82,48,34,0.585,82,54,28,0.659,32,16,34,20,204.12,217.04,210.57999999999998
2019-04-20,1610612765,1610612749,2018,103.0,119.0,222.0,100.85,105.95,99.8,108.15,82,41,41,0.5,82,60,22,0.732,26,15,33,27,206.0,200.48,203.24
2019-04-20,1610612762,1610612745,2018,101.0,104.0,205.0,95.55,106.55,112.7,109.85,82,50,32,0.61,82,53,29,0.6459999999999999,29,21,31,22,200.2,216.24,208.22
2019-04-19,1610612753,1610612761,2018,93.0,98.0,191.0,96.55,103.5,100.6,99.2,82,42,40,0.512,82,58,24,0.7070000000000001,25,17,32,26,203.64,206.0,204.82
2019-04-19,1610612754,1610612738,2018,96.0,104.0,200.0,92.05,92.25,99.65,105.5,82,48,34,0.585,82,49,33,0.598,29,19,28,21,187.28,195.08,191.18
2019-04-19,1610612760,1610612757,2018,120.0,108.0,228.0,101.8,103.4,104.75,105.45,82,49,33,0.598,82,53,29,0.6459999999999999,27,22,32,21,210.36,209.44,209.9
2019-04-18,1610612751,1610612755,2018,115.0,131.0,246.0,96.7,98.4,97.85,106.0,82,42,40,0.512,82,51,31,0.622,23,19,31,20,196.96,207.68,202.32
2019-04-18,1610612759,1610612743,2018,118.0,108.0,226.0,107.75,96.55,109.2,110.3,82,48,34,0.585,82,54,28,0.659,32,16,34,20,204.12,217.04,210.57999999999998
2019-04-18,1610612746,1610612744,2018,105.0,132.0,237.0,109.85,106.5,107.5,105.85,82,48,34,0.585,82,57,25,0.695,26,22,30,27,214.36,199.04,206.7
2019-04-17,1610612738,1610612754,2018,99.0,91.0,190.0,99.65,105.5,92.05,92.25,82,49,33,0.598,82,48,34,0.585,28,21,29,19,195.08,187.28,191.18
2019-04-17,1610612749,1610612765,2018,120.0,99.0,219.0,99.8,108.15,100.85,105.95,82,60,22,0.732,82,41,41,0.5,33,27,26,15,200.48,206.0,203.24
2019-04-17,1610612745,1610612762,2018,118.0,98.0,216.0,112.7,109.85,95.55,106.55,82,53,29,0.6459999999999999,82,50,32,0.61,31,22,29,21,216.24,200.2,208.22
2019-04-16,1610612761,1610612753,2018,111.0,82.0,193.0,100.6,99.2,96.55,103.5,82,58,24,0.7070000000000001,82,42,40,0.512,32,26,25,17,206.0,203.64,204.82
2019-04-16,1610612743,1610612759,2018,114.0,105.0,219.0,109.2,110.3,107.75,96.55,82,54,28,0.659,82,48,34,0.585,34,20,32,16,217.04,204.12,210.57999999999998
2019-04-16,1610612757,1610612760,2018,114.0,94.0,208.0,104.75,105.45,101.8,103.4,82,53,29,0.6459999999999999,82,49,33,0.598,32,21,27,22,209.44,210.36,209.9
2019-04-15,1610612755,1610612751,2018,145.0,123.0,268.0,97.85,106.0,96.7,98.4,82,51,31,0.622,82,42,40,0.512,31,20,23,19,207.68,196.96,202.32
2019-04-15,1610612744,1610612746,2018,131.0,135.0,266.0,107.5,105.85,109.85,106.5,82,57,25,0.695,82,48,34,0.585,30,27,26,22,199.04,214.36,206.7
2019-04-14,1610612738,1610612754,2018,84.0,74.0,158.0,99.65,105.5,92.05,92.25,82,49,33,0.598,82,48,34,0.585,28,21,29,19,195.08,187.28,191.18
2019-04-14,1610612757,1610612760,2018,104.0,99.0,203.0,104.75,105.45,101.8,103.4,82,53,29,0.6459999999999999,82,49,33,0.598,32,21,27,22,209.44,210.36,209.9
2019-04-14,1610612749,1610612765,2018,121.0,86.0,207.0,99.8,108.15,100.85,105.95,82,60,22,0.732,82,41,41,0.5,33,27,26,15,200.48,206.0,203.24
2019-04-14,1610612745,1610612762,2018,122.0,90.0,212.0,112.7,109.85,95.55,106.55,82,53,29,0.6459999999999999,82,50,32,0.61,31,22,29,21,216.24,200.2,208.22
2019-04-13,1610612755,1610612751,2018,102.0,111.0,213.0,97.85,106.0,96.7,98.4,82,51,31,0.622,82,42,40,0.512,31,20,23,19,207.68,196.96,202.32
2019-04-13,1610612761,1610612753,2018,101.0,104.0,205.0,100.6,99.2,96.55,103.5,82,58,24,0.7070000000000001,82,42,40,0.512,32,26,25,17,206.0,203.64,204.82
2019-04-13,1610612744,1610612746,2018,121.0,104.0,225.0,107.5,105.85,109.85,106.5,82,57,25,0.695,82,48,34,0.585,30,27,26,22,199.04,214.36,206.7
2019-04-13,1610612743,1610612759,2018,96.0,101.0,197.0,109.2,110.3,107.75,96.55,82,54,28,0.659,82,48,34,0.585,34,20,32,16,217.04,204.12,210.57999999999998
2019-04-10,1610612737,1610612754,2018,134.0,135.0,269.0,96.35,95.7,92.05,92.25,81,29,52,0.358,81,47,34,0.58,17,12,29,18,199.44,187.28,193.36
2019-04-10,1610612751,1610612748,2018,113.0,94.0,207.0,96.7,98.4,97.25,95.5,81,41,40,0.506,81,39,42,0.481,22,19,19,20,196.96,195.0,195.98000000000002
2019-04-10,1610612766,1610612753,2018,114.0,122.0,236.0,99.45,97.7,96.55,103.5,81,39,42,0.481,81,41,40,0.506,25,14,25,16,194.96,203.64,199.3
2019-04-10,1610612752,1610612765,2018,89.0,115.0,204.0,101.2,97.2,100.85,105.95,81,17,64,0.21,81,40,41,0.494,9,8,26,14,200.28,206.0,203.14
2019-04-10,1610612755,1610612741,2018,125.0,109.0,234.0,97.85,106.0,94.0,91.0,81,50,31,0.617,81,22,59,0.272,30,20,9,13,207.68,185.44,196.56
2019-04-10,1610612763,1610612744,2018,132.0,117.0,249.0,98.25,97.5,107.5,105.85,81,32,49,0.395,81,57,24,0.7040000000000001,20,12,30,27,193.96,199.04,196.5
2019-04-10,1610612749,1610612760,2018,116.0,127.0,243.0,99.8,108.15,101.8,103.4,81,60,21,0.741,81,48,33,0.593,33,27,27,21,200.48,210.36,205.42000000000002
2019-04-10,1610612759,1610612742,2018,105.0,94.0,199.0,107.75,96.55,104.45,102.7,81,47,34,0.58,81,33,48,0.407,31,16,24,9,204.12,213.0,208.56
2019-04-10,1610612743,1610612750,2018,99.0,95.0,194.0,109.2,110.3,110.05,111.2,81,53,28,0.654,81,36,45,0.444,33,20,25,11,217.04,209.4,213.22
2019-04-10,1610612746,1610612762,2018,143.0,137.0,280.0,109.85,106.5,95.55,106.55,81,47,34,0.58,81,50,31,0.617,25,22,29,21,214.36,200.2,207.28
2019-04-10,1610612757,1610612758,2018,136.0,131.0,267.0,104.75,105.45,97.75,101.5,81,52,29,0.642,81,39,42,0.481,31,21,24,15,209.44,207.08,208.26
2019-04-09,1610612739,1610612766,2018,97.0,124.0,221.0,101.9,101.55,99.45,97.7,81,19,62,0.235,80,38,42,0.475,13,6,25,13,195.48,194.96,195.22
2019-04-09,1610612765,1610612763,2018,100.0,93.0,193.0,100.85,105.95,98.25,97.5,80,39,41,0.488,80,32,48,0.4,25,14,20,12,206.0,193.96,199.98000000000002
2019-04-09,1610612764,1610612738,2018,110.0,116.0,226.0,94.7,91.35,99.65,105.5,81,32,49,0.395,81,48,33,0.593,22,10,28,20,193.0,195.08,194.04000000000002
2019-04-09,1610612748,1610612755,2018,122.0,99.0,221.0,97.25,95.5,97.85,106.0,80,38,42,0.475,80,50,30,0.625,18,20,30,20,195.0,207.68,201.34
2019-04-09,1610612741,1610612752,2018,86.0,96.0,182.0,94.0,91.0,101.2,97.2,80,22,58,0.275,80,16,64,0.2,9,13,9,7,185.44,200.28,192.86
2019-04-09,1610612750,1610612761,2018,100.0,120.0,220.0,110.05,111.2,100.6,99.2,80,36,44,0.45,81,57,24,0.7040000000000001,25,11,32,25,209.4,206.0,207.7
2019-04-09,1610612740,1610612744,2018,103.0,112.0,215.0,100.45,104.8,107.5,105.85,81,33,48,0.407,80,56,24,0.7,19,14,30,26,200.8,199.04,199.92000000000002
2019-04-09,1610612742,1610612756,2018,120.0,109.0,229.0,104.45,102.7,106.25,103.85,80,32,48,0.4,81,19,62,0.235,23,9,12,7,213.0,212.88,212.94
2019-04-09,1610612762,1610612743,2018,118.0,108.0,226.0,95.55,106.55,109.2,110.3,80,49,31,0.613,80,53,27,0.6629999999999999,28,21,33,20,200.2,217.04,208.62
2019-04-09,1610612760,1610612745,2018,112.0,111.0,223.0,101.8,103.4,112.7,109.85,80,47,33,0.588,81,53,28,0.654,26,21,31,22,210.36,216.24,213.3
2019-04-09,1610612747,1610612757,2018,101.0,104.0,205.0,107.3,114.65,104.75,105.45,81,37,44,0.457,80,51,29,0.638,22,15,31,20,219.28,209.44,214.36
2019-04-07,1610612761,1610612748,2018,117.0,109.0,226.0,100.6,99.2,97.25,95.5,80,56,24,0.7,79,38,41,0.481,31,25,18,20,206.0,195.0,200.5
2019-04-07,1610612739,1610612759,2018,90.0,112.0,202.0,101.9,101.55,107.75,96.55,80,19,61,0.238,80,46,34,0.575,13,6,31,15,195.48,204.12,199.8
2019-04-07,1610612750,1610612760,2018,126.0,132.0,258.0,110.05,111.2,101.8,103.4,79,36,43,0.456,79,46,33,0.5820000000000001,25,11,26,20,209.4,210.36,209.88
2019-04-07,1610612765,1610612766,2018,91.0,104.0,195.0,100.85,105.95,99.45,97.7,79,39,40,0.494,79,37,42,0.468,25,14,25,12,206.0,194.96,200.48000000000002
2019-04-07,1610612754,1610612751,2018,96.0,108.0,204.0,92.05,92.25,96.7,98.4,80,47,33,0.588,80,40,40,0.5,29,18,22,18,187.28,196.96,192.12
2019-04-07,1610612763,1610612742,2018,127.0,129.0,256.0,98.25,97.5,104.45,102.7,79,32,47,0.405,79,31,48,0.392,20,12,23,8,193.96,213.0,203.48000000000002
2019-04-07,1610612745,1610612756,2018,149.0,113.0,262.0,112.7,109.85,106.25,103.85,80,52,28,0.65,80,19,61,0.238,30,22,12,7,216.24,212.88,214.56
2019-04-07,1610612749,1610612737,2018,115.0,107.0,222.0,99.8,108.15,96.35,95.7,80,59,21,0.738,80,29,51,0.363,32,27,17,12,200.48,199.44,199.95999999999998
2019-04-07,1610612738,1610612753,2018,108.0,116.0,224.0,99.65,105.5,96.55,103.5,80,48,32,0.6,80,40,40,0.5,28,20,25,15,195.08,203.64,199.36
2019-04-07,1610612752,1610612764,2018,113.0,110.0,223.0,101.2,97.2,94.7,91.35,79,15,64,0.19,80,32,48,0.4,8,7,22,10,200.28,193.0,196.64
2019-04-07,1610612744,1610612746,2018,131.0,104.0,235.0,107.5,105.85,109.85,106.5,79,55,24,0.696,80,47,33,0.588,29,26,25,22,199.04,214.36,206.7
2019-04-07,1610612757,1610612743,2018,115.0,108.0,223.0,104.75,105.45,109.2,110.3,79,50,29,0.633,79,53,26,0.6709999999999999,30,20,33,20,209.44,217.04,213.24
2019-04-07,1610612758,1610612740,2018,129.0,133.0,262.0,97.75,101.5,100.45,104.8,80,39,41,0.488,80,32,48,0.4,24,15,19,13,207.08,200.8,203.94
2019-04-07,1610612747,1610612762,2018,113.0,109.0,222.0,107.3,114.65,95.55,106.55,80,36,44,0.45,79,49,30,0.62,21,15,28,21,219.28,200.2,209.74
2019-04-06,1610612749,1610612751,2018,128.0,133.0,261.0,99.8,108.15,96.7,98.4,79,59,20,0.747,79,39,40,0.494,32,27,22,17,200.48,196.96,198.72
2019-04-06,1610612741,1610612755,2018,96.0,116.0,212.0,94.0,91.0,97.85,106.0,79,22,57,0.278,79,49,30,0.62,9,13,30,19,185.44,207.68,196.56
2019-04-05,1610612766,1610612761,2018,113.0,111.0,224.0,99.45,97.7,100.6,99.2,78,36,42,0.462,79,56,23,0.7090000000000001,24,12,31,25,194.96,206.0,200.48000000000002
2019-04-05,1610612753,1610612737,2018,149.0,113.0,262.0,96.55,103.5,96.35,95.7,79,39,40,0.494,79,29,50,0.3670000000000001,24,15,17,12,203.64,199.44,201.54
2019-04-05,1610612764,1610612759,2018,112.0,129.0,241.0,94.7,91.35,107.75,96.55,79,32,47,0.405,79,45,34,0.57,22,10,31,14,193.0,204.12,198.56
2019-04-05,1610612754,1610612738,2018,97.0,117.0,214.0,92.05,92.25,99.65,105.5,79,47,32,0.595,79,47,32,0.595,29,18,28,19,187.28,195.08,191.18
2019-04-05,1610612745,1610612752,2018,120.0,96.0,216.0,112.7,109.85,101.2,97.2,79,51,28,0.6459999999999999,78,15,63,0.192,29,22,8,7,216.24,200.28,208.26
2019-04-05,1610612750,1610612748,2018,111.0,109.0,220.0,110.05,111.2,97.25,95.5,78,35,43,0.449,78,38,40,0.487,24,11,18,20,209.4,195.0,202.2
2019-04-05,1610612760,1610612765,2018,123.0,110.0,233.0,101.8,103.4,100.85,105.95,78,45,33,0.5770000000000001,78,39,39,0.5,25,20,25,14,210.36,206.0,208.18
2019-04-05,1610612742,1610612763,2018,112.0,122.0,234.0,104.45,102.7,98.25,97.5,78,31,47,0.397,78,31,47,0.397,23,8,20,11,213.0,193.96,203.48000000000002
2019-04-05,1610612762,1610612758,2018,119.0,98.0,217.0,95.55,106.55,97.75,101.5,78,48,30,0.615,79,39,40,0.494,27,21,24,15,200.2,207.08,203.64
2019-04-05,1610612756,1610612740,2018,133.0,126.0,259.0,106.25,103.85,100.45,104.8,79,18,61,0.228,79,32,47,0.405,11,7,19,13,212.88,200.8,206.84
2019-04-05,1610612743,1610612757,2018,119.0,110.0,229.0,109.2,110.3,104.75,105.45,78,52,26,0.667,78,50,28,0.6409999999999999,32,20,30,20,217.04,209.44,213.24
2019-04-05,1610612744,1610612739,2018,120.0,114.0,234.0,107.5,105.85,101.9,101.55,78,54,24,0.6920000000000001,79,19,60,0.241,28,26,13,6,199.04,195.48,197.26
2019-04-05,1610612746,1610612747,2018,117.0,122.0,239.0,109.85,106.5,107.3,114.65,79,47,32,0.595,79,35,44,0.443,25,22,21,14,214.36,219.28,216.82
2019-04-04,1610612755,1610612749,2018,122.0,128.0,250.0,97.85,106.0,99.8,108.15,78,49,29,0.628,78,58,20,0.7440000000000001,30,19,32,26,207.68,200.48,204.07999999999998
2019-04-04,1610612758,1610612739,2018,117.0,104.0,221.0,97.75,101.5,101.9,101.55,78,38,40,0.487,78,19,59,0.244,23,15,13,6,207.08,195.48,201.28
2019-04-04,1610612747,1610612744,2018,90.0,108.0,198.0,107.3,114.65,107.5,105.85,78,35,43,0.449,77,53,24,0.688,21,14,28,25,219.28,199.04,209.16
2019-04-03,1610612765,1610612754,2018,89.0,108.0,197.0,100.85,105.95,92.05,92.25,77,39,38,0.506,78,46,32,0.59,25,14,29,17,206.0,187.28,196.64
2019-04-03,1610612753,1610612752,2018,114.0,100.0,214.0,96.55,103.5,101.2,97.2,78,38,40,0.487,77,15,62,0.195,23,15,8,7,203.64,200.28,201.95999999999998
2019-04-03,1610612764,1610612741,2018,114.0,115.0,229.0,94.7,91.35,94.0,91.0,78,32,46,0.41,78,21,57,0.269,22,10,9,12,193.0,185.44,189.22
2019-04-03,1610612737,1610612755,2018,130.0,122.0,252.0,96.35,95.7,97.85,106.0,78,28,50,0.359,77,49,28,0.636,16,12,30,19,199.44,207.68,203.56
2019-04-03,1610612751,1610612761,2018,105.0,115.0,220.0,96.7,98.4,100.6,99.2,78,39,39,0.5,78,55,23,0.705,22,17,31,24,196.96,206.0,201.48000000000002
2019-04-03,1610612748,1610612738,2018,102.0,112.0,214.0,97.25,95.5,99.65,105.5,77,38,39,0.494,78,46,32,0.59,18,20,28,18,195.0,195.08,195.04000000000002
2019-04-03,1610612740,1610612766,2018,109.0,115.0,224.0,100.45,104.8,99.45,97.7,78,32,46,0.41,77,35,42,0.455,19,13,24,11,200.8,194.96,197.88
2019-04-03,1610612742,1610612750,2018,108.0,110.0,218.0,104.45,102.7,110.05,111.2,77,31,46,0.403,77,34,43,0.442,23,8,24,10,213.0,209.4,211.2
2019-04-03,1610612743,1610612759,2018,113.0,85.0,198.0,109.2,110.3,107.75,96.55,77,51,26,0.662,78,45,33,0.5770000000000001,31,20,31,14,217.04,204.12,210.57999999999998
2019-04-03,1610612756,1610612762,2018,97.0,118.0,215.0,106.25,103.85,95.55,106.55,78,18,60,0.231,77,47,30,0.61,11,7,27,20,212.88,200.2,206.54
2019-04-03,1610612757,1610612763,2018,116.0,89.0,205.0,104.75,105.45,98.25,97.5,77,49,28,0.636,77,31,46,0.403,29,20,20,11,209.44,193.96,201.7
2019-04-03,1610612746,1610612745,2018,103.0,135.0,238.0,109.85,106.5,112.7,109.85,78,47,31,0.603,78,50,28,0.6409999999999999,25,22,29,21,214.36,216.24,215.3
2019-04-02,1610612760,1610612747,2018,119.0,103.0,222.0,101.8,103.4,107.3,114.65,77,44,33,0.5710000000000001,77,35,42,0.455,24,20,21,14,210.36,219.28,214.82
2019-04-02,1610612759,1610612737,2018,117.0,111.0,228.0,107.75,96.55,96.35,95.7,77,44,33,0.5710000000000001,77,28,49,0.364,30,14,16,12,204.12,199.44,201.78
2019-04-02,1610612758,1610612745,2018,105.0,130.0,235.0,97.75,101.5,112.7,109.85,77,38,39,0.494,77,49,28,0.636,23,15,29,20,207.08,216.24,211.66000000000003
2019-04-02,1610612744,1610612743,2018,116.0,102.0,218.0,107.5,105.85,109.2,110.3,76,52,24,0.684,76,51,25,0.6709999999999999,27,25,31,20,199.04,217.04,208.04
2019-04-01,1610612754,1610612765,2018,111.0,102.0,213.0,92.05,92.25,100.85,105.95,77,45,32,0.584,76,39,37,0.513,28,17,25,14,187.28,206.0,196.64
2019-04-01,1610612738,1610612748,2018,110.0,105.0,215.0,99.65,105.5,97.25,95.5,77,45,32,0.584,76,38,38,0.5,27,18,18,20,195.08,195.0,195.04000000000002
2019-04-01,1610612751,1610612749,2018,121.0,131.0,252.0,96.7,98.4,99.8,108.15,77,39,38,0.506,77,57,20,0.74,22,17,32,25,196.96,200.48,198.72
2019-04-01,1610612752,1610612741,2018,113.0,105.0,218.0,101.2,97.2,94.0,91.0,76,14,62,0.184,77,21,56,0.273,7,7,9,12,200.28,185.44,192.86
2019-04-01,1610612761,1610612753,2018,121.0,109.0,230.0,100.6,99.2,96.55,103.5,77,54,23,0.701,77,38,39,0.494,30,24,23,15,206.0,203.64,204.82
2019-04-01,1610612750,1610612757,2018,122.0,132.0,254.0,110.05,111.2,104.75,105.45,76,34,42,0.447,76,48,28,0.632,24,10,29,19,209.4,209.44,209.42000000000002
2019-04-01,1610612742,1610612755,2018,122.0,102.0,224.0,104.45,102.7,97.85,106.0,76,30,46,0.395,76,49,27,0.645,22,8,30,19,213.0,207.68,210.34
2019-04-01,1610612762,1610612766,2018,111.0,102.0,213.0,95.55,106.55,99.45,97.7,76,46,30,0.605,76,35,41,0.461,26,20,24,11,200.2,194.96,197.57999999999998
2019-04-01,1610612756,1610612739,2018,122.0,113.0,235.0,106.25,103.85,101.9,101.55,77,17,60,0.221,77,19,58,0.247,10,7,13,6,212.88,195.48,204.18
2019-03-31,1610612737,1610612749,2018,136.0,135.0,271.0,96.35,95.7,99.8,108.15,76,27,49,0.355,76,57,19,0.75,15,12,32,25,199.44,200.48,199.95999999999998
2019-03-31,1610612760,1610612742,2018,103.0,106.0,209.0,101.8,103.4,104.45,102.7,76,44,32,0.579,75,29,46,0.387,24,20,22,7,210.36,213.0,211.68
2019-03-31,1610612740,1610612747,2018,102.0,130.0,232.0,100.45,104.8,107.3,114.65,77,32,45,0.416,76,34,42,0.447,19,13,21,13,200.8,219.28,210.04000000000002
2019-03-31,1610612759,1610612758,2018,106.0,113.0,219.0,107.75,96.55,97.75,101.5,76,44,32,0.579,76,37,39,0.487,30,14,23,14,204.12,207.08,205.60000000000002
2019-03-31,1610612743,1610612764,2018,90.0,95.0,185.0,109.2,110.3,94.7,91.35,75,51,24,0.68,77,31,46,0.403,31,20,22,9,217.04,193.0,205.01999999999998
2019-03-31,1610612744,1610612766,2018,137.0,90.0,227.0,107.5,105.85,99.45,97.7,75,51,24,0.68,75,35,40,0.467,26,25,24,11,199.04,194.96,197.0
2019-03-31,1610612746,1610612763,2018,113.0,96.0,209.0,109.85,106.5,98.25,97.5,77,46,31,0.597,76,31,45,0.408,24,22,20,11,214.36,193.96,204.16000000000003
2019-03-30,1610612746,1610612739,2018,132.0,108.0,240.0,109.85,106.5,101.9,101.55,76,45,31,0.5920000000000001,76,19,57,0.25,23,22,13,6,214.36,195.48,204.92000000000002
2019-03-30,1610612751,1610612738,2018,110.0,96.0,206.0,96.7,98.4,99.65,105.5,76,38,38,0.5,76,45,31,0.5920000000000001,21,17,27,18,196.96,195.08,196.02
2019-03-30,1610612745,1610612758,2018,119.0,108.0,227.0,112.7,109.85,97.75,101.5,76,48,28,0.632,75,37,38,0.493,28,20,23,14,216.24,207.08,211.66000000000003
2019-03-30,1610612765,1610612757,2018,99.0,90.0,189.0,100.85,105.95,104.75,105.45,75,38,37,0.507,75,48,27,0.64,24,14,29,19,206.0,209.44,207.72
2019-03-30,1610612754,1610612753,2018,116.0,121.0,237.0,92.05,92.25,96.55,103.5,76,45,31,0.5920000000000001,76,37,39,0.487,28,17,23,14,187.28,203.64,195.45999999999998
2019-03-30,1610612752,1610612748,2018,92.0,100.0,192.0,101.2,97.2,97.25,95.5,75,14,61,0.187,75,37,38,0.493,7,7,18,19,200.28,195.0,197.64
2019-03-30,1610612741,1610612761,2018,101.0,124.0,225.0,94.0,91.0,100.6,99.2,76,21,55,0.276,76,53,23,0.6970000000000001,9,12,30,23,185.44,206.0,195.72
2019-03-30,1610612750,1610612755,2018,109.0,118.0,227.0,110.05,111.2,97.85,106.0,75,34,41,0.453,75,48,27,0.64,24,10,30,18,209.4,207.68,208.54000000000002
2019-03-30,1610612756,1610612763,2018,115.0,120.0,235.0,106.25,103.85,98.25,97.5,76,17,59,0.224,75,30,45,0.4,10,7,20,10,212.88,193.96,203.42000000000002
2019-03-29,1610612738,1610612754,2018,114.0,112.0,226.0,99.65,105.5,92.05,92.25,75,44,31,0.5870000000000001,75,45,30,0.6,26,18,28,17,195.08,187.28,191.18
2019-03-29,1610612737,1610612757,2018,98.0,118.0,216.0,96.35,95.7,104.75,105.45,75,27,48,0.36,74,47,27,0.635,15,12,29,18,199.44,209.44,204.44
2019-03-29,1610612750,1610612744,2018,131.0,130.0,261.0,110.05,111.2,107.5,105.85,74,33,41,0.446,74,51,23,0.6890000000000001,23,10,26,25,209.4,199.04,204.22
2019-03-29,1610612760,1610612743,2018,105.0,115.0,220.0,101.8,103.4,109.2,110.3,75,44,31,0.5870000000000001,74,50,24,0.6759999999999999,24,20,31,19,210.36,217.04,213.7
2019-03-29,1610612762,1610612764,2018,128.0,124.0,252.0,95.55,106.55,94.7,91.35,75,45,30,0.6,76,31,45,0.408,25,20,22,9,200.2,193.0,196.6
2019-03-29,1610612747,1610612766,2018,129.0,115.0,244.0,107.3,114.65,99.45,97.7,75,33,42,0.44,74,35,39,0.473,20,13,24,11,219.28,194.96,207.12
2019-03-28,1610612765,1610612753,2018,115.0,98.0,213.0,100.85,105.95,96.55,103.5,74,37,37,0.5,75,37,38,0.493,23,14,23,14,206.0,203.64,204.82
2019-03-28,1610612755,1610612751,2018,123.0,110.0,233.0,97.85,106.0,96.7,98.4,74,47,27,0.635,75,38,37,0.507,29,18,21,17,207.68,196.96,202.32
2019-03-28,1610612748,1610612742,2018,105.0,99.0,204.0,97.25,95.5,104.45,102.7,74,36,38,0.486,74,29,45,0.392,17,19,22,7,195.0,213.0,204.0
2019-03-28,1610612752,1610612761,2018,92.0,117.0,209.0,101.2,97.2,100.6,99.2,74,14,60,0.189,75,52,23,0.693,7,7,30,22,200.28,206.0,203.14
2019-03-28,1610612745,1610612743,2018,112.0,85.0,197.0,112.7,109.85,109.2,110.3,75,47,28,0.627,73,50,23,0.685,27,20,31,19,216.24,217.04,216.64
2019-03-28,1610612749,1610612746,2018,128.0,118.0,246.0,99.8,108.15,109.85,106.5,75,56,19,0.747,75,45,30,0.6,31,25,23,22,200.48,214.36,207.42000000000002
2019-03-28,1610612740,1610612758,2018,121.0,118.0,239.0,100.45,104.8,97.75,101.5,76,31,45,0.408,74,37,37,0.5,18,13,23,14,200.8,207.08,203.94
2019-03-28,1610612759,1610612739,2018,116.0,110.0,226.0,107.75,96.55,101.9,101.55,75,43,32,0.573,75,19,56,0.253,29,14,13,6,204.12,195.48,199.8
2019-03-27,1610612741,1610612757,2018,98.0,118.0,216.0,94.0,91.0,104.75,105.45,75,21,54,0.28,73,46,27,0.63,9,12,29,17,185.44,209.44,197.44
2019-03-27,1610612763,1610612744,2018,103.0,118.0,221.0,98.25,97.5,107.5,105.85,74,30,44,0.405,73,50,23,0.685,20,10,26,24,193.96,199.04,196.5
2019-03-27,1610612760,1610612754,2018,107.0,99.0,206.0,101.8,103.4,92.05,92.25,74,43,31,0.581,74,45,29,0.608,23,20,28,17,210.36,187.28,198.82
2019-03-27,1610612756,1610612764,2018,121.0,124.0,245.0,106.25,103.85,94.7,91.35,75,17,58,0.227,75,30,45,0.4,10,7,22,8,212.88,193.0,202.94
2019-03-27,1610612762,1610612747,2018,115.0,100.0,215.0,95.55,106.55,107.3,114.65,74,44,30,0.595,74,33,41,0.446,24,20,20,13,200.2,219.28,209.74
2019-03-26,1610612766,1610612759,2018,125.0,116.0,241.0,99.45,97.7,107.75,96.55,73,34,39,0.466,74,43,31,0.581,23,11,29,14,194.96,204.12,199.54000000000002
2019-03-26,1610612739,1610612738,2018,106.0,116.0,222.0,101.9,101.55,99.65,105.5,74,19,55,0.257,74,43,31,0.581,13,6,26,17,195.48,195.08,195.28
2019-03-26,1610612748,1610612753,2018,99.0,104.0,203.0,97.25,95.5,96.55,103.5,73,36,37,0.493,74,36,38,0.486,17,19,23,13,195.0,203.64,199.32
2019-03-26,1610612761,1610612741,2018,112.0,103.0,215.0,100.6,99.2,94.0,91.0,74,51,23,0.6890000000000001,74,21,53,0.284,29,22,9,12,206.0,185.44,195.72
2019-03-26,1610612749,1610612745,2018,108.0,94.0,202.0,99.8,108.15,112.7,109.85,74,55,19,0.743,74,47,27,0.635,30,25,27,20,200.48,216.24,208.36
2019-03-26,1610612750,1610612746,2018,111.0,122.0,233.0,110.05,111.2,109.85,106.5,73,33,40,0.452,74,44,30,0.595,23,10,23,21,209.4,214.36,211.88
2019-03-26,1610612740,1610612737,2018,120.0,130.0,250.0,100.45,104.8,96.35,95.7,75,31,44,0.413,74,26,48,0.35100000000000003,18,13,15,11,200.8,199.44,200.12
2019-03-26,1610612742,1610612758,2018,121.0,125.0,246.0,104.45,102.7,97.75,101.5,73,29,44,0.397,73,36,37,0.493,22,7,23,13,213.0,207.08,210.04000000000002
2019-03-26,1610612743,1610612765,2018,95.0,92.0,187.0,109.2,110.3,100.85,105.95,72,49,23,0.6809999999999999,73,37,36,0.507,30,19,23,14,217.04,206.0,211.51999999999998
2019-03-26,1610612747,1610612764,2018,124.0,106.0,230.0,107.3,114.65,94.7,91.35,73,32,41,0.438,74,30,44,0.405,19,13,22,8,219.28,193.0,206.14
2019-03-25,1610612753,1610612755,2018,119.0,98.0,217.0,96.55,103.5,97.85,106.0,73,35,38,0.479,73,47,26,0.644,22,13,29,18,203.64,207.68,205.66
2019-03-25,1610612763,1610612760,2018,115.0,103.0,218.0,98.25,97.5,101.8,103.4,73,29,44,0.397,73,43,30,0.589,19,10,23,20,193.96,210.36,202.16000000000003
2019-03-25,1610612762,1610612756,2018,125.0,92.0,217.0,95.55,106.55,106.25,103.85,73,43,30,0.589,74,17,57,0.23,23,20,10,7,200.2,212.88,206.54
2019-03-25,1610612757,1610612751,2018,148.0,144.0,292.0,104.75,105.45,96.7,98.4,72,45,27,0.625,74,38,36,0.514,28,17,21,17,209.44,196.96,203.2
2019-03-24,1610612752,1610612746,2018,113.0,124.0,237.0,101.2,97.2,109.85,106.5,73,14,59,0.192,73,43,30,0.589,7,7,23,20,200.28,214.36,207.32
2019-03-24,1610612749,1610612739,2018,127.0,105.0,232.0,99.8,108.15,101.9,101.55,73,54,19,0.74,73,19,54,0.26,29,25,13,6,200.48,195.48,197.98
2019-03-24,1610612754,1610612743,2018,124.0,88.0,212.0,92.05,92.25,109.2,110.3,73,44,29,0.603,71,49,22,0.69,27,17,30,19,187.28,217.04,202.16
2019-03-24,1610612761,1610612766,2018,114.0,115.0,229.0,100.6,99.2,99.45,97.7,73,51,22,0.6990000000000001,72,33,39,0.458,29,22,23,10,206.0,194.96,200.48000000000002
2019-03-24,1610612740,1610612745,2018,90.0,113.0,203.0,100.45,104.8,112.7,109.85,74,31,43,0.419,73,46,27,0.63,18,13,27,19,200.8,216.24,208.52
2019-03-24,1610612738,1610612759,2018,96.0,115.0,211.0,99.65,105.5,107.75,96.55,73,43,30,0.589,73,42,31,0.575,26,17,29,13,195.08,204.12,199.60000000000002
2019-03-24,1610612744,1610612765,2018,121.0,114.0,235.0,107.5,105.85,100.85,105.95,72,49,23,0.6809999999999999,72,37,35,0.514,25,24,23,14,199.04,206.0,202.51999999999998
2019-03-24,1610612747,1610612758,2018,111.0,106.0,217.0,107.3,114.65,97.75,101.5,72,31,41,0.431,72,36,36,0.5,18,13,23,13,219.28,207.08,213.18
2019-03-23,1610612766,1610612738,2018,124.0,117.0,241.0,99.45,97.7,99.65,105.5,71,32,39,0.451,72,43,29,0.597,22,10,26,17,194.96,195.08,195.02
2019-03-23,1610612764,1610612748,2018,108.0,113.0,221.0,94.7,91.35,97.25,95.5,73,30,43,0.411,72,35,37,0.486,22,8,17,18,193.0,195.0,194.0
2019-03-23,1610612737,1610612755,2018,129.0,127.0,256.0,96.35,95.7,97.85,106.0,73,25,48,0.342,72,47,25,0.653,14,11,29,18,199.44,207.68,203.56
2019-03-23,1610612741,1610612762,2018,83.0,114.0,197.0,94.0,91.0,95.55,106.55,73,21,52,0.28800000000000003,72,42,30,0.583,9,12,23,19,185.44,200.2,192.82
2019-03-23,1610612763,1610612750,2018,99.0,112.0,211.0,98.25,97.5,110.05,111.2,72,29,43,0.403,72,32,40,0.444,19,10,23,9,193.96,209.4,201.68
2019-03-23,1610612744,1610612742,2018,91.0,126.0,217.0,107.5,105.85,104.45,102.7,71,49,22,0.69,72,28,44,0.389,25,24,22,6,199.04,213.0,206.01999999999998
2019-03-23,1610612757,1610612765,2018,117.0,112.0,229.0,104.75,105.45,100.85,105.95,71,44,27,0.62,71,37,34,0.521,27,17,23,14,209.44,206.0,207.72
2019-03-23,1610612758,1610612756,2018,112.0,103.0,215.0,97.75,101.5,106.25,103.85,71,35,36,0.493,73,17,56,0.233,22,13,10,7,207.08,212.88,209.98000000000002
2019-03-22,1610612753,1610612763,2018,123.0,119.0,242.0,96.55,103.5,98.25,97.5,72,34,38,0.472,71,29,42,0.408,21,13,19,10,203.64,193.96,198.8
2019-03-22,1610612739,1610612746,2018,108.0,110.0,218.0,101.9,101.55,109.85,106.5,72,19,53,0.264,72,42,30,0.583,13,6,23,19,195.48,214.36,204.92000000000002
2019-03-22,1610612752,1610612743,2018,93.0,111.0,204.0,101.2,97.2,109.2,110.3,72,14,58,0.194,70,48,22,0.6859999999999999,7,7,30,18,200.28,217.04,208.66
2019-03-22,1610612761,1610612760,2018,109.0,116.0,225.0,100.6,99.2,101.8,103.4,72,51,21,0.708,72,42,30,0.583,29,22,23,19,206.0,210.36,208.18
2019-03-22,1610612745,1610612759,2018,111.0,105.0,216.0,112.7,109.85,107.75,96.55,72,45,27,0.625,72,42,30,0.583,26,19,29,13,216.24,204.12,210.18
2019-03-22,1610612749,1610612748,2018,116.0,87.0,203.0,99.8,108.15,97.25,95.5,72,53,19,0.736,71,35,36,0.493,28,25,17,18,200.48,195.0,197.74
2019-03-22,1610612747,1610612751,2018,106.0,111.0,217.0,107.3,114.65,96.7,98.4,71,31,40,0.4370000000000001,73,37,36,0.507,18,13,21,16,219.28,196.96,208.12
2019-03-21,1610612766,1610612750,2018,113.0,106.0,219.0,99.45,97.7,110.05,111.2,70,31,39,0.443,71,32,39,0.451,21,10,23,9,194.96,209.4,202.18
2019-03-21,1610612764,1610612743,2018,108.0,113.0,221.0,94.7,91.35,109.2,110.3,72,30,42,0.417,69,47,22,0.6809999999999999,22,8,30,17,193.0,217.04,205.01999999999998
2019-03-21,1610612737,1610612762,2018,117.0,114.0,231.0,96.35,95.7,95.55,106.55,72,24,48,0.333,71,42,29,0.5920000000000001,13,11,23,19,199.44,200.2,199.82
2019-03-21,1610612756,1610612765,2018,98.0,118.0,216.0,106.25,103.85,100.85,105.95,72,17,55,0.236,70,36,34,0.514,10,7,23,13,212.88,206.0,209.44
2019-03-21,1610612758,1610612742,2018,116.0,100.0,216.0,97.75,101.5,104.45,102.7,70,34,36,0.486,71,28,43,0.394,21,13,22,6,207.08,213.0,210.04000000000002
2019-03-21,1610612744,1610612754,2018,112.0,89.0,201.0,107.5,105.85,92.05,92.25,70,48,22,0.6859999999999999,72,44,28,0.611,24,24,27,17,199.04,187.28,193.16
2019-03-20,1610612739,1610612749,2018,107.0,102.0,209.0,101.9,101.55,99.8,108.15,71,18,53,0.254,71,53,18,0.746,12,6,28,25,195.48,200.48,197.98
2019-03-20,1610612753,1610612740,2018,119.0,96.0,215.0,96.55,103.5,100.45,104.8,71,33,38,0.465,73,31,42,0.425,20,13,18,13,203.64,200.8,202.22
2019-03-20,1610612755,1610612738,2018,118.0,115.0,233.0,97.85,106.0,99.65,105.5,71,46,25,0.648,71,43,28,0.606,28,18,26,17,207.68,195.08,201.38
2019-03-20,1610612752,1610612762,2018,116.0,137.0,253.0,101.2,97.2,95.55,106.55,71,14,57,0.197,70,41,29,0.586,7,7,23,18,200.28,200.2,200.24
2019-03-20,1610612741,1610612764,2018,126.0,120.0,246.0,94.0,91.0,94.7,91.35,72,20,52,0.278,71,30,41,0.423,8,12,22,8,185.44,193.0,189.22
2019-03-20,1610612763,1610612745,2018,126.0,125.0,251.0,98.25,97.5,112.7,109.85,70,28,42,0.4,71,45,26,0.634,18,10,26,19,193.96,216.24,205.10000000000002
2019-03-20,1610612759,1610612748,2018,105.0,110.0,215.0,107.75,96.55,97.25,95.5,71,42,29,0.5920000000000001,70,34,36,0.486,29,13,17,17,204.12,195.0,199.56
2019-03-20,1610612760,1610612761,2018,114.0,123.0,237.0,101.8,103.4,100.6,99.2,71,42,29,0.5920000000000001,71,50,21,0.7040000000000001,23,19,29,21,210.36,206.0,208.18
2019-03-20,1610612757,1610612742,2018,126.0,118.0,244.0,104.75,105.45,104.45,102.7,70,43,27,0.614,70,28,42,0.4,26,17,22,6,209.44,213.0,211.22
2019-03-19,1610612766,1610612755,2018,114.0,118.0,232.0,99.45,97.7,97.85,106.0,69,31,38,0.449,70,45,25,0.643,21,10,28,17,194.96,207.68,201.32
2019-03-19,1610612737,1610612745,2018,105.0,121.0,226.0,96.35,95.7,112.7,109.85,71,24,47,0.338,70,44,26,0.629,13,11,26,18,199.44,216.24,207.84
2019-03-19,1610612749,1610612747,2018,115.0,101.0,216.0,99.8,108.15,107.3,114.65,70,52,18,0.743,70,31,39,0.443,27,25,18,13,200.48,219.28,209.88
2019-03-19,1610612750,1610612744,2018,107.0,117.0,224.0,110.05,111.2,107.5,105.85,70,32,38,0.457,69,47,22,0.6809999999999999,23,9,24,23,209.4,199.04,204.22
2019-03-19,1610612758,1610612751,2018,121.0,123.0,244.0,97.75,101.5,96.7,98.4,69,34,35,0.493,72,36,36,0.5,21,13,21,15,207.08,196.96,202.02
2019-03-19,1610612746,1610612754,2018,115.0,109.0,224.0,109.85,106.5,92.05,92.25,71,41,30,0.5770000000000001,71,44,27,0.62,22,19,27,17,214.36,187.28,200.82
2019-03-18,1610612739,1610612765,2018,126.0,119.0,245.0,101.9,101.55,100.85,105.95,70,17,53,0.243,69,36,33,0.522,11,6,23,13,195.48,206.0,200.74
2019-03-18,1610612764,1610612762,2018,95.0,116.0,211.0,94.7,91.35,95.55,106.55,70,30,40,0.429,69,40,29,0.58,22,8,23,17,193.0,200.2,196.6
2019-03-18,1610612738,1610612743,2018,105.0,114.0,219.0,99.65,105.5,109.2,110.3,70,43,27,0.614,68,46,22,0.6759999999999999,26,17,30,16,195.08,217.04,206.06
2019-03-18,1610612761,1610612752,2018,128.0,92.0,220.0,100.6,99.2,101.2,97.2,70,49,21,0.7,70,14,56,0.2,28,21,7,7,206.0,200.28,203.14
2019-03-18,1610612760,1610612748,2018,107.0,116.0,223.0,101.8,103.4,97.25,95.5,70,42,28,0.6,69,33,36,0.478,23,19,17,16,210.36,195.0,202.68
2019-03-18,1610612759,1610612744,2018,111.0,105.0,216.0,107.75,96.55,107.5,105.85,70,41,29,0.586,68,47,21,0.691,28,13,24,23,204.12,199.04,201.57999999999998
2019-03-18,1610612742,1610612740,2018,125.0,129.0,254.0,104.45,102.7,100.45,104.8,69,28,41,0.406,72,30,42,0.417,22,6,18,12,213.0,200.8,206.9
2019-03-18,1610612756,1610612741,2018,101.0,116.0,217.0,106.25,103.85,94.0,91.0,71,17,54,0.239,71,19,52,0.268,10,7,8,11,212.88,185.44,199.16
2019-03-18,1610612757,1610612754,2018,106.0,98.0,204.0,104.75,105.45,92.05,92.25,69,42,27,0.609,70,44,26,0.629,25,17,27,17,209.44,187.28,198.36
2019-03-17,1610612752,1610612747,2018,124.0,123.0,247.0,101.2,97.2,107.3,114.65,69,13,56,0.188,69,31,38,0.449,6,7,18,13,200.28,219.28,209.78
2019-03-17,1610612748,1610612766,2018,93.0,75.0,168.0,97.25,95.5,99.45,97.7,68,32,36,0.471,68,31,37,0.456,16,16,21,10,195.0,194.96,194.98000000000002
2019-03-17,1610612749,1610612755,2018,125.0,130.0,255.0,99.8,108.15,97.85,106.0,69,52,17,0.754,69,44,25,0.638,27,25,28,16,200.48,207.68,204.07999999999998
2019-03-17,1610612765,1610612761,2018,110.0,107.0,217.0,100.85,105.95,100.6,99.2,68,35,33,0.515,69,49,20,0.71,22,13,28,21,206.0,206.0,206.0
2019-03-17,1610612753,1610612737,2018,101.0,91.0,192.0,96.55,103.5,96.35,95.7,70,32,38,0.457,70,24,46,0.343,19,13,13,11,203.64,199.44,201.54
2019-03-17,1610612758,1610612741,2018,129.0,102.0,231.0,97.75,101.5,94.0,91.0,68,33,35,0.485,70,19,51,0.271,20,13,8,11,207.08,185.44,196.26
2019-03-17,1610612745,1610612750,2018,117.0,102.0,219.0,112.7,109.85,110.05,111.2,69,43,26,0.623,69,32,37,0.464,25,18,23,9,216.24,209.4,212.82
2019-03-17,1610612746,1610612751,2018,119.0,116.0,235.0,109.85,106.5,96.7,98.4,70,40,30,0.5710000000000001,71,36,35,0.507,21,19,21,15,214.36,196.96,205.66000000000003
2019-03-16,1610612738,1610612737,2018,129.0,120.0,249.0,99.65,105.5,96.35,95.7,69,42,27,0.609,69,24,45,0.348,25,17,13,11,195.08,199.44,197.26
2019-03-16,1610612764,1610612763,2018,135.0,128.0,263.0,94.7,91.35,98.25,97.5,69,29,40,0.42,69,28,41,0.406,21,8,18,10,193.0,193.96,193.48000000000002
2019-03-16,1610612740,1610612756,2018,136.0,138.0,274.0,100.45,104.8,106.25,103.85,71,30,41,0.423,70,16,54,0.229,18,12,10,6,200.8,212.88,206.84
2019-03-16,1610612742,1610612739,2018,121.0,116.0,237.0,104.45,102.7,101.9,101.55,68,27,41,0.397,69,17,52,0.246,21,6,11,6,213.0,195.48,204.24
2019-03-16,1610612760,1610612744,2018,88.0,110.0,198.0,101.8,103.4,107.5,105.85,69,42,27,0.609,67,46,21,0.687,23,19,24,22,210.36,199.04,204.7
2019-03-16,1610612759,1610612757,2018,108.0,103.0,211.0,107.75,96.55,104.75,105.45,69,40,29,0.58,68,42,26,0.618,27,13,25,17,204.12,209.44,206.78
2019-03-16,1610612743,1610612754,2018,102.0,100.0,202.0,109.2,110.3,92.05,92.25,67,45,22,0.672,69,44,25,0.638,29,16,27,17,217.04,187.28,202.16
2019-03-16,1610612762,1610612751,2018,114.0,98.0,212.0,95.55,106.55,96.7,98.4,68,39,29,0.574,70,36,34,0.514,22,17,21,15,200.2,196.96,198.57999999999998
2019-03-15,1610612765,1610612747,2018,111.0,97.0,208.0,100.85,105.95,107.3,114.65,67,34,33,0.507,68,31,37,0.456,21,13,18,13,206.0,219.28,212.64
2019-03-15,1610612755,1610612758,2018,123.0,114.0,237.0,97.85,106.0,97.75,101.5,68,43,25,0.632,67,33,34,0.493,27,16,20,13,207.68,207.08,207.38
2019-03-15,1610612764,1610612766,2018,110.0,116.0,226.0,94.7,91.35,99.45,97.7,68,29,39,0.426,67,30,37,0.448,21,8,21,9,193.0,194.96,193.98000000000002
2019-03-15,1610612748,1610612749,2018,98.0,113.0,211.0,97.25,95.5,99.8,108.15,67,32,35,0.478,68,51,17,0.75,16,16,27,24,195.0,200.48,197.74
2019-03-15,1610612745,1610612756,2018,108.0,102.0,210.0,112.7,109.85,106.25,103.85,68,42,26,0.618,69,16,53,0.232,24,18,10,6,216.24,212.88,214.56
2019-03-15,1610612740,1610612757,2018,110.0,122.0,232.0,100.45,104.8,104.75,105.45,70,30,40,0.429,67,41,26,0.612,18,12,25,16,200.8,209.44,205.12
2019-03-15,1610612759,1610612752,2018,109.0,83.0,192.0,107.75,96.55,101.2,97.2,68,39,29,0.574,68,13,55,0.191,26,13,6,7,204.12,200.28,202.2
2019-03-15,1610612746,1610612741,2018,128.0,121.0,249.0,109.85,106.5,94.0,91.0,69,39,30,0.565,69,19,50,0.275,20,19,8,11,214.36,185.44,199.9
2019-03-14,1610612754,1610612760,2018,108.0,106.0,214.0,92.05,92.25,101.8,103.4,68,43,25,0.632,68,42,26,0.618,26,17,23,19,187.28,210.36,198.82
2019-03-14,1610612753,1610612739,2018,120.0,91.0,211.0,96.55,103.5,101.9,101.55,69,31,38,0.449,68,17,51,0.25,18,13,11,6,203.64,195.48,199.56
2019-03-14,1610612738,1610612758,2018,126.0,120.0,246.0,99.65,105.5,97.75,101.5,68,41,27,0.603,66,33,33,0.5,24,17,20,13,195.08,207.08,201.08
2019-03-14,1610612761,1610612747,2018,111.0,98.0,209.0,100.6,99.2,107.3,114.65,68,48,20,0.706,67,31,36,0.463,27,21,18,13,206.0,219.28,212.64
2019-03-14,1610612762,1610612750,2018,120.0,100.0,220.0,95.55,106.55,110.05,111.2,67,38,29,0.5670000000000001,68,32,36,0.471,21,17,23,9,200.2,209.4,204.8
2019-03-14,1610612743,1610612742,2018,100.0,99.0,199.0,109.2,110.3,104.45,102.7,66,44,22,0.667,67,27,40,0.403,28,16,21,6,217.04,213.0,215.01999999999998
2019-03-13,1610612764,1610612753,2018,100.0,90.0,190.0,94.7,91.35,96.55,103.5,67,28,39,0.418,68,31,37,0.456,20,8,18,13,193.0,203.64,198.32
2019-03-13,1610612760,1610612751,2018,108.0,96.0,204.0,101.8,103.4,96.7,98.4,67,41,26,0.612,69,36,33,0.522,22,19,21,15,210.36,196.96,203.66000000000003
2019-03-13,1610612748,1610612765,2018,108.0,74.0,182.0,97.25,95.5,100.85,105.95,66,31,35,0.47,66,34,32,0.515,15,16,21,13,195.0,206.0,200.5
2019-03-13,1610612737,1610612763,2018,132.0,111.0,243.0,96.35,95.7,98.25,97.5,68,23,45,0.338,68,28,40,0.412,12,11,18,10,199.44,193.96,196.7
2019-03-13,1610612745,1610612744,2018,104.0,106.0,210.0,112.7,109.85,107.5,105.85,67,42,25,0.627,66,45,21,0.682,24,18,24,21,216.24,199.04,207.64
2019-03-13,1610612756,1610612762,2018,97.0,114.0,211.0,106.25,103.85,95.55,106.55,68,16,52,0.235,66,37,29,0.561,10,6,21,16,212.88,200.2,206.54
2019-03-12,1610612754,1610612752,2018,103.0,98.0,201.0,92.05,92.25,101.2,97.2,67,42,25,0.627,67,13,54,0.194,25,17,6,7,187.28,200.28,193.78
2019-03-12,1610612755,1610612739,2018,106.0,99.0,205.0,97.85,106.0,101.9,101.55,67,42,25,0.627,67,17,50,0.254,26,16,11,6,207.68,195.48,201.57999999999998
2019-03-12,1610612741,1610612747,2018,107.0,123.0,230.0,94.0,91.0,107.3,114.65,68,19,49,0.279,66,30,36,0.455,8,11,18,12,185.44,219.28,202.36
2019-03-12,1610612740,1610612749,2018,113.0,130.0,243.0,100.45,104.8,99.8,108.15,69,30,39,0.435,67,50,17,0.746,18,12,27,23,200.8,200.48,200.64
2019-03-12,1610612742,1610612759,2018,105.0,112.0,217.0,104.45,102.7,107.75,96.55,66,27,39,0.409,67,38,29,0.5670000000000001,21,6,26,12,213.0,204.12,208.56
2019-03-12,1610612743,1610612750,2018,133.0,107.0,240.0,109.2,110.3,110.05,111.2,65,43,22,0.662,67,32,35,0.478,27,16,23,9,217.04,209.4,213.22
2019-03-12,1610612746,1610612757,2018,104.0,125.0,229.0,109.85,106.5,104.75,105.45,68,39,29,0.574,66,40,26,0.606,20,19,25,15,214.36,209.44,211.9
2019-03-11,1610612739,1610612761,2018,126.0,101.0,227.0,101.9,101.55,100.6,99.2,66,16,50,0.242,67,48,19,0.716,10,6,27,21,195.48,206.0,200.74
2019-03-11,1610612764,1610612758,2018,121.0,115.0,236.0,94.7,91.35,97.75,101.5,66,27,39,0.409,65,33,32,0.508,19,8,20,13,193.0,207.08,200.04000000000002
2019-03-11,1610612751,1610612765,2018,103.0,75.0,178.0,96.7,98.4,100.85,105.95,68,35,33,0.515,65,34,31,0.523,20,15,21,13,196.96,206.0,201.48000000000002
2019-03-11,1610612745,1610612766,2018,118.0,106.0,224.0,112.7,109.85,99.45,97.7,66,41,25,0.621,66,30,36,0.455,23,18,21,9,216.24,194.96,205.60000000000002
2019-03-11,1610612762,1610612760,2018,89.0,98.0,187.0,95.55,106.55,101.8,103.4,65,37,28,0.569,66,40,26,0.606,21,16,22,18,200.2,210.36,205.28
2019-03-11,1610612746,1610612738,2018,140.0,115.0,255.0,109.85,106.5,99.65,105.5,67,38,29,0.5670000000000001,67,41,26,0.612,19,19,24,17,214.36,195.08,204.72000000000003
2019-03-10,1610612765,1610612741,2018,131.0,108.0,239.0,100.85,105.95,94.0,91.0,64,33,31,0.516,67,19,48,0.284,20,13,8,11,206.0,185.44,195.72
2019-03-10,1610612748,1610612761,2018,104.0,125.0,229.0,97.25,95.5,100.6,99.2,65,31,34,0.477,66,47,19,0.7120000000000001,15,16,27,20,195.0,206.0,200.5
2019-03-10,1610612755,1610612754,2018,106.0,89.0,195.0,97.85,106.0,92.05,92.25,66,41,25,0.621,66,42,24,0.636,25,16,25,17,207.68,187.28,197.48000000000002
2019-03-10,1610612737,1610612740,2018,128.0,116.0,244.0,96.35,95.7,100.45,104.8,67,22,45,0.328,68,30,38,0.441,11,11,18,12,199.44,200.8,200.12
2019-03-10,1610612763,1610612753,2018,105.0,97.0,202.0,98.25,97.5,96.55,103.5,67,27,40,0.403,67,31,36,0.463,17,10,18,13,193.96,203.64,198.8
2019-03-10,1610612742,1610612745,2018,93.0,94.0,187.0,104.45,102.7,112.7,109.85,65,27,38,0.415,65,40,25,0.615,21,6,23,17,213.0,216.24,214.62
2019-03-10,1610612750,1610612752,2018,103.0,92.0,195.0,110.05,111.2,101.2,97.2,66,31,35,0.47,66,13,53,0.197,22,9,6,7,209.4,200.28,204.84
2019-03-10,1610612759,1610612749,2018,121.0,114.0,235.0,107.75,96.55,99.8,108.15,66,37,29,0.561,66,50,16,0.758,25,12,27,23,204.12,200.48,202.3
2019-03-10,1610612744,1610612756,2018,111.0,115.0,226.0,107.5,105.85,106.25,103.85,65,45,20,0.6920000000000001,67,15,52,0.224,24,21,10,5,199.04,212.88,205.95999999999998
2019-03-09,1610612752,1610612758,2018,94.0,102.0,196.0,101.2,97.2,97.75,101.5,65,13,52,0.2,64,32,32,0.5,6,7,20,12,200.28,207.08,203.68
2019-03-09,1610612737,1610612751,2018,112.0,114.0,226.0,96.35,95.7,96.7,98.4,66,22,44,0.333,67,34,33,0.507,11,11,20,14,199.44,196.96,198.2
2019-03-09,1610612750,1610612764,2018,135.0,130.0,265.0,110.05,111.2,94.7,91.35,65,30,35,0.462,65,27,38,0.415,21,9,19,8,209.4,193.0,201.2
2019-03-09,1610612747,1610612738,2018,107.0,120.0,227.0,107.3,114.65,99.65,105.5,65,30,35,0.462,66,40,26,0.606,18,12,24,16,219.28,195.08,207.18
2019-03-09,1610612749,1610612766,2018,131.0,114.0,245.0,99.8,108.15,99.45,97.7,65,49,16,0.754,65,30,35,0.462,26,23,21,9,200.48,194.96,197.72
2019-03-09,1610612757,1610612756,2018,127.0,120.0,247.0,104.75,105.45,106.25,103.85,65,39,26,0.6,66,15,51,0.227,24,15,10,5,209.44,212.88,211.16
2019-03-08,1610612766,1610612764,2018,112.0,111.0,223.0,99.45,97.7,94.7,91.35,64,29,35,0.453,64,27,37,0.422,20,9,19,8,194.96,193.0,193.98000000000002
2019-03-08,1610612753,1610612742,2018,111.0,106.0,217.0,96.55,103.5,104.45,102.7,66,30,36,0.455,64,27,37,0.422,17,13,21,6,203.64,213.0,208.32
2019-03-08,1610612748,1610612739,2018,126.0,110.0,236.0,97.25,95.5,101.9,101.55,64,30,34,0.469,65,16,49,0.246,14,16,10,6,195.0,195.48,195.24
2019-03-08,1610612741,1610612765,2018,104.0,112.0,216.0,94.0,91.0,100.85,105.95,66,19,47,0.28800000000000003,63,32,31,0.508,8,11,20,12,185.44,206.0,195.72
2019-03-08,1610612745,1610612755,2018,107.0,91.0,198.0,112.7,109.85,97.85,106.0,64,39,25,0.609,65,41,24,0.631,22,17,25,16,216.24,207.68,211.96
2019-03-08,1610612763,1610612762,2018,114.0,104.0,218.0,98.25,97.5,95.55,106.55,66,26,40,0.394,64,37,27,0.578,16,10,21,16,193.96,200.2,197.07999999999998
2019-03-08,1610612740,1610612761,2018,104.0,127.0,231.0,100.45,104.8,100.6,99.2,67,30,37,0.448,65,46,19,0.708,18,12,27,19,200.8,206.0,203.4
2019-03-08,1610612744,1610612743,2018,122.0,105.0,227.0,107.5,105.85,109.2,110.3,64,44,20,0.688,64,43,21,0.672,23,21,27,16,199.04,217.04,208.04
2019-03-08,1610612746,1610612760,2018,118.0,110.0,228.0,109.85,106.5,101.8,103.4,66,37,29,0.561,65,40,25,0.615,18,19,22,18,214.36,210.36,212.36
2019-03-07,1610612749,1610612754,2018,117.0,98.0,215.0,99.8,108.15,92.05,92.25,64,48,16,0.75,65,42,23,0.6459999999999999,25,23,25,17,200.48,187.28,193.88
2019-03-07,1610612757,1610612760,2018,121.0,129.0,250.0,104.75,105.45,101.8,103.4,64,39,25,0.609,64,39,25,0.609,24,15,22,17,209.44,210.36,209.9
2019-03-06,1610612766,1610612748,2018,84.0,91.0,175.0,99.45,97.7,97.25,95.5,63,29,34,0.46,63,29,34,0.46,20,9,14,15,194.96,195.0,194.98000000000002
2019-03-06,1610612765,1610612750,2018,131.0,114.0,245.0,100.85,105.95,110.05,111.2,62,31,31,0.5,64,30,34,0.469,19,12,21,9,206.0,209.4,207.7
2019-03-06,1610612764,1610612742,2018,132.0,123.0,255.0,94.7,91.35,104.45,102.7,63,26,37,0.413,63,27,36,0.429,18,8,21,6,193.0,213.0,203.0
2019-03-06,1610612737,1610612759,2018,104.0,111.0,215.0,96.35,95.7,107.75,96.55,65,22,43,0.338,65,36,29,0.5539999999999999,11,11,25,11,199.44,204.12,201.78
2019-03-06,1610612751,1610612739,2018,113.0,107.0,220.0,96.7,98.4,101.9,101.55,66,33,33,0.5,64,16,48,0.25,19,14,10,6,196.96,195.48,196.22
2019-03-06,1610612741,1610612755,2018,108.0,107.0,215.0,94.0,91.0,97.85,106.0,65,18,47,0.277,64,41,23,0.6409999999999999,7,11,25,16,185.44,207.68,196.56
2019-03-06,1610612740,1610612762,2018,104.0,114.0,218.0,100.45,104.8,95.55,106.55,66,30,36,0.455,63,36,27,0.5710000000000001,18,12,21,15,200.8,200.2,200.5
2019-03-06,1610612756,1610612752,2018,107.0,96.0,203.0,106.25,103.85,101.2,97.2,65,14,51,0.215,64,13,51,0.203,9,5,6,7,212.88,200.28,206.57999999999998
2019-03-06,1610612758,1610612738,2018,109.0,111.0,220.0,97.75,101.5,99.65,105.5,63,32,31,0.508,65,39,26,0.6,20,12,24,15,207.08,195.08,201.08
2019-03-06,1610612747,1610612743,2018,99.0,115.0,214.0,107.3,114.65,109.2,110.3,64,30,34,0.469,63,42,21,0.667,18,12,27,15,219.28,217.04,218.16
2019-03-05,1610612754,1610612741,2018,105.0,96.0,201.0,92.05,92.25,94.0,91.0,64,41,23,0.6409999999999999,64,18,46,0.281,24,17,7,11,187.28,185.44,186.36
2019-03-05,1610612755,1610612753,2018,114.0,106.0,220.0,97.85,106.0,96.55,103.5,63,40,23,0.635,65,30,35,0.462,24,16,17,13,207.68,203.64,205.66
2019-03-05,1610612761,1610612745,2018,95.0,107.0,202.0,100.6,99.2,112.7,109.85,64,46,18,0.7190000000000001,63,38,25,0.603,27,19,22,16,206.0,216.24,211.12
2019-03-05,1610612763,1610612757,2018,120.0,111.0,231.0,98.25,97.5,104.75,105.45,65,25,40,0.385,63,39,24,0.619,15,10,24,15,193.96,209.44,201.7
2019-03-05,1610612750,1610612760,2018,131.0,120.0,251.0,110.05,111.2,101.8,103.4,63,29,34,0.46,63,39,24,0.619,20,9,22,17,209.4,210.36,209.88
2019-03-05,1610612744,1610612738,2018,95.0,128.0,223.0,107.5,105.85,99.65,105.5,63,44,19,0.698,64,38,26,0.594,23,21,24,14,199.04,195.08,197.06
2019-03-04,1610612751,1610612742,2018,127.0,88.0,215.0,96.7,98.4,104.45,102.7,65,32,33,0.4920000000000001,62,27,35,0.435,18,14,21,6,196.96,213.0,204.98000000000002
2019-03-04,1610612748,1610612737,2018,114.0,113.0,227.0,97.25,95.5,96.35,95.7,62,28,34,0.452,64,22,42,0.344,13,15,11,11,195.0,199.44,197.22
2019-03-04,1610612759,1610612743,2018,104.0,103.0,207.0,107.75,96.55,109.2,110.3,64,35,29,0.547,62,42,20,0.677,24,11,27,15,204.12,217.04,210.57999999999998
2019-03-04,1610612756,1610612749,2018,114.0,105.0,219.0,106.25,103.85,99.8,108.15,64,13,51,0.203,63,48,15,0.762,8,5,25,23,212.88,200.48,206.68
2019-03-04,1610612762,1610612740,2018,112.0,115.0,227.0,95.55,106.55,100.45,104.8,62,36,26,0.581,65,29,36,0.446,21,15,18,11,200.2,200.8,200.5
2019-03-04,1610612758,1610612752,2018,115.0,108.0,223.0,97.75,101.5,101.2,97.2,62,31,31,0.5,63,13,50,0.206,19,12,6,7,207.08,200.28,203.68
2019-03-04,1610612747,1610612746,2018,105.0,113.0,218.0,107.3,114.65,109.85,106.5,63,30,33,0.476,65,36,29,0.5539999999999999,18,12,18,18,219.28,214.36,216.82
2019-03-03,1610612766,1610612757,2018,108.0,118.0,226.0,99.45,97.7,104.75,105.45,62,29,33,0.468,62,38,24,0.613,20,9,24,14,194.96,209.44,202.2
2019-03-03,1610612738,1610612745,2018,104.0,115.0,219.0,99.65,105.5,112.7,109.85,63,38,25,0.603,62,37,25,0.597,24,14,22,15,195.08,216.24,205.66000000000003
2019-03-03,1610612741,1610612737,2018,118.0,123.0,241.0,94.0,91.0,96.35,95.7,63,18,45,0.28600000000000003,63,21,42,0.333,7,11,11,10,185.44,199.44,192.44
2019-03-03,1610612746,1610612752,2018,128.0,107.0,235.0,109.85,106.5,101.2,97.2,64,35,29,0.547,62,13,49,0.21,17,18,6,7,214.36,200.28,207.32
2019-03-03,1610612739,1610612753,2018,107.0,93.0,200.0,101.9,101.55,96.55,103.5,63,15,48,0.238,64,30,34,0.469,9,6,17,13,195.48,203.64,199.56
2019-03-03,1610612765,1610612761,2018,112.0,107.0,219.0,100.85,105.95,100.6,99.2,61,30,31,0.4920000000000001,63,46,17,0.73,18,12,27,19,206.0,206.0,206.0
2019-03-03,1610612764,1610612750,2018,135.0,121.0,256.0,94.7,91.35,110.05,111.2,62,25,37,0.403,62,29,33,0.468,17,8,20,9,193.0,209.4,201.2
2019-03-03,1610612760,1610612763,2018,99.0,95.0,194.0,101.8,103.4,98.25,97.5,62,38,24,0.613,64,25,39,0.391,21,17,15,10,210.36,193.96,202.16000000000003
2019-03-02,1610612739,1610612765,2018,93.0,129.0,222.0,101.9,101.55,100.85,105.95,62,15,47,0.242,60,29,31,0.483,9,6,18,11,195.48,206.0,200.74
2019-03-02,1610612754,1610612753,2018,112.0,117.0,229.0,92.05,92.25,96.55,103.5,63,41,22,0.6509999999999999,63,29,34,0.46,24,17,17,12,187.28,203.64,195.45999999999998
2019-03-02,1610612748,1610612751,2018,117.0,88.0,205.0,97.25,95.5,96.7,98.4,61,27,34,0.443,64,32,32,0.5,12,15,18,14,195.0,196.96,195.98000000000002
2019-03-02,1610612755,1610612744,2018,117.0,120.0,237.0,97.85,106.0,107.5,105.85,62,40,22,0.645,62,43,19,0.6940000000000001,24,16,23,20,207.68,199.04,203.36
2019-03-02,1610612742,1610612763,2018,81.0,111.0,192.0,104.45,102.7,98.25,97.5,61,27,34,0.443,63,24,39,0.381,21,6,15,9,213.0,193.96,203.48000000000002
2019-03-02,1610612759,1610612760,2018,116.0,102.0,218.0,107.75,96.55,101.8,103.4,63,34,29,0.54,61,38,23,0.623,23,11,21,17,204.12,210.36,207.24
2019-03-02,1610612743,1610612740,2018,112.0,120.0,232.0,109.2,110.3,100.45,104.8,61,42,19,0.6890000000000001,64,28,36,0.438,27,15,18,10,217.04,200.8,208.92000000000002
2019-03-02,1610612756,1610612747,2018,118.0,109.0,227.0,106.25,103.85,107.3,114.65,63,12,51,0.19,62,30,32,0.484,7,5,18,12,212.88,219.28,216.07999999999998
2019-03-02,1610612762,1610612749,2018,115.0,111.0,226.0,95.55,106.55,99.8,108.15,61,35,26,0.574,62,48,14,0.774,20,15,25,23,200.2,200.48,200.33999999999997
2019-03-01,1610612737,1610612741,2018,161.0,168.0,329.0,96.35,95.7,94.0,91.0,62,21,41,0.339,62,17,45,0.274,11,10,7,10,199.44,185.44,192.44
2019-03-01,1610612751,1610612766,2018,112.0,123.0,235.0,96.7,98.4,99.45,97.7,63,32,31,0.508,61,28,33,0.459,18,14,20,8,196.96,194.96,195.96
2019-03-01,1610612761,1610612757,2018,119.0,117.0,236.0,100.6,99.2,104.75,105.45,62,45,17,0.726,61,38,23,0.623,26,19,24,14,206.0,209.44,207.72
2019-03-01,1610612738,1610612764,2018,107.0,96.0,203.0,99.65,105.5,94.7,91.35,62,37,25,0.597,61,25,36,0.41,23,14,17,8,195.08,193.0,194.04000000000002
2019-03-01,1610612756,1610612740,2018,116.0,130.0,246.0,106.25,103.85,100.45,104.8,62,12,50,0.194,63,27,36,0.429,7,5,18,9,212.88,200.8,206.84
2019-03-01,1610612758,1610612746,2018,109.0,116.0,225.0,97.75,101.5,109.85,106.5,61,31,30,0.508,63,34,29,0.54,19,12,17,17,207.08,214.36,210.72000000000003
2019-03-01,1610612747,1610612749,2018,120.0,131.0,251.0,107.3,114.65,99.8,108.15,61,30,31,0.4920000000000001,61,47,14,0.77,18,12,25,22,219.28,200.48,209.88
2019-02-28,1610612754,1610612750,2018,122.0,115.0,237.0,92.05,92.25,110.05,111.2,62,40,22,0.645,61,29,32,0.475,23,17,20,9,187.28,209.4,198.34
2019-02-28,1610612753,1610612744,2018,103.0,96.0,199.0,96.55,103.5,107.5,105.85,62,28,34,0.452,61,43,18,0.705,16,12,23,20,203.64,199.04,201.33999999999997
2019-02-28,1610612752,1610612739,2018,118.0,125.0,243.0,101.2,97.2,101.9,101.55,61,13,48,0.213,61,14,47,0.23,6,7,9,5,200.28,195.48,197.88
2019-02-28,1610612745,1610612748,2018,121.0,118.0,239.0,112.7,109.85,97.25,95.5,61,36,25,0.59,60,27,33,0.45,21,15,12,15,216.24,195.0,205.62
2019-02-28,1610612760,1610612755,2018,104.0,108.0,212.0,101.8,103.4,97.85,106.0,60,38,22,0.633,61,39,22,0.639,21,17,24,15,210.36,207.68,209.02
2019-02-28,1610612743,1610612762,2018,104.0,111.0,215.0,109.2,110.3,95.55,106.55,60,42,18,0.7,60,34,26,0.5670000000000001,27,15,20,14,217.04,200.2,208.62
2019-02-27,1610612766,1610612745,2018,113.0,118.0,231.0,99.45,97.7,112.7,109.85,60,28,32,0.467,60,35,25,0.583,20,8,21,14,194.96,216.24,205.60000000000002
2019-02-27,1610612737,1610612750,2018,131.0,123.0,254.0,96.35,95.7,110.05,111.2,61,20,41,0.328,60,29,31,0.483,10,10,20,9,199.44,209.4,204.42000000000002
2019-02-27,1610612751,1610612764,2018,116.0,125.0,241.0,96.7,98.4,94.7,91.35,62,32,30,0.516,60,24,36,0.4,18,14,17,7,196.96,193.0,194.98000000000002
2019-02-27,1610612748,1610612744,2018,126.0,125.0,251.0,97.25,95.5,107.5,105.85,59,26,33,0.441,60,43,17,0.7170000000000001,11,15,23,20,195.0,199.04,197.01999999999998
2019-02-27,1610612738,1610612757,2018,92.0,97.0,189.0,99.65,105.5,104.75,105.45,61,37,24,0.607,60,37,23,0.617,23,14,24,13,195.08,209.44,202.26
2019-02-27,1610612763,1610612741,2018,107.0,109.0,216.0,98.25,97.5,94.0,91.0,62,24,38,0.387,61,16,45,0.262,15,9,7,9,193.96,185.44,189.7
2019-02-27,1610612759,1610612765,2018,105.0,93.0,198.0,107.75,96.55,100.85,105.95,62,33,29,0.532,59,29,30,0.4920000000000001,22,11,18,11,204.12,206.0,205.06
2019-02-27,1610612742,1610612754,2018,110.0,101.0,211.0,104.45,102.7,92.05,92.25,60,26,34,0.433,61,40,21,0.6559999999999999,20,6,23,17,213.0,187.28,200.14
2019-02-27,1610612762,1610612746,2018,111.0,105.0,216.0,95.55,106.55,109.85,106.5,59,33,26,0.5589999999999999,62,34,28,0.5479999999999999,19,14,17,17,200.2,214.36,207.28
2019-02-27,1610612758,1610612749,2018,140.0,141.0,281.0,97.75,101.5,99.8,108.15,60,31,29,0.517,60,46,14,0.767,19,12,25,21,207.08,200.48,203.78
2019-02-27,1610612747,1610612740,2018,125.0,119.0,244.0,107.3,114.65,100.45,104.8,60,29,31,0.483,62,27,35,0.435,17,12,18,9,219.28,200.8,210.04000000000002
2019-02-26,1610612752,1610612753,2018,108.0,103.0,211.0,101.2,97.2,96.55,103.5,60,12,48,0.2,61,28,33,0.459,5,7,16,12,200.28,203.64,201.95999999999998
2019-02-26,1610612761,1610612738,2018,118.0,95.0,213.0,100.6,99.2,99.65,105.5,61,44,17,0.721,60,37,23,0.617,25,19,23,14,206.0,195.08,200.54000000000002
2019-02-26,1610612743,1610612760,2018,121.0,112.0,233.0,109.2,110.3,101.8,103.4,59,41,18,0.695,59,38,21,0.644,26,15,21,17,217.04,210.36,213.7
2019-02-25,1610612766,1610612744,2018,110.0,121.0,231.0,99.45,97.7,107.5,105.85,59,28,31,0.475,59,42,17,0.7120000000000001,20,8,23,19,194.96,199.04,197.0
2019-02-25,1610612739,1610612757,2018,110.0,123.0,233.0,101.9,101.55,104.75,105.45,60,14,46,0.233,59,36,23,0.61,9,5,24,12,195.48,209.44,202.45999999999998
2019-02-25,1610612765,1610612754,2018,113.0,109.0,222.0,100.85,105.95,92.05,92.25,58,28,30,0.483,60,40,20,0.667,17,11,23,17,206.0,187.28,196.64
2019-02-25,1610612751,1610612759,2018,101.0,85.0,186.0,96.7,98.4,107.75,96.55,61,31,30,0.508,61,33,28,0.541,17,14,22,11,196.96,204.12,200.54000000000002
2019-02-25,1610612748,1610612756,2018,121.0,124.0,245.0,97.25,95.5,106.25,103.85,58,26,32,0.448,61,11,50,0.18,11,15,7,4,195.0,212.88,203.94
2019-02-25,1610612741,1610612749,2018,106.0,117.0,223.0,94.0,91.0,99.8,108.15,60,16,44,0.267,59,45,14,0.763,7,9,25,20,185.44,200.48,192.95999999999998
2019-02-25,1610612745,1610612737,2018,119.0,111.0,230.0,112.7,109.85,96.35,95.7,59,34,25,0.5760000000000001,60,20,40,0.333,20,14,10,10,216.24,199.44,207.84
2019-02-25,1610612763,1610612747,2018,110.0,105.0,215.0,98.25,97.5,107.3,114.65,61,23,38,0.377,59,29,30,0.4920000000000001,14,9,17,12,193.96,219.28,206.62
2019-02-25,1610612750,1610612758,2018,112.0,105.0,217.0,110.05,111.2,97.75,101.5,59,28,31,0.475,59,31,28,0.525,19,9,19,12,209.4,207.08,208.24
2019-02-25,1610612740,1610612755,2018,110.0,111.0,221.0,100.45,104.8,97.85,106.0,61,27,34,0.443,60,38,22,0.633,18,9,24,14,200.8,207.68,204.24
2019-02-25,1610612746,1610612742,2018,121.0,112.0,233.0,109.85,106.5,104.45,102.7,61,33,28,0.541,59,26,33,0.441,16,17,20,6,214.36,213.0,213.68
2019-02-24,1610612761,1610612753,2018,98.0,113.0,211.0,100.6,99.2,96.55,103.5,60,44,16,0.733,60,27,33,0.45,25,19,16,11,206.0,203.64,204.82
2019-02-24,1610612743,1610612746,2018,123.0,96.0,219.0,109.2,110.3,109.85,106.5,58,40,18,0.69,60,33,27,0.55,25,15,16,17,217.04,214.36,215.7
2019-02-24,1610612752,1610612759,2018,130.0,118.0,248.0,101.2,97.2,107.75,96.55,59,11,48,0.18600000000000005,60,33,27,0.55,4,7,22,11,200.28,204.12,202.2
2019-02-23,1610612755,1610612757,2018,115.0,130.0,245.0,97.85,106.0,104.75,105.45,59,38,21,0.644,58,35,23,0.603,24,14,24,11,207.68,209.44,208.56
2019-02-23,1610612737,1610612756,2018,120.0,112.0,232.0,96.35,95.7,106.25,103.85,59,19,40,0.322,60,11,49,0.183,9,10,7,4,199.44,212.88,206.16
2019-02-23,1610612766,1610612751,2018,115.0,117.0,232.0,99.45,97.7,96.7,98.4,58,28,30,0.483,60,30,30,0.5,20,8,17,13,194.96,196.96,195.96
2019-02-23,1610612739,1610612763,2018,112.0,107.0,219.0,101.9,101.55,98.25,97.5,59,13,46,0.22,60,23,37,0.383,8,5,14,9,195.48,193.96,194.72
2019-02-23,1610612764,1610612754,2018,112.0,119.0,231.0,94.7,91.35,92.05,92.25,59,24,35,0.407,59,39,20,0.6609999999999999,17,7,23,16,193.0,187.28,190.14
2019-02-23,1610612740,1610612747,2018,128.0,115.0,243.0,100.45,104.8,107.3,114.65,60,26,34,0.433,58,29,29,0.5,17,9,17,12,200.8,219.28,210.04000000000002
2019-02-23,1610612748,1610612765,2018,96.0,119.0,215.0,97.25,95.5,100.85,105.95,57,26,31,0.456,57,27,30,0.474,11,15,17,10,195.0,206.0,200.5
2019-02-23,1610612741,1610612738,2018,126.0,116.0,242.0,94.0,91.0,99.65,105.5,59,15,44,0.254,59,37,22,0.627,6,9,23,14,185.44,195.08,190.26
2019-02-23,1610612760,1610612758,2018,116.0,119.0,235.0,101.8,103.4,97.75,101.5,58,38,20,0.655,58,30,28,0.517,21,17,19,11,210.36,207.08,208.72000000000003
2019-02-23,1610612749,1610612750,2018,140.0,128.0,268.0,99.8,108.15,110.05,111.2,58,44,14,0.759,58,28,30,0.483,24,20,19,9,200.48,209.4,204.94
2019-02-23,1610612744,1610612745,2018,112.0,118.0,230.0,107.5,105.85,112.7,109.85,58,42,16,0.7240000000000001,58,33,25,0.569,23,19,20,13,199.04,216.24,207.64
2019-02-23,1610612762,1610612742,2018,125.0,109.0,234.0,95.55,106.55,104.45,102.7,58,32,26,0.552,58,26,32,0.448,18,14,20,6,200.2,213.0,206.6
2019-02-22,1610612766,1610612764,2018,123.0,110.0,233.0,99.45,97.7,94.7,91.35,57,27,30,0.474,58,24,34,0.414,19,8,17,7,194.96,193.0,193.98000000000002
2019-02-22,1610612754,1610612740,2018,126.0,111.0,237.0,92.05,92.25,100.45,104.8,58,38,20,0.655,59,26,33,0.441,22,16,17,9,187.28,200.8,194.04000000000002
2019-02-22,1610612753,1610612741,2018,109.0,110.0,219.0,96.55,103.5,94.0,91.0,59,27,32,0.458,58,14,44,0.241,16,11,6,8,203.64,185.44,194.54
2019-02-22,1610612761,1610612759,2018,120.0,117.0,237.0,100.6,99.2,107.75,96.55,59,43,16,0.7290000000000001,59,33,26,0.5589999999999999,24,19,22,11,206.0,204.12,205.06
2019-02-22,1610612737,1610612765,2018,122.0,125.0,247.0,96.35,95.7,100.85,105.95,58,19,39,0.328,56,26,30,0.464,9,10,17,9,199.44,206.0,202.72
2019-02-22,1610612752,1610612750,2018,104.0,115.0,219.0,101.2,97.2,110.05,111.2,58,11,47,0.19,57,27,30,0.474,4,7,19,8,200.28,209.4,204.84
2019-02-22,1610612763,1610612746,2018,106.0,112.0,218.0,98.25,97.5,109.85,106.5,59,23,36,0.39,59,32,27,0.542,14,9,16,16,193.96,214.36,204.16000000000003
2019-02-22,1610612742,1610612743,2018,104.0,114.0,218.0,104.45,102.7,109.2,110.3,57,26,31,0.456,57,39,18,0.684,20,6,25,14,213.0,217.04,215.01999999999998
2019-02-22,1610612760,1610612762,2018,148.0,147.0,295.0,101.8,103.4,95.55,106.55,57,37,20,0.649,57,32,25,0.561,20,17,18,14,210.36,200.2,205.28
2019-02-21,1610612739,1610612756,2018,111.0,98.0,209.0,101.9,101.55,106.25,103.85,58,12,46,0.207,59,11,48,0.18600000000000005,7,5,7,4,195.48,212.88,204.18
2019-02-21,1610612755,1610612748,2018,106.0,102.0,208.0,97.85,106.0,97.25,95.5,58,37,21,0.638,56,26,30,0.464,23,14,11,15,207.68,195.0,201.34
2019-02-21,1610612751,1610612757,2018,99.0,113.0,212.0,96.7,98.4,104.75,105.45,59,30,29,0.508,57,34,23,0.596,17,13,24,10,196.96,209.44,203.2
2019-02-21,1610612749,1610612738,2018,98.0,97.0,195.0,99.8,108.15,99.65,105.5,57,43,14,0.754,58,37,21,0.638,23,20,23,14,200.48,195.08,197.78
2019-02-21,1610612744,1610612758,2018,125.0,123.0,248.0,107.5,105.85,97.75,101.5,57,41,16,0.7190000000000001,57,30,27,0.526,22,19,19,11,199.04,207.08,203.06
2019-02-21,1610612747,1610612745,2018,111.0,106.0,217.0,107.3,114.65,112.7,109.85,57,28,29,0.491,57,33,24,0.579,16,12,20,13,219.28,216.24,217.76
2019-02-14,1610612753,1610612766,2018,127.0,89.0,216.0,96.55,103.5,99.45,97.7,58,26,32,0.448,56,27,29,0.482,15,11,19,8,203.64,194.96,199.3
2019-02-14,1610612737,1610612752,2018,91.0,106.0,197.0,96.35,95.7,101.2,97.2,57,19,38,0.333,57,10,47,0.175,9,10,4,6,199.44,200.28,199.86
2019-02-14,1610612740,1610612760,2018,131.0,122.0,253.0,100.45,104.8,101.8,103.4,58,25,33,0.431,56,37,19,0.6609999999999999,16,9,20,17,200.8,210.36,205.58
2019-02-13,1610612739,1610612751,2018,139.0,148.0,287.0,101.9,101.55,96.7,98.4,57,12,45,0.211,58,29,29,0.5,7,5,17,12,195.48,196.96,196.22
2019-02-13,1610612754,1610612749,2018,97.0,106.0,203.0,92.05,92.25,99.8,108.15,57,38,19,0.667,56,42,14,0.75,22,16,23,19,187.28,200.48,193.88
2019-02-13,1610612738,1610612765,2018,118.0,110.0,228.0,99.65,105.5,100.85,105.95,57,36,21,0.632,55,26,29,0.473,22,14,17,9,195.08,206.0,200.54000000000002
2019-02-13,1610612752,1610612755,2018,111.0,126.0,237.0,101.2,97.2,97.85,106.0,56,10,46,0.179,57,36,21,0.632,4,6,23,13,200.28,207.68,203.98000000000002
2019-02-13,1610612761,1610612764,2018,129.0,120.0,249.0,100.6,99.2,94.7,91.35,58,42,16,0.7240000000000001,57,24,33,0.421,23,19,17,7,206.0,193.0,199.5
2019-02-13,1610612741,1610612763,2018,122.0,110.0,232.0,94.0,91.0,98.25,97.5,57,13,44,0.228,58,23,35,0.397,5,8,14,9,185.44,193.96,189.7
2019-02-13,1610612750,1610612745,2018,121.0,111.0,232.0,110.05,111.2,112.7,109.85,56,26,30,0.464,56,33,23,0.589,18,8,20,13,209.4,216.24,212.82
2019-02-13,1610612742,1610612748,2018,101.0,112.0,213.0,104.45,102.7,97.25,95.5,56,26,30,0.464,55,25,30,0.455,20,6,11,14,213.0,195.0,204.0
2019-02-13,1610612743,1610612758,2018,120.0,118.0,238.0,109.2,110.3,97.75,101.5,56,38,18,0.679,56,30,26,0.536,24,14,19,11,217.04,207.08,212.06
2019-02-13,1610612757,1610612744,2018,129.0,107.0,236.0,104.75,105.45,107.5,105.85,56,33,23,0.589,56,41,15,0.732,23,10,22,19,209.44,199.04,204.24
2019-02-13,1610612746,1610612756,2018,134.0,107.0,241.0,109.85,106.5,106.25,103.85,58,31,27,0.534,58,11,47,0.19,15,16,7,4,214.36,212.88,213.62
2019-02-12,1610612737,1610612747,2018,117.0,113.0,230.0,96.35,95.7,107.3,114.65,56,18,38,0.321,56,28,28,0.5,8,10,16,12,199.44,219.28,209.36
2019-02-12,1610612755,1610612738,2018,109.0,112.0,221.0,97.85,106.0,99.65,105.5,56,36,20,0.643,56,35,21,0.625,23,13,22,13,207.68,195.08,201.38
2019-02-12,1610612763,1610612759,2018,107.0,108.0,215.0,98.25,97.5,107.75,96.55,57,23,34,0.404,58,32,26,0.552,14,9,22,10,193.96,204.12,199.04000000000002
2019-02-12,1610612740,1610612753,2018,88.0,118.0,206.0,100.45,104.8,96.55,103.5,57,25,32,0.439,57,25,32,0.439,16,9,15,10,200.8,203.64,202.22
2019-02-12,1610612744,1610612762,2018,115.0,108.0,223.0,107.5,105.85,95.55,106.55,55,40,15,0.727,56,32,24,0.5710000000000001,21,19,18,14,199.04,200.2,199.62
2019-02-11,1610612739,1610612752,2018,107.0,104.0,211.0,101.9,101.55,101.2,97.2,56,11,45,0.196,55,10,45,0.182,6,5,4,6,195.48,200.28,197.88
2019-02-11,1610612765,1610612764,2018,121.0,112.0,233.0,100.85,105.95,94.7,91.35,54,25,29,0.463,56,24,32,0.429,16,9,17,7,206.0,193.0,199.5
2019-02-11,1610612754,1610612766,2018,99.0,90.0,189.0,92.05,92.25,99.45,97.7,56,37,19,0.6609999999999999,55,27,28,0.491,21,16,19,8,187.28,194.96,191.12
2019-02-11,1610612761,1610612751,2018,127.0,125.0,252.0,100.6,99.2,96.7,98.4,57,41,16,0.7190000000000001,57,29,28,0.509,22,19,17,12,206.0,196.96,201.48000000000002
2019-02-11,1610612741,1610612749,2018,99.0,112.0,211.0,94.0,91.0,99.8,108.15,56,13,43,0.232,55,41,14,0.745,5,8,23,18,185.44,200.48,192.95999999999998
2019-02-11,1610612745,1610612742,2018,120.0,104.0,224.0,112.7,109.85,104.45,102.7,55,32,23,0.5820000000000001,55,26,29,0.473,19,13,20,6,216.24,213.0,214.62
2019-02-11,1610612750,1610612746,2018,130.0,120.0,250.0,110.05,111.2,109.85,106.5,55,25,30,0.455,57,31,26,0.544,17,8,15,16,209.4,214.36,211.88
2019-02-11,1610612760,1610612757,2018,120.0,111.0,231.0,101.8,103.4,104.75,105.45,55,36,19,0.655,55,33,22,0.6,19,17,23,10,210.36,209.44,209.9
2019-02-11,1610612743,1610612748,2018,103.0,87.0,190.0,109.2,110.3,97.25,95.5,55,37,18,0.6729999999999999,54,25,29,0.463,23,14,11,14,217.04,195.0,206.01999999999998
2019-02-10,1610612742,1610612757,2018,102.0,101.0,203.0,104.45,102.7,104.75,105.45,54,25,29,0.463,54,33,21,0.611,19,6,23,10,213.0,209.44,211.22
2019-02-10,1610612755,1610612747,2018,143.0,120.0,263.0,97.85,106.0,107.3,114.65,55,35,20,0.636,55,28,27,0.509,22,13,16,12,207.68,219.28,213.48000000000002
2019-02-10,1610612758,1610612756,2018,117.0,104.0,221.0,97.75,101.5,106.25,103.85,55,29,26,0.527,57,11,46,0.193,18,11,7,4,207.08,212.88,209.98000000000002
2019-02-10,1610612737,1610612753,2018,108.0,124.0,232.0,96.35,95.7,96.55,103.5,55,18,37,0.327,56,24,32,0.429,8,10,15,9,199.44,203.64,201.54
2019-02-10,1610612744,1610612748,2018,120.0,118.0,238.0,107.5,105.85,97.25,95.5,54,39,15,0.722,53,25,28,0.472,20,19,11,14,199.04,195.0,197.01999999999998
2019-02-09,1610612762,1610612759,2018,125.0,105.0,230.0,95.55,106.55,107.75,96.55,55,31,24,0.564,57,32,25,0.561,17,14,22,10,200.2,204.12,202.16
2019-02-09,1610612754,1610612739,2018,105.0,90.0,195.0,92.05,92.25,101.9,101.55,55,36,19,0.655,55,11,44,0.2,20,16,6,5,187.28,195.48,191.38
2019-02-09,1610612737,1610612766,2018,120.0,129.0,249.0,96.35,95.7,99.45,97.7,54,18,36,0.333,54,26,28,0.481,8,10,19,7,199.44,194.96,197.2
2019-02-09,1610612752,1610612761,2018,99.0,104.0,203.0,101.2,97.2,100.6,99.2,54,10,44,0.185,56,40,16,0.7140000000000001,4,6,22,18,200.28,206.0,203.14
2019-02-09,1610612738,1610612746,2018,112.0,123.0,235.0,99.65,105.5,109.85,106.5,55,35,20,0.636,56,30,26,0.536,22,13,15,15,195.08,214.36,204.72000000000003
2019-02-09,1610612741,1610612764,2018,125.0,134.0,259.0,94.0,91.0,94.7,91.35,55,13,42,0.236,55,23,32,0.418,5,8,17,6,185.44,193.0,189.22
2019-02-09,1610612763,1610612740,2018,99.0,90.0,189.0,98.25,97.5,100.45,104.8,56,22,34,0.393,56,25,31,0.446,13,9,16,9,193.96,200.8,197.38
2019-02-09,1610612745,1610612760,2018,112.0,117.0,229.0,112.7,109.85,101.8,103.4,54,32,22,0.593,54,35,19,0.648,19,13,19,16,216.24,210.36,213.3
2019-02-09,1610612749,1610612753,2018,83.0,103.0,186.0,99.8,108.15,96.55,103.5,54,41,13,0.759,55,23,32,0.418,23,18,15,8,200.48,203.64,202.06
2019-02-08,1610612765,1610612752,2018,120.0,103.0,223.0,100.85,105.95,101.2,97.2,53,24,29,0.453,53,10,43,0.189,15,9,4,6,206.0,200.28,203.14
2019-02-08,1610612755,1610612743,2018,117.0,110.0,227.0,97.85,106.0,109.2,110.3,54,34,20,0.63,54,37,17,0.685,21,13,23,14,207.68,217.04,212.36
2019-02-08,1610612764,1610612739,2018,119.0,106.0,225.0,94.7,91.35,101.9,101.55,54,22,32,0.407,54,11,43,0.204,16,6,6,5,193.0,195.48,194.24
2019-02-08,1610612751,1610612741,2018,106.0,125.0,231.0,96.7,98.4,94.0,91.0,56,29,27,0.518,54,12,42,0.222,17,12,5,7,196.96,185.44,191.2
2019-02-08,1610612742,1610612749,2018,107.0,122.0,229.0,104.45,102.7,99.8,108.15,53,25,28,0.472,53,40,13,0.755,19,6,23,17,213.0,200.48,206.74
2019-02-08,1610612756,1610612744,2018,107.0,117.0,224.0,106.25,103.85,107.5,105.85,56,11,45,0.196,53,38,15,0.7170000000000001,7,4,20,18,212.88,199.04,205.95999999999998
2019-02-08,1610612740,1610612750,2018,122.0,117.0,239.0,100.45,104.8,110.05,111.2,55,24,31,0.436,54,25,29,0.463,15,9,17,8,200.8,209.4,205.10000000000002
2019-02-08,1610612758,1610612748,2018,102.0,96.0,198.0,97.75,101.5,97.25,95.5,54,28,26,0.519,52,25,27,0.481,17,11,11,14,207.08,195.0,201.04000000000002
2019-02-07,1610612754,1610612746,2018,116.0,92.0,208.0,92.05,92.25,109.85,106.5,54,35,19,0.648,55,30,25,0.545,19,16,15,15,187.28,214.36,200.82
2019-02-07,1610612753,1610612750,2018,122.0,112.0,234.0,96.55,103.5,110.05,111.2,54,22,32,0.407,53,25,28,0.472,14,8,17,8,203.64,209.4,206.51999999999998
2019-02-07,1610612737,1610612761,2018,101.0,119.0,220.0,96.35,95.7,100.6,99.2,53,18,35,0.34,55,39,16,0.7090000000000001,8,10,22,17,199.44,206.0,202.72
2019-02-07,1610612738,1610612747,2018,128.0,129.0,257.0,99.65,105.5,107.3,114.65,54,35,19,0.648,54,27,27,0.5,22,13,16,11,195.08,219.28,207.18
2019-02-07,1610612760,1610612763,2018,117.0,95.0,212.0,101.8,103.4,98.25,97.5,53,34,19,0.642,55,22,33,0.4,18,16,13,9,210.36,193.96,202.16000000000003
2019-02-07,1610612757,1610612759,2018,127.0,118.0,245.0,104.75,105.45,107.75,96.55,53,32,21,0.604,56,32,24,0.5710000000000001,22,10,22,10,209.44,204.12,206.78
2019-02-06,1610612751,1610612743,2018,135.0,130.0,265.0,96.7,98.4,109.2,110.3,55,28,27,0.509,53,37,16,0.698,16,12,23,14,196.96,217.04,207.0
2019-02-06,1610612741,1610612740,2018,120.0,125.0,245.0,94.0,91.0,100.45,104.8,53,12,41,0.226,54,23,31,0.426,5,7,15,8,185.44,200.8,193.12
2019-02-06,1610612749,1610612764,2018,148.0,129.0,277.0,99.8,108.15,94.7,91.35,52,39,13,0.75,53,22,31,0.415,22,17,16,6,200.48,193.0,196.74
2019-02-06,1610612742,1610612766,2018,99.0,93.0,192.0,104.45,102.7,99.45,97.7,52,24,28,0.462,53,26,27,0.491,18,6,19,7,213.0,194.96,203.98000000000002
2019-02-06,1610612762,1610612756,2018,116.0,88.0,204.0,95.55,106.55,106.25,103.85,54,30,24,0.556,55,11,44,0.2,16,14,7,4,200.2,212.88,206.54
2019-02-06,1610612758,1610612745,2018,101.0,127.0,228.0,97.75,101.5,112.7,109.85,53,28,25,0.528,53,31,22,0.585,17,11,19,12,207.08,216.24,211.66000000000003
2019-02-06,1610612744,1610612759,2018,141.0,102.0,243.0,107.5,105.85,107.75,96.55,52,37,15,0.7120000000000001,55,32,23,0.5820000000000001,19,18,22,10,199.04,204.12,201.57999999999998
2019-02-05,1610612766,1610612746,2018,115.0,117.0,232.0,99.45,97.7,109.85,106.5,52,26,26,0.5,54,29,25,0.537,19,7,15,14,194.96,214.36,204.66000000000003
2019-02-05,1610612739,1610612738,2018,96.0,103.0,199.0,101.9,101.55,99.65,105.5,53,11,42,0.208,53,34,19,0.642,6,5,22,12,195.48,195.08,195.28
2019-02-05,1610612754,1610612747,2018,136.0,94.0,230.0,92.05,92.25,107.3,114.65,53,34,19,0.642,53,27,26,0.509,18,16,16,11,187.28,219.28,203.28
2019-02-05,1610612752,1610612765,2018,92.0,105.0,197.0,101.2,97.2,100.85,105.95,52,10,42,0.192,52,23,29,0.442,4,6,15,8,200.28,206.0,203.14
2019-02-05,1610612755,1610612761,2018,107.0,119.0,226.0,97.85,106.0,100.6,99.2,53,34,19,0.642,54,38,16,0.7040000000000001,21,13,22,16,207.68,206.0,206.84
2019-02-05,1610612763,1610612750,2018,108.0,106.0,214.0,98.25,97.5,110.05,111.2,54,21,33,0.389,52,25,27,0.481,12,9,17,8,193.96,209.4,201.68
2019-02-05,1610612760,1610612753,2018,132.0,122.0,254.0,101.8,103.4,96.55,103.5,52,33,19,0.635,53,22,31,0.415,17,16,14,8,210.36,203.64,207.0
2019-02-05,1610612757,1610612748,2018,108.0,118.0,226.0,104.75,105.45,97.25,95.5,52,32,20,0.615,51,24,27,0.471,22,10,11,13,209.44,195.0,202.22
2019-02-04,1610612765,1610612743,2018,129.0,103.0,232.0,100.85,105.95,109.2,110.3,51,22,29,0.431,52,37,15,0.7120000000000001,14,8,23,14,206.0,217.04,211.51999999999998
2019-02-04,1610612764,1610612737,2018,129.0,137.0,266.0,94.7,91.35,96.35,95.7,52,22,30,0.423,52,17,35,0.327,16,6,8,9,193.0,199.44,196.22
2019-02-04,1610612751,1610612749,2018,94.0,113.0,207.0,96.7,98.4,99.8,108.15,54,28,26,0.519,51,38,13,0.745,16,12,22,16,196.96,200.48,198.72
2019-02-04,1610612740,1610612754,2018,107.0,109.0,216.0,100.45,104.8,92.05,92.25,53,23,30,0.434,52,33,19,0.635,15,8,18,15,200.8,187.28,194.04000000000002
2019-02-04,1610612756,1610612745,2018,110.0,118.0,228.0,106.25,103.85,112.7,109.85,54,11,43,0.204,52,30,22,0.5770000000000001,7,4,19,11,212.88,216.24,214.56
2019-02-04,1610612758,1610612759,2018,127.0,112.0,239.0,97.75,101.5,107.75,96.55,52,27,25,0.519,54,32,22,0.593,16,11,22,10,207.08,204.12,205.60000000000002
2019-02-03,1610612752,1610612763,2018,84.0,96.0,180.0,101.2,97.2,98.25,97.5,51,10,41,0.196,53,20,33,0.377,4,6,12,8,200.28,193.96,197.12
2019-02-03,1610612738,1610612760,2018,134.0,129.0,263.0,99.65,105.5,101.8,103.4,52,33,19,0.635,51,33,18,0.647,21,12,17,16,195.08,210.36,202.72000000000003
2019-02-03,1610612761,1610612746,2018,121.0,103.0,224.0,100.6,99.2,109.85,106.5,53,37,16,0.698,53,29,24,0.547,21,16,15,14,206.0,214.36,210.18
2019-02-02,1610612765,1610612746,2018,101.0,111.0,212.0,100.85,105.95,109.85,106.5,50,22,28,0.44,52,28,24,0.5379999999999999,14,8,15,13,206.0,214.36,210.18
2019-02-02,1610612766,1610612741,2018,125.0,118.0,243.0,99.45,97.7,94.0,91.0,51,25,26,0.49,52,12,40,0.231,18,7,5,7,194.96,185.44,190.2
2019-02-02,1610612753,1610612751,2018,102.0,89.0,191.0,96.55,103.5,96.7,98.4,52,21,31,0.404,53,28,25,0.528,13,8,16,12,203.64,196.96,200.3
2019-02-02,1610612764,1610612749,2018,115.0,131.0,246.0,94.7,91.35,99.8,108.15,51,22,29,0.431,50,37,13,0.74,16,6,22,15,193.0,200.48,196.74
2019-02-02,1610612739,1610612742,2018,98.0,111.0,209.0,101.9,101.55,104.45,102.7,52,11,41,0.212,51,23,28,0.451,6,5,18,5,195.48,213.0,204.24
2019-02-02,1610612748,1610612754,2018,88.0,95.0,183.0,97.25,95.5,92.05,92.25,50,24,26,0.48,51,32,19,0.627,11,13,18,14,195.0,187.28,191.14
2019-02-02,1610612759,1610612740,2018,113.0,108.0,221.0,107.75,96.55,100.45,104.8,53,31,22,0.585,52,23,29,0.442,21,10,15,8,204.12,200.8,202.46
2019-02-02,1610612744,1610612747,2018,115.0,101.0,216.0,107.5,105.85,107.3,114.65,51,36,15,0.706,52,27,25,0.519,18,18,16,11,199.04,219.28,209.16
2019-02-02,1610612750,1610612743,2018,106.0,107.0,213.0,110.05,111.2,109.2,110.3,51,25,26,0.49,51,36,15,0.706,17,8,23,13,209.4,217.04,213.22
2019-02-02,1610612756,1610612737,2018,112.0,118.0,230.0,106.25,103.85,96.35,95.7,53,11,42,0.208,51,16,35,0.314,7,4,8,8,212.88,199.44,206.16
2019-02-02,1610612762,1610612745,2018,98.0,125.0,223.0,95.55,106.55,112.7,109.85,53,30,23,0.5660000000000001,51,29,22,0.569,16,14,19,10,200.2,216.24,208.22
2019-02-02,1610612758,1610612755,2018,115.0,108.0,223.0,97.75,101.5,97.85,106.0,51,26,25,0.51,52,34,18,0.654,15,11,21,13,207.08,207.68,207.38
2019-02-01,1610612766,1610612763,2018,100.0,92.0,192.0,99.45,97.7,98.25,97.5,50,24,26,0.48,52,20,32,0.385,17,7,12,8,194.96,193.96,194.46
2019-02-01,1610612752,1610612738,2018,99.0,113.0,212.0,101.2,97.2,99.65,105.5,50,10,40,0.2,51,32,19,0.627,4,6,21,11,200.28,195.08,197.68
2019-02-01,1610612748,1610612760,2018,102.0,118.0,220.0,97.25,95.5,101.8,103.4,49,24,25,0.49,50,32,18,0.64,11,13,17,15,195.0,210.36,202.68
2019-02-01,1610612762,1610612737,2018,128.0,112.0,240.0,95.55,106.55,96.35,95.7,52,29,23,0.5579999999999999,50,16,34,0.32,15,14,8,8,200.2,199.44,199.82
2019-02-01,1610612743,1610612745,2018,136.0,122.0,258.0,109.2,110.3,112.7,109.85,50,35,15,0.7,50,29,21,0.58,22,13,19,10,217.04,216.24,216.64
2019-01-31,1610612765,1610612742,2018,93.0,89.0,182.0,100.85,105.95,104.45,102.7,49,21,28,0.429,50,23,27,0.46,13,8,18,5,206.0,213.0,209.5
2019-01-31,1610612753,1610612754,2018,107.0,100.0,207.0,96.55,103.5,92.05,92.25,51,20,31,0.392,50,32,18,0.64,12,8,18,14,203.64,187.28,195.45999999999998
2019-01-31,1610612761,1610612749,2018,92.0,105.0,197.0,100.6,99.2,99.8,108.15,52,37,15,0.7120000000000001,49,36,13,0.735,21,16,22,14,206.0,200.48,203.24
2019-01-31,1610612759,1610612751,2018,117.0,114.0,231.0,107.75,96.55,96.7,98.4,52,30,22,0.5770000000000001,52,28,24,0.5379999999999999,20,10,16,12,204.12,196.96,200.54000000000002
2019-01-31,1610612744,1610612755,2018,104.0,113.0,217.0,107.5,105.85,97.85,106.0,50,36,14,0.72,51,33,18,0.647,18,18,21,12,199.04,207.68,203.36
2019-01-31,1610612746,1610612747,2018,120.0,123.0,243.0,109.85,106.5,107.3,114.65,51,28,23,0.5489999999999999,51,26,25,0.51,15,13,16,10,214.36,219.28,216.82
2019-01-30,1610612738,1610612766,2018,126.0,94.0,220.0,99.65,105.5,99.45,97.7,50,31,19,0.62,49,24,25,0.49,20,11,17,7,195.08,194.96,195.02
2019-01-30,1610612748,1610612741,2018,89.0,105.0,194.0,97.25,95.5,94.0,91.0,48,24,24,0.5,51,11,40,0.21600000000000005,11,13,5,6,195.0,185.44,190.22
2019-01-30,1610612752,1610612742,2018,90.0,114.0,204.0,101.2,97.2,104.45,102.7,49,10,39,0.204,49,22,27,0.449,4,6,18,4,200.28,213.0,206.64
2019-01-30,1610612764,1610612754,2018,107.0,89.0,196.0,94.7,91.35,92.05,92.25,50,21,29,0.42,49,32,17,0.653,15,6,18,14,193.0,187.28,190.14
2019-01-30,1610612750,1610612763,2018,99.0,97.0,196.0,110.05,111.2,98.25,97.5,50,24,26,0.48,51,20,31,0.392,16,8,12,8,209.4,193.96,201.68
2019-01-30,1610612740,1610612743,2018,99.0,105.0,204.0,100.45,104.8,109.2,110.3,51,23,28,0.451,49,34,15,0.6940000000000001,15,8,22,12,200.8,217.04,208.92000000000002
2019-01-30,1610612758,1610612737,2018,135.0,113.0,248.0,97.75,101.5,96.35,95.7,50,25,25,0.5,49,16,33,0.327,14,11,8,8,207.08,199.44,203.26
2019-01-30,1610612757,1610612762,2018,132.0,105.0,237.0,104.75,105.45,95.55,106.55,51,31,20,0.608,51,29,22,0.569,21,10,15,14,209.44,200.2,204.82
2019-01-29,1610612739,1610612764,2018,116.0,113.0,229.0,101.9,101.55,94.7,91.35,51,10,41,0.196,49,21,28,0.429,5,5,15,6,195.48,193.0,194.24
2019-01-29,1610612765,1610612749,2018,105.0,115.0,220.0,100.85,105.95,99.8,108.15,48,21,27,0.438,48,35,13,0.7290000000000001,13,8,22,13,206.0,200.48,203.24
2019-01-29,1610612753,1610612760,2018,117.0,126.0,243.0,96.55,103.5,101.8,103.4,50,20,30,0.4,49,31,18,0.633,12,8,17,14,203.64,210.36,207.0
2019-01-29,1610612751,1610612741,2018,122.0,117.0,239.0,96.7,98.4,94.0,91.0,51,27,24,0.529,50,11,39,0.22,15,12,5,6,196.96,185.44,191.2
2019-01-29,1610612745,1610612740,2018,116.0,121.0,237.0,112.7,109.85,100.45,104.8,49,29,20,0.5920000000000001,50,22,28,0.44,19,10,15,7,216.24,200.8,208.52
2019-01-29,1610612759,1610612756,2018,126.0,124.0,250.0,107.75,96.55,106.25,103.85,51,29,22,0.569,52,11,41,0.212,19,10,7,4,204.12,212.88,208.5
2019-01-29,1610612747,1610612755,2018,105.0,121.0,226.0,107.3,114.65,97.85,106.0,50,26,24,0.52,50,32,18,0.64,16,10,21,11,219.28,207.68,213.48000000000002
2019-01-28,1610612766,1610612752,2018,101.0,92.0,193.0,99.45,97.7,101.2,97.2,48,23,25,0.479,48,10,38,0.208,16,7,4,6,194.96,200.28,197.62
2019-01-28,1610612754,1610612744,2018,100.0,132.0,232.0,92.05,92.25,107.5,105.85,48,32,16,0.667,49,35,14,0.7140000000000001,18,14,18,17,187.28,199.04,193.16
2019-01-28,1610612738,1610612751,2018,112.0,104.0,216.0,99.65,105.5,96.7,98.4,49,30,19,0.612,50,27,23,0.54,19,11,15,12,195.08,196.96,196.02
2019-01-28,1610612763,1610612743,2018,92.0,95.0,187.0,98.25,97.5,109.2,110.3,50,20,30,0.4,48,33,15,0.688,12,8,22,11,193.96,217.04,205.5
2019-01-28,1610612746,1610612737,2018,118.0,123.0,241.0,109.85,106.5,96.35,95.7,50,28,22,0.56,48,15,33,0.313,15,13,8,7,214.36,199.44,206.9
2019-01-27,1610612741,1610612739,2018,101.0,104.0,205.0,94.0,91.0,101.9,101.55,49,11,38,0.224,50,9,41,0.18,5,6,5,4,185.44,195.48,190.45999999999998
2019-01-27,1610612746,1610612758,2018,122.0,108.0,230.0,109.85,106.5,97.75,101.5,49,27,22,0.551,49,25,24,0.51,14,13,14,11,214.36,207.08,210.72000000000003
2019-01-27,1610612760,1610612749,2018,118.0,112.0,230.0,101.8,103.4,99.8,108.15,48,30,18,0.625,47,35,12,0.745,16,14,22,13,210.36,200.48,205.42000000000002
2019-01-27,1610612745,1610612753,2018,103.0,98.0,201.0,112.7,109.85,96.55,103.5,48,28,20,0.583,49,20,29,0.408,18,10,12,8,216.24,203.64,209.94
2019-01-27,1610612742,1610612761,2018,120.0,123.0,243.0,104.45,102.7,100.6,99.2,48,22,26,0.458,51,36,15,0.706,18,4,21,15,213.0,206.0,209.5
2019-01-27,1610612750,1610612762,2018,111.0,125.0,236.0,110.05,111.2,95.55,106.55,49,24,25,0.49,50,28,22,0.56,16,8,15,13,209.4,200.2,204.8
2019-01-27,1610612759,1610612764,2018,132.0,119.0,251.0,107.75,96.55,94.7,91.35,50,28,22,0.56,48,21,27,0.438,18,10,15,6,204.12,193.0,198.56
2019-01-27,1610612752,1610612748,2018,97.0,106.0,203.0,101.2,97.2,97.25,95.5,47,10,37,0.213,47,23,24,0.489,4,6,11,12,200.28,195.0,197.64
2019-01-27,1610612747,1610612756,2018,116.0,102.0,218.0,107.3,114.65,106.25,103.85,49,25,24,0.51,51,11,40,0.21600000000000005,15,10,7,4,219.28,212.88,216.07999999999998
2019-01-26,1610612740,1610612759,2018,114.0,126.0,240.0,100.45,104.8,107.75,96.55,49,22,27,0.449,49,27,22,0.551,15,7,18,9,200.8,204.12,202.46
2019-01-26,1610612763,1610612754,2018,106.0,103.0,209.0,98.25,97.5,92.05,92.25,49,19,30,0.388,47,32,15,0.6809999999999999,11,8,18,14,193.96,187.28,190.62
2019-01-26,1610612738,1610612744,2018,111.0,115.0,226.0,99.65,105.5,107.5,105.85,48,30,18,0.625,48,34,14,0.708,19,11,18,16,195.08,199.04,197.06
2019-01-26,1610612743,1610612755,2018,126.0,110.0,236.0,109.2,110.3,97.85,106.0,47,32,15,0.6809999999999999,49,32,17,0.653,21,11,21,11,217.04,207.68,212.36
2019-01-26,1610612757,1610612737,2018,120.0,111.0,231.0,104.75,105.45,96.35,95.7,50,30,20,0.6,47,15,32,0.319,20,10,8,7,209.44,199.44,204.44
2019-01-25,1610612753,1610612764,2018,91.0,95.0,186.0,96.55,103.5,94.7,91.35,48,20,28,0.417,47,20,27,0.426,12,8,15,5,203.64,193.0,198.32
2019-01-25,1610612751,1610612752,2018,109.0,99.0,208.0,96.7,98.4,101.2,97.2,49,26,23,0.531,46,10,36,0.217,14,12,4,6,196.96,200.28,198.62
2019-01-25,1610612739,1610612748,2018,94.0,100.0,194.0,101.9,101.55,97.25,95.5,49,9,40,0.184,46,22,24,0.478,5,4,11,11,195.48,195.0,195.24
2019-01-25,1610612741,1610612746,2018,101.0,106.0,207.0,94.0,91.0,109.85,106.5,48,11,37,0.229,48,26,22,0.542,5,6,14,12,185.44,214.36,199.9
2019-01-25,1610612745,1610612761,2018,121.0,119.0,240.0,112.7,109.85,100.6,99.2,47,27,20,0.574,50,36,14,0.72,17,10,21,15,216.24,206.0,211.12
2019-01-25,1610612763,1610612758,2018,96.0,99.0,195.0,98.25,97.5,97.75,101.5,48,19,29,0.396,48,24,24,0.5,11,8,14,10,193.96,207.08,200.52
2019-01-25,1610612742,1610612765,2018,106.0,101.0,207.0,104.45,102.7,100.85,105.95,47,21,26,0.447,47,21,26,0.447,17,4,13,8,213.0,206.0,209.5
2019-01-25,1610612749,1610612766,2018,108.0,99.0,207.0,99.8,108.15,99.45,97.7,46,34,12,0.7390000000000001,47,23,24,0.489,21,13,16,7,200.48,194.96,197.72
2019-01-25,1610612743,1610612756,2018,132.0,95.0,227.0,109.2,110.3,106.25,103.85,46,31,15,0.674,50,11,39,0.22,20,11,7,4,217.04,212.88,214.95999999999998
2019-01-25,1610612762,1610612750,2018,106.0,102.0,208.0,95.55,106.55,110.05,111.2,49,27,22,0.551,48,24,24,0.5,14,13,16,8,200.2,209.4,204.8
2019-01-24,1610612764,1610612744,2018,118.0,126.0,244.0,94.7,91.35,107.5,105.85,46,20,26,0.435,47,33,14,0.7020000000000001,15,5,18,15,193.0,199.04,196.01999999999998
2019-01-24,1610612760,1610612740,2018,122.0,116.0,238.0,101.8,103.4,100.45,104.8,47,29,18,0.617,48,22,26,0.458,15,14,15,7,210.36,200.8,205.58
2019-01-24,1610612756,1610612757,2018,106.0,120.0,226.0,106.25,103.85,104.75,105.45,49,11,38,0.224,49,29,20,0.5920000000000001,7,4,20,9,212.88,209.44,211.16
2019-01-24,1610612747,1610612750,2018,105.0,120.0,225.0,107.3,114.65,110.05,111.2,48,25,23,0.521,47,23,24,0.489,15,10,16,7,219.28,209.4,214.34
2019-01-23,1610612754,1610612761,2018,110.0,106.0,216.0,92.05,92.25,100.6,99.2,46,31,15,0.674,49,36,13,0.735,17,14,21,15,187.28,206.0,196.64
2019-01-23,1610612738,1610612739,2018,123.0,103.0,226.0,99.65,105.5,101.9,101.55,47,29,18,0.617,48,9,39,0.188,18,11,5,4,195.08,195.48,195.28
2019-01-23,1610612751,1610612753,2018,114.0,110.0,224.0,96.7,98.4,96.55,103.5,48,25,23,0.521,47,20,27,0.426,13,12,12,8,196.96,203.64,200.3
2019-01-23,1610612748,1610612746,2018,99.0,111.0,210.0,97.25,95.5,109.85,106.5,45,22,23,0.489,47,25,22,0.532,11,11,14,11,195.0,214.36,204.68
2019-01-23,1610612752,1610612745,2018,110.0,114.0,224.0,101.2,97.2,112.7,109.85,45,10,35,0.222,46,26,20,0.565,4,6,17,9,200.28,216.24,208.26
2019-01-23,1610612755,1610612759,2018,122.0,120.0,242.0,97.85,106.0,107.75,96.55,48,31,17,0.6459999999999999,48,27,21,0.563,20,11,18,9,207.68,204.12,205.9
2019-01-23,1610612741,1610612737,2018,101.0,121.0,222.0,94.0,91.0,96.35,95.7,47,11,36,0.234,46,14,32,0.304,5,6,8,6,185.44,199.44,192.44
2019-01-23,1610612763,1610612766,2018,107.0,118.0,225.0,98.25,97.5,99.45,97.7,47,19,28,0.404,46,22,24,0.478,11,8,16,6,193.96,194.96,194.46
2019-01-23,1610612740,1610612765,2018,94.0,98.0,192.0,100.45,104.8,100.85,105.95,47,22,25,0.468,46,20,26,0.435,15,7,13,7,200.8,206.0,203.4
2019-01-23,1610612762,1610612743,2018,114.0,108.0,222.0,95.55,106.55,109.2,110.3,48,26,22,0.542,45,31,14,0.6890000000000001,13,13,20,11,200.2,217.04,208.62
2019-01-22,1610612761,1610612758,2018,120.0,105.0,225.0,100.6,99.2,97.75,101.5,48,35,13,0.7290000000000001,47,24,23,0.511,20,15,14,10,206.0,207.08,206.54000000000002
2019-01-22,1610612760,1610612757,2018,123.0,114.0,237.0,101.8,103.4,104.75,105.45,46,28,18,0.609,48,29,19,0.604,14,14,20,9,210.36,209.44,209.9
2019-01-22,1610612742,1610612746,2018,106.0,98.0,204.0,104.45,102.7,109.85,106.5,46,20,26,0.435,46,25,21,0.5429999999999999,16,4,14,11,213.0,214.36,213.68
2019-01-22,1610612756,1610612750,2018,91.0,118.0,209.0,106.25,103.85,110.05,111.2,48,11,37,0.229,46,22,24,0.478,7,4,16,6,212.88,209.4,211.14
2019-01-21,1610612752,1610612760,2018,109.0,127.0,236.0,101.2,97.2,101.8,103.4,44,10,34,0.227,45,27,18,0.6,4,6,14,13,200.28,210.36,205.32
2019-01-21,1610612739,1610612741,2018,88.0,104.0,192.0,101.9,101.55,94.0,91.0,47,9,38,0.191,46,10,36,0.217,5,4,5,5,195.48,185.44,190.45999999999998
2019-01-21,1610612764,1610612765,2018,101.0,87.0,188.0,94.7,91.35,100.85,105.95,45,19,26,0.422,45,20,25,0.444,14,5,13,7,193.0,206.0,199.5
2019-01-21,1610612749,1610612742,2018,116.0,106.0,222.0,99.8,108.15,104.45,102.7,45,33,12,0.733,45,20,25,0.444,20,13,16,4,200.48,213.0,206.74
2019-01-21,1610612737,1610612753,2018,103.0,122.0,225.0,96.35,95.7,96.55,103.5,45,14,31,0.311,46,19,27,0.413,8,6,12,7,199.44,203.64,201.54
2019-01-21,1610612751,1610612758,2018,123.0,94.0,217.0,96.7,98.4,97.75,101.5,47,24,23,0.511,46,24,22,0.522,12,12,14,10,196.96,207.08,202.02
2019-01-21,1610612763,1610612740,2018,85.0,105.0,190.0,98.25,97.5,100.45,104.8,46,19,27,0.413,46,21,25,0.457,11,8,15,6,193.96,200.8,197.38
2019-01-21,1610612738,1610612748,2018,107.0,99.0,206.0,99.65,105.5,97.25,95.5,46,28,18,0.609,44,22,22,0.5,17,11,11,11,195.08,195.0,195.04000000000002
2019-01-21,1610612755,1610612745,2018,121.0,93.0,214.0,97.85,106.0,112.7,109.85,47,30,17,0.638,45,26,19,0.578,19,11,17,9,207.68,216.24,211.96
2019-01-21,1610612762,1610612757,2018,104.0,109.0,213.0,95.55,106.55,104.75,105.45,47,26,21,0.5529999999999999,47,28,19,0.596,13,13,20,8,200.2,209.44,204.82
2019-01-21,1610612747,1610612744,2018,111.0,130.0,241.0,107.3,114.65,107.5,105.85,47,25,22,0.532,46,32,14,0.696,15,10,18,14,219.28,199.04,209.16
2019-01-20,1610612754,1610612766,2018,120.0,95.0,215.0,92.05,92.25,99.45,97.7,45,30,15,0.667,45,22,23,0.489,16,14,16,6,187.28,194.96,191.12
2019-01-20,1610612750,1610612756,2018,116.0,114.0,230.0,110.05,111.2,106.25,103.85,45,21,24,0.467,47,11,36,0.234,15,6,7,4,209.4,212.88,211.14
2019-01-20,1610612759,1610612746,2018,95.0,103.0,198.0,107.75,96.55,109.85,106.5,47,27,20,0.574,45,24,21,0.5329999999999999,18,9,14,10,204.12,214.36,209.24
2019-01-19,1610612755,1610612760,2018,115.0,117.0,232.0,97.85,106.0,101.8,103.4,46,30,16,0.652,44,26,18,0.591,19,11,14,12,207.68,210.36,209.02
2019-01-19,1610612766,1610612756,2018,135.0,115.0,250.0,99.45,97.7,106.25,103.85,44,21,23,0.477,46,11,35,0.239,15,6,7,4,194.96,212.88,203.92000000000002
2019-01-19,1610612765,1610612758,2018,101.0,103.0,204.0,100.85,105.95,97.75,101.5,44,20,24,0.455,45,23,22,0.511,13,7,14,9,206.0,207.08,206.54000000000002
2019-01-19,1610612754,1610612742,2018,111.0,99.0,210.0,92.05,92.25,104.45,102.7,44,29,15,0.659,44,20,24,0.455,15,14,16,4,187.28,213.0,200.14
2019-01-19,1610612753,1610612749,2018,108.0,118.0,226.0,96.55,103.5,99.8,108.15,45,19,26,0.422,44,32,12,0.727,12,7,20,12,203.64,200.48,202.06
2019-01-19,1610612737,1610612738,2018,105.0,113.0,218.0,96.35,95.7,99.65,105.5,44,14,30,0.318,45,27,18,0.6,8,6,17,10,199.44,195.08,197.26
2019-01-19,1610612761,1610612763,2018,119.0,90.0,209.0,100.6,99.2,98.25,97.5,47,34,13,0.723,45,19,26,0.422,19,15,11,8,206.0,193.96,199.98000000000002
2019-01-19,1610612741,1610612748,2018,103.0,117.0,220.0,94.0,91.0,97.25,95.5,45,10,35,0.222,43,21,22,0.488,5,5,11,10,185.44,195.0,190.22
2019-01-19,1610612745,1610612747,2018,138.0,134.0,272.0,112.7,109.85,107.3,114.65,44,25,19,0.568,46,25,21,0.5429999999999999,16,9,15,10,216.24,219.28,217.76
2019-01-19,1610612743,1610612739,2018,124.0,102.0,226.0,109.2,110.3,101.9,101.55,44,30,14,0.682,46,9,37,0.196,19,11,5,4,217.04,195.48,206.26
2019-01-18,1610612738,1610612763,2018,122.0,116.0,238.0,99.65,105.5,98.25,97.5,44,26,18,0.591,44,19,25,0.4320000000000001,16,10,11,8,195.08,193.96,194.52
2019-01-18,1610612765,1610612748,2018,98.0,93.0,191.0,100.85,105.95,97.25,95.5,43,19,24,0.442,42,21,21,0.5,12,7,11,10,206.0,195.0,200.5
2019-01-18,1610612753,1610612751,2018,115.0,117.0,232.0,96.55,103.5,96.7,98.4,44,19,25,0.4320000000000001,46,23,23,0.5,12,7,12,11,203.64,196.96,200.3
2019-01-18,1610612750,1610612759,2018,113.0,116.0,229.0,110.05,111.2,107.75,96.55,44,21,23,0.477,46,26,20,0.565,15,6,18,8,209.4,204.12,206.76
2019-01-18,1610612762,1610612739,2018,115.0,99.0,214.0,95.55,106.55,101.9,101.55,46,25,21,0.5429999999999999,45,9,36,0.2,12,13,5,4,200.2,195.48,197.83999999999997
2019-01-18,1610612746,1610612744,2018,94.0,112.0,206.0,109.85,106.5,107.5,105.85,44,24,20,0.545,45,31,14,0.6890000000000001,14,10,18,13,214.36,199.04,206.7
2019-01-18,1610612757,1610612740,2018,128.0,112.0,240.0,104.75,105.45,100.45,104.8,46,27,19,0.5870000000000001,45,21,24,0.467,19,8,15,6,209.44,200.8,205.12
2019-01-17,1610612764,1610612752,2018,101.0,100.0,201.0,94.7,91.35,101.2,97.2,44,18,26,0.409,43,10,33,0.233,13,5,4,6,193.0,200.28,196.64
2019-01-17,1610612766,1610612758,2018,114.0,95.0,209.0,99.45,97.7,97.75,101.5,43,20,23,0.465,44,23,21,0.523,14,6,14,9,194.96,207.08,201.02
2019-01-17,1610612754,1610612755,2018,96.0,120.0,216.0,92.05,92.25,97.85,106.0,43,29,14,0.674,45,29,16,0.644,15,14,19,10,187.28,207.68,197.48000000000002
2019-01-17,1610612761,1610612756,2018,111.0,109.0,220.0,100.6,99.2,106.25,103.85,46,33,13,0.7170000000000001,45,11,34,0.244,18,15,7,4,206.0,212.88,209.44
2019-01-17,1610612743,1610612741,2018,135.0,105.0,240.0,109.2,110.3,94.0,91.0,43,29,14,0.674,44,10,34,0.227,18,11,5,5,217.04,185.44,201.24
2019-01-17,1610612760,1610612747,2018,128.0,138.0,266.0,101.8,103.4,107.3,114.65,43,26,17,0.605,45,24,21,0.5329999999999999,14,12,15,9,210.36,219.28,214.82
2019-01-16,1610612765,1610612753,2018,120.0,115.0,235.0,100.85,105.95,96.55,103.5,42,18,24,0.429,43,19,24,0.442,11,7,12,7,206.0,203.64,204.82
2019-01-16,1610612738,1610612761,2018,117.0,108.0,225.0,99.65,105.5,100.6,99.2,43,25,18,0.581,45,33,12,0.733,15,10,18,15,195.08,206.0,200.54000000000002
2019-01-16,1610612745,1610612751,2018,142.0,145.0,287.0,112.7,109.85,96.7,98.4,43,25,18,0.581,45,22,23,0.489,16,9,12,10,216.24,196.96,206.60000000000002
2019-01-16,1610612763,1610612749,2018,101.0,111.0,212.0,98.25,97.5,99.8,108.15,43,19,24,0.442,43,31,12,0.721,11,8,20,11,193.96,200.48,197.22
2019-01-16,1610612742,1610612759,2018,101.0,105.0,206.0,104.45,102.7,107.75,96.55,43,20,23,0.465,45,25,20,0.556,16,4,18,7,213.0,204.12,208.56
2019-01-16,1610612757,1610612739,2018,129.0,112.0,241.0,104.75,105.45,101.9,101.55,45,26,19,0.578,44,9,35,0.205,18,8,5,4,209.44,195.48,202.45999999999998
2019-01-16,1610612744,1610612740,2018,147.0,140.0,287.0,107.5,105.85,100.45,104.8,44,30,14,0.682,44,21,23,0.477,17,13,15,6,199.04,200.8,199.92000000000002
2019-01-16,1610612746,1610612762,2018,109.0,129.0,238.0,109.85,106.5,95.55,106.55,43,24,19,0.5579999999999999,45,24,21,0.5329999999999999,14,10,12,12,214.36,200.2,207.28
2019-01-15,1610612754,1610612756,2018,131.0,97.0,228.0,92.05,92.25,106.25,103.85,42,28,14,0.667,44,11,33,0.25,14,14,7,4,187.28,212.88,200.07999999999998
2019-01-15,1610612755,1610612750,2018,149.0,107.0,256.0,97.85,106.0,110.05,111.2,44,28,16,0.636,43,21,22,0.488,18,10,15,6,207.68,209.4,208.54000000000002
2019-01-15,1610612737,1610612760,2018,142.0,126.0,268.0,96.35,95.7,101.8,103.4,43,13,30,0.302,42,26,16,0.619,7,6,14,12,199.44,210.36,204.9
2019-01-15,1610612749,1610612748,2018,124.0,86.0,210.0,99.8,108.15,97.25,95.5,42,30,12,0.7140000000000001,41,21,20,0.512,19,11,11,10,200.48,195.0,197.74
2019-01-15,1610612743,1610612744,2018,111.0,142.0,253.0,109.2,110.3,107.5,105.85,42,29,13,0.69,43,29,14,0.674,18,11,17,12,217.04,199.04,208.04
2019-01-15,1610612747,1610612741,2018,107.0,100.0,207.0,107.3,114.65,94.0,91.0,44,23,21,0.523,43,10,33,0.233,14,9,5,5,219.28,185.44,202.36
2019-01-14,1610612751,1610612738,2018,109.0,102.0,211.0,96.7,98.4,99.65,105.5,44,21,23,0.477,42,25,17,0.595,11,10,15,10,196.96,195.08,196.02
2019-01-14,1610612745,1610612763,2018,112.0,94.0,206.0,112.7,109.85,98.25,97.5,42,24,18,0.5710000000000001,42,19,23,0.452,15,9,11,8,216.24,193.96,205.10000000000002
2019-01-14,1610612759,1610612766,2018,93.0,108.0,201.0,107.75,96.55,99.45,97.7,44,25,19,0.568,42,19,23,0.452,18,7,14,5,204.12,194.96,199.54000000000002
2019-01-14,1610612762,1610612765,2018,100.0,94.0,194.0,95.55,106.55,100.85,105.95,44,23,21,0.523,41,18,23,0.439,11,12,11,7,200.2,206.0,203.1
2019-01-14,1610612758,1610612757,2018,115.0,107.0,222.0,97.75,101.5,104.75,105.45,43,22,21,0.512,44,26,18,0.591,13,9,18,8,207.08,209.44,208.26
2019-01-14,1610612746,1610612740,2018,117.0,121.0,238.0,109.85,106.5,100.45,104.8,42,24,18,0.5710000000000001,43,20,23,0.465,14,10,15,5,214.36,200.8,207.58
2019-01-13,1610612752,1610612755,2018,105.0,108.0,213.0,101.2,97.2,97.85,106.0,42,10,32,0.238,43,27,16,0.628,4,6,18,9,200.28,207.68,203.98000000000002
2019-01-13,1610612764,1610612761,2018,138.0,140.0,278.0,94.7,91.35,100.6,99.2,43,18,25,0.419,44,32,12,0.727,13,5,18,14,193.0,206.0,199.5
2019-01-13,1610612737,1610612749,2018,114.0,133.0,247.0,96.35,95.7,99.8,108.15,42,13,29,0.31,41,29,12,0.7070000000000001,7,6,19,10,199.44,200.48,199.95999999999998
2019-01-13,1610612753,1610612745,2018,116.0,109.0,225.0,96.55,103.5,112.7,109.85,42,18,24,0.429,41,24,17,0.585,11,7,15,9,203.64,216.24,209.94
2019-01-13,1610612742,1610612744,2018,114.0,119.0,233.0,104.45,102.7,107.5,105.85,42,20,22,0.476,42,28,14,0.667,16,4,17,11,213.0,199.04,206.01999999999998
2019-01-13,1610612743,1610612757,2018,116.0,113.0,229.0,109.2,110.3,104.75,105.45,41,28,13,0.6829999999999999,43,26,17,0.605,17,11,18,8,217.04,209.44,213.24
2019-01-13,1610612747,1610612739,2018,95.0,101.0,196.0,107.3,114.65,101.9,101.55,43,23,20,0.535,43,8,35,0.18600000000000005,14,9,5,3,219.28,195.48,207.38
2019-01-12,1610612746,1610612765,2018,104.0,109.0,213.0,109.85,106.5,100.85,105.95,41,24,17,0.585,40,17,23,0.425,14,10,11,6,214.36,206.0,210.18
2019-01-12,1610612748,1610612763,2018,112.0,108.0,220.0,97.25,95.5,98.25,97.5,40,20,20,0.5,41,19,22,0.463,10,10,11,8,195.0,193.96,194.48000000000002
2019-01-12,1610612753,1610612738,2018,105.0,103.0,208.0,96.55,103.5,99.65,105.5,41,17,24,0.415,41,25,16,0.61,10,7,15,10,203.64,195.08,199.36
2019-01-12,1610612750,1610612740,2018,110.0,106.0,216.0,110.05,111.2,100.45,104.8,42,20,22,0.476,42,20,22,0.476,14,6,15,5,209.4,200.8,205.10000000000002
2019-01-12,1610612760,1610612759,2018,122.0,112.0,234.0,101.8,103.4,107.75,96.55,41,25,16,0.61,43,25,18,0.581,13,12,18,7,210.36,204.12,207.24
2019-01-12,1610612756,1610612743,2018,102.0,93.0,195.0,106.25,103.85,109.2,110.3,43,10,33,0.233,40,28,12,0.7,6,4,17,11,212.88,217.04,214.95999999999998
2019-01-12,1610612758,1610612766,2018,104.0,97.0,201.0,97.75,101.5,99.45,97.7,42,21,21,0.5,41,19,22,0.463,12,9,14,5,207.08,194.96,201.02
2019-01-12,1610612762,1610612741,2018,110.0,102.0,212.0,95.55,106.55,94.0,91.0,43,22,21,0.512,42,10,32,0.238,10,12,5,5,200.2,185.44,192.82
2019-01-11,1610612755,1610612737,2018,121.0,123.0,244.0,97.85,106.0,96.35,95.7,42,27,15,0.643,41,12,29,0.293,18,9,7,5,207.68,199.44,203.56
2019-01-11,1610612764,1610612749,2018,113.0,106.0,219.0,94.7,91.35,99.8,108.15,42,17,25,0.405,40,29,11,0.725,12,5,19,10,193.0,200.48,196.74
2019-01-11,1610612752,1610612754,2018,106.0,121.0,227.0,101.2,97.2,92.05,92.25,41,10,31,0.244,41,27,14,0.659,4,6,14,13,200.28,187.28,193.78
2019-01-11,1610612761,1610612751,2018,122.0,105.0,227.0,100.6,99.2,96.7,98.4,43,31,12,0.721,43,21,22,0.488,17,14,11,10,206.0,196.96,201.48000000000002
2019-01-11,1610612745,1610612739,2018,141.0,113.0,254.0,112.7,109.85,101.9,101.55,40,23,17,0.575,42,8,34,0.19,14,9,5,3,216.24,195.48,205.86
2019-01-11,1610612750,1610612742,2018,115.0,119.0,234.0,110.05,111.2,104.45,102.7,41,20,21,0.488,41,19,22,0.463,14,6,16,3,209.4,213.0,211.2
2019-01-11,1610612762,1610612747,2018,113.0,95.0,208.0,95.55,106.55,107.3,114.65,42,21,21,0.5,42,23,19,0.5479999999999999,9,12,14,9,200.2,219.28,209.74
2019-01-11,1610612757,1610612766,2018,127.0,96.0,223.0,104.75,105.45,99.45,97.7,42,25,17,0.595,40,19,21,0.475,17,8,14,5,209.44,194.96,202.2
2019-01-11,1610612744,1610612741,2018,146.0,109.0,255.0,107.5,105.85,94.0,91.0,41,27,14,0.659,41,10,31,0.244,16,11,5,5,199.04,185.44,192.24
2019-01-10,1610612748,1610612738,2018,115.0,99.0,214.0,97.25,95.5,99.65,105.5,39,19,20,0.487,40,25,15,0.625,9,10,15,10,195.0,195.08,195.04000000000002
2019-01-10,1610612743,1610612746,2018,121.0,100.0,221.0,109.2,110.3,109.85,106.5,39,27,12,0.6920000000000001,40,24,16,0.6,16,11,14,10,217.04,214.36,215.7
2019-01-10,1610612759,1610612760,2018,154.0,147.0,301.0,107.75,96.55,101.8,103.4,42,24,18,0.5710000000000001,40,25,15,0.625,17,7,13,12,204.12,210.36,207.24
2019-01-10,1610612758,1610612765,2018,112.0,102.0,214.0,97.75,101.5,100.85,105.95,41,20,21,0.488,39,17,22,0.436,11,9,11,6,207.08,206.0,206.54000000000002
2019-01-09,1610612738,1610612754,2018,135.0,108.0,243.0,99.65,105.5,92.05,92.25,39,24,15,0.615,40,27,13,0.675,14,10,14,13,195.08,187.28,191.18
2019-01-09,1610612764,1610612755,2018,123.0,106.0,229.0,94.7,91.35,97.85,106.0,41,16,25,0.39,41,27,14,0.659,11,5,18,9,193.0,207.68,200.34
2019-01-09,1610612751,1610612737,2018,116.0,100.0,216.0,96.7,98.4,96.35,95.7,42,20,22,0.476,40,12,28,0.3,10,10,7,5,196.96,199.44,198.2
2019-01-09,1610612745,1610612749,2018,109.0,116.0,225.0,112.7,109.85,99.8,108.15,39,23,16,0.59,39,28,11,0.718,14,9,19,9,216.24,200.48,208.36
2019-01-09,1610612763,1610612759,2018,96.0,86.0,182.0,98.25,97.5,107.75,96.55,40,18,22,0.45,41,24,17,0.585,10,8,17,7,193.96,204.12,199.04000000000002
2019-01-09,1610612740,1610612739,2018,140.0,124.0,264.0,100.45,104.8,101.9,101.55,41,19,22,0.463,41,8,33,0.195,14,5,5,3,200.8,195.48,198.14
2019-01-09,1610612742,1610612756,2018,104.0,94.0,198.0,104.45,102.7,106.25,103.85,40,18,22,0.45,42,10,32,0.238,15,3,6,4,213.0,212.88,212.94
2019-01-09,1610612762,1610612753,2018,106.0,93.0,199.0,95.55,106.55,96.55,103.5,41,20,21,0.488,40,17,23,0.425,8,12,10,7,200.2,203.64,201.92
2019-01-09,1610612757,1610612741,2018,124.0,112.0,236.0,104.75,105.45,94.0,91.0,41,24,17,0.585,40,10,30,0.25,16,8,5,5,209.44,185.44,197.44
2019-01-09,1610612747,1610612765,2018,113.0,100.0,213.0,107.3,114.65,100.85,105.95,41,22,19,0.537,38,17,21,0.447,13,9,11,6,219.28,206.0,212.64
2019-01-08,1610612739,1610612754,2018,115.0,123.0,238.0,101.9,101.55,92.05,92.25,40,8,32,0.2,39,26,13,0.667,5,3,14,12,195.48,187.28,191.38
2019-01-08,1610612755,1610612764,2018,132.0,115.0,247.0,97.85,106.0,94.7,91.35,40,26,14,0.65,40,16,24,0.4,17,9,11,5,207.68,193.0,200.34
2019-01-08,1610612748,1610612743,2018,99.0,103.0,202.0,97.25,95.5,109.2,110.3,38,19,19,0.5,38,26,12,0.684,9,10,16,10,195.0,217.04,206.01999999999998
2019-01-08,1610612761,1610612737,2018,104.0,101.0,205.0,100.6,99.2,96.35,95.7,42,30,12,0.7140000000000001,39,12,27,0.308,16,14,7,5,206.0,199.44,202.72
2019-01-08,1610612760,1610612750,2018,117.0,119.0,236.0,101.8,103.4,110.05,111.2,39,25,14,0.6409999999999999,40,19,21,0.475,13,12,14,5,210.36,209.4,209.88
2019-01-08,1610612756,1610612758,2018,115.0,111.0,226.0,106.25,103.85,97.75,101.5,41,9,32,0.22,40,20,20,0.5,5,4,11,9,212.88,207.08,209.98000000000002
2019-01-08,1610612744,1610612752,2018,122.0,95.0,217.0,107.5,105.85,101.2,97.2,40,26,14,0.65,40,10,30,0.25,15,11,4,6,199.04,200.28,199.66
2019-01-08,1610612746,1610612766,2018,128.0,109.0,237.0,109.85,106.5,99.45,97.7,39,23,16,0.59,39,19,20,0.487,13,10,14,5,214.36,194.96,204.66000000000003
2019-01-07,1610612765,1610612759,2018,107.0,119.0,226.0,100.85,105.95,107.75,96.55,37,17,20,0.459,40,23,17,0.575,11,6,17,6,206.0,204.12,205.06
2019-01-07,1610612738,1610612751,2018,116.0,95.0,211.0,99.65,105.5,96.7,98.4,38,23,15,0.605,41,20,21,0.488,13,10,10,10,195.08,196.96,196.02
2019-01-07,1610612745,1610612743,2018,125.0,113.0,238.0,112.7,109.85,109.2,110.3,38,22,16,0.579,37,26,11,0.703,13,9,16,10,216.24,217.04,216.64
2019-01-07,1610612749,1610612762,2018,114.0,102.0,216.0,99.8,108.15,95.55,106.55,38,27,11,0.711,40,20,20,0.5,18,9,8,12,200.48,200.2,200.33999999999997
2019-01-07,1610612740,1610612763,2018,114.0,95.0,209.0,100.45,104.8,98.25,97.5,40,18,22,0.45,39,18,21,0.462,13,5,10,8,200.8,193.96,197.38
2019-01-07,1610612742,1610612747,2018,97.0,107.0,204.0,104.45,102.7,107.3,114.65,39,18,21,0.462,40,21,19,0.525,15,3,13,8,213.0,219.28,216.14
2019-01-07,1610612757,1610612752,2018,111.0,101.0,212.0,104.75,105.45,101.2,97.2,40,23,17,0.575,39,10,29,0.256,15,8,4,6,209.44,200.28,204.86
2019-01-07,1610612758,1610612753,2018,111.0,95.0,206.0,97.75,101.5,96.55,103.5,39,19,20,0.487,39,17,22,0.436,10,9,10,7,207.08,203.64,205.36
2019-01-06,1610612741,1610612751,2018,100.0,117.0,217.0,94.0,91.0,96.7,98.4,39,10,29,0.256,40,19,21,0.475,5,5,10,9,185.44,196.96,191.2
2019-01-06,1610612750,1610612747,2018,108.0,86.0,194.0,110.05,111.2,107.3,114.65,39,18,21,0.462,39,21,18,0.5379999999999999,13,5,13,8,209.4,219.28,214.34
2019-01-06,1610612746,1610612753,2018,106.0,96.0,202.0,109.85,106.5,96.55,103.5,38,22,16,0.579,38,17,21,0.447,12,10,10,7,214.36,203.64,209.0
2019-01-06,1610612737,1610612748,2018,106.0,82.0,188.0,96.35,95.7,97.25,95.5,38,11,27,0.289,37,19,18,0.514,6,5,9,10,199.44,195.0,197.22
2019-01-06,1610612760,1610612764,2018,98.0,116.0,214.0,101.8,103.4,94.7,91.35,38,25,13,0.6579999999999999,39,15,24,0.385,13,12,11,4,210.36,193.0,201.68
2019-01-06,1610612761,1610612754,2018,121.0,105.0,226.0,100.6,99.2,92.05,92.25,41,29,12,0.7070000000000001,38,26,12,0.684,15,14,14,12,206.0,187.28,196.64
2019-01-06,1610612756,1610612766,2018,113.0,119.0,232.0,106.25,103.85,99.45,97.7,40,9,31,0.225,38,18,20,0.474,5,4,14,4,212.88,194.96,203.92000000000002
2019-01-05,1610612743,1610612766,2018,123.0,110.0,233.0,109.2,110.3,99.45,97.7,36,25,11,0.6940000000000001,37,18,19,0.486,15,10,14,4,217.04,194.96,206.0
2019-01-05,1610612765,1610612762,2018,105.0,110.0,215.0,100.85,105.95,95.55,106.55,36,17,19,0.472,39,19,20,0.487,11,6,8,11,206.0,200.2,203.1
2019-01-05,1610612755,1610612742,2018,106.0,100.0,206.0,97.85,106.0,104.45,102.7,39,25,14,0.6409999999999999,38,18,20,0.474,16,9,15,3,207.68,213.0,210.34
2019-01-05,1610612739,1610612740,2018,98.0,133.0,231.0,101.9,101.55,100.45,104.8,39,8,31,0.205,39,17,22,0.436,5,3,13,4,195.48,200.8,198.14
2019-01-05,1610612749,1610612761,2018,116.0,123.0,239.0,99.8,108.15,100.6,99.2,37,27,10,0.73,40,28,12,0.7,18,9,15,13,200.48,206.0,203.24
2019-01-05,1610612759,1610612763,2018,108.0,88.0,196.0,107.75,96.55,98.25,97.5,39,22,17,0.564,38,18,20,0.474,16,6,10,8,204.12,193.96,199.04000000000002
2019-01-05,1610612757,1610612745,2018,110.0,101.0,211.0,104.75,105.45,112.7,109.85,39,22,17,0.564,37,22,15,0.595,14,8,13,9,209.44,216.24,212.84
2019-01-05,1610612758,1610612744,2018,123.0,127.0,250.0,97.75,101.5,107.5,105.85,38,19,19,0.5,39,25,14,0.6409999999999999,10,9,15,10,207.08,199.04,203.06
2019-01-04,1610612739,1610612762,2018,91.0,117.0,208.0,101.9,101.55,95.55,106.55,38,8,30,0.211,38,18,20,0.474,5,3,8,10,195.48,200.2,197.83999999999997
2019-01-04,1610612738,1610612742,2018,114.0,93.0,207.0,99.65,105.5,104.45,102.7,37,22,15,0.595,37,18,19,0.486,12,10,15,3,195.08,213.0,204.04000000000002
2019-01-04,1610612748,1610612764,2018,115.0,109.0,224.0,97.25,95.5,94.7,91.35,36,18,18,0.5,38,15,23,0.395,8,10,11,4,195.0,193.0,194.0
2019-01-04,1610612741,1610612754,2018,116.0,119.0,235.0,94.0,91.0,92.05,92.25,38,10,28,0.263,37,25,12,0.6759999999999999,5,5,14,11,185.44,187.28,186.36
2019-01-04,1610612763,1610612751,2018,100.0,109.0,209.0,98.25,97.5,96.7,98.4,37,18,19,0.486,39,18,21,0.462,10,8,10,8,193.96,196.96,195.46
2019-01-04,1610612750,1610612753,2018,120.0,103.0,223.0,110.05,111.2,96.55,103.5,38,17,21,0.447,37,17,20,0.459,12,5,10,7,209.4,203.64,206.51999999999998
2019-01-04,1610612749,1610612737,2018,144.0,112.0,256.0,99.8,108.15,96.35,95.7,36,26,10,0.722,37,11,26,0.297,17,9,6,5,200.48,199.44,199.95999999999998
2019-01-04,1610612756,1610612746,2018,111.0,121.0,232.0,106.25,103.85,109.85,106.5,39,9,30,0.231,37,21,16,0.568,5,4,12,9,212.88,214.36,213.62
2019-01-04,1610612747,1610612752,2018,112.0,119.0,231.0,107.3,114.65,101.2,97.2,38,21,17,0.5529999999999999,38,9,29,0.237,13,8,4,5,219.28,200.28,209.78
2019-01-04,1610612757,1610612760,2018,109.0,111.0,220.0,104.75,105.45,101.8,103.4,38,22,16,0.579,37,24,13,0.649,14,8,13,11,209.44,210.36,209.9
2019-01-03,1610612759,1610612761,2018,125.0,107.0,232.0,107.75,96.55,100.6,99.2,38,21,17,0.5529999999999999,39,28,11,0.718,15,6,15,13,204.12,206.0,205.06
2019-01-03,1610612758,1610612743,2018,113.0,117.0,230.0,97.75,101.5,109.2,110.3,37,19,18,0.514,35,24,11,0.6859999999999999,10,9,15,9,207.08,217.04,212.06
2019-01-03,1610612744,1610612745,2018,134.0,135.0,269.0,107.5,105.85,112.7,109.85,38,25,13,0.6579999999999999,36,21,15,0.583,15,10,13,8,199.04,216.24,207.64
2019-01-02,1610612766,1610612742,2018,84.0,122.0,206.0,99.45,97.7,104.45,102.7,36,18,18,0.5,36,17,19,0.472,14,4,15,2,194.96,213.0,203.98000000000002
2019-01-02,1610612739,1610612748,2018,92.0,117.0,209.0,101.9,101.55,97.25,95.5,37,8,29,0.21600000000000005,35,17,18,0.486,5,3,8,9,195.48,195.0,195.24
2019-01-02,1610612764,1610612737,2018,114.0,98.0,212.0,94.7,91.35,96.35,95.7,37,14,23,0.378,36,11,25,0.306,10,4,6,5,193.0,199.44,196.22
2019-01-02,1610612751,1610612740,2018,126.0,121.0,247.0,96.7,98.4,100.45,104.8,38,17,21,0.447,38,17,21,0.447,9,8,13,4,196.96,200.8,198.88
2019-01-02,1610612738,1610612750,2018,115.0,102.0,217.0,99.65,105.5,110.05,111.2,36,21,15,0.583,37,17,20,0.459,11,10,12,5,195.08,209.4,202.24
2019-01-02,1610612741,1610612753,2018,84.0,112.0,196.0,94.0,91.0,96.55,103.5,37,10,27,0.27,36,16,20,0.444,5,5,10,6,185.44,203.64,194.54
2019-01-02,1610612763,1610612765,2018,94.0,101.0,195.0,98.25,97.5,100.85,105.95,36,18,18,0.5,35,16,19,0.457,10,8,11,5,193.96,206.0,199.98000000000002
2019-01-02,1610612756,1610612755,2018,127.0,132.0,259.0,106.25,103.85,97.85,106.0,38,9,29,0.237,38,24,14,0.632,5,4,16,8,212.88,207.68,210.28
2019-01-02,1610612747,1610612760,2018,100.0,107.0,207.0,107.3,114.65,101.8,103.4,37,21,16,0.568,36,23,13,0.639,13,8,13,10,219.28,210.36,214.82
2019-01-01,1610612761,1610612762,2018,122.0,116.0,238.0,100.6,99.2,95.55,106.55,38,27,11,0.711,37,18,19,0.486,14,13,8,10,206.0,200.2,203.1
2019-01-01,1610612749,1610612765,2018,121.0,98.0,219.0,99.8,108.15,100.85,105.95,35,25,10,0.7140000000000001,34,16,18,0.471,16,9,11,5,200.48,206.0,203.24
2019-01-01,1610612743,1610612752,2018,115.0,108.0,223.0,109.2,110.3,101.2,97.2,34,23,11,0.6759999999999999,37,9,28,0.243,14,9,4,5,217.04,200.28,208.66
2019-01-01,1610612758,1610612757,2018,108.0,113.0,221.0,97.75,101.5,104.75,105.45,36,19,17,0.528,37,21,16,0.568,10,9,14,7,207.08,209.44,208.26
2019-01-01,1610612746,1610612755,2018,113.0,119.0,232.0,109.85,106.5,97.85,106.0,36,21,15,0.583,37,23,14,0.622,12,9,16,7,214.36,207.68,211.02
2018-12-31,1610612754,1610612737,2018,116.0,108.0,224.0,92.05,92.25,96.35,95.7,36,24,12,0.667,35,11,24,0.314,13,11,6,5,187.28,199.44,193.36
2018-12-31,1610612766,1610612753,2018,125.0,100.0,225.0,99.45,97.7,96.55,103.5,35,17,18,0.486,35,16,19,0.457,13,4,10,6,194.96,203.64,199.3
2018-12-31,1610612745,1610612763,2018,113.0,101.0,214.0,112.7,109.85,98.25,97.5,35,20,15,0.5710000000000001,35,18,17,0.514,12,8,10,8,216.24,193.96,205.10000000000002
2018-12-31,1610612759,1610612738,2018,120.0,111.0,231.0,107.75,96.55,99.65,105.5,37,20,17,0.541,35,21,14,0.6,14,6,11,10,204.12,195.08,199.60000000000002
2018-12-31,1610612740,1610612750,2018,123.0,114.0,237.0,100.45,104.8,110.05,111.2,37,16,21,0.4320000000000001,36,17,19,0.472,12,4,12,5,200.8,209.4,205.10000000000002
2018-12-31,1610612760,1610612742,2018,122.0,102.0,224.0,101.8,103.4,104.45,102.7,35,22,13,0.629,35,17,18,0.486,12,10,15,2,210.36,213.0,211.68
2018-12-31,1610612756,1610612744,2018,109.0,132.0,241.0,106.25,103.85,107.5,105.85,37,9,28,0.243,37,24,13,0.649,5,4,15,9,212.88,199.04,205.95999999999998
2018-12-30,1610612753,1610612765,2018,109.0,107.0,216.0,96.55,103.5,100.85,105.95,34,15,19,0.441,33,16,17,0.485,9,6,11,5,203.64,206.0,204.82
2018-12-30,1610612748,1610612750,2018,104.0,113.0,217.0,97.25,95.5,110.05,111.2,34,17,17,0.5,35,16,19,0.457,8,9,12,4,195.0,209.4,202.2
2018-12-30,1610612761,1610612741,2018,95.0,89.0,184.0,100.6,99.2,94.0,91.0,37,26,11,0.703,36,10,26,0.278,13,13,5,5,206.0,185.44,195.72
2018-12-30,1610612742,1610612760,2018,105.0,103.0,208.0,104.45,102.7,101.8,103.4,34,16,18,0.471,34,22,12,0.647,14,2,12,10,213.0,210.36,211.68
2018-12-30,1610612757,1610612755,2018,129.0,95.0,224.0,104.75,105.45,97.85,106.0,36,20,16,0.556,36,23,13,0.639,13,7,16,7,209.44,207.68,208.56
2018-12-30,1610612747,1610612758,2018,121.0,114.0,235.0,107.3,114.65,97.75,101.5,36,20,16,0.556,35,19,16,0.5429999999999999,12,8,10,9,219.28,207.08,213.18
2018-12-29,1610612749,1610612751,2018,129.0,115.0,244.0,99.8,108.15,96.7,98.4,34,24,10,0.706,37,17,20,0.459,15,9,9,8,200.48,196.96,198.72
2018-12-29,1610612740,1610612745,2018,104.0,108.0,212.0,100.45,104.8,112.7,109.85,36,16,20,0.444,34,19,15,0.5589999999999999,12,4,12,7,200.8,216.24,208.52
2018-12-29,1610612764,1610612766,2018,130.0,126.0,256.0,94.7,91.35,99.45,97.7,36,13,23,0.361,34,17,17,0.5,9,4,13,4,193.0,194.96,193.98000000000002
2018-12-29,1610612737,1610612739,2018,111.0,108.0,219.0,96.35,95.7,101.9,101.55,34,10,24,0.294,36,8,28,0.222,5,5,5,3,199.44,195.48,197.45999999999998
2018-12-29,1610612763,1610612738,2018,103.0,112.0,215.0,98.25,97.5,99.65,105.5,34,18,16,0.529,34,20,14,0.588,10,8,11,9,193.96,195.08,194.52
2018-12-29,1610612762,1610612752,2018,129.0,97.0,226.0,95.55,106.55,101.2,97.2,36,17,19,0.472,36,9,27,0.25,7,10,4,5,200.2,200.28,200.24
2018-12-29,1610612756,1610612743,2018,118.0,122.0,240.0,106.25,103.85,109.2,110.3,36,9,27,0.25,33,22,11,0.667,5,4,14,8,212.88,217.04,214.95999999999998
2018-12-29,1610612757,1610612744,2018,105.0,115.0,220.0,104.75,105.45,107.5,105.85,35,20,15,0.5710000000000001,36,23,13,0.639,13,7,15,8,209.44,199.04,204.24
2018-12-29,1610612746,1610612759,2018,111.0,122.0,233.0,109.85,106.5,107.75,96.55,35,21,14,0.6,36,19,17,0.528,12,9,14,5,214.36,204.12,209.24
2018-12-28,1610612766,1610612751,2018,100.0,87.0,187.0,99.45,97.7,96.7,98.4,33,16,17,0.485,36,17,19,0.472,12,4,9,8,194.96,196.96,195.96
2018-12-28,1610612754,1610612765,2018,125.0,88.0,213.0,92.05,92.25,100.85,105.95,35,23,12,0.657,32,16,16,0.5,12,11,11,5,187.28,206.0,196.64
2018-12-28,1610612753,1610612761,2018,116.0,87.0,203.0,96.55,103.5,100.6,99.2,33,14,19,0.424,36,26,10,0.722,8,6,13,13,203.64,206.0,204.82
2018-12-28,1610612764,1610612741,2018,92.0,101.0,193.0,94.7,91.35,94.0,91.0,35,13,22,0.371,35,9,26,0.257,9,4,5,4,193.0,185.44,189.22
2018-12-28,1610612748,1610612739,2018,118.0,94.0,212.0,97.25,95.5,101.9,101.55,33,16,17,0.485,35,8,27,0.229,7,9,5,3,195.0,195.48,195.24
2018-12-28,1610612750,1610612737,2018,120.0,123.0,243.0,110.05,111.2,96.35,95.7,34,16,18,0.471,33,9,24,0.273,12,4,5,4,209.4,199.44,204.42000000000002
2018-12-28,1610612740,1610612742,2018,114.0,112.0,226.0,100.45,104.8,104.45,102.7,35,15,20,0.429,33,16,17,0.485,11,4,14,2,200.8,213.0,206.9
2018-12-28,1610612743,1610612759,2018,102.0,99.0,201.0,109.2,110.3,107.75,96.55,32,21,11,0.6559999999999999,35,19,16,0.5429999999999999,13,8,14,5,217.04,204.12,210.57999999999998
2018-12-28,1610612756,1610612760,2018,102.0,118.0,220.0,106.25,103.85,101.8,103.4,35,9,26,0.257,33,21,12,0.636,5,4,12,9,212.88,210.36,211.62
2018-12-28,1610612747,1610612746,2018,107.0,118.0,225.0,107.3,114.65,109.85,106.5,35,20,15,0.5710000000000001,34,20,14,0.588,12,8,12,8,219.28,214.36,216.82
2018-12-27,1610612745,1610612738,2018,127.0,113.0,240.0,112.7,109.85,99.65,105.5,33,18,15,0.545,33,20,13,0.606,11,7,11,9,216.24,195.08,205.66000000000003
2018-12-27,1610612749,1610612752,2018,112.0,96.0,208.0,99.8,108.15,101.2,97.2,33,23,10,0.6970000000000001,35,9,26,0.257,14,9,4,5,200.48,200.28,200.38
2018-12-27,1610612758,1610612747,2018,117.0,116.0,233.0,97.75,101.5,107.3,114.65,34,18,16,0.529,34,20,14,0.588,9,9,12,8,207.08,219.28,213.18
2018-12-27,1610612762,1610612755,2018,97.0,114.0,211.0,95.55,106.55,97.85,106.0,35,17,18,0.486,35,22,13,0.629,7,10,16,6,200.2,207.68,203.94
2018-12-27,1610612744,1610612757,2018,109.0,110.0,219.0,107.5,105.85,104.75,105.45,35,23,12,0.657,34,19,15,0.5589999999999999,15,8,13,6,199.04,209.44,204.24
2018-12-26,1610612765,1610612764,2018,106.0,95.0,201.0,100.85,105.95,94.7,91.35,31,15,16,0.484,34,13,21,0.382,10,5,9,4,206.0,193.0,199.5
2018-12-26,1610612753,1610612756,2018,120.0,122.0,242.0,96.55,103.5,106.25,103.85,32,14,18,0.438,34,8,26,0.235,8,6,5,3,203.64,212.88,208.26
2018-12-26,1610612737,1610612754,2018,121.0,129.0,250.0,96.35,95.7,92.05,92.25,32,9,23,0.281,34,22,12,0.647,5,4,12,10,199.44,187.28,193.36
2018-12-26,1610612751,1610612766,2018,134.0,132.0,266.0,96.7,98.4,99.45,97.7,35,16,19,0.457,32,16,16,0.5,8,8,12,4,196.96,194.96,195.96
2018-12-26,1610612748,1610612761,2018,104.0,106.0,210.0,97.25,95.5,100.6,99.2,32,16,16,0.5,35,25,10,0.7140000000000001,7,9,13,12,195.0,206.0,200.5
2018-12-26,1610612741,1610612750,2018,94.0,119.0,213.0,94.0,91.0,110.05,111.2,34,9,25,0.265,33,15,18,0.455,5,4,12,3,185.44,209.4,197.42000000000002
2018-12-26,1610612763,1610612739,2018,95.0,87.0,182.0,98.25,97.5,101.9,101.55,33,17,16,0.515,34,8,26,0.235,9,8,5,3,193.96,195.48,194.72
2018-12-26,1610612742,1610612740,2018,122.0,119.0,241.0,104.45,102.7,100.45,104.8,32,15,17,0.469,34,15,19,0.441,13,2,11,4,213.0,200.8,206.9
2018-12-26,1610612759,1610612743,2018,111.0,103.0,214.0,107.75,96.55,109.2,110.3,34,18,16,0.529,31,21,10,0.677,13,5,13,8,204.12,217.04,210.57999999999998
2018-12-26,1610612746,1610612758,2018,127.0,118.0,245.0,109.85,106.5,97.75,101.5,33,19,14,0.5760000000000001,33,18,15,0.545,11,8,9,9,214.36,207.08,210.72000000000003
2018-12-25,1610612752,1610612749,2018,95.0,109.0,204.0,101.2,97.2,99.8,108.15,34,9,25,0.265,32,22,10,0.688,4,5,14,8,200.28,200.48,200.38
2018-12-25,1610612745,1610612760,2018,113.0,109.0,222.0,112.7,109.85,101.8,103.4,32,17,15,0.531,32,21,11,0.6559999999999999,10,7,12,9,216.24,210.36,213.3
2018-12-25,1610612738,1610612755,2018,121.0,114.0,235.0,99.65,105.5,97.85,106.0,32,19,13,0.594,34,22,12,0.647,10,9,16,6,195.08,207.68,201.38
2018-12-25,1610612744,1610612747,2018,101.0,127.0,228.0,107.5,105.85,107.3,114.65,34,23,11,0.6759999999999999,33,19,14,0.5760000000000001,15,8,12,7,199.04,219.28,209.16
2018-12-25,1610612762,1610612757,2018,117.0,96.0,213.0,95.55,106.55,104.75,105.45,34,16,18,0.471,33,19,14,0.5760000000000001,6,10,13,6,200.2,209.44,204.82
2018-12-23,1610612765,1610612737,2018,95.0,98.0,193.0,100.85,105.95,96.35,95.7,30,15,15,0.5,31,8,23,0.258,10,5,5,3,206.0,199.44,202.72
2018-12-23,1610612754,1610612764,2018,105.0,89.0,194.0,92.05,92.25,94.7,91.35,33,21,12,0.636,33,13,20,0.394,11,10,9,4,187.28,193.0,190.14
2018-12-23,1610612738,1610612766,2018,119.0,103.0,222.0,99.65,105.5,99.45,97.7,31,18,13,0.581,31,16,15,0.516,9,9,12,4,195.08,194.96,195.02
2018-12-23,1610612751,1610612756,2018,111.0,103.0,214.0,96.7,98.4,106.25,103.85,34,15,19,0.441,33,8,25,0.242,7,8,5,3,196.96,212.88,204.92000000000002
2018-12-23,1610612739,1610612741,2018,92.0,112.0,204.0,101.9,101.55,94.0,91.0,33,8,25,0.242,33,8,25,0.242,5,3,5,3,195.48,185.44,190.45999999999998
2018-12-23,1610612753,1610612748,2018,91.0,115.0,206.0,96.55,103.5,97.25,95.5,31,14,17,0.452,31,15,16,0.484,8,6,7,8,203.64,195.0,199.32
2018-12-23,1610612758,1610612740,2018,122.0,117.0,239.0,97.75,101.5,100.45,104.8,32,17,15,0.531,33,15,18,0.455,8,9,11,4,207.08,200.8,203.94
2018-12-23,1610612760,1610612750,2018,112.0,114.0,226.0,101.8,103.4,110.05,111.2,31,21,10,0.677,32,14,18,0.438,12,9,12,2,210.36,209.4,209.88
2018-12-23,1610612744,1610612746,2018,129.0,127.0,256.0,107.5,105.85,109.85,106.5,33,22,11,0.667,32,19,13,0.594,14,8,11,8,199.04,214.36,206.7
2018-12-23,1610612757,1610612742,2018,121.0,118.0,239.0,104.75,105.45,104.45,102.7,32,18,14,0.563,31,15,16,0.484,12,6,13,2,209.44,213.0,211.22
2018-12-23,1610612747,1610612763,2018,99.0,107.0,206.0,107.3,114.65,98.25,97.5,32,19,13,0.594,32,16,16,0.5,12,7,9,7,219.28,193.96,206.62
2018-12-22,1610612746,1610612743,2018,132.0,111.0,243.0,109.85,106.5,109.2,110.3,31,18,13,0.581,30,21,9,0.7,10,8,13,8,214.36,217.04,215.7
2018-12-22,1610612764,1610612756,2018,149.0,146.0,295.0,94.7,91.35,106.25,103.85,32,12,20,0.375,32,8,24,0.25,8,4,5,3,193.0,212.88,202.94
2018-12-22,1610612755,1610612761,2018,126.0,101.0,227.0,97.85,106.0,100.6,99.2,33,21,12,0.636,34,25,9,0.735,15,6,13,12,207.68,206.0,206.84
2018-12-22,1610612748,1610612749,2018,94.0,87.0,181.0,97.25,95.5,99.8,108.15,30,14,16,0.467,31,22,9,0.71,6,8,14,8,195.0,200.48,197.74
2018-12-22,1610612745,1610612759,2018,108.0,101.0,209.0,112.7,109.85,107.75,96.55,31,16,15,0.516,33,18,15,0.545,9,7,13,5,216.24,204.12,210.18
2018-12-22,1610612744,1610612742,2018,120.0,116.0,236.0,107.5,105.85,104.45,102.7,32,21,11,0.6559999999999999,30,15,15,0.5,13,8,13,2,199.04,213.0,206.01999999999998
2018-12-22,1610612762,1610612760,2018,106.0,107.0,213.0,95.55,106.55,101.8,103.4,33,16,17,0.485,30,20,10,0.667,6,10,12,8,200.2,210.36,205.28
2018-12-21,1610612766,1610612765,2018,98.0,86.0,184.0,99.45,97.7,100.85,105.95,30,15,15,0.5,29,15,14,0.517,11,4,10,5,194.96,206.0,200.48000000000002
2018-12-21,1610612761,1610612739,2018,126.0,110.0,236.0,100.6,99.2,101.9,101.55,33,24,9,0.727,32,8,24,0.25,12,12,5,3,206.0,195.48,200.74
2018-12-21,1610612751,1610612754,2018,106.0,114.0,220.0,96.7,98.4,92.05,92.25,33,15,18,0.455,32,20,12,0.625,7,8,11,9,196.96,187.28,192.12
2018-12-21,1610612752,1610612737,2018,107.0,114.0,221.0,101.2,97.2,96.35,95.7,33,9,24,0.273,30,7,23,0.233,4,5,5,2,200.28,199.44,199.86
2018-12-21,1610612738,1610612749,2018,107.0,120.0,227.0,99.65,105.5,99.8,108.15,30,18,12,0.6,30,21,9,0.7,9,9,14,7,195.08,200.48,197.78
2018-12-21,1610612741,1610612753,2018,90.0,80.0,170.0,94.0,91.0,96.55,103.5,32,7,25,0.219,30,14,16,0.467,4,3,8,6,185.44,203.64,194.54
2018-12-21,1610612759,1610612750,2018,124.0,98.0,222.0,107.75,96.55,110.05,111.2,32,17,15,0.531,31,14,17,0.452,12,5,12,2,204.12,209.4,206.76
2018-12-21,1610612757,1610612762,2018,90.0,120.0,210.0,104.75,105.45,95.55,106.55,31,18,13,0.581,32,15,17,0.469,12,6,6,9,209.44,200.2,204.82
2018-12-21,1610612758,1610612763,2018,102.0,99.0,201.0,97.75,101.5,98.25,97.5,31,16,15,0.516,31,16,15,0.516,7,9,9,7,207.08,193.96,200.52
2018-12-21,1610612747,1610612740,2018,112.0,104.0,216.0,107.3,114.65,100.45,104.8,31,18,13,0.581,32,15,17,0.469,11,7,11,4,219.28,200.8,210.04000000000002
2018-12-20,1610612748,1610612745,2018,101.0,99.0,200.0,97.25,95.5,112.7,109.85,29,13,16,0.448,30,16,14,0.5329999999999999,5,8,9,7,195.0,216.24,205.62
2018-12-20,1610612746,1610612742,2018,125.0,121.0,246.0,109.85,106.5,104.45,102.7,30,17,13,0.5670000000000001,29,15,14,0.517,9,8,13,2,214.36,213.0,213.68
2018-12-19,1610612766,1610612739,2018,110.0,99.0,209.0,99.45,97.7,101.9,101.55,29,14,15,0.483,31,8,23,0.258,10,4,5,3,194.96,195.48,195.22
2018-12-19,1610612753,1610612759,2018,90.0,129.0,219.0,96.55,103.5,107.75,96.55,29,14,15,0.483,31,16,15,0.516,8,6,12,4,203.64,204.12,203.88
2018-12-19,1610612755,1610612752,2018,131.0,109.0,240.0,97.85,106.0,101.2,97.2,32,20,12,0.625,32,9,23,0.281,14,6,4,5,207.68,200.28,203.98000000000002
2018-12-19,1610612738,1610612756,2018,103.0,111.0,214.0,99.65,105.5,106.25,103.85,29,18,11,0.621,31,7,24,0.226,9,9,5,2,195.08,212.88,203.98000000000002
2018-12-19,1610612761,1610612754,2018,99.0,96.0,195.0,100.6,99.2,92.05,92.25,32,23,9,0.7190000000000001,31,20,11,0.645,11,12,11,9,206.0,187.28,196.64
2018-12-19,1610612741,1610612751,2018,93.0,96.0,189.0,94.0,91.0,96.7,98.4,31,7,24,0.226,32,14,18,0.438,4,3,7,7,185.44,196.96,191.2
2018-12-19,1610612745,1610612764,2018,136.0,118.0,254.0,112.7,109.85,94.7,91.35,29,15,14,0.517,31,12,19,0.387,8,7,8,4,216.24,193.0,204.62
2018-12-19,1610612749,1610612740,2018,123.0,115.0,238.0,99.8,108.15,100.45,104.8,29,20,9,0.69,31,15,16,0.484,13,7,11,4,200.48,200.8,200.64
2018-12-19,1610612750,1610612765,2018,123.0,129.0,252.0,110.05,111.2,100.85,105.95,30,14,16,0.467,28,14,14,0.5,12,2,10,4,209.4,206.0,207.7
2018-12-19,1610612762,1610612744,2018,108.0,103.0,211.0,95.55,106.55,107.5,105.85,31,14,17,0.452,31,21,10,0.677,5,9,13,8,200.2,199.04,199.62
2018-12-19,1610612757,1610612763,2018,99.0,92.0,191.0,104.75,105.45,98.25,97.5,30,17,13,0.5670000000000001,30,16,14,0.5329999999999999,11,6,9,7,209.44,193.96,201.7
2018-12-19,1610612758,1610612760,2018,113.0,132.0,245.0,97.75,101.5,101.8,103.4,30,16,14,0.5329999999999999,29,19,10,0.655,7,9,12,7,207.08,210.36,208.72000000000003
2018-12-18,1610612754,1610612739,2018,91.0,92.0,183.0,92.05,92.25,101.9,101.55,30,20,10,0.667,30,7,23,0.233,11,9,5,2,187.28,195.48,191.38
2018-12-18,1610612737,1610612764,2018,118.0,110.0,228.0,96.35,95.7,94.7,91.35,29,6,23,0.207,30,12,18,0.4,4,2,8,4,199.44,193.0,196.22
2018-12-18,1610612751,1610612747,2018,115.0,110.0,225.0,96.7,98.4,107.3,114.65,31,13,18,0.419,30,18,12,0.6,6,7,11,7,196.96,219.28,208.12
2018-12-18,1610612743,1610612742,2018,126.0,118.0,244.0,109.2,110.3,104.45,102.7,29,20,9,0.69,28,15,13,0.536,12,8,13,2,217.04,213.0,215.01999999999998
2018-12-17,1610612765,1610612749,2018,104.0,107.0,211.0,100.85,105.95,99.8,108.15,27,14,13,0.519,28,19,9,0.679,10,4,13,6,206.0,200.48,203.24
2018-12-17,1610612752,1610612756,2018,110.0,128.0,238.0,101.2,97.2,106.25,103.85,31,9,22,0.29,30,6,24,0.2,4,5,5,1,200.28,212.88,206.57999999999998
2018-12-17,1610612745,1610612762,2018,102.0,97.0,199.0,112.7,109.85,95.55,106.55,28,14,14,0.5,30,14,16,0.467,7,7,5,9,216.24,200.2,208.22
2018-12-17,1610612750,1610612758,2018,132.0,105.0,237.0,110.05,111.2,97.75,101.5,29,13,16,0.448,29,16,13,0.552,11,2,7,9,209.4,207.08,208.24
2018-12-17,1610612760,1610612741,2018,121.0,96.0,217.0,101.8,103.4,94.0,91.0,28,18,10,0.643,30,7,23,0.233,11,7,4,3,210.36,185.44,197.9
2018-12-17,1610612759,1610612755,2018,123.0,96.0,219.0,107.75,96.55,97.85,106.0,30,15,15,0.5,31,20,11,0.645,11,4,14,6,204.12,207.68,205.9
2018-12-17,1610612744,1610612763,2018,110.0,93.0,203.0,107.5,105.85,98.25,97.5,30,20,10,0.667,29,16,13,0.552,12,8,9,7,199.04,193.96,196.5
2018-12-17,1610612746,1610612757,2018,127.0,131.0,258.0,109.85,106.5,104.75,105.45,29,17,12,0.586,29,16,13,0.552,9,8,11,5,214.36,209.44,211.9
2018-12-16,1610612751,1610612737,2018,144.0,127.0,271.0,96.7,98.4,96.35,95.7,30,12,18,0.4,28,6,22,0.214,5,7,4,2,196.96,199.44,198.2
2018-12-16,1610612739,1610612755,2018,105.0,128.0,233.0,101.9,101.55,97.85,106.0,29,7,22,0.241,30,19,11,0.633,5,2,14,5,195.48,207.68,201.57999999999998
2018-12-16,1610612754,1610612752,2018,110.0,99.0,209.0,92.05,92.25,101.2,97.2,29,19,10,0.655,30,9,21,0.3,10,9,4,5,187.28,200.28,193.78
2018-12-16,1610612764,1610612747,2018,128.0,110.0,238.0,94.7,91.35,107.3,114.65,29,11,18,0.379,29,18,11,0.621,7,4,11,7,193.0,219.28,206.14
2018-12-16,1610612742,1610612758,2018,113.0,120.0,233.0,104.45,102.7,97.75,101.5,27,15,12,0.556,28,15,13,0.536,13,2,7,8,213.0,207.08,210.04000000000002
2018-12-16,1610612740,1610612748,2018,96.0,102.0,198.0,100.45,104.8,97.25,95.5,30,15,15,0.5,28,12,16,0.429,11,4,5,7,200.8,195.0,197.9
2018-12-16,1610612743,1610612761,2018,95.0,86.0,181.0,109.2,110.3,100.6,99.2,28,19,9,0.679,31,23,8,0.742,11,8,11,12,217.04,206.0,211.51999999999998
2018-12-15,1610612753,1610612762,2018,96.0,89.0,185.0,96.55,103.5,95.55,106.55,28,13,15,0.464,29,14,15,0.483,7,6,5,9,203.64,200.2,201.92
2018-12-15,1610612766,1610612747,2018,100.0,128.0,228.0,99.45,97.7,107.3,114.65,28,14,14,0.5,28,17,11,0.607,10,4,11,6,194.96,219.28,207.12
2018-12-15,1610612765,1610612738,2018,113.0,104.0,217.0,100.85,105.95,99.65,105.5,26,13,13,0.5,28,18,10,0.643,9,4,9,9,206.0,195.08,200.54000000000002
2018-12-15,1610612763,1610612745,2018,97.0,105.0,202.0,98.25,97.5,112.7,109.85,28,16,12,0.5710000000000001,27,13,14,0.481,9,7,7,6,193.96,216.24,205.10000000000002
2018-12-15,1610612759,1610612741,2018,93.0,98.0,191.0,107.75,96.55,94.0,91.0,29,15,14,0.517,29,6,23,0.207,11,4,4,2,204.12,185.44,194.78
2018-12-15,1610612760,1610612746,2018,110.0,104.0,214.0,101.8,103.4,109.85,106.5,27,17,10,0.63,28,17,11,0.607,10,7,9,8,210.36,214.36,212.36
2018-12-15,1610612756,1610612750,2018,107.0,99.0,206.0,106.25,103.85,110.05,111.2,29,5,24,0.172,28,13,15,0.464,4,1,11,2,212.88,209.4,211.14
2018-12-14,1610612738,1610612737,2018,129.0,108.0,237.0,99.65,105.5,96.35,95.7,27,17,10,0.63,27,6,21,0.222,8,9,4,2,195.08,199.44,197.26
2018-12-14,1610612766,1610612752,2018,124.0,126.0,250.0,99.45,97.7,101.2,97.2,27,14,13,0.519,29,8,21,0.276,10,4,4,4,194.96,200.28,197.62
2018-12-14,1610612751,1610612764,2018,125.0,118.0,243.0,96.7,98.4,94.7,91.35,29,11,18,0.379,28,11,17,0.393,4,7,7,4,196.96,193.0,194.98000000000002
2018-12-14,1610612739,1610612749,2018,102.0,114.0,216.0,101.9,101.55,99.8,108.15,28,7,21,0.25,27,18,9,0.667,5,2,13,5,195.48,200.48,197.98
2018-12-14,1610612755,1610612754,2018,101.0,113.0,214.0,97.85,106.0,92.05,92.25,29,19,10,0.655,28,18,10,0.643,14,5,10,8,207.68,187.28,197.48000000000002
2018-12-14,1610612763,1610612748,2018,97.0,100.0,197.0,98.25,97.5,97.25,95.5,27,16,11,0.593,27,11,16,0.407,9,7,5,6,193.96,195.0,194.48000000000002
2018-12-14,1610612743,1610612760,2018,109.0,98.0,207.0,109.2,110.3,101.8,103.4,27,18,9,0.667,26,17,9,0.654,10,8,10,7,217.04,210.36,213.7
2018-12-14,1610612757,1610612761,2018,128.0,122.0,250.0,104.75,105.45,100.6,99.2,28,15,13,0.536,30,23,7,0.767,10,5,11,12,209.44,206.0,207.72
2018-12-14,1610612758,1610612744,2018,125.0,130.0,255.0,97.75,101.5,107.5,105.85,27,15,12,0.556,29,19,10,0.655,7,8,12,7,207.08,199.04,203.06
2018-12-13,1610612745,1610612747,2018,126.0,111.0,237.0,112.7,109.85,107.3,114.65,26,12,14,0.462,27,17,10,0.63,6,6,11,6,216.24,219.28,217.76
2018-12-13,1610612759,1610612746,2018,125.0,87.0,212.0,107.75,96.55,109.85,106.5,28,14,14,0.5,27,17,10,0.63,10,4,9,8,204.12,214.36,209.24
2018-12-13,1610612753,1610612741,2018,97.0,91.0,188.0,96.55,103.5,94.0,91.0,27,12,15,0.444,28,6,22,0.214,6,6,4,2,203.64,185.44,194.54
2018-12-13,1610612756,1610612742,2018,99.0,89.0,188.0,106.25,103.85,104.45,102.7,28,4,24,0.14300000000000002,26,15,11,0.5770000000000001,3,1,13,2,212.88,213.0,212.94
2018-12-12,1610612766,1610612765,2018,108.0,107.0,215.0,99.45,97.7,100.85,105.95,26,13,13,0.5,25,13,12,0.52,9,4,9,4,194.96,206.0,200.48000000000002
2018-12-12,1610612739,1610612752,2018,113.0,106.0,219.0,101.9,101.55,101.2,97.2,27,6,21,0.222,28,8,20,0.28600000000000003,4,2,4,4,195.48,200.28,197.88
2018-12-12,1610612754,1610612749,2018,113.0,97.0,210.0,92.05,92.25,99.8,108.15,27,17,10,0.63,26,18,8,0.6920000000000001,9,8,13,5,187.28,200.48,193.88
2018-12-12,1610612755,1610612751,2018,124.0,127.0,251.0,97.85,106.0,96.7,98.4,28,19,9,0.679,28,10,18,0.35700000000000004,14,5,4,6,207.68,196.96,202.32
2018-12-12,1610612764,1610612738,2018,125.0,130.0,255.0,94.7,91.35,99.65,105.5,27,11,16,0.407,26,16,10,0.615,7,4,8,8,193.0,195.08,194.04000000000002
2018-12-12,1610612763,1610612757,2018,92.0,83.0,175.0,98.25,97.5,104.75,105.45,26,15,11,0.5770000000000001,27,15,12,0.556,8,7,10,5,193.96,209.44,201.7
2018-12-12,1610612740,1610612760,2018,118.0,114.0,232.0,100.45,104.8,101.8,103.4,29,14,15,0.483,25,17,8,0.68,10,4,10,7,200.8,210.36,205.58
2018-12-12,1610612742,1610612737,2018,114.0,107.0,221.0,104.45,102.7,96.35,95.7,25,14,11,0.56,26,6,20,0.231,12,2,4,2,213.0,199.44,206.22
2018-12-12,1610612762,1610612748,2018,111.0,84.0,195.0,95.55,106.55,97.25,95.5,28,13,15,0.464,26,11,15,0.423,4,9,5,6,200.2,195.0,197.6
2018-12-12,1610612758,1610612750,2018,141.0,130.0,271.0,97.75,101.5,110.05,111.2,26,14,12,0.5379999999999999,27,13,14,0.481,6,8,11,2,207.08,209.4,208.24
2018-12-12,1610612744,1610612761,2018,93.0,113.0,206.0,107.5,105.85,100.6,99.2,28,19,9,0.679,29,22,7,0.759,12,7,11,11,199.04,206.0,202.51999999999998
2018-12-11,1610612745,1610612757,2018,111.0,104.0,215.0,112.7,109.85,104.75,105.45,25,11,14,0.44,26,15,11,0.5770000000000001,5,6,10,5,216.24,209.44,212.84
2018-12-11,1610612759,1610612756,2018,111.0,86.0,197.0,107.75,96.55,106.25,103.85,27,13,14,0.481,27,4,23,0.14800000000000002,9,4,3,1,204.12,212.88,208.5
2018-12-11,1610612746,1610612761,2018,99.0,123.0,222.0,109.85,106.5,100.6,99.2,26,17,9,0.654,28,21,7,0.75,9,8,11,10,214.36,206.0,210.18
2018-12-10,1610612754,1610612764,2018,109.0,101.0,210.0,92.05,92.25,94.7,91.35,26,16,10,0.615,26,11,15,0.423,8,8,7,4,187.28,193.0,190.14
2018-12-10,1610612755,1610612765,2018,116.0,102.0,218.0,97.85,106.0,100.85,105.95,27,18,9,0.667,24,13,11,0.542,13,5,9,4,207.68,206.0,206.84
2018-12-10,1610612738,1610612740,2018,113.0,100.0,213.0,99.65,105.5,100.45,104.8,25,15,10,0.6,28,14,14,0.5,7,8,10,4,195.08,200.8,197.94
2018-12-10,1610612741,1610612758,2018,89.0,108.0,197.0,94.0,91.0,97.75,101.5,27,6,21,0.222,25,13,12,0.52,4,2,6,7,185.44,207.08,196.26
2018-12-10,1610612749,1610612739,2018,108.0,92.0,200.0,99.8,108.15,101.9,101.55,25,17,8,0.68,26,6,20,0.231,12,5,4,2,200.48,195.48,197.98
2018-12-10,1610612760,1610612762,2018,122.0,113.0,235.0,101.8,103.4,95.55,106.55,24,16,8,0.667,27,13,14,0.481,9,7,4,9,210.36,200.2,205.28
2018-12-10,1610612742,1610612753,2018,101.0,76.0,177.0,104.45,102.7,96.55,103.5,24,13,11,0.542,26,12,14,0.462,11,2,6,6,213.0,203.64,208.32
2018-12-10,1610612743,1610612763,2018,105.0,99.0,204.0,109.2,110.3,98.25,97.5,26,17,9,0.654,25,15,10,0.6,9,8,8,7,217.04,193.96,205.5
2018-12-10,1610612756,1610612746,2018,119.0,123.0,242.0,106.25,103.85,109.85,106.5,26,4,22,0.154,25,16,9,0.64,3,1,9,7,212.88,214.36,213.62
2018-12-10,1610612744,1610612750,2018,116.0,108.0,224.0,107.5,105.85,110.05,111.2,27,18,9,0.667,26,13,13,0.5,11,7,11,2,199.04,209.4,204.22
2018-12-10,1610612747,1610612748,2018,108.0,105.0,213.0,107.3,114.65,97.25,95.5,26,16,10,0.615,25,11,14,0.44,10,6,5,6,219.28,195.0,207.14
2018-12-09,1610612765,1610612740,2018,108.0,116.0,224.0,100.85,105.95,100.45,104.8,23,13,10,0.565,27,13,14,0.481,9,4,10,3,206.0,200.8,203.4
2018-12-09,1610612761,1610612749,2018,99.0,104.0,203.0,100.6,99.2,99.8,108.15,27,21,6,0.778,24,16,8,0.667,11,10,12,4,206.0,200.48,203.24
2018-12-09,1610612759,1610612762,2018,110.0,97.0,207.0,107.75,96.55,95.55,106.55,26,12,14,0.462,26,13,13,0.5,8,4,4,9,204.12,200.2,202.16
2018-12-09,1610612752,1610612766,2018,107.0,119.0,226.0,101.2,97.2,99.45,97.7,27,8,19,0.29600000000000004,25,12,13,0.48,4,4,9,3,200.28,194.96,197.62
2018-12-08,1610612742,1610612745,2018,107.0,104.0,211.0,104.45,102.7,112.7,109.85,23,12,11,0.522,24,11,13,0.458,10,2,5,6,213.0,216.24,214.62
2018-12-08,1610612754,1610612758,2018,107.0,97.0,204.0,92.05,92.25,97.75,101.5,25,15,10,0.6,24,13,11,0.542,7,8,6,7,187.28,207.08,197.18
2018-12-08,1610612737,1610612743,2018,106.0,98.0,204.0,96.35,95.7,109.2,110.3,25,5,20,0.2,25,17,8,0.68,3,2,9,8,199.44,217.04,208.24
2018-12-08,1610612739,1610612764,2018,116.0,101.0,217.0,101.9,101.55,94.7,91.35,25,5,20,0.2,25,11,14,0.44,3,2,7,4,195.48,193.0,194.24
2018-12-08,1610612752,1610612751,2018,104.0,112.0,216.0,101.2,97.2,96.7,98.4,26,8,18,0.308,27,9,18,0.333,4,4,4,5,200.28,196.96,198.62
2018-12-08,1610612741,1610612738,2018,77.0,133.0,210.0,94.0,91.0,99.65,105.5,26,6,20,0.231,24,14,10,0.583,4,2,7,7,185.44,195.08,190.26
2018-12-08,1610612763,1610612747,2018,88.0,111.0,199.0,98.25,97.5,107.3,114.65,24,15,9,0.625,25,15,10,0.6,8,7,10,5,193.96,219.28,206.62
2018-12-08,1610612757,1610612750,2018,113.0,105.0,218.0,104.75,105.45,110.05,111.2,25,14,11,0.56,25,13,12,0.52,9,5,11,2,209.44,209.4,209.42000000000002
2018-12-08,1610612746,1610612748,2018,98.0,121.0,219.0,109.85,106.5,97.25,95.5,24,16,8,0.667,24,10,14,0.417,9,7,5,5,214.36,195.0,204.68
2018-12-07,1610612766,1610612743,2018,113.0,107.0,220.0,99.45,97.7,109.2,110.3,24,11,13,0.458,24,17,7,0.708,8,3,9,8,194.96,217.04,206.0
2018-12-07,1610612765,1610612755,2018,111.0,117.0,228.0,100.85,105.95,97.85,106.0,22,13,9,0.591,26,17,9,0.654,9,4,13,4,206.0,207.68,206.84
2018-12-07,1610612753,1610612754,2018,90.0,112.0,202.0,96.55,103.5,92.05,92.25,25,12,13,0.48,24,14,10,0.583,6,6,7,7,203.64,187.28,195.45999999999998
2018-12-07,1610612751,1610612761,2018,106.0,105.0,211.0,96.7,98.4,100.6,99.2,26,8,18,0.308,26,21,5,0.8079999999999999,3,5,11,10,196.96,206.0,201.48000000000002
2018-12-07,1610612739,1610612758,2018,110.0,129.0,239.0,101.9,101.55,97.75,101.5,24,5,19,0.208,23,12,11,0.522,3,2,6,6,195.48,207.08,201.28
2018-12-07,1610612741,1610612760,2018,114.0,112.0,226.0,94.0,91.0,101.8,103.4,25,5,20,0.2,23,16,7,0.696,3,2,9,7,185.44,210.36,197.9
2018-12-07,1610612740,1610612763,2018,103.0,107.0,210.0,100.45,104.8,98.25,97.5,26,13,13,0.5,23,14,9,0.609,10,3,8,6,200.8,193.96,197.38
2018-12-07,1610612759,1610612747,2018,133.0,120.0,253.0,107.75,96.55,107.3,114.65,25,11,14,0.44,24,15,9,0.625,7,4,10,5,204.12,219.28,211.7
2018-12-07,1610612756,1610612748,2018,98.0,115.0,213.0,106.25,103.85,97.25,95.5,25,4,21,0.16,23,9,14,0.391,3,1,5,4,212.88,195.0,203.94
2018-12-07,1610612749,1610612744,2018,95.0,105.0,200.0,99.8,108.15,107.5,105.85,23,16,7,0.696,26,17,9,0.654,12,4,11,6,200.48,199.04,199.76
2018-12-06,1610612738,1610612752,2018,128.0,100.0,228.0,99.65,105.5,101.2,97.2,23,13,10,0.565,25,8,17,0.32,6,7,4,4,195.08,200.28,197.68
2018-12-06,1610612757,1610612756,2018,108.0,86.0,194.0,104.75,105.45,106.25,103.85,24,13,11,0.542,24,4,20,0.16699999999999998,8,5,3,1,209.44,212.88,211.16
2018-12-06,1610612762,1610612745,2018,118.0,91.0,209.0,95.55,106.55,112.7,109.85,25,12,13,0.48,23,11,12,0.478,3,9,5,6,200.2,216.24,208.22
2018-12-05,1610612739,1610612744,2018,105.0,129.0,234.0,101.9,101.55,107.5,105.85,23,5,18,0.217,25,16,9,0.64,3,2,11,5,195.48,199.04,197.26
2018-12-05,1610612753,1610612743,2018,118.0,124.0,242.0,96.55,103.5,109.2,110.3,24,12,12,0.5,23,16,7,0.696,6,6,9,7,203.64,217.04,210.33999999999997
2018-12-05,1610612737,1610612764,2018,117.0,131.0,248.0,96.35,95.7,94.7,91.35,24,5,19,0.208,24,10,14,0.417,3,2,7,3,199.44,193.0,196.22
2018-12-05,1610612751,1610612760,2018,112.0,114.0,226.0,96.7,98.4,101.8,103.4,25,8,17,0.32,22,15,7,0.682,3,5,9,6,196.96,210.36,203.66000000000003
2018-12-05,1610612761,1610612755,2018,113.0,102.0,215.0,100.6,99.2,97.85,106.0,25,20,5,0.8,25,17,8,0.68,10,10,13,4,206.0,207.68,206.84
2018-12-05,1610612763,1610612746,2018,96.0,86.0,182.0,98.25,97.5,109.85,106.5,22,13,9,0.591,23,16,7,0.696,7,6,9,7,193.96,214.36,204.16000000000003
2018-12-05,1610612749,1610612765,2018,115.0,92.0,207.0,99.8,108.15,100.85,105.95,22,15,7,0.682,21,13,8,0.619,11,4,9,4,200.48,206.0,203.24
2018-12-05,1610612750,1610612766,2018,121.0,104.0,225.0,110.05,111.2,99.45,97.7,24,12,12,0.5,23,11,12,0.478,10,2,8,3,209.4,194.96,202.18
2018-12-05,1610612740,1610612742,2018,132.0,106.0,238.0,100.45,104.8,104.45,102.7,25,12,13,0.48,22,12,10,0.545,9,3,10,2,200.8,213.0,206.9
2018-12-05,1610612747,1610612759,2018,121.0,113.0,234.0,107.3,114.65,107.75,96.55,23,14,9,0.609,24,11,13,0.458,9,5,7,4,219.28,204.12,211.7
2018-12-04,1610612754,1610612741,2018,96.0,90.0,186.0,92.05,92.25,94.0,91.0,23,13,10,0.565,24,5,19,0.208,6,7,3,2,187.28,185.44,186.36
2018-12-04,1610612748,1610612753,2018,90.0,105.0,195.0,97.25,95.5,96.55,103.5,22,9,13,0.409,23,11,12,0.478,5,4,6,5,195.0,203.64,199.32
2018-12-04,1610612742,1610612757,2018,111.0,102.0,213.0,104.45,102.7,104.75,105.45,21,11,10,0.524,23,13,10,0.565,9,2,8,5,213.0,209.44,211.22
2018-12-04,1610612756,1610612758,2018,105.0,122.0,227.0,106.25,103.85,97.75,101.5,23,4,19,0.174,22,11,11,0.5,3,1,6,5,212.88,207.08,209.98000000000002
2018-12-04,1610612762,1610612759,2018,139.0,105.0,244.0,95.55,106.55,107.75,96.55,24,11,13,0.458,23,11,12,0.478,2,9,7,4,200.2,204.12,202.16
2018-12-03,1610612765,1610612760,2018,83.0,110.0,193.0,100.85,105.95,101.8,103.4,20,13,7,0.65,21,14,7,0.667,9,4,9,5,206.0,210.36,208.18
2018-12-03,1610612737,1610612744,2018,111.0,128.0,239.0,96.35,95.7,107.5,105.85,23,5,18,0.217,24,15,9,0.625,3,2,11,4,199.44,199.04,199.24
2018-12-03,1610612751,1610612739,2018,97.0,99.0,196.0,96.7,98.4,101.9,101.55,24,8,16,0.333,22,4,18,0.182,3,5,3,1,196.96,195.48,196.22
2018-12-03,1610612752,1610612764,2018,107.0,110.0,217.0,101.2,97.2,94.7,91.35,24,8,16,0.333,23,9,14,0.391,4,4,7,2,200.28,193.0,196.64
2018-12-03,1610612761,1610612743,2018,103.0,106.0,209.0,100.6,99.2,109.2,110.3,24,20,4,0.833,22,15,7,0.682,10,10,9,6,206.0,217.04,211.51999999999998
2018-12-03,1610612750,1610612745,2018,103.0,91.0,194.0,110.05,111.2,112.7,109.85,23,11,12,0.478,22,11,11,0.5,9,2,5,6,209.4,216.24,212.82
2018-12-03,1610612740,1610612746,2018,126.0,129.0,255.0,100.45,104.8,109.85,106.5,24,12,12,0.5,22,15,7,0.682,9,3,9,6,200.8,214.36,207.58
2018-12-02,1610612747,1610612756,2018,120.0,96.0,216.0,107.3,114.65,106.25,103.85,22,13,9,0.591,22,4,18,0.182,8,5,3,1,219.28,212.88,216.07999999999998
2018-12-02,1610612766,1610612740,2018,109.0,119.0,228.0,99.45,97.7,100.45,104.8,22,11,11,0.5,23,11,12,0.478,8,3,9,2,194.96,200.8,197.88
2018-12-02,1610612748,1610612762,2018,102.0,100.0,202.0,97.25,95.5,95.55,106.55,21,8,13,0.381,23,11,12,0.478,4,4,2,9,195.0,200.2,197.6
2018-12-02,1610612755,1610612763,2018,103.0,95.0,198.0,97.85,106.0,98.25,97.5,24,16,8,0.667,21,13,8,0.619,12,4,7,6,207.68,193.96,200.82
2018-12-02,1610612742,1610612746,2018,114.0,110.0,224.0,104.45,102.7,109.85,106.5,20,10,10,0.5,21,15,6,0.7140000000000001,8,2,9,6,213.0,214.36,213.68
2018-12-02,1610612759,1610612757,2018,131.0,118.0,249.0,107.75,96.55,104.75,105.45,22,10,12,0.455,22,13,9,0.591,6,4,8,5,204.12,209.44,206.78
2018-12-01,1610612752,1610612749,2018,136.0,134.0,270.0,101.2,97.2,99.8,108.15,23,7,16,0.304,21,15,6,0.7140000000000001,3,4,11,4,200.28,200.48,200.38
2018-12-01,1610612765,1610612744,2018,111.0,102.0,213.0,100.85,105.95,107.5,105.85,19,12,7,0.632,23,15,8,0.652,8,4,11,4,206.0,199.04,202.51999999999998
2018-12-01,1610612764,1610612751,2018,102.0,88.0,190.0,94.7,91.35,96.7,98.4,22,8,14,0.364,23,8,15,0.348,6,2,3,5,193.0,196.96,194.98000000000002
2018-12-01,1610612739,1610612761,2018,95.0,106.0,201.0,101.9,101.55,100.6,99.2,21,4,17,0.19,23,19,4,0.826,3,1,10,9,195.48,206.0,200.74
2018-12-01,1610612745,1610612741,2018,121.0,105.0,226.0,112.7,109.85,94.0,91.0,21,10,11,0.476,23,5,18,0.217,4,6,3,2,216.24,185.44,200.84
2018-12-01,1610612750,1610612738,2018,109.0,118.0,227.0,110.05,111.2,99.65,105.5,22,11,11,0.5,22,12,10,0.545,9,2,6,6,209.4,195.08,202.24
2018-12-01,1610612758,1610612754,2018,111.0,110.0,221.0,97.75,101.5,92.05,92.25,21,10,11,0.476,22,13,9,0.591,5,5,6,7,207.08,187.28,197.18
2018-11-30,1610612738,1610612739,2018,128.0,95.0,223.0,99.65,105.5,101.9,101.55,21,11,10,0.524,20,4,16,0.2,5,6,3,1,195.08,195.48,195.28
2018-11-30,1610612766,1610612762,2018,111.0,119.0,230.0,99.45,97.7,95.55,106.55,21,11,10,0.524,22,10,12,0.455,8,3,2,8,194.96,200.2,197.57999999999998
2018-11-30,1610612765,1610612741,2018,107.0,88.0,195.0,100.85,105.95,94.0,91.0,18,11,7,0.611,22,5,17,0.227,7,4,3,2,206.0,185.44,195.72
2018-11-30,1610612755,1610612764,2018,123.0,98.0,221.0,97.85,106.0,94.7,91.35,23,15,8,0.652,21,8,13,0.381,11,4,6,2,207.68,193.0,200.34
2018-11-30,1610612751,1610612763,2018,125.0,131.0,256.0,96.7,98.4,98.25,97.5,22,8,14,0.364,20,12,8,0.6,3,5,7,5,196.96,193.96,195.46
2018-11-30,1610612748,1610612740,2018,106.0,101.0,207.0,97.25,95.5,100.45,104.8,20,7,13,0.35,22,11,11,0.5,3,4,9,2,195.0,200.8,197.9
2018-11-30,1610612760,1610612737,2018,124.0,109.0,233.0,101.8,103.4,96.35,95.7,20,13,7,0.65,22,5,17,0.227,8,5,3,2,210.36,199.44,204.9
2018-11-30,1610612759,1610612745,2018,105.0,136.0,241.0,107.75,96.55,112.7,109.85,21,10,11,0.476,20,9,11,0.45,6,4,4,5,204.12,216.24,210.18
2018-11-30,1610612756,1610612753,2018,85.0,99.0,184.0,106.25,103.85,96.55,103.5,21,4,17,0.19,22,10,12,0.455,3,1,6,4,212.88,203.64,208.26
2018-11-30,1610612747,1610612742,2018,114.0,103.0,217.0,107.3,114.65,104.45,102.7,21,12,9,0.5710000000000001,19,10,9,0.526,7,5,8,2,219.28,213.0,216.14
2018-11-30,1610612757,1610612743,2018,112.0,113.0,225.0,104.75,105.45,109.2,110.3,21,13,8,0.619,21,14,7,0.667,8,5,9,5,209.44,217.04,213.24
2018-11-29,1610612761,1610612744,2018,131.0,128.0,259.0,100.6,99.2,107.5,105.85,22,18,4,0.818,22,15,7,0.682,9,9,11,4,206.0,199.04,202.51999999999998
2018-11-29,1610612747,1610612754,2018,104.0,96.0,200.0,107.3,114.65,92.05,92.25,20,11,9,0.55,21,13,8,0.619,6,5,6,7,219.28,187.28,203.28
2018-11-29,1610612758,1610612746,2018,121.0,133.0,254.0,97.75,101.5,109.85,106.5,20,10,10,0.5,20,14,6,0.7,5,5,9,5,207.08,214.36,210.72000000000003
2018-11-28,1610612766,1610612737,2018,108.0,94.0,202.0,99.45,97.7,96.35,95.7,20,10,10,0.5,21,5,16,0.238,7,3,3,2,194.96,199.44,197.2
2018-11-28,1610612755,1610612752,2018,117.0,91.0,208.0,97.85,106.0,101.2,97.2,22,14,8,0.636,22,7,15,0.318,10,4,3,4,207.68,200.28,203.98000000000002
2018-11-28,1610612751,1610612762,2018,91.0,101.0,192.0,96.7,98.4,95.55,106.55,21,8,13,0.381,21,9,12,0.429,3,5,2,7,196.96,200.2,198.57999999999998
2018-11-28,1610612745,1610612742,2018,108.0,128.0,236.0,112.7,109.85,104.45,102.7,19,9,10,0.474,18,9,9,0.5,4,5,8,1,216.24,213.0,214.62
2018-11-28,1610612749,1610612741,2018,116.0,113.0,229.0,99.8,108.15,94.0,91.0,20,14,6,0.7,21,5,16,0.238,10,4,3,2,200.48,185.44,192.95999999999998
2018-11-28,1610612750,1610612759,2018,128.0,89.0,217.0,110.05,111.2,107.75,96.55,21,10,11,0.476,20,10,10,0.5,8,2,6,4,209.4,204.12,206.76
2018-11-28,1610612740,1610612764,2018,125.0,104.0,229.0,100.45,104.8,94.7,91.35,21,10,11,0.476,20,8,12,0.4,8,2,6,2,200.8,193.0,196.9
2018-11-28,1610612760,1610612739,2018,100.0,83.0,183.0,101.8,103.4,101.9,101.55,19,12,7,0.632,19,4,15,0.211,7,5,3,1,210.36,195.48,202.92000000000002
2018-11-28,1610612757,1610612753,2018,115.0,112.0,227.0,104.75,105.45,96.55,103.5,20,12,8,0.6,21,10,11,0.476,7,5,6,4,209.44,203.64,206.54
2018-11-28,1610612746,1610612756,2018,115.0,99.0,214.0,109.85,106.5,106.25,103.85,19,13,6,0.684,20,4,16,0.2,8,5,3,1,214.36,212.88,213.62
2018-11-27,1610612765,1610612752,2018,115.0,108.0,223.0,100.85,105.95,101.2,97.2,17,10,7,0.588,21,7,14,0.333,6,4,3,4,206.0,200.28,203.14
2018-11-27,1610612748,1610612737,2018,113.0,115.0,228.0,97.25,95.5,96.35,95.7,19,7,12,0.368,20,4,16,0.2,3,4,3,1,195.0,199.44,197.22
2018-11-27,1610612763,1610612761,2018,114.0,122.0,236.0,98.25,97.5,100.6,99.2,19,12,7,0.632,21,17,4,0.81,7,5,9,8,193.96,206.0,199.98000000000002
2018-11-27,1610612743,1610612747,2018,117.0,85.0,202.0,109.2,110.3,107.3,114.65,20,13,7,0.65,19,11,8,0.579,8,5,6,5,217.04,219.28,218.16
2018-11-27,1610612756,1610612754,2018,104.0,109.0,213.0,106.25,103.85,92.05,92.25,19,4,15,0.211,20,12,8,0.6,3,1,6,6,212.88,187.28,200.07999999999998
2018-11-26,1610612766,1610612749,2018,110.0,107.0,217.0,99.45,97.7,99.8,108.15,19,9,10,0.474,19,14,5,0.737,6,3,10,4,194.96,200.48,197.72
2018-11-26,1610612739,1610612750,2018,95.0,102.0,197.0,101.9,101.55,110.05,111.2,18,4,14,0.222,20,9,11,0.45,3,1,8,1,195.48,209.4,202.44
2018-11-26,1610612764,1610612745,2018,135.0,131.0,266.0,94.7,91.35,112.7,109.85,19,7,12,0.368,18,9,9,0.5,5,2,4,5,193.0,216.24,204.62
2018-11-26,1610612741,1610612759,2018,107.0,108.0,215.0,94.0,91.0,107.75,96.55,20,5,15,0.25,19,9,10,0.474,3,2,6,3,185.44,204.12,194.78
2018-11-26,1610612740,1610612738,2018,107.0,124.0,231.0,100.45,104.8,99.65,105.5,20,10,10,0.5,20,10,10,0.5,8,2,5,5,200.8,195.08,197.94
2018-11-26,1610612762,1610612754,2018,88.0,121.0,209.0,95.55,106.55,92.05,92.25,20,9,11,0.45,19,11,8,0.579,2,7,6,5,200.2,187.28,193.74
2018-11-26,1610612744,1610612753,2018,116.0,110.0,226.0,107.5,105.85,96.55,103.5,21,14,7,0.667,20,10,10,0.5,10,4,6,4,199.04,203.64,201.33999999999997
2018-11-25,1610612747,1610612753,2018,104.0,108.0,212.0,107.3,114.65,96.55,103.5,18,11,7,0.611,19,9,10,0.474,6,5,6,3,219.28,203.64,211.45999999999998
2018-11-25,1610612765,1610612756,2018,118.0,107.0,225.0,100.85,105.95,106.25,103.85,16,9,7,0.563,18,4,14,0.222,5,4,3,1,206.0,212.88,209.44
2018-11-25,1610612737,1610612766,2018,124.0,123.0,247.0,96.35,95.7,99.45,97.7,19,3,16,0.158,18,9,9,0.5,2,1,6,3,199.44,194.96,197.2
2018-11-25,1610612751,1610612755,2018,125.0,127.0,252.0,96.7,98.4,97.85,106.0,20,8,12,0.4,21,13,8,0.619,3,5,10,3,196.96,207.68,202.32
2018-11-25,1610612761,1610612748,2018,125.0,115.0,240.0,100.6,99.2,97.25,95.5,20,16,4,0.8,18,7,11,0.389,8,8,3,4,206.0,195.0,200.5
2018-11-25,1610612763,1610612752,2018,98.0,103.0,201.0,98.25,97.5,101.2,97.2,18,12,6,0.667,20,6,14,0.3,7,5,3,3,193.96,200.28,197.12
2018-11-25,1610612758,1610612762,2018,112.0,133.0,245.0,97.75,101.5,95.55,106.55,19,10,9,0.526,19,8,11,0.421,5,5,2,6,207.08,200.2,203.64
2018-11-25,1610612757,1610612746,2018,100.0,104.0,204.0,104.75,105.45,109.85,106.5,19,12,7,0.632,18,12,6,0.667,7,5,8,4,209.44,214.36,211.9
2018-11-24,1610612739,1610612745,2018,117.0,108.0,225.0,101.9,101.55,112.7,109.85,17,3,14,0.17600000000000002,17,9,8,0.529,2,1,4,5,195.48,216.24,205.86
2018-11-24,1610612764,1610612740,2018,124.0,114.0,238.0,94.7,91.35,100.45,104.8,18,6,12,0.333,19,10,9,0.526,4,2,8,2,193.0,200.8,196.9
2018-11-24,1610612750,1610612741,2018,111.0,96.0,207.0,110.05,111.2,94.0,91.0,19,8,11,0.421,19,5,14,0.263,7,1,3,2,209.4,185.44,197.42000000000002
2018-11-24,1610612760,1610612743,2018,98.0,105.0,203.0,101.8,103.4,109.2,110.3,18,12,6,0.667,19,12,7,0.632,7,5,8,4,210.36,217.04,213.7
2018-11-24,1610612742,1610612738,2018,113.0,104.0,217.0,104.45,102.7,99.65,105.5,17,8,9,0.471,19,10,9,0.526,7,1,5,5,213.0,195.08,204.04000000000002
2018-11-24,1610612749,1610612759,2018,135.0,129.0,264.0,99.8,108.15,107.75,96.55,18,13,5,0.722,18,9,9,0.5,9,4,6,3,200.48,204.12,202.3
2018-11-24,1610612744,1610612758,2018,117.0,116.0,233.0,107.5,105.85,97.75,101.5,20,13,7,0.65,18,10,8,0.556,9,4,5,5,199.04,207.08,203.06
2018-11-23,1610612751,1610612750,2018,102.0,112.0,214.0,96.7,98.4,110.05,111.2,19,8,11,0.421,18,7,11,0.389,3,5,7,0,196.96,209.4,203.18
2018-11-23,1610612746,1610612763,2018,112.0,107.0,219.0,109.85,106.5,98.25,97.5,17,11,6,0.647,17,12,5,0.706,7,4,7,5,214.36,193.96,204.16000000000003
2018-11-23,1610612765,1610612745,2018,116.0,111.0,227.0,100.85,105.95,112.7,109.85,15,8,7,0.5329999999999999,16,9,7,0.563,4,4,4,5,206.0,216.24,211.12
2018-11-23,1610612737,1610612738,2018,96.0,114.0,210.0,96.35,95.7,99.65,105.5,18,3,15,0.16699999999999998,18,9,9,0.5,2,1,5,4,199.44,195.08,197.26
2018-11-23,1610612752,1610612740,2018,114.0,109.0,223.0,101.2,97.2,100.45,104.8,19,5,14,0.263,18,10,8,0.556,2,3,8,2,200.28,200.8,200.54000000000002
2018-11-23,1610612755,1610612739,2018,112.0,121.0,233.0,97.85,106.0,101.9,101.55,20,13,7,0.65,16,2,14,0.125,10,3,2,0,207.68,195.48,201.57999999999998
2018-11-23,1610612761,1610612764,2018,125.0,107.0,232.0,100.6,99.2,94.7,91.35,19,15,4,0.789,17,6,11,0.353,7,8,4,2,206.0,193.0,199.5
2018-11-23,1610612754,1610612759,2018,100.0,111.0,211.0,92.05,92.25,107.75,96.55,18,11,7,0.611,17,8,9,0.471,6,5,6,2,187.28,204.12,195.7
2018-11-23,1610612741,1610612748,2018,96.0,103.0,199.0,94.0,91.0,97.25,95.5,18,5,13,0.278,17,6,11,0.353,3,2,3,3,185.44,195.0,190.22
2018-11-23,1610612760,1610612766,2018,109.0,104.0,213.0,101.8,103.4,99.45,97.7,17,11,6,0.647,17,9,8,0.529,6,5,6,3,210.36,194.96,202.66000000000003
2018-11-23,1610612749,1610612756,2018,114.0,116.0,230.0,99.8,108.15,106.25,103.85,17,13,4,0.765,17,3,14,0.17600000000000002,9,4,3,0,200.48,212.88,206.68
2018-11-23,1610612743,1610612753,2018,112.0,87.0,199.0,109.2,110.3,96.55,103.5,18,11,7,0.611,18,9,9,0.5,7,4,6,3,217.04,203.64,210.33999999999997
2018-11-23,1610612744,1610612757,2018,125.0,97.0,222.0,107.5,105.85,104.75,105.45,19,12,7,0.632,18,12,6,0.667,8,4,7,5,199.04,209.44,204.24
2018-11-23,1610612747,1610612762,2018,90.0,83.0,173.0,107.3,114.65,95.55,106.55,17,10,7,0.588,18,8,10,0.444,5,5,2,6,219.28,200.2,209.74
2018-11-21,1610612766,1610612754,2018,127.0,109.0,236.0,99.45,97.7,92.05,92.25,16,8,8,0.5,17,11,6,0.647,5,3,6,5,194.96,187.28,191.12
2018-11-21,1610612755,1610612740,2018,121.0,120.0,241.0,97.85,106.0,100.45,104.8,19,12,7,0.632,17,10,7,0.588,9,3,8,2,207.68,200.8,204.24
2018-11-21,1610612737,1610612761,2018,108.0,124.0,232.0,96.35,95.7,100.6,99.2,17,3,14,0.17600000000000002,18,14,4,0.778,2,1,7,7,199.44,206.0,202.72
2018-11-21,1610612738,1610612752,2018,109.0,117.0,226.0,99.65,105.5,101.2,97.2,17,9,8,0.529,18,4,14,0.222,5,4,2,2,195.08,200.28,197.68
2018-11-21,1610612739,1610612747,2018,105.0,109.0,214.0,101.9,101.55,107.3,114.65,15,2,13,0.133,16,9,7,0.563,2,0,5,4,195.48,219.28,207.38
2018-11-21,1610612741,1610612756,2018,124.0,116.0,240.0,94.0,91.0,106.25,103.85,17,4,13,0.235,16,3,13,0.188,2,2,3,0,185.44,212.88,199.16
2018-11-21,1610612745,1610612765,2018,126.0,124.0,250.0,112.7,109.85,100.85,105.95,15,8,7,0.5329999999999999,14,8,6,0.5710000000000001,3,5,4,4,216.24,206.0,211.12
2018-11-21,1610612749,1610612757,2018,143.0,100.0,243.0,99.8,108.15,104.75,105.45,16,12,4,0.75,17,12,5,0.706,8,4,7,5,200.48,209.44,204.95999999999998
2018-11-21,1610612750,1610612743,2018,101.0,103.0,204.0,110.05,111.2,109.2,110.3,17,7,10,0.412,17,10,7,0.588,7,0,7,3,209.4,217.04,213.22
2018-11-21,1610612742,1610612751,2018,119.0,113.0,232.0,104.45,102.7,96.7,98.4,16,7,9,0.438,18,8,10,0.444,6,1,3,5,213.0,196.96,204.98000000000002
2018-11-21,1610612759,1610612763,2018,103.0,104.0,207.0,107.75,96.55,98.25,97.5,16,8,8,0.5,16,11,5,0.688,6,2,7,4,204.12,193.96,199.04000000000002
2018-11-21,1610612762,1610612758,2018,110.0,119.0,229.0,95.55,106.55,97.75,101.5,17,8,9,0.471,17,9,8,0.529,2,6,5,4,200.2,207.08,203.64
2018-11-21,1610612744,1610612760,2018,95.0,123.0,218.0,107.5,105.85,101.8,103.4,18,12,6,0.667,16,10,6,0.625,8,4,6,4,199.04,210.36,204.7
2018-11-20,1610612753,1610612761,2018,91.0,93.0,184.0,96.55,103.5,100.6,99.2,17,9,8,0.529,17,13,4,0.765,6,3,7,6,203.64,206.0,204.82
2018-11-20,1610612764,1610612746,2018,125.0,118.0,243.0,94.7,91.35,109.85,106.5,16,5,11,0.313,16,11,5,0.688,3,2,7,4,193.0,214.36,203.68
2018-11-20,1610612748,1610612751,2018,92.0,104.0,196.0,97.25,95.5,96.7,98.4,16,6,10,0.375,17,7,10,0.412,3,3,3,4,195.0,196.96,195.98000000000002
2018-11-20,1610612752,1610612757,2018,114.0,118.0,232.0,101.2,97.2,104.75,105.45,17,4,13,0.235,16,11,5,0.688,2,2,7,4,200.28,209.44,204.86
2018-11-19,1610612766,1610612738,2018,117.0,112.0,229.0,99.45,97.7,99.65,105.5,15,7,8,0.467,16,9,7,0.563,4,3,5,4,194.96,195.08,195.02
2018-11-19,1610612765,1610612739,2018,113.0,102.0,215.0,100.85,105.95,101.9,101.55,13,7,6,0.5379999999999999,14,2,12,0.14300000000000002,3,4,2,0,206.0,195.48,200.74
2018-11-19,1610612754,1610612762,2018,121.0,94.0,215.0,92.05,92.25,95.55,106.55,16,10,6,0.625,16,8,8,0.5,5,5,2,6,187.28,200.2,193.74
2018-11-19,1610612755,1610612756,2018,119.0,114.0,233.0,97.85,106.0,106.25,103.85,18,11,7,0.611,15,3,12,0.2,8,3,3,0,207.68,212.88,210.28
2018-11-19,1610612737,1610612746,2018,119.0,127.0,246.0,96.35,95.7,109.85,106.5,16,3,13,0.188,15,10,5,0.667,2,1,7,3,199.44,214.36,206.9
2018-11-19,1610612763,1610612742,2018,98.0,88.0,186.0,98.25,97.5,104.45,102.7,15,10,5,0.667,15,7,8,0.467,6,4,6,1,193.96,213.0,203.48000000000002
2018-11-19,1610612749,1610612743,2018,104.0,98.0,202.0,99.8,108.15,109.2,110.3,15,11,4,0.733,16,10,6,0.625,7,4,7,3,200.48,217.04,208.76
2018-11-19,1610612740,1610612759,2018,140.0,126.0,266.0,100.45,104.8,107.75,96.55,16,9,7,0.563,15,8,7,0.5329999999999999,7,2,6,2,200.8,204.12,202.46
2018-11-19,1610612758,1610612760,2018,117.0,113.0,230.0,97.75,101.5,101.8,103.4,16,8,8,0.5,15,10,5,0.667,4,4,6,4,207.08,210.36,208.72000000000003
2018-11-18,1610612750,1610612763,2018,87.0,100.0,187.0,110.05,111.2,98.25,97.5,16,7,9,0.438,14,9,5,0.643,7,0,6,3,209.4,193.96,201.68
2018-11-18,1610612748,1610612747,2018,97.0,113.0,210.0,97.25,95.5,107.3,114.65,15,6,9,0.4,15,8,7,0.5329999999999999,3,3,5,3,195.0,219.28,207.14
2018-11-18,1610612753,1610612752,2018,131.0,117.0,248.0,96.55,103.5,101.2,97.2,16,8,8,0.5,16,4,12,0.25,5,3,2,2,203.64,200.28,201.95999999999998
2018-11-18,1610612764,1610612757,2018,109.0,119.0,228.0,94.7,91.35,104.75,105.45,15,5,10,0.333,15,10,5,0.667,3,2,7,3,193.0,209.44,201.22
2018-11-18,1610612759,1610612744,2018,104.0,92.0,196.0,107.75,96.55,107.5,105.85,14,7,7,0.5,17,12,5,0.706,5,2,8,4,204.12,199.04,201.57999999999998
2018-11-17,1610612751,1610612746,2018,119.0,127.0,246.0,96.7,98.4,109.85,106.5,16,7,9,0.438,14,9,5,0.643,3,4,7,2,196.96,214.36,205.66000000000003
2018-11-17,1610612766,1610612755,2018,119.0,122.0,241.0,99.45,97.7,97.85,106.0,14,7,7,0.5,17,10,7,0.588,4,3,8,2,194.96,207.68,201.32
2018-11-17,1610612754,1610612737,2018,97.0,89.0,186.0,92.05,92.25,96.35,95.7,15,9,6,0.6,15,3,12,0.2,4,5,2,1,187.28,199.44,193.36
2018-11-17,1610612753,1610612747,2018,130.0,117.0,247.0,96.55,103.5,107.3,114.65,15,7,8,0.467,14,8,6,0.5710000000000001,4,3,5,3,203.64,219.28,211.45999999999998
2018-11-17,1610612740,1610612743,2018,125.0,115.0,240.0,100.45,104.8,109.2,110.3,15,8,7,0.5329999999999999,15,10,5,0.667,6,2,7,3,200.8,217.04,208.92000000000002
2018-11-17,1610612738,1610612762,2018,86.0,98.0,184.0,99.65,105.5,95.55,106.55,15,9,6,0.6,15,7,8,0.467,5,4,2,5,195.08,200.2,197.64
2018-11-17,1610612741,1610612761,2018,83.0,122.0,205.0,94.0,91.0,100.6,99.2,16,4,12,0.25,16,12,4,0.75,2,2,7,5,185.44,206.0,195.72
2018-11-17,1610612745,1610612758,2018,132.0,112.0,244.0,112.7,109.85,97.75,101.5,14,7,7,0.5,15,8,7,0.5329999999999999,2,5,4,4,216.24,207.08,211.66000000000003
2018-11-17,1610612742,1610612744,2018,112.0,109.0,221.0,104.45,102.7,107.5,105.85,14,6,8,0.429,16,12,4,0.75,5,1,8,4,213.0,199.04,206.01999999999998
2018-11-17,1610612756,1610612760,2018,100.0,110.0,210.0,106.25,103.85,101.8,103.4,14,3,11,0.214,14,9,5,0.643,3,0,6,3,212.88,210.36,211.62
2018-11-16,1610612738,1610612761,2018,123.0,116.0,239.0,99.65,105.5,100.6,99.2,14,8,6,0.5710000000000001,15,12,3,0.8,4,4,7,5,195.08,206.0,200.54000000000002
2018-11-16,1610612754,1610612748,2018,99.0,91.0,190.0,92.05,92.25,97.25,95.5,14,8,6,0.5710000000000001,14,6,8,0.429,3,5,3,3,187.28,195.0,191.14
2018-11-16,1610612755,1610612762,2018,113.0,107.0,220.0,97.85,106.0,95.55,106.55,16,9,7,0.563,14,7,7,0.5,7,2,2,5,207.68,200.2,203.94
2018-11-16,1610612764,1610612751,2018,104.0,115.0,219.0,94.7,91.35,96.7,98.4,14,5,9,0.35700000000000004,15,6,9,0.4,3,2,3,3,193.0,196.96,194.98000000000002
2018-11-16,1610612763,1610612758,2018,112.0,104.0,216.0,98.25,97.5,97.75,101.5,13,8,5,0.615,14,8,6,0.5710000000000001,5,3,4,4,193.96,207.08,200.52
2018-11-16,1610612750,1610612757,2018,112.0,96.0,208.0,110.05,111.2,104.75,105.45,15,6,9,0.4,14,10,4,0.7140000000000001,6,0,7,3,209.4,209.44,209.42000000000002
2018-11-16,1610612740,1610612752,2018,129.0,124.0,253.0,100.45,104.8,101.2,97.2,14,7,7,0.5,15,4,11,0.267,5,2,2,2,200.8,200.28,200.54000000000002
2018-11-16,1610612749,1610612741,2018,123.0,104.0,227.0,99.8,108.15,94.0,91.0,14,10,4,0.7140000000000001,15,4,11,0.267,6,4,2,2,200.48,185.44,192.95999999999998
2018-11-15,1610612745,1610612744,2018,107.0,86.0,193.0,112.7,109.85,107.5,105.85,13,6,7,0.462,15,12,3,0.8,1,5,8,4,216.24,199.04,207.64
2018-11-15,1610612743,1610612737,2018,138.0,93.0,231.0,109.2,110.3,96.35,95.7,14,9,5,0.643,14,3,11,0.214,6,3,2,1,217.04,199.44,208.24
2018-11-15,1610612746,1610612759,2018,116.0,111.0,227.0,109.85,106.5,107.75,96.55,13,8,5,0.615,13,7,6,0.5379999999999999,6,2,5,2,214.36,204.12,209.24
2018-11-14,1610612753,1610612755,2018,111.0,106.0,217.0,96.55,103.5,97.85,106.0,14,6,8,0.429,15,9,6,0.6,3,3,7,2,203.64,207.68,205.66
2018-11-14,1610612764,1610612739,2018,119.0,95.0,214.0,94.7,91.35,101.9,101.55,13,4,9,0.308,13,2,11,0.154,2,2,2,0,193.0,195.48,194.24
2018-11-14,1610612738,1610612741,2018,111.0,82.0,193.0,99.65,105.5,94.0,91.0,13,7,6,0.5379999999999999,14,4,10,0.28600000000000003,3,4,2,2,195.08,185.44,190.26
2018-11-14,1610612751,1610612748,2018,107.0,120.0,227.0,96.7,98.4,97.25,95.5,14,6,8,0.429,13,5,8,0.385,3,3,3,2,196.96,195.0,195.98000000000002
2018-11-14,1610612761,1610612765,2018,104.0,106.0,210.0,100.6,99.2,100.85,105.95,14,12,2,0.857,12,6,6,0.5,7,5,3,3,206.0,206.0,206.0
2018-11-14,1610612749,1610612763,2018,113.0,116.0,229.0,99.8,108.15,98.25,97.5,13,10,3,0.769,12,7,5,0.583,6,4,5,2,200.48,193.96,197.22
2018-11-14,1610612750,1610612740,2018,107.0,100.0,207.0,110.05,111.2,100.45,104.8,14,5,9,0.35700000000000004,13,7,6,0.5379999999999999,5,0,5,2,209.4,200.8,205.10000000000002
2018-11-14,1610612760,1610612752,2018,128.0,103.0,231.0,101.8,103.4,101.2,97.2,13,8,5,0.615,14,4,10,0.28600000000000003,5,3,2,2,210.36,200.28,205.32
2018-11-14,1610612742,1610612762,2018,118.0,68.0,186.0,104.45,102.7,95.55,106.55,13,5,8,0.385,13,7,6,0.5379999999999999,4,1,2,5,213.0,200.2,206.6
2018-11-14,1610612756,1610612759,2018,116.0,96.0,212.0,106.25,103.85,107.75,96.55,13,2,11,0.154,12,7,5,0.583,2,0,5,2,212.88,204.12,208.5
2018-11-14,1610612747,1610612757,2018,126.0,117.0,243.0,107.3,114.65,104.75,105.45,13,7,6,0.5379999999999999,13,10,3,0.769,4,3,7,3,219.28,209.44,214.36
2018-11-13,1610612739,1610612766,2018,113.0,89.0,202.0,101.9,101.55,99.45,97.7,12,1,11,0.083,13,7,6,0.5379999999999999,1,0,4,3,195.48,194.96,195.22
2018-11-13,1610612743,1610612745,2018,99.0,109.0,208.0,109.2,110.3,112.7,109.85,13,9,4,0.6920000000000001,12,5,7,0.417,6,3,1,4,217.04,216.24,216.64
2018-11-13,1610612744,1610612737,2018,110.0,103.0,213.0,107.5,105.85,96.35,95.7,14,11,3,0.7859999999999999,13,3,10,0.231,7,4,2,1,199.04,199.44,199.24
2018-11-12,1610612764,1610612753,2018,117.0,109.0,226.0,94.7,91.35,96.55,103.5,12,3,9,0.25,13,6,7,0.462,1,2,3,3,193.0,203.64,198.32
2018-11-12,1610612748,1610612755,2018,114.0,124.0,238.0,97.25,95.5,97.85,106.0,12,5,7,0.417,14,8,6,0.5710000000000001,3,2,7,1,195.0,207.68,201.34
2018-11-12,1610612761,1610612740,2018,110.0,126.0,236.0,100.6,99.2,100.45,104.8,13,12,1,0.923,12,6,6,0.5,7,5,5,1,206.0,200.8,203.4
2018-11-12,1610612741,1610612742,2018,98.0,103.0,201.0,94.0,91.0,104.45,102.7,13,4,9,0.308,12,4,8,0.333,2,2,4,0,185.44,213.0,199.22
2018-11-12,1610612763,1610612762,2018,88.0,96.0,184.0,98.25,97.5,95.55,106.55,11,7,4,0.636,12,6,6,0.5,5,2,2,4,193.96,200.2,197.07999999999998
2018-11-12,1610612750,1610612751,2018,120.0,113.0,233.0,110.05,111.2,96.7,98.4,13,4,9,0.308,13,6,7,0.462,4,0,3,3,209.4,196.96,203.18
2018-11-12,1610612760,1610612756,2018,118.0,101.0,219.0,101.8,103.4,106.25,103.85,12,7,5,0.583,12,2,10,0.16699999999999998,4,3,2,0,210.36,212.88,211.62
2018-11-12,1610612758,1610612759,2018,104.0,99.0,203.0,97.75,101.5,107.75,96.55,13,7,6,0.5379999999999999,11,7,4,0.636,3,4,5,2,207.08,204.12,205.60000000000002
2018-11-12,1610612746,1610612744,2018,121.0,116.0,237.0,109.85,106.5,107.5,105.85,12,7,5,0.583,13,11,2,0.846,5,2,7,4,214.36,199.04,206.7
2018-11-11,1610612765,1610612766,2018,103.0,113.0,216.0,100.85,105.95,99.45,97.7,11,6,5,0.545,12,6,6,0.5,3,3,4,2,206.0,194.96,200.48000000000002
2018-11-11,1610612745,1610612754,2018,115.0,103.0,218.0,112.7,109.85,92.05,92.25,11,4,7,0.364,13,8,5,0.615,0,4,3,5,216.24,187.28,201.76
2018-11-11,1610612752,1610612753,2018,89.0,115.0,204.0,101.2,97.2,96.55,103.5,13,4,9,0.308,12,5,7,0.417,2,2,3,2,200.28,203.64,201.95999999999998
2018-11-11,1610612743,1610612749,2018,114.0,121.0,235.0,109.2,110.3,99.8,108.15,12,9,3,0.75,12,9,3,0.75,6,3,6,3,217.04,200.48,208.76
2018-11-11,1610612757,1610612738,2018,100.0,94.0,194.0,104.75,105.45,99.65,105.5,12,9,3,0.75,12,7,5,0.583,6,3,3,4,209.44,195.08,202.26
2018-11-11,1610612747,1610612737,2018,107.0,106.0,213.0,107.3,114.65,96.35,95.7,12,6,6,0.5,12,3,9,0.25,3,3,2,1,219.28,199.44,209.36
2018-11-10,1610612761,1610612752,2018,128.0,112.0,240.0,100.6,99.2,101.2,97.2,12,11,1,0.917,12,4,8,0.333,6,5,2,2,206.0,200.28,203.14
2018-11-10,1610612746,1610612749,2018,128.0,126.0,254.0,109.85,106.5,99.8,108.15,11,6,5,0.545,11,9,2,0.818,4,2,6,3,214.36,200.48,207.42000000000002
2018-11-10,1610612740,1610612756,2018,119.0,99.0,218.0,100.45,104.8,106.25,103.85,11,5,6,0.455,11,2,9,0.182,4,1,2,0,200.8,212.88,206.84
2018-11-10,1610612748,1610612764,2018,110.0,116.0,226.0,97.25,95.5,94.7,91.35,11,5,6,0.455,11,2,9,0.182,3,2,1,1,195.0,193.0,194.0
2018-11-10,1610612741,1610612739,2018,99.0,98.0,197.0,94.0,91.0,101.9,101.55,12,3,9,0.25,11,1,10,0.091,1,2,1,0,185.44,195.48,190.45999999999998
2018-11-10,1610612763,1610612755,2018,112.0,106.0,218.0,98.25,97.5,97.85,106.0,10,6,4,0.6,13,8,5,0.615,4,2,7,1,193.96,207.68,200.82
2018-11-10,1610612759,1610612745,2018,96.0,89.0,185.0,107.75,96.55,112.7,109.85,10,6,4,0.6,10,4,6,0.4,4,2,0,4,204.12,216.24,210.18
2018-11-10,1610612744,1610612751,2018,116.0,100.0,216.0,107.5,105.85,96.7,98.4,12,10,2,0.833,12,6,6,0.5,6,4,3,3,199.04,196.96,198.0
2018-11-10,1610612742,1610612760,2018,111.0,96.0,207.0,104.45,102.7,101.8,103.4,11,3,8,0.273,11,7,4,0.636,3,0,4,3,213.0,210.36,211.68
2018-11-10,1610612758,1610612747,2018,86.0,101.0,187.0,97.75,101.5,107.3,114.65,12,7,5,0.583,11,5,6,0.455,3,4,3,2,207.08,219.28,213.18
2018-11-09,1610612753,1610612764,2018,117.0,108.0,225.0,96.55,103.5,94.7,91.35,11,4,7,0.364,10,2,8,0.2,2,2,1,1,203.64,193.0,198.32
2018-11-09,1610612755,1610612766,2018,133.0,132.0,265.0,97.85,106.0,99.45,97.7,12,7,5,0.583,11,6,5,0.545,6,1,4,2,207.68,194.96,201.32
2018-11-09,1610612737,1610612765,2018,109.0,124.0,233.0,96.35,95.7,100.85,105.95,11,3,8,0.273,10,5,5,0.5,2,1,3,2,199.44,206.0,202.72
2018-11-09,1610612748,1610612754,2018,102.0,110.0,212.0,97.25,95.5,92.05,92.25,10,5,5,0.5,12,7,5,0.583,3,2,3,4,195.0,187.28,191.14
2018-11-09,1610612743,1610612751,2018,110.0,112.0,222.0,109.2,110.3,96.7,98.4,11,9,2,0.818,11,5,6,0.455,6,3,3,2,217.04,196.96,207.0
2018-11-09,1610612762,1610612738,2018,123.0,115.0,238.0,95.55,106.55,99.65,105.5,11,5,6,0.455,11,7,4,0.636,1,4,3,4,200.2,195.08,197.64
2018-11-09,1610612758,1610612750,2018,121.0,110.0,231.0,97.75,101.5,110.05,111.2,11,6,5,0.545,12,4,8,0.333,2,4,4,0,207.08,209.4,208.24
2018-11-08,1610612760,1610612745,2018,98.0,80.0,178.0,101.8,103.4,112.7,109.85,10,6,4,0.6,9,4,5,0.444,3,3,0,4,210.36,216.24,213.3
2018-11-08,1610612756,1610612738,2018,109.0,116.0,225.0,106.25,103.85,99.65,105.5,10,2,8,0.2,10,6,4,0.6,2,0,3,3,212.88,195.08,203.98000000000002
2018-11-08,1610612757,1610612746,2018,116.0,105.0,221.0,104.75,105.45,109.85,106.5,11,8,3,0.727,10,6,4,0.6,5,3,4,2,209.44,214.36,211.9
2018-11-08,1610612744,1610612749,2018,111.0,134.0,245.0,107.5,105.85,99.8,108.15,11,10,1,0.909,10,8,2,0.8,6,4,6,2,199.04,200.48,199.76
2018-11-07,1610612739,1610612760,2018,86.0,95.0,181.0,101.9,101.55,101.8,103.4,10,1,9,0.1,9,5,4,0.556,1,0,3,2,195.48,210.36,202.92000000000002
2018-11-07,1610612753,1610612765,2018,96.0,103.0,199.0,96.55,103.5,100.85,105.95,10,4,6,0.4,9,4,5,0.444,2,2,3,1,203.64,206.0,204.82
2018-11-07,1610612737,1610612752,2018,107.0,112.0,219.0,96.35,95.7,101.2,97.2,10,3,7,0.3,11,3,8,0.273,2,1,2,1,199.44,200.28,199.86
2018-11-07,1610612748,1610612759,2018,95.0,88.0,183.0,97.25,95.5,107.75,96.55,9,4,5,0.444,9,6,3,0.667,2,2,4,2,195.0,204.12,199.56
2018-11-07,1610612754,1610612755,2018,94.0,100.0,194.0,92.05,92.25,97.85,106.0,11,7,4,0.636,11,6,5,0.545,3,4,6,0,187.28,207.68,197.48000000000002
2018-11-07,1610612763,1610612743,2018,89.0,87.0,176.0,98.25,97.5,109.2,110.3,9,5,4,0.556,10,9,1,0.9,3,2,6,3,193.96,217.04,205.5
2018-11-07,1610612740,1610612741,2018,107.0,98.0,205.0,100.45,104.8,94.0,91.0,10,4,6,0.4,11,3,8,0.273,3,1,1,2,200.8,185.44,193.12
2018-11-07,1610612762,1610612742,2018,117.0,102.0,219.0,95.55,106.55,104.45,102.7,10,4,6,0.4,10,3,7,0.3,0,4,3,0,200.2,213.0,206.6
2018-11-07,1610612758,1610612761,2018,105.0,114.0,219.0,97.75,101.5,100.6,99.2,10,6,4,0.6,11,10,1,0.909,2,4,6,4,207.08,206.0,206.54000000000002
2018-11-07,1610612747,1610612750,2018,114.0,110.0,224.0,107.3,114.65,110.05,111.2,10,4,6,0.4,11,4,7,0.364,2,2,4,0,219.28,209.4,214.34
2018-11-06,1610612766,1610612737,2018,113.0,102.0,215.0,99.45,97.7,96.35,95.7,10,5,5,0.5,9,3,6,0.333,3,2,2,1,194.96,199.44,197.2
2018-11-06,1610612742,1610612764,2018,119.0,100.0,219.0,104.45,102.7,94.7,91.35,9,2,7,0.222,9,2,7,0.222,2,0,1,1,213.0,193.0,203.0
2018-11-06,1610612756,1610612751,2018,82.0,104.0,186.0,106.25,103.85,96.7,98.4,9,2,7,0.222,10,4,6,0.4,2,0,3,1,212.88,196.96,204.92000000000002
2018-11-06,1610612757,1610612749,2018,118.0,103.0,221.0,104.75,105.45,99.8,108.15,10,7,3,0.7,9,8,1,0.889,4,3,6,2,209.44,200.48,204.95999999999998
2018-11-05,1610612765,1610612748,2018,115.0,120.0,235.0,100.85,105.95,97.25,95.5,8,4,4,0.5,8,3,5,0.375,3,1,2,1,206.0,195.0,200.5
2018-11-05,1610612754,1610612745,2018,94.0,98.0,192.0,92.05,92.25,112.7,109.85,10,7,3,0.7,8,3,5,0.375,3,4,0,3,187.28,216.24,201.76
2018-11-05,1610612753,1610612739,2018,102.0,100.0,202.0,96.55,103.5,101.9,101.55,9,3,6,0.333,9,1,8,0.111,1,2,1,0,203.64,195.48,199.56
2018-11-05,1610612752,1610612741,2018,115.0,116.0,231.0,101.2,97.2,94.0,91.0,10,3,7,0.3,10,2,8,0.2,2,1,1,1,200.28,185.44,192.86
2018-11-05,1610612760,1610612740,2018,122.0,116.0,238.0,101.8,103.4,100.45,104.8,8,4,4,0.5,9,4,5,0.444,2,2,3,1,210.36,200.8,205.58
2018-11-05,1610612743,1610612738,2018,115.0,107.0,222.0,109.2,110.3,99.65,105.5,9,8,1,0.889,9,6,3,0.667,5,3,3,3,217.04,195.08,206.06
2018-11-05,1610612762,1610612761,2018,111.0,124.0,235.0,95.55,106.55,100.6,99.2,9,4,5,0.444,10,9,1,0.9,0,4,6,3,200.2,206.0,203.1
2018-11-05,1610612744,1610612763,2018,117.0,101.0,218.0,107.5,105.85,98.25,97.5,10,9,1,0.9,8,5,3,0.625,5,4,3,2,199.04,193.96,196.5
2018-11-05,1610612746,1610612750,2018,120.0,109.0,229.0,109.85,106.5,110.05,111.2,9,5,4,0.556,10,4,6,0.4,3,2,4,0,214.36,209.4,211.88
2018-11-04,1610612749,1610612758,2018,144.0,109.0,253.0,99.8,108.15,97.75,101.5,8,7,1,0.875,9,6,3,0.667,5,2,2,4,200.48,207.08,203.78
2018-11-04,1610612751,1610612755,2018,122.0,97.0,219.0,96.7,98.4,97.85,106.0,9,3,6,0.333,10,6,4,0.6,2,1,6,0,196.96,207.68,202.32
2018-11-04,1610612764,1610612752,2018,108.0,95.0,203.0,94.7,91.35,101.2,97.2,8,1,7,0.125,9,3,6,0.333,0,1,2,1,193.0,200.28,196.64
2018-11-04,1610612759,1610612753,2018,110.0,117.0,227.0,107.75,96.55,96.55,103.5,8,6,2,0.75,8,2,6,0.25,4,2,1,1,204.12,203.64,203.88
2018-11-04,1610612756,1610612763,2018,102.0,100.0,202.0,106.25,103.85,98.25,97.5,8,1,7,0.125,7,5,2,0.7140000000000001,1,0,3,2,212.88,193.96,203.42000000000002
2018-11-04,1610612757,1610612750,2018,111.0,81.0,192.0,104.75,105.45,110.05,111.2,9,6,3,0.667,9,4,5,0.444,3,3,4,0,209.44,209.4,209.42000000000002
2018-11-04,1610612747,1610612761,2018,107.0,121.0,228.0,107.3,114.65,100.6,99.2,9,4,5,0.444,9,8,1,0.889,2,2,6,2,219.28,206.0,212.64
2018-11-03,1610612755,1610612765,2018,109.0,99.0,208.0,97.85,106.0,100.85,105.95,9,5,4,0.556,7,4,3,0.5710000000000001,5,0,3,1,207.68,206.0,206.84
2018-11-03,1610612766,1610612739,2018,126.0,94.0,220.0,99.45,97.7,101.9,101.55,9,4,5,0.444,8,1,7,0.125,2,2,1,0,194.96,195.48,195.22
2018-11-03,1610612754,1610612738,2018,102.0,101.0,203.0,92.05,92.25,99.65,105.5,9,6,3,0.667,8,6,2,0.75,2,4,3,3,187.28,195.08,191.18
2018-11-03,1610612737,1610612748,2018,123.0,118.0,241.0,96.35,95.7,97.25,95.5,8,2,6,0.25,7,3,4,0.429,1,1,2,1,199.44,195.0,197.22
2018-11-03,1610612741,1610612745,2018,88.0,96.0,184.0,94.0,91.0,112.7,109.85,9,2,7,0.222,7,2,5,0.28600000000000003,1,1,0,2,185.44,216.24,200.84
2018-11-03,1610612759,1610612740,2018,109.0,95.0,204.0,107.75,96.55,100.45,104.8,7,5,2,0.7140000000000001,8,4,4,0.5,3,2,3,1,204.12,200.8,202.46
2018-11-03,1610612743,1610612762,2018,103.0,88.0,191.0,109.2,110.3,95.55,106.55,8,7,1,0.875,8,4,4,0.5,4,3,0,4,217.04,200.2,208.62
2018-11-03,1610612757,1610612747,2018,110.0,114.0,224.0,104.75,105.45,107.3,114.65,8,6,2,0.75,8,3,5,0.375,3,3,2,1,209.44,219.28,214.36
2018-11-02,1610612753,1610612746,2018,95.0,120.0,215.0,96.55,103.5,109.85,106.5,7,2,5,0.28600000000000003,8,4,4,0.5,1,1,3,1,203.64,214.36,209.0
2018-11-02,1610612751,1610612745,2018,111.0,119.0,230.0,96.7,98.4,112.7,109.85,8,3,5,0.375,6,1,5,0.16699999999999998,2,1,0,1,196.96,216.24,206.60000000000002
2018-11-02,1610612764,1610612760,2018,111.0,134.0,245.0,94.7,91.35,101.8,103.4,7,1,6,0.14300000000000002,7,3,4,0.429,0,1,2,1,193.0,210.36,201.68
2018-11-02,1610612741,1610612754,2018,105.0,107.0,212.0,94.0,91.0,92.05,92.25,8,2,6,0.25,8,5,3,0.625,1,1,2,3,185.44,187.28,186.36
2018-11-02,1610612742,1610612752,2018,106.0,118.0,224.0,104.45,102.7,101.2,97.2,8,2,6,0.25,8,2,6,0.25,2,0,2,0,213.0,200.28,206.64
2018-11-02,1610612762,1610612763,2018,100.0,110.0,210.0,95.55,106.55,98.25,97.5,7,4,3,0.5710000000000001,6,4,2,0.667,0,4,3,1,200.2,193.96,197.07999999999998
2018-11-02,1610612756,1610612761,2018,98.0,107.0,205.0,106.25,103.85,100.6,99.2,7,1,6,0.14300000000000002,8,7,1,0.875,1,0,6,1,212.88,206.0,209.44
2018-11-02,1610612744,1610612750,2018,116.0,99.0,215.0,107.5,105.85,110.05,111.2,9,8,1,0.889,8,4,4,0.5,4,4,4,0,199.04,209.4,204.22
2018-11-01,1610612766,1610612760,2018,107.0,111.0,218.0,99.45,97.7,101.8,103.4,8,4,4,0.5,6,2,4,0.333,2,2,2,0,194.96,210.36,202.66000000000003
2018-11-01,1610612739,1610612743,2018,91.0,110.0,201.0,101.9,101.55,109.2,110.3,7,1,6,0.14300000000000002,7,6,1,0.857,1,0,4,2,195.48,217.04,206.26
2018-11-01,1610612755,1610612746,2018,122.0,113.0,235.0,97.85,106.0,109.85,106.5,8,4,4,0.5,7,4,3,0.5710000000000001,4,0,3,1,207.68,214.36,211.02
2018-11-01,1610612737,1610612758,2018,115.0,146.0,261.0,96.35,95.7,97.75,101.5,7,2,5,0.28600000000000003,8,5,3,0.625,1,1,2,3,199.44,207.08,203.26
2018-11-01,1610612738,1610612749,2018,117.0,113.0,230.0,99.65,105.5,99.8,108.15,7,5,2,0.7140000000000001,7,7,0,1.0,2,3,5,2,195.08,200.48,197.78
2018-11-01,1610612757,1610612740,2018,132.0,119.0,251.0,104.75,105.45,100.45,104.8,7,5,2,0.7140000000000001,7,4,3,0.5710000000000001,2,3,3,1,209.44,200.8,205.12
2018-10-31,1610612751,1610612765,2018,120.0,119.0,239.0,96.7,98.4,100.85,105.95,7,2,5,0.28600000000000003,6,4,2,0.667,1,1,3,1,196.96,206.0,201.48000000000002
2018-10-31,1610612752,1610612754,2018,101.0,107.0,208.0,101.2,97.2,92.05,92.25,7,2,5,0.28600000000000003,7,4,3,0.5710000000000001,2,0,2,2,200.28,187.28,193.78
2018-10-31,1610612741,1610612743,2018,107.0,108.0,215.0,94.0,91.0,109.2,110.3,7,2,5,0.28600000000000003,6,5,1,0.833,1,1,4,1,185.44,217.04,201.24
2018-10-31,1610612750,1610612762,2018,128.0,125.0,253.0,110.05,111.2,95.55,106.55,7,3,4,0.429,6,4,2,0.667,3,0,0,4,209.4,200.2,204.8
2018-10-31,1610612744,1610612740,2018,131.0,121.0,252.0,107.5,105.85,100.45,104.8,8,7,1,0.875,6,4,2,0.667,3,4,3,1,199.04,200.8,199.92000000000002
2018-10-31,1610612747,1610612742,2018,114.0,113.0,227.0,107.3,114.65,104.45,102.7,7,2,5,0.28600000000000003,7,2,5,0.28600000000000003,1,1,2,0,219.28,213.0,216.14
2018-10-31,1610612756,1610612759,2018,90.0,120.0,210.0,106.25,103.85,107.75,96.55,6,1,5,0.16699999999999998,6,4,2,0.667,1,0,3,1,212.88,204.12,208.5
2018-10-30,1610612766,1610612748,2018,125.0,113.0,238.0,99.45,97.7,97.25,95.5,7,3,4,0.429,6,3,3,0.5,1,2,2,1,194.96,195.0,194.98000000000002
2018-10-30,1610612739,1610612737,2018,136.0,114.0,250.0,101.9,101.55,96.35,95.7,6,0,6,0.0,6,2,4,0.333,0,0,1,1,195.48,199.44,197.45999999999998
2018-10-30,1610612753,1610612758,2018,99.0,107.0,206.0,96.55,103.5,97.75,101.5,6,2,4,0.333,7,4,3,0.5710000000000001,1,1,2,2,203.64,207.08,205.36
2018-10-30,1610612738,1610612765,2018,108.0,105.0,213.0,99.65,105.5,100.85,105.95,6,4,2,0.667,5,4,1,0.8,1,3,3,1,195.08,206.0,200.54000000000002
2018-10-30,1610612761,1610612755,2018,129.0,112.0,241.0,100.6,99.2,97.85,106.0,7,6,1,0.857,7,4,3,0.5710000000000001,5,1,4,0,206.0,207.68,206.84
2018-10-30,1610612745,1610612757,2018,85.0,104.0,189.0,112.7,109.85,104.75,105.45,5,1,4,0.2,6,4,2,0.667,0,1,2,2,216.24,209.44,212.84
2018-10-30,1610612763,1610612764,2018,107.0,95.0,202.0,98.25,97.5,94.7,91.35,5,3,2,0.6,6,1,5,0.16699999999999998,2,1,0,1,193.96,193.0,193.48000000000002
2018-10-30,1610612760,1610612746,2018,128.0,110.0,238.0,101.8,103.4,109.85,106.5,5,1,4,0.2,6,4,2,0.667,1,0,3,1,210.36,214.36,212.36
2018-10-29,1610612754,1610612757,2018,93.0,103.0,196.0,92.05,92.25,104.75,105.45,6,4,2,0.667,5,3,2,0.6,2,2,2,1,187.28,209.44,198.36
2018-10-29,1610612755,1610612737,2018,113.0,92.0,205.0,97.85,106.0,96.35,95.7,6,3,3,0.5,5,2,3,0.4,3,0,1,1,207.68,199.44,203.56
2018-10-29,1610612748,1610612758,2018,113.0,123.0,236.0,97.25,95.5,97.75,101.5,5,3,2,0.6,6,3,3,0.5,2,1,2,1,195.0,207.08,201.04000000000002
2018-10-29,1610612752,1610612751,2018,115.0,96.0,211.0,101.2,97.2,96.7,98.4,6,1,5,0.16699999999999998,6,2,4,0.333,1,0,1,1,200.28,196.96,198.62
2018-10-29,1610612741,1610612744,2018,124.0,149.0,273.0,94.0,91.0,107.5,105.85,6,2,4,0.333,7,6,1,0.857,1,1,3,3,185.44,199.04,192.24
2018-10-29,1610612749,1610612761,2018,124.0,109.0,233.0,99.8,108.15,100.6,99.2,6,6,0,1.0,6,6,0,1.0,4,2,5,1,200.48,206.0,203.24
2018-10-29,1610612750,1610612747,2018,124.0,120.0,244.0,110.05,111.2,107.3,114.65,6,2,4,0.333,6,2,4,0.333,2,0,1,1,209.4,219.28,214.34
2018-10-29,1610612759,1610612742,2018,113.0,108.0,221.0,107.75,96.55,104.45,102.7,5,3,2,0.6,6,2,4,0.333,2,1,2,0,204.12,213.0,208.56
2018-10-29,1610612743,1610612740,2018,116.0,111.0,227.0,109.2,110.3,100.45,104.8,5,4,1,0.8,5,4,1,0.8,3,1,3,1,217.04,200.8,208.92000000000002
2018-10-28,1610612751,1610612744,2018,114.0,120.0,234.0,96.7,98.4,107.5,105.85,5,2,3,0.4,6,5,1,0.833,1,1,3,2,196.96,199.04,198.0
2018-10-28,1610612742,1610612762,2018,104.0,113.0,217.0,104.45,102.7,95.55,106.55,5,2,3,0.4,5,3,2,0.6,2,0,0,3,213.0,200.2,206.6
2018-10-28,1610612760,1610612756,2018,117.0,110.0,227.0,101.8,103.4,106.25,103.85,4,0,4,0.0,5,1,4,0.2,0,0,1,0,210.36,212.88,211.62
2018-10-28,1610612746,1610612764,2018,136.0,104.0,240.0,109.85,106.5,94.7,91.35,5,3,2,0.6,5,1,4,0.2,2,1,0,1,214.36,193.0,203.68
2018-10-27,1610612765,1610612738,2018,89.0,109.0,198.0,100.85,105.95,99.65,105.5,4,4,0,1.0,5,3,2,0.6,3,1,1,2,206.0,195.08,200.54000000000002
2018-10-27,1610612740,1610612762,2018,111.0,132.0,243.0,100.45,104.8,95.55,106.55,4,4,0,1.0,4,2,2,0.5,3,1,0,2,200.8,200.2,200.5
2018-10-27,1610612737,1610612741,2018,85.0,97.0,182.0,96.35,95.7,94.0,91.0,4,2,2,0.5,5,1,4,0.2,1,1,1,0,199.44,185.44,192.44
2018-10-27,1610612739,1610612754,2018,107.0,119.0,226.0,101.9,101.55,92.05,92.25,5,0,5,0.0,5,3,2,0.6,0,0,2,1,195.48,187.28,191.38
2018-10-27,1610612755,1610612766,2018,105.0,103.0,208.0,97.85,106.0,99.45,97.7,5,2,3,0.4,6,3,3,0.5,2,0,1,2,207.68,194.96,201.32
2018-10-27,1610612748,1610612757,2018,120.0,111.0,231.0,97.25,95.5,104.75,105.45,4,2,2,0.5,4,3,1,0.75,1,1,2,1,195.0,209.44,202.22
2018-10-27,1610612763,1610612756,2018,117.0,96.0,213.0,98.25,97.5,106.25,103.85,4,2,2,0.5,4,1,3,0.25,1,1,1,0,193.96,212.88,203.42000000000002
2018-10-27,1610612749,1610612753,2018,113.0,91.0,204.0,99.8,108.15,96.55,103.5,5,5,0,1.0,5,2,3,0.4,3,2,1,1,200.48,203.64,202.06
2018-10-27,1610612759,1610612747,2018,110.0,106.0,216.0,107.75,96.55,107.3,114.65,4,2,2,0.5,5,2,3,0.4,1,1,1,1,204.12,219.28,211.7
2018-10-26,1610612766,1610612741,2018,135.0,106.0,241.0,99.45,97.7,94.0,91.0,5,2,3,0.4,4,1,3,0.25,0,2,1,0,194.96,185.44,190.2
2018-10-26,1610612752,1610612744,2018,100.0,128.0,228.0,101.2,97.2,107.5,105.85,5,1,4,0.2,5,4,1,0.8,1,0,3,1,200.28,199.04,199.66
2018-10-26,1610612761,1610612742,2018,116.0,107.0,223.0,100.6,99.2,104.45,102.7,5,5,0,1.0,4,2,2,0.5,4,1,2,0,206.0,213.0,209.5
2018-10-26,1610612745,1610612746,2018,113.0,133.0,246.0,112.7,109.85,109.85,106.5,4,1,3,0.25,4,2,2,0.5,0,1,2,0,216.24,214.36,215.3
2018-10-26,1610612750,1610612749,2018,95.0,125.0,220.0,110.05,111.2,99.8,108.15,5,2,3,0.4,4,4,0,1.0,2,0,3,1,209.4,200.48,204.94
2018-10-26,1610612740,1610612751,2018,117.0,115.0,232.0,100.45,104.8,96.7,98.4,3,3,0,1.0,4,2,2,0.5,2,1,1,1,200.8,196.96,198.88
2018-10-26,1610612758,1610612764,2018,116.0,112.0,228.0,97.75,101.5,94.7,91.35,5,2,3,0.4,4,1,3,0.25,1,1,0,1,207.08,193.0,200.04000000000002
2018-10-25,1610612765,1610612739,2018,110.0,103.0,213.0,100.85,105.95,101.9,101.55,3,3,0,1.0,4,0,4,0.0,2,1,0,0,206.0,195.48,200.74
2018-10-25,1610612753,1610612757,2018,114.0,128.0,242.0,96.55,103.5,104.75,105.45,4,2,2,0.5,3,2,1,0.667,1,1,2,0,203.64,209.44,206.54
2018-10-25,1610612760,1610612738,2018,95.0,101.0,196.0,101.8,103.4,99.65,105.5,3,0,3,0.0,4,2,2,0.5,0,0,1,1,210.36,195.08,202.72000000000003
2018-10-25,1610612747,1610612743,2018,121.0,114.0,235.0,107.3,114.65,109.2,110.3,4,1,3,0.25,4,4,0,1.0,0,1,3,1,219.28,217.04,218.16
2018-10-24,1610612737,1610612742,2018,111.0,104.0,215.0,96.35,95.7,104.45,102.7,3,1,2,0.333,3,2,1,0.667,0,1,2,0,199.44,213.0,206.22
2018-10-24,1610612739,1610612751,2018,86.0,102.0,188.0,101.9,101.55,96.7,98.4,3,0,3,0.0,3,1,2,0.333,0,0,1,0,195.48,196.96,196.22
2018-10-24,1610612748,1610612752,2018,110.0,87.0,197.0,97.25,95.5,101.2,97.2,3,1,2,0.333,4,1,3,0.25,0,1,1,0,195.0,200.28,197.64
2018-10-24,1610612761,1610612750,2018,112.0,105.0,217.0,100.6,99.2,110.05,111.2,4,4,0,1.0,4,2,2,0.5,3,1,2,0,206.0,209.4,207.7
2018-10-24,1610612741,1610612766,2018,112.0,110.0,222.0,94.0,91.0,99.45,97.7,3,0,3,0.0,4,2,2,0.5,0,0,0,2,185.44,194.96,190.2
2018-10-24,1610612745,1610612762,2018,89.0,100.0,189.0,112.7,109.85,95.55,106.55,3,1,2,0.333,3,1,2,0.333,0,1,0,1,216.24,200.2,208.22
2018-10-24,1610612759,1610612754,2018,96.0,116.0,212.0,107.75,96.55,92.05,92.25,3,2,1,0.667,4,2,2,0.5,1,1,2,0,204.12,187.28,195.7
2018-10-24,1610612749,1610612755,2018,123.0,108.0,231.0,99.8,108.15,97.85,106.0,3,3,0,1.0,4,2,2,0.5,2,1,2,0,200.48,207.68,204.07999999999998
2018-10-24,1610612756,1610612747,2018,113.0,131.0,244.0,106.25,103.85,107.3,114.65,3,1,2,0.333,3,0,3,0.0,1,0,0,0,212.88,219.28,216.07999999999998
2018-10-24,1610612758,1610612763,2018,97.0,92.0,189.0,97.75,101.5,98.25,97.5,4,1,3,0.25,3,2,1,0.667,0,1,1,1,207.08,193.96,200.52
2018-10-24,1610612744,1610612764,2018,144.0,122.0,266.0,107.5,105.85,94.7,91.35,4,3,1,0.75,3,1,2,0.333,2,1,0,1,199.04,193.0,196.01999999999998
2018-10-23,1610612765,1610612755,2018,133.0,132.0,265.0,100.85,105.95,97.85,106.0,2,2,0,1.0,3,2,1,0.667,1,1,2,0,206.0,207.68,206.84
2018-10-23,1610612740,1610612746,2018,116.0,109.0,225.0,100.45,104.8,109.85,106.5,2,2,0,1.0,3,2,1,0.667,1,1,2,0,200.8,214.36,207.58
2018-10-23,1610612743,1610612758,2018,126.0,112.0,238.0,109.2,110.3,97.75,101.5,3,3,0,1.0,3,1,2,0.333,2,1,0,1,217.04,207.08,212.06
2018-10-22,1610612738,1610612753,2018,90.0,93.0,183.0,99.65,105.5,96.55,103.5,3,2,1,0.667,3,1,2,0.333,1,1,1,0,195.08,203.64,199.36
2018-10-22,1610612761,1610612766,2018,127.0,106.0,233.0,100.6,99.2,99.45,97.7,3,3,0,1.0,3,2,1,0.667,2,1,0,2,206.0,194.96,200.48000000000002
2018-10-22,1610612749,1610612752,2018,124.0,113.0,237.0,99.8,108.15,101.2,97.2,2,2,0,1.0,3,1,2,0.333,1,1,1,0,200.48,200.28,200.38
2018-10-22,1610612750,1610612754,2018,101.0,91.0,192.0,110.05,111.2,92.05,92.25,3,1,2,0.333,3,2,1,0.667,1,0,2,0,209.4,187.28,198.34
2018-10-22,1610612742,1610612741,2018,115.0,109.0,224.0,104.45,102.7,94.0,91.0,2,1,1,0.5,2,0,2,0.0,1,0,0,0,213.0,185.44,199.22
2018-10-22,1610612762,1610612763,2018,84.0,92.0,176.0,95.55,106.55,98.25,97.5,2,1,1,0.5,2,1,1,0.5,0,1,1,0,200.2,193.96,197.07999999999998
2018-10-22,1610612757,1610612764,2018,124.0,125.0,249.0,104.75,105.45,94.7,91.35,2,2,0,1.0,2,0,2,0.0,2,0,0,0,209.44,193.0,201.22
2018-10-22,1610612744,1610612756,2018,123.0,103.0,226.0,107.5,105.85,106.25,103.85,3,2,1,0.667,2,1,1,0.5,1,1,1,0,199.04,212.88,205.95999999999998
2018-10-22,1610612747,1610612759,2018,142.0,143.0,285.0,107.3,114.65,107.75,96.55,2,0,2,0.0,2,1,1,0.5,0,0,1,0,219.28,204.12,211.7
2018-10-21,1610612739,1610612737,2018,111.0,133.0,244.0,101.9,101.55,96.35,95.7,2,0,2,0.0,2,0,2,0.0,0,0,0,0,195.48,199.44,197.45999999999998
2018-10-21,1610612760,1610612758,2018,120.0,131.0,251.0,101.8,103.4,97.75,101.5,2,0,2,0.0,2,0,2,0.0,0,0,0,0,210.36,207.08,208.72000000000003
2018-10-21,1610612743,1610612744,2018,100.0,98.0,198.0,109.2,110.3,107.5,105.85,2,2,0,1.0,2,2,0,1.0,1,1,1,1,217.04,199.04,208.04
2018-10-21,1610612746,1610612745,2018,115.0,112.0,227.0,109.85,106.5,112.7,109.85,2,1,1,0.5,2,1,1,0.5,1,0,0,1,214.36,216.24,215.3
2018-10-20,1610612754,1610612751,2018,132.0,112.0,244.0,92.05,92.25,96.7,98.4,2,1,1,0.5,2,1,1,0.5,1,0,1,0,187.28,196.96,192.12
2018-10-20,1610612764,1610612761,2018,113.0,117.0,230.0,94.7,91.35,100.6,99.2,1,0,1,0.0,2,2,0,1.0,0,0,2,0,193.0,206.0,199.5
2018-10-20,1610612752,1610612738,2018,101.0,103.0,204.0,101.2,97.2,99.65,105.5,2,1,1,0.5,2,1,1,0.5,1,0,1,0,200.28,195.08,197.68
2018-10-20,1610612755,1610612753,2018,116.0,115.0,231.0,97.85,106.0,96.55,103.5,2,1,1,0.5,2,1,1,0.5,1,0,1,0,207.68,203.64,205.66
2018-10-20,1610612748,1610612766,2018,112.0,113.0,225.0,97.25,95.5,99.45,97.7,2,1,1,0.5,2,1,1,0.5,0,1,0,1,195.0,194.96,194.98000000000002
2018-10-20,1610612741,1610612765,2018,116.0,118.0,234.0,94.0,91.0,100.85,105.95,1,0,1,0.0,1,1,0,1.0,0,0,1,0,185.44,206.0,195.72
2018-10-20,1610612742,1610612750,2018,140.0,136.0,276.0,104.45,102.7,110.05,111.2,1,0,1,0.0,2,1,1,0.5,0,0,1,0,213.0,209.4,211.2
2018-10-20,1610612743,1610612756,2018,119.0,91.0,210.0,109.2,110.3,106.25,103.85,1,1,0,1.0,1,1,0,1.0,0,1,1,0,217.04,212.88,214.95999999999998
2018-10-20,1610612757,1610612759,2018,121.0,108.0,229.0,104.75,105.45,107.75,96.55,1,1,0,1.0,1,1,0,1.0,1,0,1,0,209.44,204.12,206.78
2018-10-20,1610612747,1610612745,2018,115.0,124.0,239.0,107.3,114.65,112.7,109.85,1,0,1,0.0,1,0,1,0.0,0,0,0,0,219.28,216.24,217.76
2018-10-19,1610612753,1610612766,2018,88.0,120.0,208.0,96.55,103.5,99.45,97.7,1,1,0,1.0,1,0,1,0.0,1,0,0,0,203.64,194.96,199.3
2018-10-19,1610612751,1610612752,2018,107.0,105.0,212.0,96.7,98.4,101.2,97.2,1,0,1,0.0,1,1,0,1.0,0,0,1,0,196.96,200.28,198.62
2018-10-19,1610612761,1610612738,2018,113.0,101.0,214.0,100.6,99.2,99.65,105.5,1,1,0,1.0,1,1,0,1.0,1,0,1,0,206.0,195.08,200.54000000000002
2018-10-19,1610612763,1610612737,2018,131.0,117.0,248.0,98.25,97.5,96.35,95.7,1,0,1,0.0,1,0,1,0.0,0,0,0,0,193.96,199.44,196.7
2018-10-19,1610612750,1610612739,2018,131.0,123.0,254.0,110.05,111.2,101.9,101.55,1,0,1,0.0,1,0,1,0.0,0,0,0,0,209.4,195.48,202.44
2018-10-19,1610612740,1610612758,2018,149.0,129.0,278.0,100.45,104.8,97.75,101.5,1,1,0,1.0,1,0,1,0.0,0,1,0,0,200.8,207.08,203.94
2018-10-19,1610612749,1610612754,2018,118.0,101.0,219.0,99.8,108.15,92.05,92.25,1,1,0,1.0,1,1,0,1.0,0,1,1,0,200.48,187.28,193.88
2018-10-19,1610612762,1610612744,2018,123.0,124.0,247.0,95.55,106.55,107.5,105.85,1,1,0,1.0,1,1,0,1.0,0,1,1,0,200.2,199.04,199.62
2018-10-19,1610612746,1610612760,2018,108.0,92.0,200.0,109.85,106.5,101.8,103.4,1,0,1,0.0,1,0,1,0.0,0,0,0,0,214.36,210.36,212.36
2018-10-18,1610612755,1610612741,2018,127.0,108.0,235.0,97.85,106.0,94.0,91.0,1,0,1,0.0,0,0,0,0.0,0,0,0,0,207.68,185.44,196.56
2018-10-18,1610612764,1610612748,2018,112.0,113.0,225.0,94.7,91.35,97.25,95.5,0,0,0,0.0,1,0,1,0.0,0,0,0,0,193.0,195.0,194.0
2018-10-18,1610612757,1610612747,2018,128.0,119.0,247.0,104.75,105.45,107.3,114.65,0,0,0,0.0,0,0,0,0.0,0,0,0,0,209.44,219.28,214.36
2018-10-17,1610612766,1610612749,2018,112.0,113.0,225.0,99.45,97.7,99.8,108.15,0,0,0,0.0,0,0,0,0.0,0,0,0,0,194.96,200.48,197.72
2018-10-17,1610612765,1610612751,2018,103.0,100.0,203.0,100.85,105.95,96.7,98.4,0,0,0,0.0,0,0,0,0.0,0,0,0,0,206.0,196.96,201.48000000000002
2018-10-17,1610612754,1610612763,2018,111.0,83.0,194.0,92.05,92.25,98.25,97.5,0,0,0,0.0,0,0,0,0.0,0,0,0,0,187.28,193.96,190.62
2018-10-17,1610612753,1610612748,2018,104.0,101.0,205.0,96.55,103.5,97.25,95.5,0,0,0,0.0,0,0,0,0.0,0,0,0,0,203.64,195.0,199.32
2018-10-17,1610612752,1610612737,2018,126.0,107.0,233.0,101.2,97.2,96.35,95.7,0,0,0,0.0,0,0,0,0.0,0,0,0,0,200.28,199.44,199.86
2018-10-17,1610612761,1610612739,2018,116.0,104.0,220.0,100.6,99.2,101.9,101.55,0,0,0,0.0,0,0,0,0.0,0,0,0,0,206.0,195.48,200.74
2018-10-17,1610612745,1610612740,2018,112.0,131.0,243.0,112.7,109.85,100.45,104.8,0,0,0,0.0,0,0,0,0.0,0,0,0,0,216.24,200.8,208.52
2018-10-17,1610612759,1610612750,2018,112.0,108.0,220.0,107.75,96.55,110.05,111.2,0,0,0,0.0,0,0,0,0.0,0,0,0,0,204.12,209.4,206.76
2018-10-17,1610612758,1610612762,2018,117.0,123.0,240.0,97.75,101.5,95.55,106.55,0,0,0,0.0,0,0,0,0.0,0,0,0,0,207.08,200.2,203.64
2018-10-17,1610612746,1610612743,2018,98.0,107.0,205.0,109.85,106.5,109.2,110.3,0,0,0,0.0,0,0,0,0.0,0,0,0,0,214.36,217.04,215.7
2018-10-17,1610612756,1610612742,2018,121.0,100.0,221.0,106.25,103.85,104.45,102.7,0,0,0,0.0,0,0,0,0.0,0,0,0,0,212.88,213.0,212.94
2018-10-16,1610612738,1610612755,2018,105.0,87.0,192.0,99.65,105.5,97.85,106.0,4,1,3,0.25,4,3,1,0.75,1,0,2,1,195.08,207.68,201.38
2018-10-16,1610612744,1610612760,2018,108.0,100.0,208.0,107.5,105.85,101.8,103.4,5,1,4,0.2,4,3,1,0.75,1,0,2,1,199.04,210.36,204.7
2018-10-12,1610612753,1610612759,2018,81.0,100.0,181.0,96.55,103.5,107.75,96.55,4,2,2,0.5,4,2,2,0.5,2,0,2,0,203.64,204.12,203.88
2018-10-12,1610612742,1610612766,2018,118.0,123.0,241.0,104.45,102.7,99.45,97.7,3,2,1,0.667,4,3,1,0.75,1,1,3,0,213.0,194.96,203.98000000000002
2018-10-12,1610612739,1610612765,2018,110.0,129.0,239.0,101.9,101.55,100.85,105.95,3,2,1,0.667,4,1,3,0.25,1,1,0,1,195.48,206.0,200.74
2018-10-12,1610612752,1610612751,2018,107.0,113.0,220.0,101.2,97.2,96.7,98.4,4,3,1,0.75,3,1,2,0.333,1,2,0,1,200.28,196.96,198.62
2018-10-12,1610612748,1610612737,2018,119.0,113.0,232.0,97.25,95.5,96.35,95.7,5,2,3,0.4,4,2,2,0.5,2,0,2,0,195.0,199.44,197.22
2018-10-12,1610612741,1610612743,2018,93.0,98.0,191.0,94.0,91.0,109.2,110.3,4,2,2,0.5,4,3,1,0.75,2,0,1,2,185.44,217.04,201.24
2018-10-12,1610612763,1610612745,2018,103.0,121.0,224.0,98.25,97.5,112.7,109.85,4,2,2,0.5,4,3,1,0.75,2,0,2,1,193.96,216.24,205.10000000000002
2018-10-12,1610612749,1610612750,2018,143.0,121.0,264.0,99.8,108.15,110.05,111.2,3,2,1,0.667,4,1,3,0.25,1,1,0,1,200.48,209.4,204.94
2018-10-12,1610612757,1610612758,2018,118.0,115.0,233.0,104.75,105.45,97.75,101.5,4,2,2,0.5,5,2,3,0.4,1,1,1,1,209.44,207.08,208.26
2018-10-12,1610612744,1610612747,2018,105.0,119.0,224.0,107.5,105.85,107.3,114.65,4,1,3,0.25,5,2,3,0.4,1,0,2,0,199.04,219.28,209.16
2018-10-11,1610612740,1610612761,2018,119.0,134.0,253.0,100.45,104.8,100.6,99.2,4,0,4,0.0,4,3,1,0.75,0,0,3,0,200.8,206.0,203.4
2018-10-11,1610612758,1610612762,2018,93.0,132.0,225.0,97.75,101.5,95.55,106.55,4,2,2,0.5,4,4,0,1.0,1,1,3,1,207.08,200.2,203.64
2018-10-10,1610612765,1610612764,2018,97.0,102.0,199.0,100.85,105.95,94.7,91.35,3,1,2,0.333,3,2,1,0.667,0,1,1,1,206.0,193.0,199.5
2018-10-10,1610612753,1610612763,2018,102.0,86.0,188.0,96.55,103.5,98.25,97.5,3,1,2,0.333,3,2,1,0.667,1,0,2,0,203.64,193.96,198.8
2018-10-10,1610612761,1610612751,2018,118.0,91.0,209.0,100.6,99.2,96.7,98.4,3,2,1,0.667,2,1,1,0.5,2,0,0,1,206.0,196.96,201.48000000000002
2018-10-10,1610612737,1610612759,2018,130.0,127.0,257.0,96.35,95.7,107.75,96.55,3,1,2,0.333,3,2,1,0.667,1,0,2,0,199.44,204.12,201.78
2018-10-10,1610612748,1610612740,2018,140.0,128.0,268.0,97.25,95.5,100.45,104.8,4,1,3,0.25,3,0,3,0.0,1,0,0,0,195.0,200.8,197.9
2018-10-10,1610612741,1610612754,2018,104.0,89.0,193.0,94.0,91.0,92.05,92.25,3,1,2,0.333,3,2,1,0.667,1,0,0,2,185.44,187.28,186.36
2018-10-10,1610612757,1610612756,2018,116.0,83.0,199.0,104.75,105.45,106.25,103.85,3,1,2,0.333,4,2,2,0.5,0,1,1,1,209.44,212.88,211.16
2018-10-10,1610612747,1610612744,2018,123.0,113.0,236.0,107.3,114.65,107.5,105.85,4,1,3,0.25,3,1,2,0.333,1,0,1,0,219.28,199.04,209.16
2018-10-09,1610612760,1610612749,2018,119.0,115.0,234.0,101.8,103.4,99.8,108.15,3,2,1,0.667,2,2,0,1.0,1,1,1,1,210.36,200.48,205.42000000000002
2018-10-09,1610612746,1610612743,2018,109.0,103.0,212.0,109.85,106.5,109.2,110.3,3,3,0,1.0,3,3,0,1.0,2,1,1,2,214.36,217.04,215.7
2018-10-08,1610612755,1610612742,2018,112.0,115.0,227.0,97.85,106.0,104.45,102.7,3,3,0,1.0,2,1,1,0.5,2,1,1,0,207.68,213.0,210.34
2018-10-08,1610612766,1610612741,2018,110.0,104.0,214.0,99.45,97.7,94.0,91.0,3,2,1,0.667,2,1,1,0.5,2,0,1,0,194.96,185.44,190.2
2018-10-08,1610612739,1610612754,2018,102.0,111.0,213.0,101.9,101.55,92.05,92.25,2,2,0,1.0,2,1,1,0.5,1,1,0,1,195.48,187.28,191.38
2018-10-08,1610612765,1610612751,2018,108.0,110.0,218.0,100.85,105.95,96.7,98.4,2,1,1,0.5,1,0,1,0.0,0,1,0,0,206.0,196.96,201.48000000000002
2018-10-08,1610612748,1610612753,2018,90.0,89.0,179.0,97.25,95.5,96.55,103.5,3,0,3,0.0,2,1,1,0.5,0,0,1,0,195.0,203.64,199.32
2018-10-08,1610612752,1610612764,2018,98.0,110.0,208.0,101.2,97.2,94.7,91.35,3,3,0,1.0,2,1,1,0.5,1,2,1,0,200.28,193.0,196.64
2018-10-08,1610612744,1610612756,2018,109.0,117.0,226.0,107.5,105.85,106.25,103.85,2,1,1,0.5,3,1,2,0.333,1,0,1,0,199.04,212.88,205.95999999999998
2018-10-07,1610612760,1610612737,2018,113.0,94.0,207.0,101.8,103.4,96.35,95.7,2,1,1,0.5,2,1,1,0.5,0,1,1,0,210.36,199.44,204.9
2018-10-07,1610612759,1610612745,2018,93.0,108.0,201.0,107.75,96.55,112.7,109.85,2,2,0,1.0,2,1,1,0.5,2,0,1,0,204.12,216.24,210.18
2018-10-07,1610612750,1610612749,2018,107.0,125.0,232.0,110.05,111.2,99.8,108.15,3,1,2,0.333,1,1,0,1.0,0,1,1,0,209.4,200.48,204.94
2018-10-07,1610612757,1610612762,2018,112.0,123.0,235.0,104.75,105.45,95.55,106.55,2,1,1,0.5,3,3,0,1.0,0,1,3,0,209.44,200.2,204.82
2018-10-06,1610612739,1610612738,2018,113.0,102.0,215.0,101.9,101.55,99.65,105.5,1,1,0,1.0,3,1,2,0.333,0,1,1,0,195.48,195.08,195.28
2018-10-06,1610612763,1610612754,2018,109.0,104.0,213.0,98.25,97.5,92.05,92.25,2,1,1,0.5,1,1,0,1.0,1,0,0,1,193.96,187.28,190.62
2018-10-06,1610612747,1610612746,2018,87.0,103.0,190.0,107.3,114.65,109.85,106.5,3,1,2,0.333,2,2,0,1.0,1,0,2,0,219.28,214.36,216.82
2018-10-05,1610612742,1610612755,2018,114.0,120.0,234.0,104.45,102.7,97.85,106.0,1,1,0,1.0,2,2,0,1.0,1,0,2,0,213.0,207.68,210.34
2018-10-05,1610612764,1610612748,2018,121.0,114.0,235.0,94.7,91.35,97.25,95.5,1,0,1,0.0,2,0,2,0.0,0,0,0,0,193.0,195.0,194.0
2018-10-05,1610612752,1610612740,2018,106.0,100.0,206.0,101.2,97.2,100.45,104.8,2,2,0,1.0,2,0,2,0.0,0,2,0,0,200.28,200.8,200.54000000000002
2018-10-05,1610612763,1610612737,2018,120.0,110.0,230.0,98.25,97.5,96.35,95.7,1,0,1,0.0,1,1,0,1.0,0,0,1,0,193.96,199.44,196.7
2018-10-05,1610612750,1610612760,2018,101.0,113.0,214.0,110.05,111.2,101.8,103.4,2,1,1,0.5,1,0,1,0.0,0,1,0,0,209.4,210.36,209.88
2018-10-05,1610612759,1610612765,2018,117.0,93.0,210.0,107.75,96.55,100.85,105.95,1,1,0,1.0,1,1,0,1.0,1,0,0,1,204.12,206.0,205.06
2018-10-05,1610612756,1610612757,2018,93.0,115.0,208.0,106.25,103.85,104.75,105.45,2,1,1,0.5,1,0,1,0.0,1,0,0,0,212.88,209.44,211.16
2018-10-05,1610612744,1610612758,2018,122.0,94.0,216.0,107.5,105.85,97.75,101.5,1,0,1,0.0,2,1,1,0.5,0,0,0,1,199.04,207.08,203.06
2018-10-04,1610612745,1610612754,2018,100.0,110.0,210.0,112.7,109.85,92.05,92.25,1,1,0,1.0,0,0,0,0.0,1,0,0,0,216.24,187.28,201.76
2018-10-04,1610612747,1610612758,2018,128.0,123.0,251.0,107.3,114.65,97.75,101.5,2,0,2,0.0,1,1,0,1.0,0,0,0,1,219.28,207.08,213.18
2018-10-03,1610612751,1610612752,2018,102.0,107.0,209.0,96.7,98.4,101.2,97.2,0,0,0,0.0,1,1,0,1.0,0,0,0,1,196.96,200.28,198.62
2018-10-03,1610612749,1610612741,2018,116.0,82.0,198.0,99.8,108.15,94.0,91.0,0,0,0,0.0,1,1,0,1.0,0,0,1,0,200.48,185.44,192.95999999999998
2018-10-03,1610612760,1610612765,2018,91.0,97.0,188.0,101.8,103.4,100.85,105.95,0,0,0,0.0,0,0,0,0.0,0,0,0,0,210.36,206.0,208.18
2018-10-03,1610612746,1610612750,2018,128.0,101.0,229.0,109.85,106.5,110.05,111.2,1,1,0,1.0,1,1,0,1.0,1,0,0,1,214.36,209.4,211.88
2018-10-02,1610612766,1610612748,2018,122.0,113.0,235.0,99.45,97.7,97.25,95.5,2,1,1,0.5,1,0,1,0.0,1,0,0,0,194.96,195.0,194.98000000000002
2018-10-02,1610612738,1610612739,2018,95.0,102.0,197.0,99.65,105.5,101.9,101.55,2,1,1,0.5,0,0,0,0.0,1,0,0,0,195.08,195.48,195.28
2018-10-02,1610612745,1610612763,2018,131.0,115.0,246.0,112.7,109.85,98.25,97.5,0,0,0,0.0,0,0,0,0.0,0,0,0,0,216.24,193.96,205.10000000000002
2018-10-02,1610612762,1610612761,2018,105.0,90.0,195.0,95.55,106.55,100.6,99.2,1,1,0,1.0,1,1,0,1.0,1,0,1,0,200.2,206.0,203.1
2018-10-02,1610612747,1610612743,2018,111.0,113.0,224.0,107.3,114.65,109.2,110.3,1,0,1,0.0,1,1,0,1.0,0,0,0,1,219.28,217.04,218.16
2018-10-01,1610612755,1610612753,2018,120.0,114.0,234.0,97.85,106.0,96.55,103.5,1,1,0,1.0,0,0,0,0.0,1,0,0,0,207.68,203.64,205.66
2018-10-01,1610612764,1610612752,2018,121.0,124.0,245.0,94.7,91.35,101.2,97.2,0,0,0,0.0,0,0,0,0.0,0,0,0,0,193.0,200.28,196.64
2018-10-01,1610612737,1610612740,2018,116.0,102.0,218.0,96.35,95.7,100.45,104.8,0,0,0,0.0,1,0,1,0.0,0,0,0,0,199.44,200.8,200.12
2018-10-01,1610612756,1610612758,2018,102.0,106.0,208.0,106.25,103.85,97.75,101.5,0,0,0,0.0,0,0,0,0.0,0,0,0,0,212.88,207.08,209.98000000000002
2018-09-30,1610612759,1610612748,2018,104.0,100.0,204.0,107.75,96.55,97.25,95.5,0,0,0,0.0,0,0,0,0.0,0,0,0,0,204.12,195.0,199.56
2018-09-30,1610612738,1610612766,2018,115.0,112.0,227.0,99.65,105.5,99.45,97.7,1,0,1,0.0,1,1,0,1.0,0,0,1,0,195.08,194.96,195.02
2018-09-30,1610612741,1610612740,2018,128.0,116.0,244.0,94.0,91.0,100.45,104.8,0,0,0,0.0,0,0,0,0.0,0,0,0,0,185.44,200.8,193.12
2018-09-30,1610612747,1610612743,2018,107.0,124.0,231.0,107.3,114.65,109.2,110.3,0,0,0,0.0,0,0,0,0.0,0,0,0,0,219.28,217.04,218.16
2018-09-29,1610612761,1610612757,2018,122.0,104.0,226.0,100.6,99.2,104.75,105.45,0,0,0,0.0,0,0,0,0.0,0,0,0,0,206.0,209.44,207.72
2018-09-29,1610612744,1610612750,2018,110.0,114.0,224.0,107.5,105.85,110.05,111.2,0,0,0,0.0,0,0,0,0.0,0,0,0,0,199.04,209.4,204.22
2018-09-28,1610612766,1610612738,2018,104.0,97.0,201.0,99.45,97.7,99.65,105.5,0,0,0,0.0,0,0,0,0.0,0,0,0,0,194.96,195.08,195.02
2018-06-08,1610612739,1610612744,2017,85.0,108.0,193.0,101.9,101.55,107.5,105.85,82,50,32,0.61,82,58,24,0.7070000000000001,29,21,29,29,195.48,199.04,197.26
2018-06-06,1610612739,1610612744,2017,102.0,110.0,212.0,101.9,101.55,107.5,105.85,82,50,32,0.61,82,58,24,0.7070000000000001,29,21,29,29,195.48,199.04,197.26
2018-06-03,1610612744,1610612739,2017,122.0,103.0,225.0,107.5,105.85,101.9,101.55,82,58,24,0.7070000000000001,82,50,32,0.61,29,29,29,21,199.04,195.48,197.26
2018-05-31,1610612744,1610612739,2017,124.0,114.0,238.0,107.5,105.85,101.9,101.55,82,58,24,0.7070000000000001,82,50,32,0.61,29,29,29,21,199.04,195.48,197.26
2018-05-28,1610612745,1610612744,2017,92.0,101.0,193.0,112.7,109.85,107.5,105.85,82,65,17,0.7929999999999999,82,58,24,0.7070000000000001,34,31,29,29,216.24,199.04,207.64
2018-05-27,1610612738,1610612739,2017,79.0,87.0,166.0,99.65,105.5,101.9,101.55,82,55,27,0.6709999999999999,82,50,32,0.61,27,28,29,21,195.08,195.48,195.28
2018-05-26,1610612744,1610612745,2017,115.0,86.0,201.0,107.5,105.85,112.7,109.85,82,58,24,0.7070000000000001,82,65,17,0.7929999999999999,29,29,34,31,199.04,216.24,207.64
2018-05-25,1610612739,1610612738,2017,109.0,99.0,208.0,101.9,101.55,99.65,105.5,82,50,32,0.61,82,55,27,0.6709999999999999,29,21,27,28,195.48,195.08,195.28
2018-05-24,1610612745,1610612744,2017,98.0,94.0,192.0,112.7,109.85,107.5,105.85,82,65,17,0.7929999999999999,82,58,24,0.7070000000000001,34,31,29,29,216.24,199.04,207.64
2018-05-23,1610612738,1610612739,2017,96.0,83.0,179.0,99.65,105.5,101.9,101.55,82,55,27,0.6709999999999999,82,50,32,0.61,27,28,29,21,195.08,195.48,195.28
2018-05-22,1610612744,1610612745,2017,92.0,95.0,187.0,107.5,105.85,112.7,109.85,82,58,24,0.7070000000000001,82,65,17,0.7929999999999999,29,29,34,31,199.04,216.24,207.64
2018-05-21,1610612739,1610612738,2017,111.0,102.0,213.0,101.9,101.55,99.65,105.5,82,50,32,0.61,82,55,27,0.6709999999999999,29,21,27,28,195.48,195.08,195.28
2018-05-20,1610612744,1610612745,2017,126.0,85.0,211.0,107.5,105.85,112.7,109.85,82,58,24,0.7070000000000001,82,65,17,0.7929999999999999,29,29,34,31,199.04,216.24,207.64
2018-05-19,1610612739,1610612738,2017,116.0,86.0,202.0,101.9,101.55,99.65,105.5,82,50,32,0.61,82,55,27,0.6709999999999999,29,21,27,28,195.48,195.08,195.28
2018-05-16,1610612745,1610612744,2017,127.0,105.0,232.0,112.7,109.85,107.5,105.85,82,65,17,0.7929999999999999,82,58,24,0.7070000000000001,34,31,29,29,216.24,199.04,207.64
2018-05-15,1610612738,1610612739,2017,107.0,94.0,201.0,99.65,105.5,101.9,101.55,82,55,27,0.6709999999999999,82,50,32,0.61,27,28,29,21,195.08,195.48,195.28
2018-05-14,1610612745,1610612744,2017,106.0,119.0,225.0,112.7,109.85,107.5,105.85,82,65,17,0.7929999999999999,82,58,24,0.7070000000000001,34,31,29,29,216.24,199.04,207.64
2018-05-13,1610612738,1610612739,2017,108.0,83.0,191.0,99.65,105.5,101.9,101.55,82,55,27,0.6709999999999999,82,50,32,0.61,27,28,29,21,195.08,195.48,195.28
2018-05-09,1610612738,1610612755,2017,114.0,112.0,226.0,99.65,105.5,97.85,106.0,82,55,27,0.6709999999999999,82,52,30,0.634,27,28,30,22,195.08,207.68,201.38
2018-05-08,1610612745,1610612762,2017,112.0,102.0,214.0,112.7,109.85,95.55,106.55,82,65,17,0.7929999999999999,82,48,34,0.585,34,31,28,20,216.24,200.2,208.22
2018-05-08,1610612744,1610612740,2017,113.0,104.0,217.0,107.5,105.85,100.45,104.8,82,58,24,0.7070000000000001,82,48,34,0.585,29,29,24,24,199.04,200.8,199.92000000000002
2018-05-07,1610612755,1610612738,2017,103.0,92.0,195.0,97.85,106.0,99.65,105.5,82,52,30,0.634,82,55,27,0.6709999999999999,30,22,27,28,207.68,195.08,201.38
2018-05-07,1610612739,1610612761,2017,128.0,93.0,221.0,101.9,101.55,100.6,99.2,82,50,32,0.61,82,59,23,0.72,29,21,34,25,195.48,206.0,200.74
2018-05-06,1610612740,1610612744,2017,92.0,118.0,210.0,100.45,104.8,107.5,105.85,82,48,34,0.585,82,58,24,0.7070000000000001,24,24,29,29,200.8,199.04,199.92000000000002
2018-05-06,1610612762,1610612745,2017,87.0,100.0,187.0,95.55,106.55,112.7,109.85,82,48,34,0.585,82,65,17,0.7929999999999999,28,20,34,31,200.2,216.24,208.22
2018-05-05,1610612755,1610612738,2017,98.0,101.0,199.0,97.85,106.0,99.65,105.5,82,52,30,0.634,82,55,27,0.6709999999999999,30,22,27,28,207.68,195.08,201.38
2018-05-05,1610612739,1610612761,2017,105.0,103.0,208.0,101.9,101.55,100.6,99.2,82,50,32,0.61,82,59,23,0.72,29,21,34,25,195.48,206.0,200.74
2018-05-04,1610612740,1610612744,2017,119.0,100.0,219.0,100.45,104.8,107.5,105.85,82,48,34,0.585,82,58,24,0.7070000000000001,24,24,29,29,200.8,199.04,199.92000000000002
2018-05-04,1610612762,1610612745,2017,92.0,113.0,205.0,95.55,106.55,112.7,109.85,82,48,34,0.585,82,65,17,0.7929999999999999,28,20,34,31,200.2,216.24,208.22
2018-05-03,1610612761,1610612739,2017,110.0,128.0,238.0,100.6,99.2,101.9,101.55,82,59,23,0.72,82,50,32,0.61,34,25,29,21,206.0,195.48,200.74
2018-05-03,1610612738,1610612755,2017,108.0,103.0,211.0,99.65,105.5,97.85,106.0,82,55,27,0.6709999999999999,82,52,30,0.634,27,28,30,22,195.08,207.68,201.38
2018-05-02,1610612745,1610612762,2017,108.0,116.0,224.0,112.7,109.85,95.55,106.55,82,65,17,0.7929999999999999,82,48,34,0.585,34,31,28,20,216.24,200.2,208.22
2018-05-01,1610612761,1610612739,2017,112.0,113.0,225.0,100.6,99.2,101.9,101.55,82,59,23,0.72,82,50,32,0.61,34,25,29,21,206.0,195.48,200.74
2018-05-01,1610612744,1610612740,2017,121.0,116.0,237.0,107.5,105.85,100.45,104.8,82,58,24,0.7070000000000001,82,48,34,0.585,29,29,24,24,199.04,200.8,199.92000000000002
2018-04-30,1610612738,1610612755,2017,117.0,101.0,218.0,99.65,105.5,97.85,106.0,82,55,27,0.6709999999999999,82,52,30,0.634,27,28,30,22,195.08,207.68,201.38
2018-04-29,1610612739,1610612754,2017,105.0,101.0,206.0,101.9,101.55,92.05,92.25,82,50,32,0.61,82,48,34,0.585,29,21,27,21,195.48,187.28,191.38
2018-04-29,1610612745,1610612762,2017,110.0,96.0,206.0,112.7,109.85,95.55,106.55,82,65,17,0.7929999999999999,82,48,34,0.585,34,31,28,20,216.24,200.2,208.22
2018-04-28,1610612738,1610612749,2017,112.0,96.0,208.0,99.65,105.5,99.8,108.15,82,55,27,0.6709999999999999,82,44,38,0.537,27,28,25,19,195.08,200.48,197.78
2018-04-28,1610612744,1610612740,2017,123.0,101.0,224.0,107.5,105.85,100.45,104.8,82,58,24,0.7070000000000001,82,48,34,0.585,29,29,24,24,199.04,200.8,199.92000000000002
2018-04-27,1610612764,1610612761,2017,92.0,102.0,194.0,94.7,91.35,100.6,99.2,82,43,39,0.524,82,59,23,0.72,23,20,34,25,193.0,206.0,199.5
2018-04-27,1610612754,1610612739,2017,121.0,87.0,208.0,92.05,92.25,101.9,101.55,82,48,34,0.585,82,50,32,0.61,27,21,29,21,187.28,195.48,191.38
2018-04-27,1610612762,1610612760,2017,96.0,91.0,187.0,95.55,106.55,101.8,103.4,82,48,34,0.585,82,48,34,0.585,28,20,27,21,200.2,210.36,205.28
2018-04-26,1610612749,1610612738,2017,97.0,86.0,183.0,99.8,108.15,99.65,105.5,82,44,38,0.537,82,55,27,0.6709999999999999,25,19,27,28,200.48,195.08,197.78
2018-04-25,1610612761,1610612764,2017,108.0,98.0,206.0,100.6,99.2,94.7,91.35,82,59,23,0.72,82,43,39,0.524,34,25,23,20,206.0,193.0,199.5
2018-04-25,1610612739,1610612754,2017,98.0,95.0,193.0,101.9,101.55,92.05,92.25,82,50,32,0.61,82,48,34,0.585,29,21,27,21,195.48,187.28,191.38
2018-04-25,1610612745,1610612750,2017,122.0,104.0,226.0,112.7,109.85,110.05,111.2,82,65,17,0.7929999999999999,82,47,35,0.573,34,31,30,17,216.24,209.4,212.82
2018-04-25,1610612760,1610612762,2017,107.0,99.0,206.0,101.8,103.4,95.55,106.55,82,48,34,0.585,82,48,34,0.585,27,21,28,20,210.36,200.2,205.28
2018-04-24,1610612738,1610612749,2017,92.0,87.0,179.0,99.65,105.5,99.8,108.15,82,55,27,0.6709999999999999,82,44,38,0.537,27,28,25,19,195.08,200.48,197.78
2018-04-24,1610612755,1610612748,2017,104.0,91.0,195.0,97.85,106.0,97.25,95.5,82,52,30,0.634,82,44,38,0.537,30,22,26,18,207.68,195.0,201.34
2018-04-24,1610612744,1610612759,2017,99.0,91.0,190.0,107.5,105.85,107.75,96.55,82,58,24,0.7070000000000001,82,47,35,0.573,29,29,33,14,199.04,204.12,201.57999999999998
2018-04-23,1610612750,1610612745,2017,100.0,119.0,219.0,110.05,111.2,112.7,109.85,82,47,35,0.573,82,65,17,0.7929999999999999,30,17,34,31,209.4,216.24,212.82
2018-04-23,1610612762,1610612760,2017,113.0,96.0,209.0,95.55,106.55,101.8,103.4,82,48,34,0.585,82,48,34,0.585,28,20,27,21,200.2,210.36,205.28
2018-04-22,1610612749,1610612738,2017,104.0,102.0,206.0,99.8,108.15,99.65,105.5,82,44,38,0.537,82,55,27,0.6709999999999999,25,19,27,28,200.48,195.08,197.78
2018-04-22,1610612759,1610612744,2017,103.0,90.0,193.0,107.75,96.55,107.5,105.85,82,47,35,0.573,82,58,24,0.7070000000000001,33,14,29,29,204.12,199.04,201.57999999999998
2018-04-22,1610612764,1610612761,2017,106.0,98.0,204.0,94.7,91.35,100.6,99.2,82,43,39,0.524,82,59,23,0.72,23,20,34,25,193.0,206.0,199.5
2018-04-22,1610612754,1610612739,2017,100.0,104.0,204.0,92.05,92.25,101.9,101.55,82,48,34,0.585,82,50,32,0.61,27,21,29,21,187.28,195.48,191.38
2018-04-21,1610612748,1610612755,2017,102.0,106.0,208.0,97.25,95.5,97.85,106.0,82,44,38,0.537,82,52,30,0.634,26,18,30,22,195.0,207.68,201.34
2018-04-21,1610612740,1610612757,2017,131.0,123.0,254.0,100.45,104.8,104.75,105.45,82,48,34,0.585,82,49,33,0.598,24,24,28,21,200.8,209.44,205.12
2018-04-21,1610612750,1610612745,2017,121.0,105.0,226.0,110.05,111.2,112.7,109.85,82,47,35,0.573,82,65,17,0.7929999999999999,30,17,34,31,209.4,216.24,212.82
2018-04-21,1610612762,1610612760,2017,115.0,102.0,217.0,95.55,106.55,101.8,103.4,82,48,34,0.585,82,48,34,0.585,28,20,27,21,200.2,210.36,205.28
2018-04-20,1610612754,1610612739,2017,92.0,90.0,182.0,92.05,92.25,101.9,101.55,82,48,34,0.585,82,50,32,0.61,27,21,29,21,187.28,195.48,191.38
2018-04-20,1610612764,1610612761,2017,122.0,103.0,225.0,94.7,91.35,100.6,99.2,82,43,39,0.524,82,59,23,0.72,23,20,34,25,193.0,206.0,199.5
2018-04-20,1610612749,1610612738,2017,116.0,92.0,208.0,99.8,108.15,99.65,105.5,82,44,38,0.537,82,55,27,0.6709999999999999,25,19,27,28,200.48,195.08,197.78
2018-04-19,1610612748,1610612755,2017,108.0,128.0,236.0,97.25,95.5,97.85,106.0,82,44,38,0.537,82,52,30,0.634,26,18,30,22,195.0,207.68,201.34
2018-04-19,1610612740,1610612757,2017,119.0,102.0,221.0,100.45,104.8,104.75,105.45,82,48,34,0.585,82,49,33,0.598,24,24,28,21,200.8,209.44,205.12
2018-04-19,1610612759,1610612744,2017,97.0,110.0,207.0,107.75,96.55,107.5,105.85,82,47,35,0.573,82,58,24,0.7070000000000001,33,14,29,29,204.12,199.04,201.57999999999998
2018-04-18,1610612739,1610612754,2017,100.0,97.0,197.0,101.9,101.55,92.05,92.25,82,50,32,0.61,82,48,34,0.585,29,21,27,21,195.48,187.28,191.38
2018-04-18,1610612760,1610612762,2017,95.0,102.0,197.0,101.8,103.4,95.55,106.55,82,48,34,0.585,82,48,34,0.585,27,21,28,20,210.36,200.2,205.28
2018-04-18,1610612745,1610612750,2017,102.0,82.0,184.0,112.7,109.85,110.05,111.2,82,65,17,0.7929999999999999,82,47,35,0.573,34,31,30,17,216.24,209.4,212.82
2018-04-17,1610612761,1610612764,2017,130.0,119.0,249.0,100.6,99.2,94.7,91.35,82,59,23,0.72,82,43,39,0.524,34,25,23,20,206.0,193.0,199.5
2018-04-17,1610612738,1610612749,2017,120.0,106.0,226.0,99.65,105.5,99.8,108.15,82,55,27,0.6709999999999999,82,44,38,0.537,27,28,25,19,195.08,200.48,197.78
2018-04-17,1610612757,1610612740,2017,102.0,111.0,213.0,104.75,105.45,100.45,104.8,82,49,33,0.598,82,48,34,0.585,28,21,24,24,209.44,200.8,205.12
2018-04-16,1610612755,1610612748,2017,103.0,113.0,216.0,97.85,106.0,97.25,95.5,82,52,30,0.634,82,44,38,0.537,30,22,26,18,207.68,195.0,201.34
2018-04-16,1610612744,1610612759,2017,116.0,101.0,217.0,107.5,105.85,107.75,96.55,82,58,24,0.7070000000000001,82,47,35,0.573,29,29,33,14,199.04,204.12,201.57999999999998
2018-04-15,1610612738,1610612749,2017,113.0,107.0,220.0,99.65,105.5,99.8,108.15,82,55,27,0.6709999999999999,82,44,38,0.537,27,28,25,19,195.08,200.48,197.78
2018-04-15,1610612739,1610612754,2017,80.0,98.0,178.0,101.9,101.55,92.05,92.25,82,50,32,0.61,82,48,34,0.585,29,21,27,21,195.48,187.28,191.38
2018-04-15,1610612760,1610612762,2017,116.0,108.0,224.0,101.8,103.4,95.55,106.55,82,48,34,0.585,82,48,34,0.585,27,21,28,20,210.36,200.2,205.28
2018-04-15,1610612745,1610612750,2017,104.0,101.0,205.0,112.7,109.85,110.05,111.2,82,65,17,0.7929999999999999,82,47,35,0.573,34,31,30,17,216.24,209.4,212.82
2018-04-14,1610612744,1610612759,2017,113.0,92.0,205.0,107.5,105.85,107.75,96.55,82,58,24,0.7070000000000001,82,47,35,0.573,29,29,33,14,199.04,204.12,201.57999999999998
2018-04-14,1610612761,1610612764,2017,114.0,106.0,220.0,100.6,99.2,94.7,91.35,82,59,23,0.72,82,43,39,0.524,34,25,23,20,206.0,193.0,199.5
2018-04-14,1610612755,1610612748,2017,130.0,103.0,233.0,97.85,106.0,97.25,95.5,82,52,30,0.634,82,44,38,0.537,30,22,26,18,207.68,195.0,201.34
2018-04-14,1610612757,1610612740,2017,95.0,97.0,192.0,104.75,105.45,100.45,104.8,82,49,33,0.598,82,48,34,0.585,28,21,24,24,209.44,200.8,205.12
2018-04-11,1610612738,1610612751,2017,110.0,97.0,207.0,99.65,105.5,96.7,98.4,81,54,27,0.667,81,28,53,0.34600000000000003,26,28,15,13,195.08,196.96,196.02
2018-04-11,1610612739,1610612752,2017,98.0,110.0,208.0,101.9,101.55,101.2,97.2,81,50,31,0.617,81,28,53,0.34600000000000003,29,21,19,9,195.48,200.28,197.88
2018-04-11,1610612748,1610612761,2017,116.0,109.0,225.0,97.25,95.5,100.6,99.2,81,43,38,0.531,81,59,22,0.728,25,18,34,25,195.0,206.0,200.5
2018-04-11,1610612753,1610612764,2017,101.0,92.0,193.0,96.55,103.5,94.7,91.35,81,24,57,0.29600000000000004,81,43,38,0.531,16,8,23,20,203.64,193.0,198.32
2018-04-11,1610612755,1610612749,2017,130.0,95.0,225.0,97.85,106.0,99.8,108.15,81,51,30,0.63,81,44,37,0.5429999999999999,29,22,25,19,207.68,200.48,204.07999999999998
2018-04-11,1610612741,1610612765,2017,87.0,119.0,206.0,94.0,91.0,100.85,105.95,81,27,54,0.333,81,38,43,0.469,17,10,25,13,185.44,206.0,195.72
2018-04-11,1610612750,1610612743,2017,112.0,106.0,218.0,110.05,111.2,109.2,110.3,81,46,35,0.568,81,46,35,0.568,29,17,31,15,209.4,217.04,213.22
2018-04-11,1610612740,1610612759,2017,122.0,98.0,220.0,100.45,104.8,107.75,96.55,81,47,34,0.58,81,47,34,0.58,23,24,33,14,200.8,204.12,202.46
2018-04-11,1610612760,1610612763,2017,137.0,123.0,260.0,101.8,103.4,98.25,97.5,81,47,34,0.58,81,22,59,0.272,26,21,16,6,210.36,193.96,202.16000000000003
2018-04-11,1610612746,1610612747,2017,100.0,115.0,215.0,109.85,106.5,107.3,114.65,81,42,39,0.519,81,34,47,0.42,22,20,20,14,214.36,219.28,216.82
2018-04-11,1610612757,1610612762,2017,102.0,93.0,195.0,104.75,105.45,95.55,106.55,81,48,33,0.593,81,48,33,0.593,27,21,28,20,209.44,200.2,204.82
2018-04-11,1610612758,1610612745,2017,96.0,83.0,179.0,97.75,101.5,112.7,109.85,81,26,55,0.321,81,65,16,0.802,13,13,34,31,207.08,216.24,211.66000000000003
2018-04-10,1610612754,1610612766,2017,93.0,119.0,212.0,92.05,92.25,99.45,97.7,81,48,33,0.593,81,35,46,0.4320000000000001,27,21,21,14,187.28,194.96,191.12
2018-04-10,1610612737,1610612755,2017,113.0,121.0,234.0,96.35,95.7,97.85,106.0,81,24,57,0.29600000000000004,80,50,30,0.625,16,8,29,21,199.44,207.68,203.56
2018-04-10,1610612764,1610612738,2017,113.0,101.0,214.0,94.7,91.35,99.65,105.5,80,42,38,0.525,80,54,26,0.675,22,20,26,28,193.0,195.08,194.04000000000002
2018-04-10,1610612742,1610612756,2017,97.0,124.0,221.0,104.45,102.7,106.25,103.85,81,24,57,0.29600000000000004,81,20,61,0.247,15,9,10,10,213.0,212.88,212.94
2018-04-10,1610612762,1610612744,2017,119.0,79.0,198.0,95.55,106.55,107.5,105.85,80,47,33,0.588,81,58,23,0.716,27,20,29,29,200.2,199.04,199.62
2018-04-10,1610612747,1610612745,2017,99.0,105.0,204.0,107.3,114.65,112.7,109.85,80,34,46,0.425,80,64,16,0.8,20,14,34,30,219.28,216.24,217.76
2018-04-09,1610612765,1610612761,2017,98.0,108.0,206.0,100.85,105.95,100.6,99.2,80,38,42,0.475,80,58,22,0.725,25,13,34,24,206.0,206.0,206.0
2018-04-09,1610612751,1610612741,2017,114.0,105.0,219.0,96.7,98.4,94.0,91.0,80,27,53,0.338,80,27,53,0.338,14,13,17,10,196.96,185.44,191.2
2018-04-09,1610612748,1610612760,2017,93.0,115.0,208.0,97.25,95.5,101.8,103.4,80,43,37,0.5379999999999999,80,46,34,0.575,25,18,26,20,195.0,210.36,202.68
2018-04-09,1610612752,1610612739,2017,109.0,123.0,232.0,101.2,97.2,101.9,101.55,80,28,52,0.35,80,49,31,0.613,19,9,29,20,200.28,195.48,197.88
2018-04-09,1610612749,1610612753,2017,102.0,86.0,188.0,99.8,108.15,96.55,103.5,80,43,37,0.5379999999999999,80,24,56,0.3,24,19,16,8,200.48,203.64,202.06
2018-04-09,1610612750,1610612763,2017,113.0,94.0,207.0,110.05,111.2,98.25,97.5,80,45,35,0.563,80,22,58,0.275,28,17,16,6,209.4,193.96,201.68
2018-04-09,1610612759,1610612758,2017,98.0,85.0,183.0,107.75,96.55,97.75,101.5,80,46,34,0.575,80,26,54,0.325,32,14,13,13,204.12,207.08,205.60000000000002
2018-04-09,1610612743,1610612757,2017,88.0,82.0,170.0,109.2,110.3,104.75,105.45,80,45,35,0.563,80,48,32,0.6,30,15,27,21,217.04,209.44,213.24
2018-04-09,1610612746,1610612740,2017,100.0,113.0,213.0,109.85,106.5,100.45,104.8,80,42,38,0.525,80,46,34,0.575,22,20,23,23,214.36,200.8,207.58
2018-04-08,1610612766,1610612754,2017,117.0,123.0,240.0,99.45,97.7,92.05,92.25,80,35,45,0.438,80,47,33,0.588,21,14,27,20,194.96,187.28,191.12
2018-04-08,1610612755,1610612742,2017,109.0,97.0,206.0,97.85,106.0,104.45,102.7,79,49,30,0.62,80,24,56,0.3,28,21,15,9,207.68,213.0,210.34
2018-04-08,1610612738,1610612737,2017,106.0,112.0,218.0,99.65,105.5,96.35,95.7,79,54,25,0.684,80,23,57,0.28800000000000003,26,28,16,7,195.08,199.44,197.26
2018-04-08,1610612763,1610612765,2017,130.0,117.0,247.0,98.25,97.5,100.85,105.95,79,21,58,0.266,79,38,41,0.481,15,6,25,13,193.96,206.0,199.98000000000002
2018-04-08,1610612761,1610612753,2017,112.0,101.0,213.0,100.6,99.2,96.55,103.5,79,57,22,0.722,79,24,55,0.304,33,24,16,8,206.0,203.64,204.82
2018-04-08,1610612747,1610612762,2017,97.0,112.0,209.0,107.3,114.65,95.55,106.55,79,34,45,0.43,79,46,33,0.5820000000000001,20,14,27,19,219.28,200.2,209.74
2018-04-08,1610612756,1610612744,2017,100.0,117.0,217.0,106.25,103.85,107.5,105.85,80,20,60,0.25,80,57,23,0.713,10,10,29,28,212.88,199.04,205.95999999999998
2018-04-07,1610612746,1610612743,2017,115.0,134.0,249.0,109.85,106.5,109.2,110.3,79,42,37,0.532,79,44,35,0.557,22,20,30,14,214.36,217.04,215.7
2018-04-07,1610612752,1610612749,2017,102.0,115.0,217.0,101.2,97.2,99.8,108.15,79,28,51,0.354,79,42,37,0.532,19,9,24,18,200.28,200.48,200.38
2018-04-07,1610612741,1610612751,2017,96.0,124.0,220.0,94.0,91.0,96.7,98.4,79,27,52,0.342,79,26,53,0.329,17,10,14,12,185.44,196.96,191.2
2018-04-07,1610612745,1610612760,2017,102.0,108.0,210.0,112.7,109.85,101.8,103.4,79,64,15,0.81,79,45,34,0.57,34,30,26,19,216.24,210.36,213.3
2018-04-07,1610612744,1610612740,2017,120.0,126.0,246.0,107.5,105.85,100.45,104.8,79,57,22,0.722,79,45,34,0.57,29,28,23,22,199.04,200.8,199.92000000000002
2018-04-07,1610612759,1610612757,2017,116.0,105.0,221.0,107.75,96.55,104.75,105.45,79,45,34,0.57,79,48,31,0.608,31,14,27,21,204.12,209.44,206.78
2018-04-06,1610612765,1610612742,2017,113.0,106.0,219.0,100.85,105.95,104.45,102.7,78,37,41,0.474,79,24,55,0.304,24,13,15,9,206.0,213.0,209.5
2018-04-06,1610612753,1610612766,2017,100.0,137.0,237.0,96.55,103.5,99.45,97.7,78,24,54,0.308,79,34,45,0.43,16,8,21,13,203.64,194.96,199.3
2018-04-06,1610612755,1610612739,2017,132.0,130.0,262.0,97.85,106.0,101.9,101.55,78,48,30,0.615,79,49,30,0.62,27,21,29,20,207.68,195.48,201.57999999999998
2018-04-06,1610612764,1610612737,2017,97.0,103.0,200.0,94.7,91.35,96.35,95.7,79,42,37,0.532,79,22,57,0.278,22,20,16,6,193.0,199.44,196.22
2018-04-06,1610612738,1610612741,2017,111.0,104.0,215.0,99.65,105.5,94.0,91.0,78,53,25,0.679,78,27,51,0.34600000000000003,25,28,17,10,195.08,185.44,190.26
2018-04-06,1610612752,1610612748,2017,122.0,98.0,220.0,101.2,97.2,97.25,95.5,78,27,51,0.34600000000000003,79,43,36,0.544,18,9,25,18,200.28,195.0,197.64
2018-04-06,1610612761,1610612754,2017,92.0,73.0,165.0,100.6,99.2,92.05,92.25,78,56,22,0.718,79,47,32,0.595,32,24,27,20,206.0,187.28,196.64
2018-04-06,1610612763,1610612758,2017,93.0,94.0,187.0,98.25,97.5,97.75,101.5,78,21,57,0.269,79,25,54,0.316,15,6,13,12,193.96,207.08,200.52
2018-04-06,1610612756,1610612740,2017,103.0,122.0,225.0,106.25,103.85,100.45,104.8,79,20,59,0.253,78,44,34,0.564,10,10,23,21,212.88,200.8,206.84
2018-04-06,1610612747,1610612750,2017,96.0,113.0,209.0,107.3,114.65,110.05,111.2,78,34,44,0.436,79,44,35,0.557,20,14,28,16,219.28,209.4,214.34
2018-04-05,1610612754,1610612744,2017,126.0,106.0,232.0,92.05,92.25,107.5,105.85,78,46,32,0.59,78,57,21,0.731,26,20,29,28,187.28,199.04,193.16
2018-04-05,1610612739,1610612764,2017,119.0,115.0,234.0,101.9,101.55,94.7,91.35,78,48,30,0.615,78,42,36,0.5379999999999999,28,20,22,20,195.48,193.0,194.24
2018-04-05,1610612745,1610612757,2017,96.0,94.0,190.0,112.7,109.85,104.75,105.45,78,63,15,0.8079999999999999,78,48,30,0.615,33,30,27,21,216.24,209.44,212.84
2018-04-05,1610612749,1610612751,2017,111.0,119.0,230.0,99.8,108.15,96.7,98.4,78,42,36,0.5379999999999999,78,25,53,0.321,24,18,14,11,200.48,196.96,198.72
2018-04-05,1610612762,1610612746,2017,117.0,95.0,212.0,95.55,106.55,109.85,106.5,78,45,33,0.5770000000000001,78,42,36,0.5379999999999999,26,19,22,20,200.2,214.36,207.28
2018-04-05,1610612743,1610612750,2017,100.0,96.0,196.0,109.2,110.3,110.05,111.2,78,43,35,0.551,78,44,34,0.564,29,14,28,16,217.04,209.4,213.22
2018-04-04,1610612765,1610612755,2017,108.0,115.0,223.0,100.85,105.95,97.85,106.0,77,37,40,0.481,77,47,30,0.61,24,13,27,20,206.0,207.68,206.84
2018-04-04,1610612753,1610612742,2017,105.0,100.0,205.0,96.55,103.5,104.45,102.7,77,23,54,0.299,78,24,54,0.308,15,8,15,9,203.64,213.0,208.32
2018-04-04,1610612737,1610612748,2017,86.0,115.0,201.0,96.35,95.7,97.25,95.5,78,22,56,0.282,78,42,36,0.5379999999999999,16,6,25,17,199.44,195.0,197.22
2018-04-04,1610612761,1610612738,2017,96.0,78.0,174.0,100.6,99.2,99.65,105.5,77,55,22,0.7140000000000001,77,53,24,0.688,31,24,25,28,206.0,195.08,200.54000000000002
2018-04-04,1610612740,1610612763,2017,123.0,95.0,218.0,100.45,104.8,98.25,97.5,77,43,34,0.5579999999999999,77,21,56,0.273,22,21,15,6,200.8,193.96,197.38
2018-04-04,1610612747,1610612759,2017,122.0,112.0,234.0,107.3,114.65,107.75,96.55,77,33,44,0.429,78,45,33,0.5770000000000001,19,14,31,14,219.28,204.12,211.7
2018-04-03,1610612739,1610612761,2017,112.0,106.0,218.0,101.9,101.55,100.6,99.2,77,47,30,0.61,76,55,21,0.7240000000000001,27,20,31,24,195.48,206.0,200.74
2018-04-03,1610612755,1610612751,2017,121.0,95.0,216.0,97.85,106.0,96.7,98.4,76,46,30,0.605,77,25,52,0.325,26,20,14,11,207.68,196.96,202.32
2018-04-03,1610612748,1610612737,2017,101.0,98.0,199.0,97.25,95.5,96.35,95.7,77,41,36,0.532,77,22,55,0.28600000000000003,24,17,16,6,195.0,199.44,197.22
2018-04-03,1610612752,1610612753,2017,73.0,97.0,170.0,101.2,97.2,96.55,103.5,77,27,50,0.35100000000000003,76,22,54,0.289,18,9,15,7,200.28,203.64,201.95999999999998
2018-04-03,1610612741,1610612766,2017,120.0,114.0,234.0,94.0,91.0,99.45,97.7,77,26,51,0.338,78,34,44,0.436,16,10,21,13,185.44,194.96,190.2
2018-04-03,1610612745,1610612764,2017,120.0,104.0,224.0,112.7,109.85,94.7,91.35,77,62,15,0.805,77,42,35,0.545,32,30,22,20,216.24,193.0,204.62
2018-04-03,1610612749,1610612738,2017,106.0,102.0,208.0,99.8,108.15,99.65,105.5,77,41,36,0.532,76,53,23,0.6970000000000001,23,18,25,28,200.48,195.08,197.78
2018-04-03,1610612760,1610612744,2017,107.0,111.0,218.0,101.8,103.4,107.5,105.85,78,45,33,0.5770000000000001,77,56,21,0.727,26,19,29,27,210.36,199.04,204.7
2018-04-03,1610612742,1610612757,2017,115.0,109.0,224.0,104.45,102.7,104.75,105.45,77,23,54,0.299,77,48,29,0.623,14,9,27,21,213.0,209.44,211.22
2018-04-03,1610612743,1610612754,2017,107.0,104.0,211.0,109.2,110.3,92.05,92.25,77,42,35,0.545,77,46,31,0.597,28,14,26,20,217.04,187.28,202.16
2018-04-03,1610612762,1610612747,2017,117.0,110.0,227.0,95.55,106.55,107.3,114.65,77,44,33,0.5710000000000001,76,33,43,0.434,25,19,19,14,200.2,219.28,209.74
2018-04-03,1610612756,1610612758,2017,97.0,94.0,191.0,106.25,103.85,97.75,101.5,78,19,59,0.244,78,25,53,0.321,9,10,13,12,212.88,207.08,209.98000000000002
2018-04-03,1610612746,1610612759,2017,113.0,110.0,223.0,109.85,106.5,107.75,96.55,77,41,36,0.532,77,45,32,0.584,21,20,31,14,214.36,204.12,209.24
2018-04-01,1610612766,1610612755,2017,102.0,119.0,221.0,99.45,97.7,97.85,106.0,77,34,43,0.442,75,45,30,0.6,21,13,26,19,194.96,207.68,201.32
2018-04-01,1610612741,1610612764,2017,113.0,94.0,207.0,94.0,91.0,94.7,91.35,76,25,51,0.329,76,42,34,0.5529999999999999,15,10,22,20,185.44,193.0,189.22
2018-04-01,1610612759,1610612745,2017,100.0,83.0,183.0,107.75,96.55,112.7,109.85,76,44,32,0.579,76,62,14,0.816,30,14,32,30,204.12,216.24,210.18
2018-04-01,1610612746,1610612754,2017,104.0,111.0,215.0,109.85,106.5,92.05,92.25,76,41,35,0.539,76,45,31,0.5920000000000001,21,20,26,19,214.36,187.28,200.82
2018-04-01,1610612737,1610612753,2017,94.0,88.0,182.0,96.35,95.7,96.55,103.5,76,21,55,0.276,75,22,53,0.293,15,6,15,7,199.44,203.64,201.54
2018-04-01,1610612751,1610612765,2017,96.0,108.0,204.0,96.7,98.4,100.85,105.95,76,25,51,0.329,76,36,40,0.474,14,11,24,12,196.96,206.0,201.48000000000002
2018-04-01,1610612739,1610612742,2017,98.0,87.0,185.0,101.9,101.55,104.45,102.7,76,46,30,0.605,76,23,53,0.303,26,20,14,9,195.48,213.0,204.24
2018-04-01,1610612740,1610612760,2017,104.0,109.0,213.0,100.45,104.8,101.8,103.4,76,43,33,0.5660000000000001,77,44,33,0.5710000000000001,22,21,26,18,200.8,210.36,205.58
2018-04-01,1610612750,1610612762,2017,97.0,121.0,218.0,110.05,111.2,95.55,106.55,77,44,33,0.5710000000000001,76,43,33,0.5660000000000001,28,16,25,18,209.4,200.2,204.8
2018-04-01,1610612743,1610612749,2017,128.0,125.0,253.0,109.2,110.3,99.8,108.15,76,41,35,0.539,76,41,35,0.539,27,14,23,18,217.04,200.48,208.76
2018-04-01,1610612744,1610612756,2017,117.0,107.0,224.0,107.5,105.85,106.25,103.85,76,55,21,0.7240000000000001,77,19,58,0.247,28,27,9,10,199.04,212.88,205.95999999999998
2018-04-01,1610612757,1610612763,2017,113.0,98.0,211.0,104.75,105.45,98.25,97.5,76,47,29,0.618,76,21,55,0.276,26,21,15,6,209.44,193.96,201.7
2018-04-01,1610612747,1610612758,2017,83.0,84.0,167.0,107.3,114.65,97.75,101.5,75,33,42,0.44,77,24,53,0.312,19,14,13,11,219.28,207.08,213.18
2018-03-31,1610612764,1610612766,2017,107.0,93.0,200.0,94.7,91.35,99.45,97.7,75,41,34,0.547,76,34,42,0.447,21,20,21,13,193.0,194.96,193.98000000000002
2018-03-31,1610612752,1610612765,2017,109.0,115.0,224.0,101.2,97.2,100.85,105.95,76,27,49,0.355,75,35,40,0.467,18,9,24,11,200.28,206.0,203.14
2018-03-31,1610612738,1610612761,2017,110.0,99.0,209.0,99.65,105.5,100.6,99.2,75,52,23,0.693,75,55,20,0.733,24,28,31,24,195.08,206.0,200.54000000000002
2018-03-31,1610612748,1610612751,2017,109.0,110.0,219.0,97.25,95.5,96.7,98.4,76,41,35,0.539,75,24,51,0.32,24,17,14,10,195.0,196.96,195.98000000000002
2018-03-31,1610612758,1610612744,2017,96.0,112.0,208.0,97.75,101.5,107.5,105.85,76,24,52,0.316,75,54,21,0.72,13,11,28,26,207.08,199.04,203.06
2018-03-30,1610612753,1610612741,2017,82.0,90.0,172.0,96.55,103.5,94.0,91.0,74,22,52,0.297,75,24,51,0.32,15,7,15,9,203.64,185.44,194.54
2018-03-30,1610612737,1610612755,2017,91.0,101.0,192.0,96.35,95.7,97.85,106.0,75,21,54,0.28,74,44,30,0.595,15,6,26,18,199.44,207.68,203.56
2018-03-30,1610612739,1610612740,2017,107.0,102.0,209.0,101.9,101.55,100.45,104.8,75,45,30,0.6,75,43,32,0.573,25,20,22,21,195.48,200.8,198.14
2018-03-30,1610612745,1610612756,2017,104.0,103.0,207.0,112.7,109.85,106.25,103.85,75,61,14,0.813,76,19,57,0.25,31,30,9,10,216.24,212.88,214.56
2018-03-30,1610612760,1610612743,2017,125.0,126.0,251.0,101.8,103.4,109.2,110.3,76,44,32,0.579,75,40,35,0.5329999999999999,26,18,27,13,210.36,217.04,213.7
2018-03-30,1610612742,1610612750,2017,92.0,93.0,185.0,104.45,102.7,110.05,111.2,75,23,52,0.307,76,43,33,0.5660000000000001,14,9,28,15,213.0,209.4,211.2
2018-03-30,1610612762,1610612763,2017,107.0,97.0,204.0,95.55,106.55,98.25,97.5,75,42,33,0.56,75,21,54,0.28,24,18,15,6,200.2,193.96,197.07999999999998
2018-03-30,1610612747,1610612749,2017,122.0,124.0,246.0,107.3,114.65,99.8,108.15,74,33,41,0.446,75,40,35,0.5329999999999999,19,14,23,17,219.28,200.48,209.88
2018-03-30,1610612757,1610612746,2017,105.0,96.0,201.0,104.75,105.45,109.85,106.5,75,46,29,0.613,75,41,34,0.547,25,21,21,20,209.44,214.36,211.9
2018-03-29,1610612765,1610612764,2017,103.0,92.0,195.0,100.85,105.95,94.7,91.35,74,34,40,0.459,74,41,33,0.5539999999999999,23,11,21,20,206.0,193.0,199.5
2018-03-29,1610612748,1610612741,2017,103.0,92.0,195.0,97.25,95.5,94.0,91.0,75,40,35,0.5329999999999999,74,24,50,0.324,23,17,15,9,195.0,185.44,190.22
2018-03-29,1610612759,1610612760,2017,103.0,99.0,202.0,107.75,96.55,101.8,103.4,75,43,32,0.573,75,44,31,0.5870000000000001,29,14,26,18,204.12,210.36,207.24
2018-03-29,1610612758,1610612754,2017,103.0,106.0,209.0,97.75,101.5,92.05,92.25,75,24,51,0.32,75,44,31,0.5870000000000001,13,11,26,18,207.08,187.28,197.18
2018-03-29,1610612744,1610612749,2017,107.0,116.0,223.0,107.5,105.85,99.8,108.15,74,54,20,0.73,74,39,35,0.527,28,26,23,16,199.04,200.48,199.76
2018-03-28,1610612766,1610612739,2017,105.0,118.0,223.0,99.45,97.7,101.9,101.55,75,34,41,0.453,74,44,30,0.595,21,13,25,19,194.96,195.48,195.22
2018-03-28,1610612753,1610612751,2017,104.0,111.0,215.0,96.55,103.5,96.7,98.4,73,22,51,0.301,74,23,51,0.311,15,7,14,9,203.64,196.96,200.3
2018-03-28,1610612755,1610612752,2017,118.0,101.0,219.0,97.85,106.0,101.2,97.2,73,43,30,0.589,75,27,48,0.36,25,18,18,9,207.68,200.28,203.98000000000002
2018-03-28,1610612763,1610612757,2017,108.0,103.0,211.0,98.25,97.5,104.75,105.45,74,20,54,0.27,74,46,28,0.622,14,6,25,21,193.96,209.44,201.7
2018-03-28,1610612750,1610612737,2017,126.0,114.0,240.0,110.05,111.2,96.35,95.7,75,42,33,0.56,74,21,53,0.284,27,15,15,6,209.4,199.44,204.42000000000002
2018-03-28,1610612762,1610612738,2017,94.0,97.0,191.0,95.55,106.55,99.65,105.5,74,42,32,0.568,74,51,23,0.6890000000000001,24,18,24,27,200.2,195.08,197.64
2018-03-28,1610612756,1610612746,2017,99.0,111.0,210.0,106.25,103.85,109.85,106.5,75,19,56,0.253,74,40,34,0.541,9,10,21,19,212.88,214.36,213.62
2018-03-28,1610612747,1610612742,2017,103.0,93.0,196.0,107.3,114.65,104.45,102.7,73,32,41,0.438,74,23,51,0.311,18,14,14,9,219.28,213.0,216.14
2018-03-27,1610612764,1610612759,2017,116.0,106.0,222.0,94.7,91.35,107.75,96.55,73,40,33,0.5479999999999999,74,43,31,0.581,20,20,29,14,193.0,204.12,198.56
2018-03-27,1610612761,1610612743,2017,114.0,110.0,224.0,100.6,99.2,109.2,110.3,74,54,20,0.73,74,40,34,0.541,30,24,27,13,206.0,217.04,211.51999999999998
2018-03-27,1610612748,1610612739,2017,98.0,79.0,177.0,97.25,95.5,101.9,101.55,74,39,35,0.527,73,44,29,0.603,22,17,25,19,195.0,195.48,195.24
2018-03-27,1610612745,1610612741,2017,118.0,86.0,204.0,112.7,109.85,94.0,91.0,74,60,14,0.8109999999999999,73,24,49,0.329,30,30,15,9,216.24,185.44,200.84
2018-03-27,1610612740,1610612757,2017,103.0,107.0,210.0,100.45,104.8,104.75,105.45,74,43,31,0.581,73,45,28,0.616,22,21,25,20,200.8,209.44,205.12
2018-03-27,1610612758,1610612742,2017,97.0,103.0,200.0,97.75,101.5,104.45,102.7,74,24,50,0.324,73,22,51,0.301,13,11,14,8,207.08,213.0,210.04000000000002
2018-03-27,1610612744,1610612754,2017,81.0,92.0,173.0,107.5,105.85,92.05,92.25,73,54,19,0.74,74,43,31,0.581,28,26,26,17,199.04,187.28,193.16
2018-03-27,1610612746,1610612749,2017,105.0,98.0,203.0,109.85,106.5,99.8,108.15,73,39,34,0.534,73,39,34,0.534,20,19,23,16,214.36,200.48,207.42000000000002
2018-03-26,1610612766,1610612752,2017,137.0,128.0,265.0,99.45,97.7,101.2,97.2,74,33,41,0.446,74,27,47,0.365,20,13,18,9,194.96,200.28,197.62
2018-03-26,1610612765,1610612747,2017,112.0,106.0,218.0,100.85,105.95,107.3,114.65,73,33,40,0.452,72,32,40,0.444,22,11,18,14,206.0,219.28,212.64
2018-03-26,1610612755,1610612743,2017,123.0,104.0,227.0,97.85,106.0,109.2,110.3,72,42,30,0.583,73,40,33,0.5479999999999999,24,18,27,13,207.68,217.04,212.36
2018-03-26,1610612750,1610612763,2017,93.0,101.0,194.0,110.05,111.2,98.25,97.5,74,42,32,0.568,73,19,54,0.26,27,15,14,5,209.4,193.96,201.68
2018-03-26,1610612756,1610612738,2017,94.0,102.0,196.0,106.25,103.85,99.65,105.5,74,19,55,0.257,73,50,23,0.685,9,10,24,26,212.88,195.08,203.98000000000002
2018-03-25,1610612751,1610612739,2017,114.0,121.0,235.0,96.7,98.4,101.9,101.55,73,23,50,0.315,72,43,29,0.597,14,9,25,18,196.96,195.48,196.22
2018-03-25,1610612749,1610612759,2017,106.0,103.0,209.0,99.8,108.15,107.75,96.55,72,38,34,0.528,73,43,30,0.589,22,16,29,14,200.48,204.12,202.3
2018-03-25,1610612754,1610612748,2017,113.0,107.0,220.0,92.05,92.25,97.25,95.5,73,42,31,0.575,73,39,34,0.534,25,17,22,17,187.28,195.0,191.14
2018-03-25,1610612761,1610612746,2017,106.0,117.0,223.0,100.6,99.2,109.85,106.5,73,54,19,0.74,72,38,34,0.528,30,24,20,18,206.0,214.36,210.18
2018-03-25,1610612764,1610612752,2017,97.0,101.0,198.0,94.7,91.35,101.2,97.2,72,40,32,0.556,73,26,47,0.35600000000000004,20,20,18,8,193.0,200.28,196.64
2018-03-25,1610612758,1610612738,2017,93.0,104.0,197.0,97.75,101.5,99.65,105.5,73,24,49,0.329,72,49,23,0.6809999999999999,13,11,24,25,207.08,195.08,201.08
2018-03-25,1610612760,1610612757,2017,105.0,108.0,213.0,101.8,103.4,104.75,105.45,74,44,30,0.595,72,44,28,0.611,26,18,25,19,210.36,209.44,209.9
2018-03-25,1610612745,1610612737,2017,118.0,99.0,217.0,112.7,109.85,96.35,95.7,73,59,14,0.8079999999999999,73,21,52,0.28800000000000003,29,30,15,6,216.24,199.44,207.84
2018-03-25,1610612744,1610612762,2017,91.0,110.0,201.0,107.5,105.85,95.55,106.55,72,54,18,0.75,73,41,32,0.562,28,26,24,17,199.04,200.2,199.62
2018-03-24,1610612755,1610612750,2017,120.0,108.0,228.0,97.85,106.0,110.05,111.2,71,41,30,0.5770000000000001,73,42,31,0.575,23,18,27,15,207.68,209.4,208.54000000000002
2018-03-24,1610612765,1610612741,2017,117.0,95.0,212.0,100.85,105.95,94.0,91.0,72,32,40,0.444,72,24,48,0.333,21,11,15,9,206.0,185.44,195.72
2018-03-24,1610612753,1610612756,2017,105.0,99.0,204.0,96.55,103.5,106.25,103.85,72,21,51,0.292,73,19,54,0.26,14,7,9,10,203.64,212.88,208.26
2018-03-24,1610612745,1610612740,2017,114.0,91.0,205.0,112.7,109.85,100.45,104.8,72,58,14,0.8059999999999999,73,43,30,0.589,28,30,22,21,216.24,200.8,208.52
2018-03-24,1610612763,1610612747,2017,93.0,100.0,193.0,98.25,97.5,107.3,114.65,72,19,53,0.264,71,31,40,0.4370000000000001,14,5,18,13,193.96,219.28,206.62
2018-03-24,1610612742,1610612766,2017,98.0,102.0,200.0,104.45,102.7,99.45,97.7,72,22,50,0.306,73,32,41,0.438,14,8,20,12,213.0,194.96,203.98000000000002
2018-03-23,1610612754,1610612746,2017,109.0,104.0,213.0,92.05,92.25,109.85,106.5,72,41,31,0.569,71,38,33,0.535,24,17,20,18,187.28,214.36,200.82
2018-03-23,1610612764,1610612743,2017,100.0,108.0,208.0,94.7,91.35,109.2,110.3,71,40,31,0.563,72,39,33,0.542,20,20,27,12,193.0,217.04,205.01999999999998
2018-03-23,1610612739,1610612756,2017,120.0,95.0,215.0,101.9,101.55,106.25,103.85,71,42,29,0.5920000000000001,72,19,53,0.264,24,18,9,10,195.48,212.88,204.18
2018-03-23,1610612752,1610612750,2017,104.0,108.0,212.0,101.2,97.2,110.05,111.2,72,26,46,0.361,72,41,31,0.569,18,8,27,14,200.28,209.4,204.84
2018-03-23,1610612761,1610612751,2017,116.0,112.0,228.0,100.6,99.2,96.7,98.4,72,53,19,0.736,72,23,49,0.319,29,24,14,9,206.0,196.96,201.48000000000002
2018-03-23,1610612741,1610612749,2017,105.0,118.0,223.0,94.0,91.0,99.8,108.15,71,24,47,0.338,71,37,34,0.521,15,9,22,15,185.44,200.48,192.95999999999998
2018-03-23,1610612760,1610612748,2017,105.0,99.0,204.0,101.8,103.4,97.25,95.5,73,43,30,0.589,72,39,33,0.542,25,18,22,17,210.36,195.0,202.68
2018-03-23,1610612759,1610612762,2017,124.0,120.0,244.0,107.75,96.55,95.55,106.55,72,42,30,0.583,72,41,31,0.569,28,14,24,17,204.12,200.2,202.16
2018-03-23,1610612757,1610612738,2017,100.0,105.0,205.0,104.75,105.45,99.65,105.5,71,44,27,0.62,71,48,23,0.6759999999999999,25,19,24,24,209.44,195.08,202.26
2018-03-23,1610612744,1610612737,2017,106.0,94.0,200.0,107.5,105.85,96.35,95.7,71,53,18,0.746,72,21,51,0.292,27,26,15,6,199.04,199.44,199.24
2018-03-22,1610612766,1610612763,2017,140.0,79.0,219.0,99.45,97.7,98.25,97.5,72,31,41,0.431,71,19,52,0.268,19,12,14,5,194.96,193.96,194.46
2018-03-22,1610612753,1610612755,2017,98.0,118.0,216.0,96.55,103.5,97.85,106.0,71,21,50,0.29600000000000004,70,40,30,0.5710000000000001,14,7,23,17,203.64,207.68,205.66
2018-03-22,1610612745,1610612765,2017,100.0,96.0,196.0,112.7,109.85,100.85,105.95,71,57,14,0.8029999999999999,71,32,39,0.451,27,30,21,11,216.24,206.0,211.12
2018-03-22,1610612740,1610612747,2017,128.0,125.0,253.0,100.45,104.8,107.3,114.65,72,42,30,0.583,70,31,39,0.443,21,21,18,13,200.8,219.28,210.04000000000002
2018-03-22,1610612742,1610612762,2017,112.0,119.0,231.0,104.45,102.7,95.55,106.55,71,22,49,0.31,71,40,31,0.563,14,8,24,16,213.0,200.2,206.6
2018-03-22,1610612758,1610612737,2017,105.0,90.0,195.0,97.75,101.5,96.35,95.7,72,23,49,0.319,71,21,50,0.29600000000000004,12,11,15,6,207.08,199.44,203.26
2018-03-21,1610612739,1610612761,2017,132.0,129.0,261.0,101.9,101.55,100.6,99.2,70,41,29,0.586,71,53,18,0.746,23,18,29,24,195.48,206.0,200.74
2018-03-21,1610612755,1610612763,2017,119.0,105.0,224.0,97.85,106.0,98.25,97.5,69,39,30,0.565,70,19,51,0.271,22,17,14,5,207.68,193.96,200.82
2018-03-21,1610612751,1610612766,2017,105.0,111.0,216.0,96.7,98.4,99.45,97.7,71,23,48,0.324,71,30,41,0.423,14,9,19,11,196.96,194.96,195.96
2018-03-21,1610612748,1610612752,2017,119.0,98.0,217.0,97.25,95.5,101.2,97.2,71,38,33,0.535,71,26,45,0.366,21,17,18,8,195.0,200.28,197.64
2018-03-21,1610612740,1610612754,2017,96.0,92.0,188.0,100.45,104.8,92.05,92.25,71,41,30,0.5770000000000001,71,41,30,0.5770000000000001,20,21,24,17,200.8,187.28,194.04000000000002
2018-03-21,1610612741,1610612743,2017,102.0,135.0,237.0,94.0,91.0,109.2,110.3,70,24,46,0.343,71,38,33,0.535,15,9,27,11,185.44,217.04,201.24
2018-03-21,1610612749,1610612746,2017,120.0,127.0,247.0,99.8,108.15,109.85,106.5,70,37,33,0.529,70,37,33,0.529,22,15,20,17,200.48,214.36,207.42000000000002
2018-03-21,1610612759,1610612764,2017,98.0,90.0,188.0,107.75,96.55,94.7,91.35,71,41,30,0.5770000000000001,70,40,30,0.5710000000000001,27,14,20,20,204.12,193.0,198.56
2018-03-20,1610612753,1610612761,2017,86.0,93.0,179.0,96.55,103.5,100.6,99.2,70,21,49,0.3,70,52,18,0.743,14,7,29,23,203.64,206.0,204.82
2018-03-20,1610612738,1610612760,2017,100.0,99.0,199.0,99.65,105.5,101.8,103.4,70,47,23,0.6709999999999999,72,43,29,0.597,23,24,25,18,195.08,210.36,202.72000000000003
2018-03-20,1610612750,1610612746,2017,123.0,109.0,232.0,110.05,111.2,109.85,106.5,71,40,31,0.563,69,37,32,0.536,26,14,20,17,209.4,214.36,211.88
2018-03-20,1610612740,1610612742,2017,115.0,105.0,220.0,100.45,104.8,104.45,102.7,70,40,30,0.5710000000000001,70,22,48,0.314,19,21,14,8,200.8,213.0,206.9
2018-03-20,1610612762,1610612737,2017,94.0,99.0,193.0,95.55,106.55,96.35,95.7,70,40,30,0.5710000000000001,70,20,50,0.28600000000000003,24,16,15,5,200.2,199.44,199.82
2018-03-20,1610612756,1610612765,2017,88.0,115.0,203.0,106.25,103.85,100.85,105.95,71,19,52,0.268,70,31,39,0.443,9,10,21,10,212.88,206.0,209.44
2018-03-20,1610612757,1610612745,2017,111.0,115.0,226.0,104.75,105.45,112.7,109.85,70,44,26,0.629,70,56,14,0.8,25,19,27,29,209.44,216.24,212.84
2018-03-19,1610612739,1610612749,2017,124.0,117.0,241.0,101.9,101.55,99.8,108.15,69,40,29,0.58,69,37,32,0.536,22,18,22,15,195.48,200.48,197.98
2018-03-19,1610612754,1610612747,2017,110.0,100.0,210.0,92.05,92.25,107.3,114.65,70,40,30,0.5710000000000001,69,31,38,0.449,23,17,18,13,187.28,219.28,203.28
2018-03-19,1610612755,1610612766,2017,108.0,94.0,202.0,97.85,106.0,99.45,97.7,68,38,30,0.5589999999999999,70,30,40,0.429,21,17,19,11,207.68,194.96,201.32
2018-03-19,1610612751,1610612763,2017,118.0,115.0,233.0,96.7,98.4,98.25,97.5,70,22,48,0.314,69,19,50,0.275,13,9,14,5,196.96,193.96,195.46
2018-03-19,1610612748,1610612743,2017,149.0,141.0,290.0,97.25,95.5,109.2,110.3,70,37,33,0.529,70,38,32,0.5429999999999999,20,17,27,11,195.0,217.04,206.01999999999998
2018-03-19,1610612752,1610612741,2017,110.0,92.0,202.0,101.2,97.2,94.0,91.0,70,25,45,0.35700000000000004,69,24,45,0.348,17,8,15,9,200.28,185.44,192.86
2018-03-19,1610612759,1610612744,2017,89.0,75.0,164.0,107.75,96.55,107.5,105.85,70,40,30,0.5710000000000001,70,53,17,0.757,26,14,27,26,204.12,199.04,201.57999999999998
2018-03-19,1610612758,1610612765,2017,90.0,106.0,196.0,97.75,101.5,100.85,105.95,71,23,48,0.324,69,30,39,0.435,12,11,21,9,207.08,206.0,206.54000000000002
2018-03-18,1610612761,1610612760,2017,125.0,132.0,257.0,100.6,99.2,101.8,103.4,69,52,17,0.754,71,42,29,0.5920000000000001,29,23,25,17,206.0,210.36,208.18
2018-03-18,1610612740,1610612738,2017,108.0,89.0,197.0,100.45,104.8,99.65,105.5,69,39,30,0.565,69,47,22,0.6809999999999999,18,21,23,24,200.8,195.08,197.94
2018-03-18,1610612750,1610612745,2017,120.0,129.0,249.0,110.05,111.2,112.7,109.85,70,40,30,0.5710000000000001,69,55,14,0.797,26,14,27,28,209.4,216.24,212.82
2018-03-18,1610612746,1610612757,2017,109.0,122.0,231.0,109.85,106.5,104.75,105.45,68,37,31,0.544,69,43,26,0.623,20,17,25,18,214.36,209.44,211.9
2018-03-17,1610612749,1610612737,2017,122.0,117.0,239.0,99.8,108.15,96.35,95.7,68,36,32,0.529,69,20,49,0.29,21,15,15,5,200.48,199.44,199.95999999999998
2018-03-17,1610612764,1610612754,2017,109.0,102.0,211.0,94.7,91.35,92.05,92.25,69,39,30,0.565,69,40,29,0.58,19,20,23,17,193.0,187.28,190.14
2018-03-17,1610612740,1610612745,2017,101.0,107.0,208.0,100.45,104.8,112.7,109.85,68,39,29,0.574,68,54,14,0.794,18,21,27,27,200.8,216.24,208.52
2018-03-17,1610612751,1610612742,2017,114.0,106.0,220.0,96.7,98.4,104.45,102.7,69,21,48,0.304,69,22,47,0.319,12,9,14,8,196.96,213.0,204.98000000000002
2018-03-17,1610612752,1610612766,2017,124.0,101.0,225.0,101.2,97.2,99.45,97.7,69,24,45,0.348,69,30,39,0.435,16,8,19,11,200.28,194.96,197.62
2018-03-17,1610612741,1610612739,2017,109.0,114.0,223.0,94.0,91.0,101.9,101.55,68,24,44,0.353,68,39,29,0.574,15,9,22,17,185.44,195.48,190.45999999999998
2018-03-17,1610612763,1610612743,2017,101.0,94.0,195.0,98.25,97.5,109.2,110.3,68,18,50,0.265,69,38,31,0.551,13,5,27,11,193.96,217.04,205.5
2018-03-17,1610612759,1610612750,2017,117.0,101.0,218.0,107.75,96.55,110.05,111.2,69,39,30,0.565,69,40,29,0.58,25,14,26,14,204.12,209.4,206.76
2018-03-17,1610612762,1610612758,2017,103.0,97.0,200.0,95.55,106.55,97.75,101.5,69,39,30,0.565,70,23,47,0.329,23,16,12,11,200.2,207.08,203.64
2018-03-17,1610612756,1610612744,2017,109.0,124.0,233.0,106.25,103.85,107.5,105.85,70,19,51,0.271,69,52,17,0.754,9,10,27,25,212.88,199.04,205.95999999999998
2018-03-17,1610612757,1610612765,2017,100.0,87.0,187.0,104.75,105.45,100.85,105.95,68,42,26,0.618,68,30,38,0.441,24,18,21,9,209.44,206.0,207.72
2018-03-16,1610612753,1610612738,2017,83.0,92.0,175.0,96.55,103.5,99.65,105.5,69,21,48,0.304,68,46,22,0.6759999999999999,14,7,23,23,203.64,195.08,199.36
2018-03-16,1610612755,1610612751,2017,120.0,116.0,236.0,97.85,106.0,96.7,98.4,67,37,30,0.552,68,21,47,0.309,20,17,12,9,207.68,196.96,202.32
2018-03-16,1610612761,1610612742,2017,122.0,115.0,237.0,100.6,99.2,104.45,102.7,68,51,17,0.75,68,22,46,0.324,28,23,14,8,206.0,213.0,209.5
2018-03-16,1610612760,1610612746,2017,121.0,113.0,234.0,101.8,103.4,109.85,106.5,70,41,29,0.586,67,37,30,0.552,24,17,20,17,210.36,214.36,212.36
2018-03-16,1610612744,1610612758,2017,93.0,98.0,191.0,107.5,105.85,97.75,101.5,68,52,16,0.765,69,22,47,0.319,27,25,12,10,199.04,207.08,203.06
2018-03-16,1610612747,1610612748,2017,91.0,92.0,183.0,107.3,114.65,97.25,95.5,68,31,37,0.456,69,36,33,0.522,18,13,20,16,219.28,195.0,207.14
2018-03-15,1610612754,1610612761,2017,99.0,106.0,205.0,92.05,92.25,100.6,99.2,68,40,28,0.588,67,50,17,0.746,23,17,28,22,187.28,206.0,196.64
2018-03-15,1610612737,1610612766,2017,117.0,129.0,246.0,96.35,95.7,99.45,97.7,68,20,48,0.294,68,29,39,0.426,15,5,19,10,199.44,194.96,197.2
2018-03-15,1610612752,1610612755,2017,110.0,118.0,228.0,101.2,97.2,97.85,106.0,68,24,44,0.353,66,36,30,0.545,16,8,20,16,200.28,207.68,203.98000000000002
2018-03-15,1610612745,1610612746,2017,101.0,96.0,197.0,112.7,109.85,109.85,106.5,67,53,14,0.7909999999999999,66,37,29,0.561,26,27,20,17,216.24,214.36,215.3
2018-03-15,1610612763,1610612741,2017,110.0,111.0,221.0,98.25,97.5,94.0,91.0,67,18,49,0.269,67,23,44,0.343,13,5,15,8,193.96,185.44,189.7
2018-03-15,1610612759,1610612740,2017,98.0,93.0,191.0,107.75,96.55,100.45,104.8,68,38,30,0.5589999999999999,67,39,28,0.5820000000000001,24,14,18,21,204.12,200.8,202.46
2018-03-15,1610612743,1610612765,2017,120.0,113.0,233.0,109.2,110.3,100.85,105.95,68,37,31,0.544,67,30,37,0.448,26,11,21,9,217.04,206.0,211.51999999999998
2018-03-15,1610612762,1610612756,2017,116.0,88.0,204.0,95.55,106.55,106.25,103.85,68,38,30,0.5589999999999999,69,19,50,0.275,22,16,9,10,200.2,212.88,206.54
2018-03-15,1610612757,1610612739,2017,113.0,105.0,218.0,104.75,105.45,101.9,101.55,67,41,26,0.612,67,39,28,0.5820000000000001,23,18,22,17,209.44,195.48,202.45999999999998
2018-03-14,1610612753,1610612749,2017,126.0,117.0,243.0,96.55,103.5,99.8,108.15,68,20,48,0.294,67,36,31,0.537,13,7,21,15,203.64,200.48,202.06
2018-03-14,1610612738,1610612764,2017,124.0,125.0,249.0,99.65,105.5,94.7,91.35,67,46,21,0.687,68,38,30,0.5589999999999999,23,23,19,19,195.08,193.0,194.04000000000002
2018-03-14,1610612758,1610612748,2017,123.0,119.0,242.0,97.75,101.5,97.25,95.5,68,21,47,0.309,68,36,32,0.529,11,10,20,16,207.08,195.0,201.04000000000002
2018-03-14,1610612744,1610612747,2017,117.0,106.0,223.0,107.5,105.85,107.3,114.65,67,51,16,0.7609999999999999,67,31,36,0.463,26,25,18,13,199.04,219.28,209.16
2018-03-13,1610612755,1610612754,2017,98.0,101.0,199.0,97.85,106.0,92.05,92.25,65,36,29,0.5539999999999999,67,39,28,0.5820000000000001,20,16,23,16,207.68,187.28,197.48000000000002
2018-03-13,1610612764,1610612750,2017,111.0,116.0,227.0,94.7,91.35,110.05,111.2,67,38,29,0.5670000000000001,68,39,29,0.574,19,19,26,13,193.0,209.4,201.2
2018-03-13,1610612737,1610612760,2017,107.0,119.0,226.0,96.35,95.7,101.8,103.4,67,20,47,0.299,69,40,29,0.58,15,5,24,16,199.44,210.36,204.9
2018-03-13,1610612751,1610612761,2017,102.0,116.0,218.0,96.7,98.4,100.6,99.2,67,21,46,0.313,66,49,17,0.742,12,9,28,21,196.96,206.0,201.48000000000002
2018-03-13,1610612752,1610612742,2017,97.0,110.0,207.0,101.2,97.2,104.45,102.7,67,24,43,0.358,67,21,46,0.313,16,8,14,7,200.28,213.0,206.64
2018-03-13,1610612741,1610612746,2017,106.0,112.0,218.0,94.0,91.0,109.85,106.5,66,23,43,0.348,65,36,29,0.5539999999999999,15,8,20,16,185.44,214.36,199.9
2018-03-13,1610612740,1610612766,2017,119.0,115.0,234.0,100.45,104.8,99.45,97.7,66,38,28,0.5760000000000001,67,29,38,0.433,17,21,19,10,200.8,194.96,197.88
2018-03-13,1610612759,1610612753,2017,108.0,72.0,180.0,107.75,96.55,96.55,103.5,67,37,30,0.552,67,20,47,0.299,23,14,13,7,204.12,203.64,203.88
2018-03-13,1610612762,1610612765,2017,110.0,79.0,189.0,95.55,106.55,100.85,105.95,67,37,30,0.552,66,30,36,0.455,21,16,21,9,200.2,206.0,203.1
2018-03-13,1610612756,1610612739,2017,107.0,129.0,236.0,106.25,103.85,101.9,101.55,68,19,49,0.279,66,38,28,0.5760000000000001,9,10,22,16,212.88,195.48,204.18
2018-03-13,1610612747,1610612743,2017,112.0,103.0,215.0,107.3,114.65,109.2,110.3,66,30,36,0.455,67,37,30,0.552,17,13,26,11,219.28,217.04,218.16
2018-03-12,1610612745,1610612759,2017,109.0,93.0,202.0,112.7,109.85,107.75,96.55,66,52,14,0.7879999999999999,66,37,29,0.561,25,27,23,14,216.24,204.12,210.18
2018-03-12,1610612763,1610612749,2017,103.0,121.0,224.0,98.25,97.5,99.8,108.15,66,18,48,0.273,66,35,31,0.53,13,5,21,14,193.96,200.48,197.22
2018-03-12,1610612760,1610612758,2017,106.0,101.0,207.0,101.8,103.4,97.75,101.5,68,39,29,0.574,67,21,46,0.313,23,16,11,10,210.36,207.08,208.72000000000003
2018-03-12,1610612757,1610612748,2017,115.0,99.0,214.0,104.75,105.45,97.25,95.5,66,40,26,0.606,67,36,31,0.537,22,18,20,16,209.44,195.0,202.22
2018-03-11,1610612752,1610612761,2017,106.0,132.0,238.0,101.2,97.2,100.6,99.2,66,24,42,0.364,65,48,17,0.738,16,8,28,20,200.28,206.0,203.14
2018-03-11,1610612737,1610612741,2017,122.0,129.0,251.0,96.35,95.7,94.0,91.0,66,20,46,0.303,65,22,43,0.338,15,5,15,7,199.44,185.44,192.44
2018-03-11,1610612750,1610612744,2017,109.0,103.0,212.0,110.05,111.2,107.5,105.85,67,38,29,0.5670000000000001,66,51,15,0.773,25,13,26,25,209.4,199.04,204.22
2018-03-11,1610612740,1610612762,2017,99.0,116.0,215.0,100.45,104.8,95.55,106.55,65,38,27,0.585,66,36,30,0.545,17,21,21,15,200.8,200.2,200.5
2018-03-11,1610612743,1610612758,2017,130.0,104.0,234.0,109.2,110.3,97.75,101.5,66,36,30,0.545,66,21,45,0.318,25,11,11,10,217.04,207.08,212.06
2018-03-11,1610612742,1610612745,2017,82.0,105.0,187.0,104.45,102.7,112.7,109.85,66,21,45,0.318,65,51,14,0.785,14,7,25,26,213.0,216.24,214.62
2018-03-11,1610612738,1610612754,2017,97.0,99.0,196.0,99.65,105.5,92.05,92.25,66,46,20,0.6970000000000001,66,38,28,0.5760000000000001,23,23,23,15,195.08,187.28,191.18
2018-03-11,1610612751,1610612755,2017,97.0,120.0,217.0,96.7,98.4,97.85,106.0,66,21,45,0.318,64,35,29,0.547,12,9,20,15,196.96,207.68,202.32
2018-03-11,1610612747,1610612739,2017,127.0,113.0,240.0,107.3,114.65,101.9,101.55,65,29,36,0.446,65,38,27,0.585,16,13,22,16,219.28,195.48,207.38
2018-03-10,1610612766,1610612756,2017,122.0,115.0,237.0,99.45,97.7,106.25,103.85,66,28,38,0.424,67,19,48,0.284,18,10,9,10,194.96,212.88,203.92000000000002
2018-03-10,1610612748,1610612764,2017,129.0,102.0,231.0,97.25,95.5,94.7,91.35,66,35,31,0.53,66,38,28,0.5760000000000001,19,16,19,19,195.0,193.0,194.0
2018-03-10,1610612742,1610612763,2017,114.0,80.0,194.0,104.45,102.7,98.25,97.5,65,20,45,0.308,65,18,47,0.277,13,7,13,5,213.0,193.96,203.48000000000002
2018-03-10,1610612760,1610612759,2017,104.0,94.0,198.0,101.8,103.4,107.75,96.55,67,38,29,0.5670000000000001,65,37,28,0.569,22,16,23,14,210.36,204.12,207.24
2018-03-10,1610612746,1610612753,2017,113.0,105.0,218.0,109.85,106.5,96.55,103.5,64,35,29,0.547,66,20,46,0.303,19,16,13,7,214.36,203.64,209.0
2018-03-09,1610612765,1610612741,2017,99.0,83.0,182.0,100.85,105.95,94.0,91.0,65,29,36,0.446,64,22,42,0.344,20,9,15,7,206.0,185.44,195.72
2018-03-09,1610612754,1610612737,2017,112.0,87.0,199.0,92.05,92.25,96.35,95.7,65,37,28,0.569,65,20,45,0.308,22,15,15,5,187.28,199.44,193.36
2018-03-09,1610612761,1610612745,2017,108.0,105.0,213.0,100.6,99.2,112.7,109.85,64,47,17,0.7340000000000001,64,51,13,0.797,27,20,25,26,206.0,216.24,211.12
2018-03-09,1610612763,1610612762,2017,78.0,95.0,173.0,98.25,97.5,95.55,106.55,64,18,46,0.281,65,35,30,0.5379999999999999,13,5,21,14,193.96,200.2,197.07999999999998
2018-03-09,1610612749,1610612752,2017,120.0,112.0,232.0,99.8,108.15,101.2,97.2,65,34,31,0.523,65,24,41,0.369,20,14,16,8,200.48,200.28,200.38
2018-03-09,1610612740,1610612764,2017,97.0,116.0,213.0,100.45,104.8,94.7,91.35,64,38,26,0.594,65,37,28,0.569,17,21,19,18,200.8,193.0,196.9
2018-03-09,1610612743,1610612747,2017,125.0,116.0,241.0,109.2,110.3,107.3,114.65,65,35,30,0.5379999999999999,64,29,35,0.453,24,11,16,13,217.04,219.28,218.16
2018-03-09,1610612757,1610612744,2017,125.0,108.0,233.0,104.75,105.45,107.5,105.85,65,39,26,0.6,65,51,14,0.785,21,18,26,25,209.44,199.04,204.24
2018-03-09,1610612758,1610612753,2017,94.0,88.0,182.0,97.75,101.5,96.55,103.5,65,20,45,0.308,65,20,45,0.308,10,10,13,7,207.08,203.64,205.36
2018-03-09,1610612746,1610612739,2017,116.0,102.0,218.0,109.85,106.5,101.9,101.55,63,34,29,0.54,64,38,26,0.594,18,16,22,16,214.36,195.48,204.92000000000002
2018-03-08,1610612766,1610612751,2017,111.0,125.0,236.0,99.45,97.7,96.7,98.4,65,28,37,0.431,65,20,45,0.308,18,10,12,8,194.96,196.96,195.96
2018-03-08,1610612748,1610612755,2017,108.0,99.0,207.0,97.25,95.5,97.85,106.0,65,34,31,0.523,63,35,28,0.556,18,16,20,15,195.0,207.68,201.34
2018-03-08,1610612750,1610612738,2017,109.0,117.0,226.0,110.05,111.2,99.65,105.5,66,38,28,0.5760000000000001,65,45,20,0.6920000000000001,25,13,23,22,209.4,195.08,202.24
2018-03-08,1610612760,1610612756,2017,115.0,87.0,202.0,101.8,103.4,106.25,103.85,66,37,29,0.561,66,19,47,0.28800000000000003,21,16,9,10,210.36,212.88,211.62
2018-03-08,1610612744,1610612759,2017,110.0,107.0,217.0,107.5,105.85,107.75,96.55,64,50,14,0.7809999999999999,64,37,27,0.578,25,25,23,14,199.04,204.12,201.57999999999998
2018-03-07,1610612754,1610612762,2017,84.0,104.0,188.0,92.05,92.25,95.55,106.55,64,37,27,0.578,64,34,30,0.531,22,15,21,13,187.28,200.2,193.74
2018-03-07,1610612765,1610612761,2017,119.0,121.0,240.0,100.85,105.95,100.6,99.2,64,29,35,0.453,63,46,17,0.73,20,9,27,19,206.0,206.0,206.0
2018-03-07,1610612741,1610612763,2017,119.0,110.0,229.0,94.0,91.0,98.25,97.5,63,21,42,0.333,63,18,45,0.28600000000000003,14,7,13,5,185.44,193.96,189.7
2018-03-07,1610612749,1610612745,2017,99.0,110.0,209.0,99.8,108.15,112.7,109.85,64,34,30,0.531,63,50,13,0.794,20,14,25,25,200.48,216.24,208.36
2018-03-07,1610612758,1610612740,2017,101.0,114.0,215.0,97.75,101.5,100.45,104.8,64,20,44,0.313,63,37,26,0.5870000000000001,10,10,17,20,207.08,200.8,203.94
2018-03-07,1610612743,1610612739,2017,108.0,113.0,221.0,109.2,110.3,101.9,101.55,64,35,29,0.547,63,37,26,0.5870000000000001,24,11,22,15,217.04,195.48,206.26
2018-03-07,1610612747,1610612753,2017,108.0,107.0,215.0,107.3,114.65,96.55,103.5,63,28,35,0.444,64,20,44,0.313,15,13,13,7,219.28,203.64,211.45999999999998
2018-03-06,1610612766,1610612755,2017,114.0,128.0,242.0,99.45,97.7,97.85,106.0,64,28,36,0.438,62,34,28,0.5479999999999999,18,10,20,14,194.96,207.68,201.32
2018-03-06,1610612761,1610612737,2017,106.0,90.0,196.0,100.6,99.2,96.35,95.7,62,45,17,0.726,64,20,44,0.313,26,19,15,5,206.0,199.44,202.72
2018-03-06,1610612764,1610612748,2017,117.0,113.0,230.0,94.7,91.35,97.25,95.5,64,36,28,0.563,64,34,30,0.531,18,18,18,16,193.0,195.0,194.0
2018-03-06,1610612760,1610612745,2017,112.0,122.0,234.0,101.8,103.4,112.7,109.85,65,37,28,0.569,62,49,13,0.79,21,16,25,24,210.36,216.24,213.3
2018-03-06,1610612742,1610612743,2017,118.0,107.0,225.0,104.45,102.7,109.2,110.3,64,19,45,0.297,63,35,28,0.556,12,7,24,11,213.0,217.04,215.01999999999998
2018-03-06,1610612757,1610612752,2017,111.0,87.0,198.0,104.75,105.45,101.2,97.2,64,38,26,0.594,64,24,40,0.375,20,18,16,8,209.44,200.28,204.86
2018-03-06,1610612744,1610612751,2017,114.0,101.0,215.0,107.5,105.85,96.7,98.4,63,49,14,0.778,64,20,44,0.313,24,25,12,8,199.04,196.96,198.0
2018-03-06,1610612746,1610612740,2017,116.0,121.0,237.0,109.85,106.5,100.45,104.8,62,34,28,0.5479999999999999,62,36,26,0.581,18,16,17,19,214.36,200.8,207.58
2018-03-05,1610612739,1610612765,2017,112.0,90.0,202.0,101.9,101.55,100.85,105.95,62,36,26,0.581,63,29,34,0.46,21,15,20,9,195.48,206.0,200.74
2018-03-05,1610612754,1610612749,2017,92.0,89.0,181.0,92.05,92.25,99.8,108.15,63,36,27,0.5710000000000001,63,34,29,0.54,21,15,20,14,187.28,200.48,193.88
2018-03-05,1610612748,1610612756,2017,125.0,103.0,228.0,97.25,95.5,106.25,103.85,63,33,30,0.524,65,19,46,0.292,17,16,9,10,195.0,212.88,203.94
2018-03-05,1610612741,1610612738,2017,89.0,105.0,194.0,94.0,91.0,99.65,105.5,62,21,41,0.339,64,44,20,0.688,14,7,23,21,185.44,195.08,190.26
2018-03-05,1610612759,1610612763,2017,100.0,98.0,198.0,107.75,96.55,98.25,97.5,63,36,27,0.5710000000000001,62,18,44,0.29,22,14,13,5,204.12,193.96,199.04000000000002
2018-03-05,1610612762,1610612753,2017,94.0,80.0,174.0,95.55,106.55,96.55,103.5,63,33,30,0.524,63,20,43,0.317,20,13,13,7,200.2,203.64,201.92
2018-03-05,1610612747,1610612757,2017,103.0,108.0,211.0,107.3,114.65,104.75,105.45,62,28,34,0.452,63,37,26,0.5870000000000001,15,13,20,17,219.28,209.44,214.36
2018-03-04,1610612737,1610612756,2017,113.0,112.0,225.0,96.35,95.7,106.25,103.85,63,19,44,0.302,64,19,45,0.297,14,5,9,10,199.44,212.88,206.16
2018-03-04,1610612761,1610612766,2017,103.0,98.0,201.0,100.6,99.2,99.45,97.7,61,44,17,0.721,63,28,35,0.444,25,19,18,10,206.0,194.96,200.48000000000002
2018-03-04,1610612764,1610612754,2017,95.0,98.0,193.0,94.7,91.35,92.05,92.25,63,36,27,0.5710000000000001,62,35,27,0.565,18,18,21,14,193.0,187.28,190.14
2018-03-04,1610612742,1610612740,2017,109.0,126.0,235.0,104.45,102.7,100.45,104.8,63,19,44,0.302,61,35,26,0.574,12,7,17,18,213.0,200.8,206.9
2018-03-04,1610612749,1610612755,2017,118.0,110.0,228.0,99.8,108.15,97.85,106.0,62,33,29,0.532,61,34,27,0.557,19,14,20,14,200.48,207.68,204.07999999999998
2018-03-04,1610612746,1610612751,2017,123.0,120.0,243.0,109.85,106.5,96.7,98.4,61,33,28,0.541,63,20,43,0.317,17,16,12,8,214.36,196.96,205.66000000000003
2018-03-04,1610612758,1610612752,2017,102.0,99.0,201.0,97.75,101.5,101.2,97.2,63,19,44,0.302,63,24,39,0.381,9,10,16,8,207.08,200.28,203.68
2018-03-03,1610612753,1610612763,2017,107.0,100.0,207.0,96.55,103.5,98.25,97.5,62,19,43,0.306,61,18,43,0.295,12,7,13,5,203.64,193.96,198.8
2018-03-03,1610612739,1610612743,2017,117.0,126.0,243.0,101.9,101.55,109.2,110.3,61,36,25,0.59,62,34,28,0.5479999999999999,21,15,24,10,195.48,217.04,206.26
2018-03-03,1610612748,1610612765,2017,105.0,96.0,201.0,97.25,95.5,100.85,105.95,62,32,30,0.516,62,29,33,0.468,16,16,20,9,195.0,206.0,200.5
2018-03-03,1610612745,1610612738,2017,123.0,120.0,243.0,112.7,109.85,99.65,105.5,61,48,13,0.787,63,44,19,0.698,24,24,23,21,216.24,195.08,205.66000000000003
2018-03-03,1610612759,1610612747,2017,112.0,116.0,228.0,107.75,96.55,107.3,114.65,62,36,26,0.581,61,27,34,0.443,22,14,15,12,204.12,219.28,211.7
2018-03-03,1610612757,1610612760,2017,108.0,100.0,208.0,104.75,105.45,101.8,103.4,62,36,26,0.581,64,37,27,0.578,19,17,21,16,209.44,210.36,209.9
2018-03-03,1610612758,1610612762,2017,91.0,98.0,189.0,97.75,101.5,95.55,106.55,62,19,43,0.306,62,32,30,0.516,9,10,20,12,207.08,200.2,203.64
2018-03-02,1610612753,1610612765,2017,115.0,106.0,221.0,96.55,103.5,100.85,105.95,61,18,43,0.295,61,29,32,0.475,11,7,20,9,203.64,206.0,204.82
2018-03-02,1610612755,1610612766,2017,110.0,99.0,209.0,97.85,106.0,99.45,97.7,60,33,27,0.55,62,28,34,0.452,19,14,18,10,207.68,194.96,201.32
2018-03-02,1610612737,1610612744,2017,109.0,114.0,223.0,96.35,95.7,107.5,105.85,62,19,43,0.306,62,48,14,0.774,14,5,24,24,199.44,199.04,199.24
2018-03-02,1610612764,1610612761,2017,95.0,102.0,197.0,94.7,91.35,100.6,99.2,62,36,26,0.581,60,43,17,0.7170000000000001,18,18,25,18,193.0,206.0,199.5
2018-03-02,1610612741,1610612742,2017,108.0,100.0,208.0,94.0,91.0,104.45,102.7,61,20,41,0.328,62,19,43,0.306,13,7,12,7,185.44,213.0,199.22
2018-03-02,1610612763,1610612743,2017,102.0,108.0,210.0,98.25,97.5,109.2,110.3,60,18,42,0.3,61,33,28,0.541,13,5,24,9,193.96,217.04,205.5
2018-03-02,1610612749,1610612754,2017,96.0,103.0,199.0,99.8,108.15,92.05,92.25,61,33,28,0.541,61,34,27,0.557,19,14,21,13,200.48,187.28,193.88
2018-03-02,1610612756,1610612760,2017,116.0,124.0,240.0,106.25,103.85,101.8,103.4,63,19,44,0.302,63,36,27,0.5710000000000001,9,10,21,15,212.88,210.36,211.62
2018-03-02,1610612762,1610612750,2017,116.0,108.0,224.0,95.55,106.55,110.05,111.2,61,31,30,0.508,65,38,27,0.585,19,12,25,13,200.2,209.4,204.8
2018-03-02,1610612746,1610612752,2017,128.0,105.0,233.0,109.85,106.5,101.2,97.2,60,32,28,0.5329999999999999,62,24,38,0.387,16,16,16,8,214.36,200.28,207.32
2018-03-01,1610612748,1610612747,2017,113.0,131.0,244.0,97.25,95.5,107.3,114.65,61,32,29,0.525,60,26,34,0.433,16,16,15,11,195.0,219.28,207.14
2018-03-01,1610612739,1610612755,2017,97.0,108.0,205.0,101.9,101.55,97.85,106.0,60,36,24,0.6,59,32,27,0.542,21,15,19,13,195.48,207.68,201.57999999999998
2018-03-01,1610612758,1610612751,2017,116.0,111.0,227.0,97.75,101.5,96.7,98.4,61,18,43,0.295,62,20,42,0.32299999999999995,8,10,12,8,207.08,196.96,202.02
2018-03-01,1610612757,1610612750,2017,108.0,99.0,207.0,104.75,105.45,110.05,111.2,61,35,26,0.574,64,38,26,0.594,18,17,25,13,209.44,209.4,209.42000000000002
2018-02-28,1610612765,1610612749,2017,110.0,87.0,197.0,100.85,105.95,99.8,108.15,60,28,32,0.467,60,33,27,0.55,19,9,19,14,206.0,200.48,203.24
2018-02-28,1610612753,1610612761,2017,104.0,117.0,221.0,96.55,103.5,100.6,99.2,60,18,42,0.3,59,42,17,0.7120000000000001,11,7,25,17,203.64,206.0,204.82
2018-02-28,1610612737,1610612754,2017,107.0,102.0,209.0,96.35,95.7,92.05,92.25,61,18,43,0.295,60,34,26,0.5670000000000001,13,5,21,13,199.44,187.28,193.36
2018-02-28,1610612738,1610612766,2017,134.0,106.0,240.0,99.65,105.5,99.45,97.7,62,43,19,0.6940000000000001,61,28,33,0.459,22,21,18,10,195.08,194.96,195.02
2018-02-28,1610612764,1610612744,2017,101.0,109.0,210.0,94.7,91.35,107.5,105.85,61,36,25,0.59,61,47,14,0.77,18,18,24,23,193.0,199.04,196.01999999999998
2018-02-28,1610612763,1610612756,2017,102.0,110.0,212.0,98.25,97.5,106.25,103.85,59,18,41,0.305,62,18,44,0.29,13,5,9,9,193.96,212.88,203.42000000000002
2018-02-28,1610612742,1610612760,2017,110.0,111.0,221.0,104.45,102.7,101.8,103.4,61,19,42,0.311,62,35,27,0.565,12,7,21,14,213.0,210.36,211.68
2018-02-28,1610612759,1610612740,2017,116.0,121.0,237.0,107.75,96.55,100.45,104.8,61,36,25,0.59,60,34,26,0.5670000000000001,22,14,17,17,204.12,200.8,202.46
2018-02-28,1610612746,1610612745,2017,92.0,105.0,197.0,109.85,106.5,112.7,109.85,59,32,27,0.542,60,47,13,0.7829999999999999,16,16,24,23,214.36,216.24,215.3
2018-02-27,1610612766,1610612741,2017,118.0,103.0,221.0,99.45,97.7,94.0,91.0,60,27,33,0.45,60,20,40,0.333,17,10,13,7,194.96,185.44,190.2
2018-02-27,1610612739,1610612751,2017,129.0,123.0,252.0,101.9,101.55,96.7,98.4,59,35,24,0.593,61,20,41,0.328,20,15,12,8,195.48,196.96,196.22
2018-02-27,1610612748,1610612755,2017,102.0,101.0,203.0,97.25,95.5,97.85,106.0,60,31,29,0.517,58,32,26,0.552,15,16,19,13,195.0,207.68,201.34
2018-02-27,1610612749,1610612764,2017,104.0,107.0,211.0,99.8,108.15,94.7,91.35,59,33,26,0.5589999999999999,60,35,25,0.583,19,14,18,17,200.48,193.0,196.74
2018-02-27,1610612757,1610612758,2017,116.0,99.0,215.0,104.75,105.45,97.75,101.5,60,34,26,0.5670000000000001,60,18,42,0.3,17,17,8,10,209.44,207.08,208.26
2018-02-27,1610612743,1610612746,2017,120.0,122.0,242.0,109.2,110.3,109.85,106.5,60,33,27,0.55,58,31,27,0.534,24,9,16,15,217.04,214.36,215.7
2018-02-26,1610612737,1610612747,2017,104.0,123.0,227.0,96.35,95.7,107.3,114.65,60,18,42,0.3,59,25,34,0.424,13,5,15,10,199.44,219.28,209.36
2018-02-26,1610612738,1610612763,2017,109.0,98.0,207.0,99.65,105.5,98.25,97.5,61,42,19,0.6890000000000001,58,18,40,0.31,21,21,13,5,195.08,193.96,194.52
2018-02-26,1610612751,1610612741,2017,104.0,87.0,191.0,96.7,98.4,94.0,91.0,60,19,41,0.317,59,20,39,0.339,11,8,13,7,196.96,185.44,191.2
2018-02-26,1610612752,1610612744,2017,111.0,125.0,236.0,101.2,97.2,107.5,105.85,61,24,37,0.393,60,46,14,0.767,16,8,24,22,200.28,199.04,199.66
2018-02-26,1610612761,1610612765,2017,123.0,94.0,217.0,100.6,99.2,100.85,105.95,58,41,17,0.7070000000000001,59,28,31,0.475,24,17,19,9,206.0,206.0,206.0
2018-02-26,1610612740,1610612756,2017,125.0,116.0,241.0,100.45,104.8,106.25,103.85,59,33,26,0.5589999999999999,61,18,43,0.295,16,17,9,9,200.8,212.88,206.84
2018-02-26,1610612760,1610612753,2017,112.0,105.0,217.0,101.8,103.4,96.55,103.5,61,34,27,0.557,59,18,41,0.305,20,14,11,7,210.36,203.64,207.0
2018-02-26,1610612742,1610612754,2017,109.0,103.0,212.0,104.45,102.7,92.05,92.25,60,18,42,0.3,59,34,25,0.5760000000000001,11,7,21,13,213.0,187.28,200.14
2018-02-26,1610612762,1610612745,2017,85.0,96.0,181.0,95.55,106.55,112.7,109.85,60,31,29,0.517,59,46,13,0.78,19,12,24,22,200.2,216.24,208.22
2018-02-26,1610612758,1610612750,2017,100.0,118.0,218.0,97.75,101.5,110.05,111.2,59,18,41,0.305,63,37,26,0.5870000000000001,8,10,25,12,207.08,209.4,208.24
2018-02-25,1610612766,1610612765,2017,114.0,98.0,212.0,99.45,97.7,100.85,105.95,59,26,33,0.441,58,28,30,0.483,16,10,19,9,194.96,206.0,200.48000000000002
2018-02-25,1610612749,1610612740,2017,121.0,123.0,244.0,99.8,108.15,100.45,104.8,58,33,25,0.569,58,32,26,0.552,19,14,16,16,200.48,200.8,200.64
2018-02-25,1610612739,1610612759,2017,94.0,110.0,204.0,101.9,101.55,107.75,96.55,58,35,23,0.603,60,35,25,0.583,20,15,22,13,195.48,204.12,199.8
2018-02-25,1610612764,1610612755,2017,109.0,94.0,203.0,94.7,91.35,97.85,106.0,59,34,25,0.5760000000000001,57,32,25,0.561,17,17,19,13,193.0,207.68,200.34
2018-02-25,1610612743,1610612745,2017,114.0,119.0,233.0,109.2,110.3,112.7,109.85,59,33,26,0.5589999999999999,58,45,13,0.7759999999999999,24,9,24,21,217.04,216.24,216.64
2018-02-24,1610612755,1610612753,2017,116.0,105.0,221.0,97.85,106.0,96.55,103.5,56,31,25,0.5539999999999999,58,18,40,0.31,18,13,11,7,207.68,203.64,205.66
2018-02-24,1610612748,1610612763,2017,115.0,89.0,204.0,97.25,95.5,98.25,97.5,59,30,29,0.508,57,18,39,0.316,14,16,13,5,195.0,193.96,194.48000000000002
2018-02-24,1610612752,1610612738,2017,112.0,121.0,233.0,101.2,97.2,99.65,105.5,60,24,36,0.4,60,41,19,0.6829999999999999,16,8,21,20,200.28,195.08,197.68
2018-02-24,1610612744,1610612760,2017,112.0,80.0,192.0,107.5,105.85,101.8,103.4,59,45,14,0.763,60,34,26,0.5670000000000001,23,22,20,14,199.04,210.36,204.7
2018-02-24,1610612750,1610612741,2017,122.0,104.0,226.0,110.05,111.2,94.0,91.0,62,36,26,0.581,58,20,38,0.345,24,12,13,7,209.4,185.44,197.42000000000002
2018-02-24,1610612756,1610612757,2017,104.0,106.0,210.0,106.25,103.85,104.75,105.45,60,18,42,0.3,59,33,26,0.5589999999999999,9,9,17,16,212.88,209.44,211.16
2018-02-24,1610612762,1610612742,2017,97.0,90.0,187.0,95.55,106.55,104.45,102.7,59,30,29,0.508,59,18,41,0.305,18,12,11,7,200.2,213.0,206.6
2018-02-24,1610612758,1610612747,2017,108.0,113.0,221.0,97.75,101.5,107.3,114.65,58,18,40,0.31,58,24,34,0.414,8,10,15,9,207.08,219.28,213.18
2018-02-23,1610612765,1610612738,2017,98.0,110.0,208.0,100.85,105.95,99.65,105.5,57,28,29,0.491,59,40,19,0.6779999999999999,19,9,21,19,206.0,195.08,200.54000000000002
2018-02-23,1610612754,1610612737,2017,116.0,93.0,209.0,92.05,92.25,96.35,95.7,58,33,25,0.569,59,18,41,0.305,20,13,13,5,187.28,199.44,193.36
2018-02-23,1610612764,1610612766,2017,105.0,122.0,227.0,94.7,91.35,99.45,97.7,58,34,24,0.586,58,25,33,0.431,17,17,16,9,193.0,194.96,193.98000000000002
2018-02-23,1610612761,1610612749,2017,119.0,122.0,241.0,100.6,99.2,99.8,108.15,57,41,16,0.7190000000000001,57,32,25,0.561,24,17,19,13,206.0,200.48,203.24
2018-02-23,1610612745,1610612750,2017,120.0,102.0,222.0,112.7,109.85,110.05,111.2,57,44,13,0.772,61,36,25,0.59,23,21,24,12,216.24,209.4,212.82
2018-02-23,1610612763,1610612739,2017,89.0,112.0,201.0,98.25,97.5,101.9,101.55,56,18,38,0.321,57,34,23,0.596,13,5,20,14,193.96,195.48,194.72
2018-02-23,1610612740,1610612748,2017,124.0,123.0,247.0,100.45,104.8,97.25,95.5,57,31,26,0.544,58,30,28,0.517,15,16,14,16,200.8,195.0,197.9
2018-02-23,1610612743,1610612759,2017,122.0,119.0,241.0,109.2,110.3,107.75,96.55,58,32,26,0.552,59,35,24,0.593,23,9,22,13,217.04,204.12,210.57999999999998
2018-02-23,1610612756,1610612746,2017,117.0,128.0,245.0,106.25,103.85,109.85,106.5,59,18,41,0.305,57,30,27,0.526,9,9,16,14,212.88,214.36,213.62
2018-02-23,1610612762,1610612757,2017,81.0,100.0,181.0,95.55,106.55,104.75,105.45,58,30,28,0.517,58,32,26,0.552,18,12,17,15,200.2,209.44,204.82
2018-02-23,1610612747,1610612742,2017,124.0,102.0,226.0,107.3,114.65,104.45,102.7,57,23,34,0.404,58,18,40,0.31,14,9,11,7,219.28,213.0,216.14
2018-02-22,1610612766,1610612751,2017,111.0,96.0,207.0,99.45,97.7,96.7,98.4,57,24,33,0.421,59,19,40,0.322,15,9,11,8,194.96,196.96,195.96
2018-02-22,1610612753,1610612752,2017,113.0,120.0,233.0,96.55,103.5,101.2,97.2,57,18,39,0.316,59,23,36,0.39,11,7,16,7,203.64,200.28,201.95999999999998
2018-02-22,1610612739,1610612764,2017,103.0,110.0,213.0,101.9,101.55,94.7,91.35,56,34,22,0.607,57,33,24,0.579,20,14,17,16,195.48,193.0,194.24
2018-02-22,1610612741,1610612755,2017,115.0,116.0,231.0,94.0,91.0,97.85,106.0,57,20,37,0.35100000000000003,55,30,25,0.545,13,7,18,12,185.44,207.68,196.56
2018-02-22,1610612758,1610612760,2017,107.0,110.0,217.0,97.75,101.5,101.8,103.4,57,18,39,0.316,59,33,26,0.5589999999999999,8,10,20,13,207.08,210.36,208.72000000000003
2018-02-22,1610612744,1610612746,2017,134.0,127.0,261.0,107.5,105.85,109.85,106.5,58,44,14,0.759,56,30,26,0.536,22,22,16,14,199.04,214.36,206.7
2018-02-15,1610612749,1610612743,2017,123.0,134.0,257.0,99.8,108.15,109.2,110.3,56,32,24,0.5710000000000001,57,31,26,0.544,19,13,23,8,200.48,217.04,208.76
2018-02-15,1610612750,1610612747,2017,119.0,111.0,230.0,110.05,111.2,107.3,114.65,60,35,25,0.583,56,23,33,0.411,23,12,14,9,209.4,219.28,214.34
2018-02-14,1610612765,1610612737,2017,104.0,98.0,202.0,100.85,105.95,96.35,95.7,56,27,29,0.482,58,18,40,0.31,18,9,13,5,206.0,199.44,202.72
2018-02-14,1610612753,1610612766,2017,102.0,104.0,206.0,96.55,103.5,99.45,97.7,56,18,38,0.321,56,23,33,0.411,11,7,15,8,203.64,194.96,199.3
2018-02-14,1610612755,1610612748,2017,104.0,102.0,206.0,97.85,106.0,97.25,95.5,54,29,25,0.537,57,30,27,0.526,17,12,14,16,207.68,195.0,201.34
2018-02-14,1610612751,1610612754,2017,103.0,108.0,211.0,96.7,98.4,92.05,92.25,58,19,39,0.328,57,32,25,0.561,11,8,20,12,196.96,187.28,192.12
2018-02-14,1610612752,1610612764,2017,113.0,118.0,231.0,101.2,97.2,94.7,91.35,58,23,35,0.397,56,32,24,0.5710000000000001,16,7,17,15,200.28,193.0,196.64
2018-02-14,1610612738,1610612746,2017,119.0,129.0,248.0,99.65,105.5,109.85,106.5,58,40,18,0.69,55,29,26,0.527,21,19,16,13,195.08,214.36,204.72000000000003
2018-02-14,1610612741,1610612761,2017,98.0,122.0,220.0,94.0,91.0,100.6,99.2,56,20,36,0.35700000000000004,56,40,16,0.7140000000000001,13,7,24,16,185.44,206.0,195.72
2018-02-14,1610612745,1610612758,2017,100.0,91.0,191.0,112.7,109.85,97.75,101.5,56,43,13,0.768,56,18,38,0.321,22,21,8,10,216.24,207.08,211.66000000000003
2018-02-14,1610612763,1610612760,2017,114.0,121.0,235.0,98.25,97.5,101.8,103.4,55,18,37,0.327,58,32,26,0.552,13,5,20,12,193.96,210.36,202.16000000000003
2018-02-14,1610612740,1610612747,2017,139.0,117.0,256.0,100.45,104.8,107.3,114.65,56,30,26,0.536,55,23,32,0.418,14,16,14,9,200.8,219.28,210.04000000000002
2018-02-14,1610612762,1610612756,2017,107.0,97.0,204.0,95.55,106.55,106.25,103.85,57,29,28,0.509,58,18,40,0.31,17,12,9,9,200.2,212.88,206.54
2018-02-14,1610612757,1610612744,2017,123.0,117.0,240.0,104.75,105.45,107.5,105.85,57,31,26,0.544,57,44,13,0.772,16,15,22,22,209.44,199.04,204.24
2018-02-13,1610612761,1610612748,2017,115.0,112.0,227.0,100.6,99.2,97.25,95.5,55,39,16,0.7090000000000001,56,30,26,0.536,23,16,14,16,206.0,195.0,200.5
2018-02-13,1610612749,1610612737,2017,97.0,92.0,189.0,99.8,108.15,96.35,95.7,55,31,24,0.564,57,18,39,0.316,18,13,13,5,200.48,199.44,199.95999999999998
2018-02-13,1610612750,1610612745,2017,108.0,126.0,234.0,110.05,111.2,112.7,109.85,59,35,24,0.593,55,42,13,0.764,23,12,22,20,209.4,216.24,212.82
2018-02-13,1610612760,1610612739,2017,112.0,120.0,232.0,101.8,103.4,101.9,101.55,57,32,25,0.561,55,33,22,0.6,20,12,20,13,210.36,195.48,202.92000000000002
2018-02-13,1610612742,1610612758,2017,109.0,114.0,223.0,104.45,102.7,97.75,101.5,57,18,39,0.316,55,17,38,0.309,11,7,8,9,213.0,207.08,210.04000000000002
2018-02-13,1610612743,1610612759,2017,117.0,109.0,226.0,109.2,110.3,107.75,96.55,56,30,26,0.536,58,35,23,0.603,22,8,22,13,217.04,204.12,210.57999999999998
2018-02-12,1610612765,1610612740,2017,103.0,118.0,221.0,100.85,105.95,100.45,104.8,55,27,28,0.491,55,29,26,0.527,18,9,14,15,206.0,200.8,203.4
2018-02-12,1610612755,1610612752,2017,108.0,92.0,200.0,97.85,106.0,101.2,97.2,53,28,25,0.528,57,23,34,0.404,16,12,16,7,207.68,200.28,203.98000000000002
2018-02-12,1610612751,1610612746,2017,101.0,114.0,215.0,96.7,98.4,109.85,106.5,57,19,38,0.333,54,28,26,0.519,11,8,16,12,196.96,214.36,205.66000000000003
2018-02-12,1610612741,1610612753,2017,105.0,101.0,206.0,94.0,91.0,96.55,103.5,55,19,36,0.345,55,18,37,0.327,12,7,11,7,185.44,203.64,194.54
2018-02-12,1610612762,1610612759,2017,101.0,99.0,200.0,95.55,106.55,107.75,96.55,56,28,28,0.5,57,35,22,0.614,16,12,22,13,200.2,204.12,202.16
2018-02-12,1610612744,1610612756,2017,129.0,83.0,212.0,107.5,105.85,106.25,103.85,56,43,13,0.768,57,18,39,0.316,21,22,9,9,199.04,212.88,205.95999999999998
2018-02-11,1610612766,1610612761,2017,103.0,123.0,226.0,99.45,97.7,100.6,99.2,55,23,32,0.418,54,38,16,0.7040000000000001,15,8,23,15,194.96,206.0,200.48000000000002
2018-02-11,1610612737,1610612765,2017,118.0,115.0,233.0,96.35,95.7,100.85,105.95,56,17,39,0.304,54,27,27,0.5,12,5,18,9,199.44,206.0,202.72
2018-02-11,1610612738,1610612739,2017,99.0,121.0,220.0,99.65,105.5,101.9,101.55,57,40,17,0.7020000000000001,54,32,22,0.593,21,19,20,12,195.08,195.48,195.28
2018-02-11,1610612754,1610612752,2017,121.0,113.0,234.0,92.05,92.25,101.2,97.2,56,31,25,0.5539999999999999,56,23,33,0.411,19,12,16,7,187.28,200.28,193.78
2018-02-11,1610612745,1610612742,2017,104.0,97.0,201.0,112.7,109.85,104.45,102.7,54,41,13,0.759,56,18,38,0.321,21,20,11,7,216.24,213.0,214.62
2018-02-11,1610612750,1610612758,2017,111.0,106.0,217.0,110.05,111.2,97.75,101.5,58,34,24,0.586,54,17,37,0.315,22,12,8,9,209.4,207.08,208.24
2018-02-11,1610612760,1610612763,2017,110.0,92.0,202.0,101.8,103.4,98.25,97.5,56,31,25,0.5539999999999999,54,18,36,0.333,19,12,13,5,210.36,193.96,202.16000000000003
2018-02-11,1610612757,1610612762,2017,96.0,115.0,211.0,104.75,105.45,95.55,106.55,56,31,25,0.5539999999999999,55,27,28,0.491,16,15,16,11,209.44,200.2,204.82
2018-02-10,1610612751,1610612740,2017,128.0,138.0,266.0,96.7,98.4,100.45,104.8,56,19,37,0.339,54,28,26,0.519,11,8,14,14,196.96,200.8,198.88
2018-02-10,1610612753,1610612749,2017,104.0,111.0,215.0,96.55,103.5,99.8,108.15,54,18,36,0.333,54,30,24,0.556,11,7,18,12,203.64,200.48,202.06
2018-02-10,1610612755,1610612746,2017,112.0,98.0,210.0,97.85,106.0,109.85,106.5,52,27,25,0.519,53,28,25,0.528,15,12,16,12,207.68,214.36,211.02
2018-02-10,1610612741,1610612764,2017,90.0,101.0,191.0,94.0,91.0,94.7,91.35,54,19,35,0.35200000000000004,55,31,24,0.564,12,7,17,14,185.44,193.0,189.22
2018-02-10,1610612742,1610612747,2017,130.0,123.0,253.0,104.45,102.7,107.3,114.65,55,17,38,0.309,54,23,31,0.426,10,7,14,9,213.0,219.28,216.14
2018-02-10,1610612744,1610612759,2017,122.0,105.0,227.0,107.5,105.85,107.75,96.55,55,42,13,0.764,56,35,21,0.625,20,22,22,13,199.04,204.12,201.57999999999998
2018-02-10,1610612756,1610612743,2017,113.0,123.0,236.0,106.25,103.85,109.2,110.3,56,18,38,0.321,55,29,26,0.527,9,9,22,7,212.88,217.04,214.95999999999998
2018-02-09,1610612765,1610612746,2017,95.0,108.0,203.0,100.85,105.95,109.85,106.5,53,27,26,0.509,52,27,25,0.519,18,9,16,11,206.0,214.36,210.18
2018-02-09,1610612755,1610612740,2017,100.0,82.0,182.0,97.85,106.0,100.45,104.8,51,26,25,0.51,53,28,25,0.528,14,12,14,14,207.68,200.8,204.24
2018-02-09,1610612737,1610612739,2017,107.0,123.0,230.0,96.35,95.7,101.9,101.55,55,17,38,0.309,53,31,22,0.585,12,5,20,11,199.44,195.48,197.45999999999998
2018-02-09,1610612738,1610612754,2017,91.0,97.0,188.0,99.65,105.5,92.05,92.25,56,40,16,0.7140000000000001,55,30,25,0.545,21,19,19,11,195.08,187.28,191.18
2018-02-09,1610612748,1610612749,2017,91.0,85.0,176.0,97.25,95.5,99.8,108.15,55,29,26,0.527,53,30,23,0.5660000000000001,13,16,18,12,195.0,200.48,197.74
2018-02-09,1610612745,1610612743,2017,130.0,104.0,234.0,112.7,109.85,109.2,110.3,53,40,13,0.755,54,29,25,0.537,20,20,22,7,216.24,217.04,216.64
2018-02-09,1610612762,1610612766,2017,106.0,94.0,200.0,95.55,106.55,99.45,97.7,54,26,28,0.481,54,23,31,0.426,15,11,15,8,200.2,194.96,197.57999999999998
2018-02-09,1610612741,1610612750,2017,114.0,113.0,227.0,94.0,91.0,110.05,111.2,53,18,35,0.34,57,34,23,0.596,11,7,22,12,185.44,209.4,197.42000000000002
2018-02-09,1610612758,1610612757,2017,100.0,118.0,218.0,97.75,101.5,104.75,105.45,53,17,36,0.321,55,30,25,0.545,8,9,16,14,207.08,209.44,208.26
2018-02-08,1610612753,1610612737,2017,100.0,98.0,198.0,96.55,103.5,96.35,95.7,53,17,36,0.321,54,17,37,0.315,10,7,12,5,203.64,199.44,201.54
2018-02-08,1610612761,1610612752,2017,113.0,88.0,201.0,100.6,99.2,101.2,97.2,53,37,16,0.698,55,23,32,0.418,22,15,16,7,206.0,200.28,203.14
2018-02-08,1610612764,1610612738,2017,104.0,110.0,214.0,94.7,91.35,99.65,105.5,54,31,23,0.574,55,39,16,0.7090000000000001,17,14,21,18,193.0,195.08,194.04000000000002
2018-02-08,1610612757,1610612766,2017,109.0,103.0,212.0,104.75,105.45,99.45,97.7,54,29,25,0.537,53,23,30,0.434,15,14,15,8,209.44,194.96,202.2
2018-02-08,1610612744,1610612742,2017,121.0,103.0,224.0,107.5,105.85,104.45,102.7,54,41,13,0.759,54,17,37,0.315,19,22,10,7,199.04,213.0,206.01999999999998
2018-02-08,1610612747,1610612760,2017,106.0,81.0,187.0,107.3,114.65,101.8,103.4,53,22,31,0.415,55,31,24,0.564,13,9,19,12,219.28,210.36,214.82
2018-02-07,1610612765,1610612751,2017,115.0,106.0,221.0,100.85,105.95,96.7,98.4,52,26,26,0.5,55,19,36,0.345,17,9,11,8,206.0,196.96,201.48000000000002
2018-02-07,1610612748,1610612745,2017,101.0,109.0,210.0,97.25,95.5,112.7,109.85,54,29,25,0.537,52,39,13,0.75,13,16,20,19,195.0,216.24,205.62
2018-02-07,1610612739,1610612750,2017,140.0,138.0,278.0,101.9,101.55,110.05,111.2,52,30,22,0.5770000000000001,56,34,22,0.607,19,11,22,12,195.48,209.4,202.44
2018-02-07,1610612763,1610612762,2017,88.0,92.0,180.0,98.25,97.5,95.55,106.55,53,18,35,0.34,53,25,28,0.472,13,5,15,10,193.96,200.2,197.07999999999998
2018-02-07,1610612756,1610612759,2017,81.0,129.0,210.0,106.25,103.85,107.75,96.55,55,18,37,0.327,55,34,21,0.618,9,9,22,12,212.88,204.12,208.5
2018-02-06,1610612753,1610612739,2017,116.0,98.0,214.0,96.55,103.5,101.9,101.55,52,16,36,0.308,51,30,21,0.588,9,7,19,11,203.64,195.48,199.56
2018-02-06,1610612761,1610612738,2017,111.0,91.0,202.0,100.6,99.2,99.65,105.5,52,36,16,0.6920000000000001,54,39,15,0.722,21,15,21,18,206.0,195.08,200.54000000000002
2018-02-06,1610612737,1610612763,2017,108.0,82.0,190.0,96.35,95.7,98.25,97.5,53,16,37,0.302,52,18,34,0.34600000000000003,11,5,13,5,199.44,193.96,196.7
2018-02-06,1610612751,1610612745,2017,113.0,123.0,236.0,96.7,98.4,112.7,109.85,54,19,35,0.35200000000000004,51,38,13,0.745,11,8,20,18,196.96,216.24,206.60000000000002
2018-02-06,1610612752,1610612749,2017,89.0,103.0,192.0,101.2,97.2,99.8,108.15,54,23,31,0.426,52,29,23,0.5579999999999999,16,7,18,11,200.28,200.48,200.38
2018-02-06,1610612755,1610612764,2017,115.0,102.0,217.0,97.85,106.0,94.7,91.35,50,25,25,0.5,53,31,22,0.585,13,12,17,14,207.68,193.0,200.34
2018-02-06,1610612744,1610612760,2017,105.0,125.0,230.0,107.5,105.85,101.8,103.4,53,41,12,0.774,54,30,24,0.556,19,22,19,11,199.04,210.36,204.7
2018-02-06,1610612747,1610612756,2017,112.0,93.0,205.0,107.3,114.65,106.25,103.85,52,21,31,0.404,54,18,36,0.333,12,9,9,9,219.28,212.88,216.07999999999998
2018-02-05,1610612765,1610612757,2017,111.0,91.0,202.0,100.85,105.95,104.75,105.45,51,25,26,0.49,53,29,24,0.547,16,9,15,14,206.0,209.44,207.72
2018-02-05,1610612754,1610612764,2017,102.0,111.0,213.0,92.05,92.25,94.7,91.35,54,30,24,0.556,52,30,22,0.5770000000000001,19,11,17,13,187.28,193.0,190.14
2018-02-05,1610612748,1610612753,2017,109.0,111.0,220.0,97.25,95.5,96.55,103.5,53,29,24,0.547,51,15,36,0.294,13,16,9,6,195.0,203.64,199.32
2018-02-05,1610612740,1610612762,2017,109.0,133.0,242.0,100.45,104.8,95.55,106.55,52,28,24,0.5379999999999999,52,24,28,0.462,14,14,15,9,200.8,200.2,200.5
2018-02-05,1610612743,1610612766,2017,121.0,104.0,225.0,109.2,110.3,99.45,97.7,53,28,25,0.528,52,23,29,0.442,21,7,15,8,217.04,194.96,206.0
2018-02-05,1610612758,1610612741,2017,104.0,98.0,202.0,97.75,101.5,94.0,91.0,52,16,36,0.308,52,18,34,0.34600000000000003,7,9,11,7,207.08,185.44,196.26
2018-02-05,1610612746,1610612742,2017,104.0,101.0,205.0,109.85,106.5,104.45,102.7,51,26,25,0.51,53,17,36,0.321,15,11,10,7,214.36,213.0,213.68
2018-02-04,1610612738,1610612757,2017,97.0,96.0,193.0,99.65,105.5,104.75,105.45,53,38,15,0.7170000000000001,52,29,23,0.5579999999999999,20,18,15,14,195.08,209.44,202.26
2018-02-04,1610612751,1610612749,2017,94.0,109.0,203.0,96.7,98.4,99.8,108.15,53,19,34,0.358,51,28,23,0.5489999999999999,11,8,18,10,196.96,200.48,198.72
2018-02-04,1610612752,1610612737,2017,96.0,99.0,195.0,101.2,97.2,96.35,95.7,53,23,30,0.434,52,15,37,0.28800000000000003,16,7,11,4,200.28,199.44,199.86
2018-02-04,1610612761,1610612763,2017,101.0,86.0,187.0,100.6,99.2,98.25,97.5,51,35,16,0.6859999999999999,51,18,33,0.353,20,15,13,5,206.0,193.96,199.98000000000002
2018-02-04,1610612760,1610612747,2017,104.0,108.0,212.0,101.8,103.4,107.3,114.65,53,30,23,0.5660000000000001,51,20,31,0.392,19,11,12,8,210.36,219.28,214.82
2018-02-04,1610612756,1610612766,2017,110.0,115.0,225.0,106.25,103.85,99.45,97.7,53,18,35,0.34,51,22,29,0.431,9,9,15,7,212.88,194.96,203.92000000000002
2018-02-03,1610612746,1610612741,2017,113.0,103.0,216.0,109.85,106.5,94.0,91.0,50,25,25,0.5,51,18,33,0.353,14,11,11,7,214.36,185.44,199.9
2018-02-03,1610612765,1610612748,2017,111.0,107.0,218.0,100.85,105.95,97.25,95.5,50,24,26,0.48,52,29,23,0.5579999999999999,15,9,13,16,206.0,195.0,200.5
2018-02-03,1610612754,1610612755,2017,100.0,92.0,192.0,92.05,92.25,97.85,106.0,53,29,24,0.547,49,25,24,0.51,18,11,13,12,187.28,207.68,197.48000000000002
2018-02-03,1610612753,1610612764,2017,98.0,115.0,213.0,96.55,103.5,94.7,91.35,50,15,35,0.3,51,29,22,0.569,9,6,17,12,203.64,193.0,198.32
2018-02-03,1610612739,1610612745,2017,88.0,120.0,208.0,101.9,101.55,112.7,109.85,50,30,20,0.6,50,37,13,0.74,19,11,20,17,195.48,216.24,205.86
2018-02-03,1610612750,1610612740,2017,118.0,107.0,225.0,110.05,111.2,100.45,104.8,55,33,22,0.6,51,28,23,0.5489999999999999,21,12,14,14,209.4,200.8,205.10000000000002
2018-02-03,1610612759,1610612762,2017,111.0,120.0,231.0,107.75,96.55,95.55,106.55,54,34,20,0.63,51,23,28,0.451,22,12,15,8,204.12,200.2,202.16
2018-02-03,1610612743,1610612744,2017,115.0,108.0,223.0,109.2,110.3,107.5,105.85,52,27,25,0.519,52,41,11,0.7879999999999999,20,7,19,22,217.04,199.04,208.04
2018-02-03,1610612758,1610612742,2017,99.0,106.0,205.0,97.75,101.5,104.45,102.7,51,16,35,0.314,52,16,36,0.308,7,9,10,6,207.08,213.0,210.04000000000002
2018-02-02,1610612766,1610612754,2017,133.0,126.0,259.0,99.45,97.7,92.05,92.25,50,21,29,0.42,52,29,23,0.5579999999999999,14,7,18,11,194.96,187.28,191.12
2018-02-02,1610612738,1610612737,2017,119.0,110.0,229.0,99.65,105.5,96.35,95.7,52,37,15,0.7120000000000001,51,15,36,0.294,19,18,11,4,195.08,199.44,197.26
2018-02-02,1610612751,1610612747,2017,99.0,102.0,201.0,96.7,98.4,107.3,114.65,52,19,33,0.365,50,19,31,0.38,11,8,12,7,196.96,219.28,208.12
2018-02-02,1610612761,1610612757,2017,130.0,105.0,235.0,100.6,99.2,104.75,105.45,50,34,16,0.68,51,29,22,0.569,19,15,15,14,206.0,209.44,207.72
2018-02-02,1610612755,1610612748,2017,103.0,97.0,200.0,97.85,106.0,97.25,95.5,48,24,24,0.5,51,29,22,0.569,12,12,13,16,207.68,195.0,201.34
2018-02-02,1610612749,1610612752,2017,92.0,90.0,182.0,99.8,108.15,101.2,97.2,50,27,23,0.54,52,23,29,0.442,17,10,16,7,200.48,200.28,200.38
2018-02-02,1610612760,1610612740,2017,100.0,114.0,214.0,101.8,103.4,100.45,104.8,52,30,22,0.5770000000000001,50,27,23,0.54,19,11,14,13,210.36,200.8,205.58
2018-02-02,1610612756,1610612762,2017,97.0,129.0,226.0,106.25,103.85,95.55,106.55,52,18,34,0.34600000000000003,50,22,28,0.44,9,9,15,7,212.88,200.2,206.54
2018-02-02,1610612758,1610612744,2017,104.0,119.0,223.0,97.75,101.5,107.5,105.85,50,16,34,0.32,51,40,11,0.784,7,9,19,21,207.08,199.04,203.06
2018-02-01,1610612765,1610612763,2017,104.0,102.0,206.0,100.85,105.95,98.25,97.5,49,23,26,0.469,50,18,32,0.36,14,9,13,5,206.0,193.96,199.98000000000002
2018-02-01,1610612764,1610612761,2017,122.0,119.0,241.0,94.7,91.35,100.6,99.2,50,28,22,0.56,49,34,15,0.6940000000000001,16,12,19,15,193.0,206.0,199.5
2018-02-01,1610612750,1610612749,2017,108.0,89.0,197.0,110.05,111.2,99.8,108.15,54,32,22,0.593,49,27,22,0.551,20,12,17,10,209.4,200.48,204.94
2018-02-01,1610612759,1610612745,2017,91.0,102.0,193.0,107.75,96.55,112.7,109.85,53,34,19,0.642,49,36,13,0.735,22,12,20,16,204.12,216.24,210.18
2018-02-01,1610612743,1610612760,2017,127.0,124.0,251.0,109.2,110.3,101.8,103.4,51,26,25,0.51,51,30,21,0.588,19,7,19,11,217.04,210.36,213.7
2018-01-31,1610612754,1610612763,2017,105.0,101.0,206.0,92.05,92.25,98.25,97.5,51,28,23,0.5489999999999999,49,18,31,0.3670000000000001,17,11,13,5,187.28,193.96,190.62
2018-01-31,1610612753,1610612747,2017,127.0,105.0,232.0,96.55,103.5,107.3,114.65,49,14,35,0.28600000000000003,49,19,30,0.388,8,6,12,7,203.64,219.28,211.45999999999998
2018-01-31,1610612737,1610612766,2017,110.0,123.0,233.0,96.35,95.7,99.45,97.7,50,15,35,0.3,49,20,29,0.408,11,4,14,6,199.44,194.96,197.2
2018-01-31,1610612751,1610612755,2017,116.0,108.0,224.0,96.7,98.4,97.85,106.0,51,18,33,0.353,47,24,23,0.511,10,8,12,12,196.96,207.68,202.32
2018-01-31,1610612739,1610612748,2017,91.0,89.0,180.0,101.9,101.55,97.25,95.5,49,29,20,0.5920000000000001,50,29,21,0.58,18,11,13,16,195.48,195.0,195.24
2018-01-31,1610612738,1610612752,2017,103.0,73.0,176.0,99.65,105.5,101.2,97.2,51,36,15,0.706,51,23,28,0.451,18,18,16,7,195.08,200.28,197.68
2018-01-31,1610612757,1610612741,2017,124.0,108.0,232.0,104.75,105.45,94.0,91.0,50,28,22,0.56,50,18,32,0.36,14,14,11,7,209.44,185.44,197.44
2018-01-31,1610612756,1610612742,2017,102.0,88.0,190.0,106.25,103.85,104.45,102.7,51,17,34,0.333,51,16,35,0.314,8,9,10,6,212.88,213.0,212.94
2018-01-30,1610612764,1610612760,2017,102.0,96.0,198.0,94.7,91.35,101.8,103.4,49,27,22,0.551,50,30,20,0.6,15,12,19,11,193.0,210.36,201.68
2018-01-30,1610612752,1610612751,2017,111.0,95.0,206.0,101.2,97.2,96.7,98.4,50,22,28,0.44,50,18,32,0.36,15,7,10,8,200.28,196.96,198.62
2018-01-30,1610612761,1610612750,2017,109.0,104.0,213.0,100.6,99.2,110.05,111.2,48,33,15,0.688,53,32,21,0.604,18,15,20,12,206.0,209.4,207.7
2018-01-30,1610612765,1610612739,2017,125.0,114.0,239.0,100.85,105.95,101.9,101.55,48,22,26,0.458,48,29,19,0.604,13,9,18,11,206.0,195.48,200.74
2018-01-30,1610612745,1610612753,2017,114.0,107.0,221.0,112.7,109.85,96.55,103.5,48,35,13,0.7290000000000001,48,14,34,0.292,19,16,8,6,216.24,203.64,209.94
2018-01-30,1610612740,1610612758,2017,103.0,114.0,217.0,100.45,104.8,97.75,101.5,49,27,22,0.551,49,15,34,0.306,14,13,7,8,200.8,207.08,203.94
2018-01-30,1610612759,1610612743,2017,106.0,104.0,210.0,107.75,96.55,109.2,110.3,52,33,19,0.635,50,26,24,0.52,21,12,19,7,204.12,217.04,210.57999999999998
2018-01-30,1610612762,1610612744,2017,129.0,99.0,228.0,95.55,106.55,107.5,105.85,49,21,28,0.429,50,40,10,0.8,14,7,19,21,200.2,199.04,199.62
2018-01-30,1610612746,1610612757,2017,96.0,104.0,200.0,109.85,106.5,104.75,105.45,49,25,24,0.51,49,27,22,0.551,14,11,14,13,214.36,209.44,211.9
2018-01-29,1610612754,1610612766,2017,105.0,96.0,201.0,92.05,92.25,99.45,97.7,50,27,23,0.54,48,20,28,0.417,16,11,14,6,187.28,194.96,191.12
2018-01-29,1610612737,1610612750,2017,105.0,100.0,205.0,96.35,95.7,110.05,111.2,49,14,35,0.28600000000000003,52,32,20,0.615,10,4,20,12,199.44,209.4,204.42000000000002
2018-01-29,1610612763,1610612756,2017,120.0,109.0,229.0,98.25,97.5,106.25,103.85,48,17,31,0.354,50,17,33,0.34,12,5,8,9,193.96,212.88,203.42000000000002
2018-01-29,1610612749,1610612755,2017,107.0,95.0,202.0,99.8,108.15,97.85,106.0,48,26,22,0.542,46,24,22,0.522,16,10,12,12,200.48,207.68,204.07999999999998
2018-01-29,1610612742,1610612748,2017,88.0,95.0,183.0,104.45,102.7,97.25,95.5,50,16,34,0.32,49,28,21,0.5710000000000001,10,6,13,15,213.0,195.0,204.0
2018-01-29,1610612743,1610612738,2017,110.0,111.0,221.0,109.2,110.3,99.65,105.5,49,26,23,0.531,50,35,15,0.7,19,7,18,17,217.04,195.08,206.06
2018-01-28,1610612741,1610612749,2017,96.0,110.0,206.0,94.0,91.0,99.8,108.15,49,18,31,0.3670000000000001,47,25,22,0.532,11,7,16,9,185.44,200.48,192.95999999999998
2018-01-28,1610612745,1610612756,2017,113.0,102.0,215.0,112.7,109.85,106.25,103.85,47,34,13,0.723,49,17,32,0.34700000000000003,18,16,8,9,216.24,212.88,214.56
2018-01-28,1610612740,1610612746,2017,103.0,112.0,215.0,100.45,104.8,109.85,106.5,48,27,21,0.563,48,24,24,0.5,14,13,14,10,200.8,214.36,207.58
2018-01-28,1610612739,1610612765,2017,121.0,104.0,225.0,101.9,101.55,100.85,105.95,47,28,19,0.596,47,22,25,0.468,17,11,13,9,195.48,206.0,200.74
2018-01-28,1610612761,1610612747,2017,123.0,111.0,234.0,100.6,99.2,107.3,114.65,47,32,15,0.6809999999999999,48,19,29,0.396,17,15,12,7,206.0,219.28,212.64
2018-01-28,1610612760,1610612755,2017,122.0,112.0,234.0,101.8,103.4,97.85,106.0,49,29,20,0.5920000000000001,45,24,21,0.5329999999999999,18,11,12,12,210.36,207.68,209.02
2018-01-28,1610612759,1610612758,2017,113.0,98.0,211.0,107.75,96.55,97.75,101.5,51,32,19,0.627,48,15,33,0.313,20,12,7,8,204.12,207.08,205.60000000000002
2018-01-27,1610612765,1610612760,2017,108.0,121.0,229.0,100.85,105.95,101.8,103.4,46,22,24,0.478,48,28,20,0.583,13,9,18,10,206.0,210.36,208.18
2018-01-27,1610612754,1610612753,2017,114.0,112.0,226.0,92.05,92.25,96.55,103.5,49,26,23,0.531,47,14,33,0.298,15,11,8,6,187.28,203.64,195.45999999999998
2018-01-27,1610612737,1610612764,2017,104.0,129.0,233.0,96.35,95.7,94.7,91.35,48,14,34,0.292,48,26,22,0.542,10,4,15,11,199.44,193.0,196.22
2018-01-27,1610612748,1610612766,2017,95.0,91.0,186.0,97.25,95.5,99.45,97.7,48,27,21,0.563,47,20,27,0.426,12,15,14,6,195.0,194.96,194.98000000000002
2018-01-27,1610612744,1610612738,2017,109.0,105.0,214.0,107.5,105.85,99.65,105.5,49,39,10,0.7959999999999999,49,35,14,0.7140000000000001,18,21,18,17,199.04,195.08,197.06
2018-01-27,1610612750,1610612751,2017,111.0,97.0,208.0,110.05,111.2,96.7,98.4,51,31,20,0.608,49,18,31,0.3670000000000001,19,12,10,8,209.4,196.96,203.18
2018-01-27,1610612743,1610612742,2017,91.0,89.0,180.0,109.2,110.3,104.45,102.7,48,25,23,0.521,49,16,33,0.327,18,7,10,6,217.04,213.0,215.01999999999998
2018-01-26,1610612766,1610612737,2017,121.0,110.0,231.0,99.45,97.7,96.35,95.7,46,19,27,0.413,47,14,33,0.298,13,6,10,4,194.96,199.44,197.2
2018-01-26,1610612739,1610612754,2017,115.0,108.0,223.0,101.9,101.55,92.05,92.25,46,27,19,0.5870000000000001,48,26,22,0.542,16,11,15,11,195.48,187.28,191.38
2018-01-26,1610612761,1610612762,2017,93.0,97.0,190.0,100.6,99.2,95.55,106.55,46,32,14,0.696,48,20,28,0.417,17,15,14,6,206.0,200.2,203.1
2018-01-26,1610612741,1610612747,2017,103.0,108.0,211.0,94.0,91.0,107.3,114.65,48,18,30,0.375,47,18,29,0.383,11,7,12,6,185.44,219.28,202.36
2018-01-26,1610612763,1610612746,2017,100.0,109.0,209.0,98.25,97.5,109.85,106.5,47,17,30,0.362,47,23,24,0.489,12,5,14,9,193.96,214.36,204.16000000000003
2018-01-26,1610612749,1610612751,2017,116.0,91.0,207.0,99.8,108.15,96.7,98.4,46,24,22,0.522,48,18,30,0.375,15,9,10,8,200.48,196.96,198.72
2018-01-26,1610612740,1610612745,2017,115.0,113.0,228.0,100.45,104.8,112.7,109.85,47,26,21,0.5529999999999999,46,34,12,0.7390000000000001,13,13,18,16,200.8,216.24,208.52
2018-01-26,1610612742,1610612757,2017,93.0,107.0,200.0,104.45,102.7,104.75,105.45,48,16,32,0.333,48,26,22,0.542,10,6,14,12,213.0,209.44,211.22
2018-01-26,1610612759,1610612755,2017,78.0,97.0,175.0,107.75,96.55,97.85,106.0,50,32,18,0.64,44,23,21,0.523,20,12,12,11,204.12,207.68,205.9
2018-01-26,1610612756,1610612752,2017,85.0,107.0,192.0,106.25,103.85,101.2,97.2,48,17,31,0.354,49,21,28,0.429,8,9,15,6,212.88,200.28,206.57999999999998
2018-01-25,1610612748,1610612758,2017,88.0,89.0,177.0,97.25,95.5,97.75,101.5,47,27,20,0.574,47,14,33,0.298,12,15,7,7,195.0,207.08,201.04000000000002
2018-01-25,1610612760,1610612764,2017,121.0,112.0,233.0,101.8,103.4,94.7,91.35,47,27,20,0.574,47,26,21,0.5529999999999999,17,10,15,11,210.36,193.0,201.68
2018-01-25,1610612743,1610612752,2017,130.0,118.0,248.0,109.2,110.3,101.2,97.2,47,24,23,0.511,48,21,27,0.438,17,7,15,6,217.04,200.28,208.66
2018-01-25,1610612744,1610612750,2017,126.0,113.0,239.0,107.5,105.85,110.05,111.2,48,38,10,0.792,50,31,19,0.62,17,21,19,12,199.04,209.4,204.22
2018-01-24,1610612766,1610612740,2017,96.0,101.0,197.0,99.45,97.7,100.45,104.8,45,19,26,0.422,46,25,21,0.5429999999999999,13,6,13,12,194.96,200.8,197.88
2018-01-24,1610612765,1610612762,2017,95.0,98.0,193.0,100.85,105.95,95.55,106.55,45,22,23,0.489,47,19,28,0.404,13,9,14,5,206.0,200.2,203.1
2018-01-24,1610612754,1610612756,2017,116.0,101.0,217.0,92.05,92.25,106.25,103.85,47,25,22,0.532,47,17,30,0.362,14,11,8,9,187.28,212.88,200.07999999999998
2018-01-24,1610612755,1610612741,2017,115.0,101.0,216.0,97.85,106.0,94.0,91.0,43,22,21,0.512,47,18,29,0.383,11,11,11,7,207.68,185.44,196.56
2018-01-24,1610612737,1610612761,2017,93.0,108.0,201.0,96.35,95.7,100.6,99.2,46,14,32,0.304,45,31,14,0.6890000000000001,10,4,17,14,199.44,206.0,202.72
2018-01-24,1610612742,1610612745,2017,97.0,104.0,201.0,104.45,102.7,112.7,109.85,47,16,31,0.34,45,33,12,0.733,10,6,18,15,213.0,216.24,214.62
2018-01-24,1610612763,1610612759,2017,85.0,108.0,193.0,98.25,97.5,107.75,96.55,46,17,29,0.37,49,31,18,0.633,12,5,20,11,193.96,204.12,199.04000000000002
2018-01-24,1610612757,1610612750,2017,123.0,114.0,237.0,104.75,105.45,110.05,111.2,47,25,22,0.532,49,31,18,0.633,13,12,19,12,209.44,209.4,209.42000000000002
2018-01-24,1610612746,1610612738,2017,102.0,113.0,215.0,109.85,106.5,99.65,105.5,46,23,23,0.5,48,34,14,0.708,14,9,18,16,214.36,195.08,204.72000000000003
2018-01-23,1610612753,1610612758,2017,99.0,105.0,204.0,96.55,103.5,97.75,101.5,46,14,32,0.304,46,13,33,0.28300000000000003,8,6,7,6,203.64,207.08,205.36
2018-01-23,1610612760,1610612751,2017,109.0,108.0,217.0,101.8,103.4,96.7,98.4,46,26,20,0.565,47,18,29,0.383,16,10,10,8,210.36,196.96,203.66000000000003
2018-01-23,1610612759,1610612739,2017,114.0,102.0,216.0,107.75,96.55,101.9,101.55,48,30,18,0.625,45,27,18,0.6,19,11,16,11,204.12,195.48,199.8
2018-01-23,1610612744,1610612752,2017,123.0,112.0,235.0,107.5,105.85,101.2,97.2,47,37,10,0.787,47,21,26,0.447,16,21,15,6,199.04,200.28,199.66
2018-01-23,1610612747,1610612738,2017,108.0,107.0,215.0,107.3,114.65,99.65,105.5,46,17,29,0.37,47,34,13,0.723,11,6,18,16,219.28,195.08,207.18
2018-01-22,1610612766,1610612758,2017,112.0,107.0,219.0,99.45,97.7,97.75,101.5,44,18,26,0.409,45,13,32,0.289,12,6,7,6,194.96,207.08,201.02
2018-01-22,1610612737,1610612762,2017,104.0,90.0,194.0,96.35,95.7,95.55,106.55,45,13,32,0.289,46,19,27,0.413,9,4,14,5,199.44,200.2,199.82
2018-01-22,1610612745,1610612748,2017,99.0,90.0,189.0,112.7,109.85,97.25,95.5,44,32,12,0.727,46,27,19,0.5870000000000001,17,15,12,15,216.24,195.0,205.62
2018-01-22,1610612763,1610612755,2017,105.0,101.0,206.0,98.25,97.5,97.85,106.0,45,16,29,0.35600000000000004,42,22,20,0.524,11,5,11,11,193.96,207.68,200.82
2018-01-22,1610612749,1610612756,2017,109.0,105.0,214.0,99.8,108.15,106.25,103.85,45,23,22,0.511,46,17,29,0.37,14,9,8,9,200.48,212.88,206.68
2018-01-22,1610612740,1610612741,2017,132.0,128.0,260.0,100.45,104.8,94.0,91.0,45,24,21,0.5329999999999999,46,18,28,0.391,12,12,11,7,200.8,185.44,193.12
2018-01-22,1610612742,1610612764,2017,98.0,75.0,173.0,104.45,102.7,94.7,91.35,46,15,31,0.326,46,26,20,0.565,9,6,15,11,213.0,193.0,203.0
2018-01-22,1610612743,1610612757,2017,104.0,101.0,205.0,109.2,110.3,104.75,105.45,46,23,23,0.5,46,25,21,0.5429999999999999,16,7,13,12,217.04,209.44,213.24
2018-01-22,1610612746,1610612750,2017,118.0,126.0,244.0,109.85,106.5,110.05,111.2,45,23,22,0.511,48,30,18,0.625,14,9,19,11,214.36,209.4,211.88
2018-01-21,1610612738,1610612753,2017,95.0,103.0,198.0,99.65,105.5,96.55,103.5,46,34,12,0.7390000000000001,45,13,32,0.289,18,16,8,5,195.08,203.64,199.36
2018-01-21,1610612747,1610612752,2017,127.0,107.0,234.0,107.3,114.65,101.2,97.2,45,16,29,0.35600000000000004,46,21,25,0.457,10,6,15,6,219.28,200.28,209.78
2018-01-21,1610612765,1610612751,2017,100.0,101.0,201.0,100.85,105.95,96.7,98.4,44,22,22,0.5,46,17,29,0.37,13,9,10,7,206.0,196.96,201.48000000000002
2018-01-21,1610612759,1610612754,2017,86.0,94.0,180.0,107.75,96.55,92.05,92.25,47,30,17,0.638,46,24,22,0.522,19,11,14,10,204.12,187.28,195.7
2018-01-20,1610612739,1610612760,2017,124.0,148.0,272.0,101.9,101.55,101.8,103.4,44,27,17,0.614,45,25,20,0.556,16,11,16,9,195.48,210.36,202.92000000000002
2018-01-20,1610612737,1610612741,2017,97.0,113.0,210.0,96.35,95.7,94.0,91.0,44,13,31,0.295,45,17,28,0.378,9,4,11,6,199.44,185.44,192.44
2018-01-20,1610612766,1610612748,2017,105.0,106.0,211.0,99.45,97.7,97.25,95.5,43,18,25,0.419,45,26,19,0.578,12,6,12,14,194.96,195.0,194.98000000000002
2018-01-20,1610612740,1610612763,2017,111.0,104.0,215.0,100.45,104.8,98.25,97.5,44,23,21,0.523,44,16,28,0.364,11,12,11,5,200.8,193.96,197.38
2018-01-20,1610612755,1610612749,2017,116.0,94.0,210.0,97.85,106.0,99.8,108.15,41,21,20,0.512,44,23,21,0.523,10,11,14,9,207.68,200.48,204.07999999999998
2018-01-20,1610612745,1610612744,2017,116.0,108.0,224.0,112.7,109.85,107.5,105.85,43,31,12,0.721,46,37,9,0.804,16,15,16,21,216.24,199.04,207.64
2018-01-20,1610612750,1610612761,2017,115.0,109.0,224.0,110.05,111.2,100.6,99.2,47,29,18,0.617,44,31,13,0.705,18,11,17,14,209.4,206.0,207.7
2018-01-20,1610612762,1610612746,2017,125.0,113.0,238.0,95.55,106.55,109.85,106.5,45,18,27,0.4,44,23,21,0.523,13,5,14,9,200.2,214.36,207.28
2018-01-20,1610612757,1610612742,2017,117.0,108.0,225.0,104.75,105.45,104.45,102.7,45,24,21,0.5329999999999999,45,15,30,0.333,12,12,9,6,209.44,213.0,211.22
2018-01-19,1610612761,1610612759,2017,86.0,83.0,169.0,100.6,99.2,107.75,96.55,43,30,13,0.698,46,30,16,0.652,16,14,19,11,206.0,204.12,205.06
2018-01-19,1610612751,1610612748,2017,101.0,95.0,196.0,96.7,98.4,97.25,95.5,45,16,29,0.35600000000000004,44,26,18,0.591,9,7,12,14,196.96,195.0,195.98000000000002
2018-01-19,1610612765,1610612764,2017,112.0,122.0,234.0,100.85,105.95,94.7,91.35,43,22,21,0.512,45,25,20,0.556,13,9,15,10,206.0,193.0,199.5
2018-01-19,1610612763,1610612758,2017,106.0,88.0,194.0,98.25,97.5,97.75,101.5,43,15,28,0.349,44,13,31,0.295,10,5,7,6,193.96,207.08,200.52
2018-01-19,1610612743,1610612756,2017,100.0,108.0,208.0,109.2,110.3,106.25,103.85,45,23,22,0.511,45,16,29,0.35600000000000004,16,7,8,8,217.04,212.88,214.95999999999998
2018-01-19,1610612762,1610612752,2017,115.0,117.0,232.0,95.55,106.55,101.2,97.2,44,18,26,0.409,45,20,25,0.444,13,5,15,5,200.2,200.28,200.24
2018-01-19,1610612747,1610612754,2017,99.0,86.0,185.0,107.3,114.65,92.05,92.25,44,15,29,0.341,45,24,21,0.5329999999999999,9,6,14,10,219.28,187.28,203.28
2018-01-18,1610612738,1610612755,2017,80.0,89.0,169.0,99.65,105.5,97.85,106.0,45,34,11,0.7559999999999999,40,20,20,0.5,18,16,10,10,195.08,207.68,201.38
2018-01-18,1610612739,1610612753,2017,104.0,103.0,207.0,101.9,101.55,96.55,103.5,43,26,17,0.605,44,13,31,0.295,15,11,8,5,195.48,203.64,199.56
2018-01-18,1610612745,1610612750,2017,116.0,98.0,214.0,112.7,109.85,110.05,111.2,42,30,12,0.7140000000000001,46,29,17,0.63,15,15,18,11,216.24,209.4,212.82
2018-01-18,1610612757,1610612754,2017,100.0,86.0,186.0,104.75,105.45,92.05,92.25,44,23,21,0.523,44,24,20,0.545,11,12,14,10,209.44,187.28,198.36
2018-01-17,1610612766,1610612764,2017,133.0,109.0,242.0,99.45,97.7,94.7,91.35,42,17,25,0.405,44,25,19,0.568,11,6,15,10,194.96,193.0,193.98000000000002
2018-01-17,1610612737,1610612740,2017,94.0,93.0,187.0,96.35,95.7,100.45,104.8,43,12,31,0.279,43,23,20,0.535,8,4,11,12,199.44,200.8,200.12
2018-01-17,1610612751,1610612759,2017,95.0,100.0,195.0,96.7,98.4,107.75,96.55,44,16,28,0.364,45,29,16,0.644,9,7,19,10,196.96,204.12,200.54000000000002
2018-01-17,1610612761,1610612765,2017,96.0,91.0,187.0,100.6,99.2,100.85,105.95,42,29,13,0.69,42,22,20,0.524,15,14,13,9,206.0,206.0,206.0
2018-01-17,1610612741,1610612744,2017,112.0,119.0,231.0,94.0,91.0,107.5,105.85,44,17,27,0.386,45,36,9,0.8,11,6,16,20,185.44,199.04,192.24
2018-01-17,1610612763,1610612752,2017,105.0,99.0,204.0,98.25,97.5,101.2,97.2,42,14,28,0.333,44,20,24,0.455,9,5,15,5,193.96,200.28,197.12
2018-01-17,1610612749,1610612748,2017,101.0,106.0,207.0,99.8,108.15,97.25,95.5,43,23,20,0.535,43,25,18,0.581,14,9,12,13,200.48,195.0,197.74
2018-01-17,1610612760,1610612747,2017,114.0,90.0,204.0,101.8,103.4,107.3,114.65,44,24,20,0.545,43,15,28,0.349,15,9,9,6,210.36,219.28,214.82
2018-01-17,1610612758,1610612762,2017,105.0,120.0,225.0,97.75,101.5,95.55,106.55,43,13,30,0.302,43,17,26,0.395,7,6,13,4,207.08,200.2,203.64
2018-01-17,1610612746,1610612743,2017,109.0,104.0,213.0,109.85,106.5,109.2,110.3,43,22,21,0.512,44,23,21,0.523,13,9,16,7,214.36,217.04,215.7
2018-01-16,1610612753,1610612750,2017,108.0,102.0,210.0,96.55,103.5,110.05,111.2,43,12,31,0.279,45,29,16,0.644,7,5,18,11,203.64,209.4,206.51999999999998
2018-01-16,1610612738,1610612740,2017,113.0,116.0,229.0,99.65,105.5,100.45,104.8,44,34,10,0.773,42,22,20,0.524,18,16,11,11,195.08,200.8,197.94
2018-01-16,1610612743,1610612742,2017,105.0,102.0,207.0,109.2,110.3,104.45,102.7,43,22,21,0.512,44,15,29,0.341,15,7,9,6,217.04,213.0,215.01999999999998
2018-01-16,1610612757,1610612756,2017,118.0,111.0,229.0,104.75,105.45,106.25,103.85,43,22,21,0.512,44,16,28,0.364,10,12,8,8,209.44,212.88,211.16
2018-01-15,1610612765,1610612766,2017,107.0,118.0,225.0,100.85,105.95,99.45,97.7,41,22,19,0.537,41,16,25,0.39,13,9,11,5,206.0,194.96,200.48000000000002
2018-01-15,1610612755,1610612761,2017,117.0,111.0,228.0,97.85,106.0,100.6,99.2,39,19,20,0.487,41,29,12,0.7070000000000001,9,10,15,14,207.68,206.0,206.84
2018-01-15,1610612764,1610612749,2017,95.0,104.0,199.0,94.7,91.35,99.8,108.15,43,25,18,0.581,42,22,20,0.524,15,10,14,8,193.0,200.48,196.74
2018-01-15,1610612737,1610612759,2017,102.0,99.0,201.0,96.35,95.7,107.75,96.55,42,11,31,0.262,44,29,15,0.659,7,4,19,10,199.44,204.12,201.78
2018-01-15,1610612751,1610612752,2017,104.0,119.0,223.0,96.7,98.4,101.2,97.2,43,16,27,0.3720000000000001,43,19,24,0.442,9,7,15,4,196.96,200.28,198.62
2018-01-15,1610612741,1610612748,2017,119.0,111.0,230.0,94.0,91.0,97.25,95.5,43,16,27,0.3720000000000001,42,25,17,0.595,10,6,12,13,185.44,195.0,190.22
2018-01-15,1610612763,1610612747,2017,123.0,114.0,237.0,98.25,97.5,107.3,114.65,41,13,28,0.317,42,15,27,0.35700000000000004,8,5,9,6,193.96,219.28,206.62
2018-01-15,1610612760,1610612758,2017,95.0,88.0,183.0,101.8,103.4,97.75,101.5,43,23,20,0.535,42,13,29,0.31,14,9,7,6,210.36,207.08,208.72000000000003
2018-01-15,1610612739,1610612744,2017,108.0,118.0,226.0,101.9,101.55,107.5,105.85,42,26,16,0.619,44,35,9,0.795,15,11,16,19,195.48,199.04,197.26
2018-01-15,1610612762,1610612754,2017,94.0,109.0,203.0,95.55,106.55,92.05,92.25,42,17,25,0.405,43,23,20,0.535,13,4,14,9,200.2,187.28,193.74
2018-01-15,1610612746,1610612745,2017,113.0,102.0,215.0,109.85,106.5,112.7,109.85,42,21,21,0.5,41,30,11,0.732,12,9,15,15,214.36,216.24,215.3
2018-01-14,1610612748,1610612749,2017,97.0,79.0,176.0,97.25,95.5,99.8,108.15,41,24,17,0.585,41,22,19,0.537,11,13,14,8,195.0,200.48,197.74
2018-01-14,1610612752,1610612740,2017,118.0,123.0,241.0,101.2,97.2,100.45,104.8,42,19,23,0.452,41,21,20,0.512,15,4,11,10,200.28,200.8,200.54000000000002
2018-01-14,1610612756,1610612754,2017,97.0,120.0,217.0,106.25,103.85,92.05,92.25,43,16,27,0.3720000000000001,42,22,20,0.524,8,8,14,8,212.88,187.28,200.07999999999998
2018-01-14,1610612750,1610612757,2017,120.0,103.0,223.0,110.05,111.2,104.75,105.45,44,28,16,0.636,42,22,20,0.524,17,11,10,12,209.4,209.44,209.42000000000002
2018-01-13,1610612742,1610612747,2017,101.0,107.0,208.0,104.45,102.7,107.3,114.65,43,15,28,0.349,41,14,27,0.341,9,6,9,5,213.0,219.28,216.14
2018-01-13,1610612746,1610612758,2017,126.0,105.0,231.0,109.85,106.5,97.75,101.5,41,20,21,0.488,41,13,28,0.317,11,9,7,6,214.36,207.08,210.72000000000003
2018-01-13,1610612766,1610612760,2017,91.0,101.0,192.0,99.45,97.7,101.8,103.4,40,16,24,0.4,42,22,20,0.524,11,5,14,8,194.96,210.36,202.66000000000003
2018-01-13,1610612764,1610612751,2017,119.0,113.0,232.0,94.7,91.35,96.7,98.4,42,24,18,0.5710000000000001,42,16,26,0.381,14,10,9,7,193.0,196.96,194.98000000000002
2018-01-13,1610612761,1610612744,2017,125.0,127.0,252.0,100.6,99.2,107.5,105.85,40,29,11,0.725,43,34,9,0.7909999999999999,15,14,16,18,206.0,199.04,202.51999999999998
2018-01-13,1610612741,1610612765,2017,107.0,105.0,212.0,94.0,91.0,100.85,105.95,42,15,27,0.35700000000000004,40,22,18,0.55,9,6,13,9,185.44,206.0,195.72
2018-01-13,1610612759,1610612743,2017,112.0,80.0,192.0,107.75,96.55,109.2,110.3,43,28,15,0.6509999999999999,42,22,20,0.524,18,10,15,7,204.12,217.04,210.57999999999998
2018-01-12,1610612766,1610612762,2017,99.0,88.0,187.0,99.45,97.7,95.55,106.55,39,15,24,0.385,41,17,24,0.415,10,5,13,4,194.96,200.2,197.57999999999998
2018-01-12,1610612754,1610612739,2017,97.0,95.0,192.0,92.05,92.25,101.9,101.55,41,21,20,0.512,41,26,15,0.634,13,8,15,11,187.28,195.48,191.38
2018-01-12,1610612764,1610612753,2017,125.0,119.0,244.0,94.7,91.35,96.55,103.5,41,23,18,0.561,42,12,30,0.28600000000000003,13,10,7,5,193.0,203.64,198.32
2018-01-12,1610612737,1610612751,2017,105.0,110.0,215.0,96.35,95.7,96.7,98.4,41,11,30,0.268,41,15,26,0.366,7,4,9,6,199.44,196.96,198.2
2018-01-12,1610612749,1610612744,2017,94.0,108.0,202.0,99.8,108.15,107.5,105.85,40,22,18,0.55,42,33,9,0.7859999999999999,14,8,16,17,200.48,199.04,199.76
2018-01-12,1610612750,1610612752,2017,118.0,108.0,226.0,110.05,111.2,101.2,97.2,43,27,16,0.628,41,19,22,0.463,16,11,15,4,209.4,200.28,204.84
2018-01-12,1610612740,1610612757,2017,119.0,113.0,232.0,100.45,104.8,104.75,105.45,40,20,20,0.5,41,22,19,0.537,10,10,10,12,200.8,209.44,205.12
2018-01-12,1610612743,1610612763,2017,87.0,78.0,165.0,109.2,110.3,98.25,97.5,41,21,20,0.512,40,13,27,0.325,14,7,8,5,217.04,193.96,205.5
2018-01-12,1610612756,1610612745,2017,95.0,112.0,207.0,106.25,103.85,112.7,109.85,42,16,26,0.381,40,29,11,0.725,8,8,15,14,212.88,216.24,214.56
2018-01-11,1610612755,1610612738,2017,103.0,114.0,217.0,97.85,106.0,99.65,105.5,38,19,19,0.5,43,33,10,0.767,9,10,18,15,207.68,195.08,201.38
2018-01-11,1610612761,1610612739,2017,133.0,99.0,232.0,100.6,99.2,101.9,101.55,39,28,11,0.718,40,26,14,0.65,14,14,15,11,206.0,195.48,200.74
2018-01-11,1610612758,1610612746,2017,115.0,121.0,236.0,97.75,101.5,109.85,106.5,40,13,27,0.325,40,19,21,0.475,7,6,11,8,207.08,214.36,210.72000000000003
2018-01-11,1610612747,1610612759,2017,93.0,81.0,174.0,107.3,114.65,107.75,96.55,40,13,27,0.325,42,28,14,0.667,8,5,18,10,219.28,204.12,211.7
2018-01-10,1610612766,1610612742,2017,111.0,115.0,226.0,99.45,97.7,104.45,102.7,38,15,23,0.395,42,14,28,0.333,10,5,9,5,194.96,213.0,203.98000000000002
2018-01-10,1610612754,1610612748,2017,106.0,114.0,220.0,92.05,92.25,97.25,95.5,40,21,19,0.525,40,23,17,0.575,13,8,11,12,187.28,195.0,191.14
2018-01-10,1610612764,1610612762,2017,104.0,107.0,211.0,94.7,91.35,95.55,106.55,40,23,17,0.575,40,16,24,0.4,13,10,13,3,193.0,200.2,196.6
2018-01-10,1610612751,1610612765,2017,80.0,114.0,194.0,96.7,98.4,100.85,105.95,40,15,25,0.375,39,21,18,0.5379999999999999,9,6,13,8,196.96,206.0,201.48000000000002
2018-01-10,1610612752,1610612741,2017,119.0,122.0,241.0,101.2,97.2,94.0,91.0,40,19,21,0.475,41,14,27,0.341,15,4,9,5,200.28,185.44,192.86
2018-01-10,1610612745,1610612757,2017,121.0,112.0,233.0,112.7,109.85,104.75,105.45,39,28,11,0.718,40,22,18,0.55,14,14,10,12,216.24,209.44,212.84
2018-01-10,1610612763,1610612740,2017,105.0,102.0,207.0,98.25,97.5,100.45,104.8,39,12,27,0.308,39,20,19,0.513,7,5,10,10,193.96,200.8,197.38
2018-01-10,1610612749,1610612753,2017,110.0,103.0,213.0,99.8,108.15,96.55,103.5,39,21,18,0.5379999999999999,41,12,29,0.293,13,8,7,5,200.48,203.64,202.06
2018-01-10,1610612750,1610612760,2017,104.0,88.0,192.0,110.05,111.2,101.8,103.4,42,26,16,0.619,41,22,19,0.537,15,11,14,8,209.4,210.36,209.88
2018-01-10,1610612743,1610612737,2017,97.0,110.0,207.0,109.2,110.3,96.35,95.7,40,21,19,0.525,40,10,30,0.25,14,7,7,3,217.04,199.44,208.24
2018-01-10,1610612744,1610612746,2017,106.0,125.0,231.0,107.5,105.85,109.85,106.5,41,33,8,0.805,39,18,21,0.462,16,17,11,7,199.04,214.36,206.7
2018-01-09,1610612761,1610612748,2017,89.0,90.0,179.0,100.6,99.2,97.25,95.5,38,28,10,0.737,39,22,17,0.564,14,14,11,11,206.0,195.0,200.5
2018-01-09,1610612760,1610612757,2017,106.0,117.0,223.0,101.8,103.4,104.75,105.45,40,22,18,0.55,39,21,18,0.5379999999999999,14,8,10,11,210.36,209.44,209.9
2018-01-09,1610612742,1610612753,2017,114.0,99.0,213.0,104.45,102.7,96.55,103.5,41,13,28,0.317,40,12,28,0.3,8,5,7,5,213.0,203.64,208.32
2018-01-09,1610612747,1610612758,2017,99.0,86.0,185.0,107.3,114.65,97.75,101.5,39,12,27,0.308,39,13,26,0.333,7,5,7,6,219.28,207.08,213.18
2018-01-08,1610612754,1610612749,2017,109.0,96.0,205.0,92.05,92.25,99.8,108.15,39,20,19,0.513,38,21,17,0.5529999999999999,12,8,13,8,187.28,200.48,193.88
2018-01-08,1610612751,1610612761,2017,113.0,114.0,227.0,96.7,98.4,100.6,99.2,39,15,24,0.385,37,27,10,0.73,9,6,14,13,196.96,206.0,201.48000000000002
2018-01-08,1610612741,1610612745,2017,107.0,116.0,223.0,94.0,91.0,112.7,109.85,40,14,26,0.35,38,27,11,0.711,9,5,14,13,185.44,216.24,200.84
2018-01-08,1610612750,1610612739,2017,127.0,99.0,226.0,110.05,111.2,101.9,101.55,41,25,16,0.61,39,26,13,0.667,14,11,15,11,209.4,195.48,202.44
2018-01-08,1610612740,1610612765,2017,112.0,109.0,221.0,100.45,104.8,100.85,105.95,38,19,19,0.5,38,21,17,0.5529999999999999,9,10,13,8,200.8,206.0,203.4
2018-01-08,1610612758,1610612759,2017,100.0,107.0,207.0,97.75,101.5,107.75,96.55,38,13,25,0.342,41,27,14,0.659,7,6,18,9,207.08,204.12,205.60000000000002
2018-01-08,1610612744,1610612743,2017,124.0,114.0,238.0,107.5,105.85,109.2,110.3,40,32,8,0.8,39,21,18,0.5379999999999999,15,17,14,7,199.04,217.04,208.04
2018-01-08,1610612746,1610612737,2017,108.0,107.0,215.0,109.85,106.5,96.35,95.7,38,17,21,0.447,39,10,29,0.256,10,7,7,3,214.36,199.44,206.9
2018-01-07,1610612748,1610612762,2017,103.0,102.0,205.0,97.25,95.5,95.55,106.55,38,21,17,0.5529999999999999,39,16,23,0.41,10,11,13,3,195.0,200.2,197.6
2018-01-07,1610612742,1610612752,2017,96.0,100.0,196.0,104.45,102.7,101.2,97.2,40,13,27,0.325,39,18,21,0.462,8,5,15,3,213.0,200.28,206.64
2018-01-07,1610612756,1610612760,2017,114.0,100.0,214.0,106.25,103.85,101.8,103.4,41,15,26,0.366,39,22,17,0.564,7,8,14,8,212.88,210.36,211.62
2018-01-07,1610612757,1610612759,2017,111.0,110.0,221.0,104.75,105.45,107.75,96.55,38,20,18,0.526,40,27,13,0.675,9,11,18,9,209.44,204.12,206.78
2018-01-07,1610612747,1610612737,2017,132.0,113.0,245.0,107.3,114.65,96.35,95.7,38,11,27,0.289,38,10,28,0.263,6,5,7,3,219.28,199.44,209.36
2018-01-06,1610612746,1610612744,2017,105.0,121.0,226.0,109.85,106.5,107.5,105.85,37,17,20,0.459,39,31,8,0.795,10,7,15,16,214.36,199.04,206.7
2018-01-06,1610612751,1610612738,2017,85.0,87.0,172.0,96.7,98.4,99.65,105.5,38,15,23,0.395,42,32,10,0.762,9,6,18,14,196.96,195.08,196.02
2018-01-06,1610612765,1610612745,2017,108.0,101.0,209.0,100.85,105.95,112.7,109.85,37,20,17,0.541,37,27,10,0.73,12,8,14,13,206.0,216.24,211.12
2018-01-06,1610612754,1610612741,2017,125.0,86.0,211.0,92.05,92.25,94.0,91.0,38,19,19,0.5,39,14,25,0.359,11,8,9,5,187.28,185.44,186.36
2018-01-06,1610612753,1610612739,2017,127.0,131.0,258.0,96.55,103.5,101.9,101.55,39,12,27,0.308,38,25,13,0.6579999999999999,7,5,15,10,203.64,195.48,199.56
2018-01-06,1610612764,1610612749,2017,103.0,110.0,213.0,94.7,91.35,99.8,108.15,39,23,16,0.59,37,20,17,0.541,13,10,13,7,193.0,200.48,196.74
2018-01-06,1610612750,1610612740,2017,116.0,98.0,214.0,110.05,111.2,100.45,104.8,40,24,16,0.6,37,19,18,0.514,13,11,9,10,209.4,200.8,205.10000000000002
2018-01-06,1610612758,1610612743,2017,106.0,98.0,204.0,97.75,101.5,109.2,110.3,37,12,25,0.324,38,21,17,0.5529999999999999,6,6,14,7,207.08,217.04,212.06
2018-01-05,1610612755,1610612765,2017,114.0,78.0,192.0,97.85,106.0,100.85,105.95,37,18,19,0.486,36,20,16,0.556,8,10,12,8,207.68,206.0,206.84
2018-01-05,1610612738,1610612750,2017,91.0,84.0,175.0,99.65,105.5,110.05,111.2,41,31,10,0.7559999999999999,39,24,15,0.615,17,14,13,11,195.08,209.4,202.24
2018-01-05,1610612748,1610612752,2017,107.0,103.0,210.0,97.25,95.5,101.2,97.2,37,20,17,0.541,38,18,20,0.474,9,11,15,3,195.0,200.28,197.64
2018-01-05,1610612749,1610612761,2017,110.0,129.0,239.0,99.8,108.15,100.6,99.2,36,20,16,0.556,36,26,10,0.722,13,7,14,12,200.48,206.0,203.24
2018-01-05,1610612742,1610612741,2017,124.0,127.0,251.0,104.45,102.7,94.0,91.0,39,13,26,0.333,38,13,25,0.342,8,5,9,4,213.0,185.44,199.22
2018-01-05,1610612759,1610612756,2017,103.0,89.0,192.0,107.75,96.55,106.25,103.85,39,26,13,0.667,40,15,25,0.375,17,9,7,8,204.12,212.88,208.5
2018-01-05,1610612743,1610612762,2017,99.0,91.0,190.0,109.2,110.3,95.55,106.55,37,20,17,0.541,38,16,22,0.421,13,7,13,3,217.04,200.2,208.62
2018-01-05,1610612763,1610612764,2017,100.0,102.0,202.0,98.25,97.5,94.7,91.35,38,12,26,0.316,38,22,16,0.579,7,5,13,9,193.96,193.0,193.48000000000002
2018-01-05,1610612757,1610612737,2017,110.0,89.0,199.0,104.75,105.45,96.35,95.7,37,19,18,0.514,37,10,27,0.27,8,11,7,3,209.44,199.44,204.44
2018-01-05,1610612747,1610612766,2017,94.0,108.0,202.0,107.3,114.65,99.45,97.7,37,11,26,0.297,37,14,23,0.378,6,5,10,4,219.28,194.96,207.12
2018-01-04,1610612745,1610612744,2017,114.0,124.0,238.0,112.7,109.85,107.5,105.85,36,27,9,0.75,38,30,8,0.789,14,13,15,15,216.24,199.04,207.64
2018-01-04,1610612746,1610612760,2017,117.0,127.0,244.0,109.85,106.5,101.8,103.4,36,17,19,0.472,38,21,17,0.5529999999999999,10,7,14,7,214.36,210.36,212.36
2018-01-03,1610612753,1610612745,2017,98.0,116.0,214.0,96.55,103.5,112.7,109.85,38,12,26,0.316,35,26,9,0.743,7,5,14,12,203.64,216.24,209.94
2018-01-03,1610612755,1610612759,2017,112.0,106.0,218.0,97.85,106.0,107.75,96.55,36,17,19,0.472,38,26,12,0.684,7,10,17,9,207.68,204.12,205.9
2018-01-03,1610612764,1610612752,2017,121.0,103.0,224.0,94.7,91.35,101.2,97.2,37,21,16,0.568,37,18,19,0.486,12,9,15,3,193.0,200.28,196.64
2018-01-03,1610612751,1610612750,2017,98.0,97.0,195.0,96.7,98.4,110.05,111.2,37,14,23,0.378,38,24,14,0.632,8,6,13,11,196.96,209.4,203.18
2018-01-03,1610612748,1610612765,2017,111.0,104.0,215.0,97.25,95.5,100.85,105.95,36,19,17,0.528,35,20,15,0.5710000000000001,8,11,12,8,195.0,206.0,200.5
2018-01-03,1610612738,1610612739,2017,102.0,88.0,190.0,99.65,105.5,101.9,101.55,40,30,10,0.75,37,25,12,0.6759999999999999,16,14,15,10,195.08,195.48,195.28
2018-01-03,1610612741,1610612761,2017,115.0,124.0,239.0,94.0,91.0,100.6,99.2,37,13,24,0.35100000000000003,35,25,10,0.7140000000000001,9,4,14,11,185.44,206.0,195.72
2018-01-03,1610612749,1610612754,2017,122.0,101.0,223.0,99.8,108.15,92.05,92.25,35,19,16,0.5429999999999999,37,19,18,0.514,12,7,11,8,200.48,187.28,193.88
2018-01-03,1610612742,1610612744,2017,122.0,125.0,247.0,104.45,102.7,107.5,105.85,38,13,25,0.342,37,29,8,0.784,8,5,15,14,213.0,199.04,206.01999999999998
2018-01-03,1610612743,1610612756,2017,134.0,111.0,245.0,109.2,110.3,106.25,103.85,36,19,17,0.528,39,15,24,0.385,12,7,7,8,217.04,212.88,214.95999999999998
2018-01-03,1610612762,1610612740,2017,98.0,108.0,206.0,95.55,106.55,100.45,104.8,37,16,21,0.4320000000000001,36,18,18,0.5,13,3,9,9,200.2,200.8,200.5
2018-01-03,1610612747,1610612760,2017,96.0,133.0,229.0,107.3,114.65,101.8,103.4,36,11,25,0.306,37,20,17,0.541,6,5,14,6,219.28,210.36,214.82
2018-01-02,1610612739,1610612757,2017,127.0,110.0,237.0,101.9,101.55,104.75,105.45,36,24,12,0.667,36,19,17,0.528,14,10,8,11,195.48,209.44,202.45999999999998
2018-01-02,1610612752,1610612759,2017,91.0,100.0,191.0,101.2,97.2,107.75,96.55,36,18,18,0.5,37,25,12,0.6759999999999999,15,3,17,8,200.28,204.12,202.2
2018-01-02,1610612756,1610612737,2017,104.0,103.0,207.0,106.25,103.85,96.35,95.7,38,14,24,0.368,36,10,26,0.278,6,8,7,3,212.88,199.44,206.16
2018-01-02,1610612758,1610612766,2017,111.0,131.0,242.0,97.75,101.5,99.45,97.7,36,12,24,0.333,36,13,23,0.361,6,6,10,3,207.08,194.96,201.02
2018-01-02,1610612746,1610612763,2017,113.0,105.0,218.0,109.85,106.5,98.25,97.5,35,16,19,0.457,37,12,25,0.324,9,7,7,5,214.36,193.96,204.16000000000003
2018-01-01,1610612751,1610612753,2017,98.0,95.0,193.0,96.7,98.4,96.55,103.5,36,13,23,0.361,37,12,25,0.324,7,6,7,5,196.96,203.64,200.3
2018-01-01,1610612761,1610612749,2017,131.0,127.0,258.0,100.6,99.2,99.8,108.15,34,24,10,0.706,34,19,15,0.5589999999999999,13,11,12,7,206.0,200.48,203.24
2018-01-01,1610612741,1610612757,2017,120.0,124.0,244.0,94.0,91.0,104.75,105.45,36,13,23,0.361,35,18,17,0.514,9,4,8,10,185.44,209.44,197.44
2018-01-01,1610612750,1610612747,2017,114.0,96.0,210.0,110.05,111.2,107.3,114.65,37,23,14,0.622,35,11,24,0.314,12,11,6,5,209.4,219.28,214.34
2017-12-31,1610612764,1610612741,2017,114.0,110.0,224.0,94.7,91.35,94.0,91.0,36,20,16,0.556,35,13,22,0.371,11,9,9,4,193.0,185.44,189.22
2017-12-31,1610612754,1610612750,2017,90.0,107.0,197.0,92.05,92.25,110.05,111.2,36,19,17,0.528,36,22,14,0.611,11,8,12,10,187.28,209.4,198.34
2017-12-31,1610612738,1610612751,2017,108.0,105.0,213.0,99.65,105.5,96.7,98.4,39,29,10,0.7440000000000001,35,13,22,0.371,15,14,7,6,195.08,196.96,196.02
2017-12-31,1610612745,1610612747,2017,148.0,142.0,290.0,112.7,109.85,107.3,114.65,34,25,9,0.735,34,11,23,0.324,13,12,6,5,216.24,219.28,217.76
2017-12-31,1610612760,1610612742,2017,113.0,116.0,229.0,101.8,103.4,104.45,102.7,36,20,16,0.556,37,12,25,0.324,14,6,8,4,210.36,213.0,211.68
2017-12-31,1610612746,1610612766,2017,106.0,98.0,204.0,109.85,106.5,99.45,97.7,34,15,19,0.441,35,13,22,0.371,8,7,10,3,214.36,194.96,204.66000000000003
2017-12-31,1610612758,1610612763,2017,96.0,114.0,210.0,97.75,101.5,98.25,97.5,35,12,23,0.343,36,11,25,0.306,6,6,7,4,207.08,193.96,200.52
2017-12-31,1610612756,1610612755,2017,110.0,123.0,233.0,106.25,103.85,97.85,106.0,37,14,23,0.378,35,16,19,0.457,6,8,7,9,212.88,207.68,210.28
2017-12-30,1610612765,1610612759,2017,93.0,79.0,172.0,100.85,105.95,107.75,96.55,34,19,15,0.5589999999999999,36,25,11,0.6940000000000001,11,8,17,8,206.0,204.12,205.06
2017-12-30,1610612753,1610612748,2017,111.0,117.0,228.0,96.55,103.5,97.25,95.5,36,12,24,0.333,35,18,17,0.514,7,5,8,10,203.64,195.0,199.32
2017-12-30,1610612740,1610612752,2017,103.0,105.0,208.0,100.45,104.8,101.2,97.2,35,18,17,0.514,35,17,18,0.486,9,9,15,2,200.8,200.28,200.54000000000002
2017-12-30,1610612737,1610612757,2017,104.0,89.0,193.0,96.35,95.7,104.75,105.45,35,9,26,0.257,34,18,16,0.529,6,3,8,10,199.44,209.44,204.44
2017-12-30,1610612762,1610612739,2017,104.0,101.0,205.0,95.55,106.55,101.9,101.55,36,15,21,0.417,35,24,11,0.6859999999999999,12,3,14,10,200.2,195.48,197.83999999999997
2017-12-30,1610612744,1610612763,2017,141.0,128.0,269.0,107.5,105.85,98.25,97.5,36,28,8,0.778,35,11,24,0.314,14,14,7,4,199.04,193.96,196.5
2017-12-30,1610612743,1610612755,2017,102.0,107.0,209.0,109.2,110.3,97.85,106.0,35,19,16,0.5429999999999999,34,15,19,0.441,12,7,7,8,217.04,207.68,212.36
2017-12-29,1610612764,1610612745,2017,121.0,103.0,224.0,94.7,91.35,112.7,109.85,35,19,16,0.5429999999999999,33,25,8,0.758,10,9,13,12,193.0,216.24,204.62
2017-12-29,1610612761,1610612737,2017,111.0,98.0,209.0,100.6,99.2,96.35,95.7,33,23,10,0.6970000000000001,34,9,25,0.265,12,11,6,3,206.0,199.44,202.72
2017-12-29,1610612748,1610612751,2017,87.0,111.0,198.0,97.25,95.5,96.7,98.4,34,18,16,0.529,34,12,22,0.353,8,10,7,5,195.0,196.96,195.98000000000002
2017-12-29,1610612741,1610612754,2017,119.0,107.0,226.0,94.0,91.0,92.05,92.25,34,12,22,0.353,35,19,16,0.5429999999999999,8,4,11,8,185.44,187.28,186.36
2017-12-29,1610612740,1610612742,2017,120.0,128.0,248.0,100.45,104.8,104.45,102.7,34,18,16,0.529,36,11,25,0.306,9,9,8,3,200.8,213.0,206.9
2017-12-29,1610612760,1610612749,2017,95.0,97.0,192.0,101.8,103.4,99.8,108.15,35,20,15,0.5710000000000001,33,18,15,0.545,14,6,12,6,210.36,200.48,205.42000000000002
2017-12-29,1610612758,1610612756,2017,101.0,111.0,212.0,97.75,101.5,106.25,103.85,34,12,22,0.353,36,13,23,0.361,6,6,6,7,207.08,212.88,209.98000000000002
2017-12-29,1610612744,1610612766,2017,100.0,111.0,211.0,107.5,105.85,99.45,97.7,35,28,7,0.8,34,12,22,0.353,14,14,10,2,199.04,194.96,197.0
2017-12-29,1610612747,1610612746,2017,106.0,121.0,227.0,107.3,114.65,109.85,106.5,33,11,22,0.333,33,14,19,0.424,6,5,8,6,219.28,214.36,216.82
2017-12-28,1610612753,1610612765,2017,102.0,89.0,191.0,96.55,103.5,100.85,105.95,35,11,24,0.314,33,19,14,0.5760000000000001,6,5,11,8,203.64,206.0,204.82
2017-12-28,1610612738,1610612745,2017,99.0,98.0,197.0,99.65,105.5,112.7,109.85,38,28,10,0.737,32,25,7,0.7809999999999999,14,14,13,12,195.08,216.24,205.66000000000003
2017-12-28,1610612749,1610612750,2017,102.0,96.0,198.0,99.8,108.15,110.05,111.2,32,17,15,0.531,35,22,13,0.629,11,6,12,10,200.48,209.4,204.94
2017-12-28,1610612759,1610612752,2017,119.0,107.0,226.0,107.75,96.55,101.2,97.2,35,24,11,0.6859999999999999,34,17,17,0.5,16,8,15,2,204.12,200.28,202.2
2017-12-28,1610612757,1610612755,2017,114.0,110.0,224.0,104.75,105.45,97.85,106.0,33,17,16,0.515,33,15,18,0.455,7,10,7,8,209.44,207.68,208.56
2017-12-27,1610612766,1610612738,2017,91.0,102.0,193.0,99.45,97.7,99.65,105.5,33,12,21,0.364,37,27,10,0.73,10,2,14,13,194.96,195.08,195.02
2017-12-27,1610612754,1610612742,2017,94.0,98.0,192.0,92.05,92.25,104.45,102.7,34,19,15,0.5589999999999999,35,10,25,0.28600000000000003,11,8,8,2,187.28,213.0,200.14
2017-12-27,1610612737,1610612764,2017,113.0,99.0,212.0,96.35,95.7,94.7,91.35,33,8,25,0.242,34,19,15,0.5589999999999999,5,3,10,9,199.44,193.0,196.22
2017-12-27,1610612741,1610612752,2017,92.0,87.0,179.0,94.0,91.0,101.2,97.2,33,11,22,0.333,33,17,16,0.515,7,4,15,2,185.44,200.28,192.86
2017-12-27,1610612750,1610612743,2017,128.0,125.0,253.0,110.05,111.2,109.2,110.3,34,21,13,0.618,34,19,15,0.5589999999999999,11,10,12,7,209.4,217.04,213.22
2017-12-27,1610612740,1610612751,2017,128.0,113.0,241.0,100.45,104.8,96.7,98.4,33,17,16,0.515,33,12,21,0.364,8,9,7,5,200.8,196.96,198.88
2017-12-27,1610612760,1610612761,2017,124.0,107.0,231.0,101.8,103.4,100.6,99.2,34,19,15,0.5589999999999999,32,23,9,0.7190000000000001,13,6,12,11,210.36,206.0,208.18
2017-12-27,1610612758,1610612739,2017,109.0,95.0,204.0,97.75,101.5,101.9,101.55,33,11,22,0.333,34,24,10,0.706,5,6,14,10,207.08,195.48,201.28
2017-12-27,1610612744,1610612762,2017,126.0,101.0,227.0,107.5,105.85,95.55,106.55,34,27,7,0.794,35,15,20,0.429,13,14,12,3,199.04,200.2,199.62
2017-12-27,1610612747,1610612763,2017,99.0,109.0,208.0,107.3,114.65,98.25,97.5,32,11,21,0.344,34,10,24,0.294,6,5,7,3,219.28,193.96,206.62
2017-12-26,1610612765,1610612754,2017,107.0,83.0,190.0,100.85,105.95,92.05,92.25,32,18,14,0.563,33,19,14,0.5760000000000001,10,8,11,8,206.0,187.28,196.64
2017-12-26,1610612742,1610612761,2017,98.0,93.0,191.0,104.45,102.7,100.6,99.2,34,9,25,0.265,31,23,8,0.742,7,2,12,11,213.0,206.0,209.5
2017-12-26,1610612748,1610612753,2017,107.0,89.0,196.0,97.25,95.5,96.55,103.5,33,17,16,0.515,34,11,23,0.324,7,10,6,5,195.0,203.64,199.32
2017-12-26,1610612749,1610612741,2017,106.0,115.0,221.0,99.8,108.15,94.0,91.0,31,17,14,0.5479999999999999,32,10,22,0.313,11,6,7,3,200.48,185.44,192.95999999999998
2017-12-26,1610612759,1610612751,2017,109.0,97.0,206.0,107.75,96.55,96.7,98.4,34,23,11,0.6759999999999999,32,12,20,0.375,15,8,7,5,204.12,196.96,200.54000000000002
2017-12-26,1610612743,1610612762,2017,107.0,83.0,190.0,109.2,110.3,95.55,106.55,33,18,15,0.545,34,15,19,0.441,11,7,12,3,217.04,200.2,208.62
2017-12-26,1610612756,1610612763,2017,99.0,97.0,196.0,106.25,103.85,98.25,97.5,35,12,23,0.343,33,10,23,0.303,5,7,7,3,212.88,193.96,203.42000000000002
2017-12-26,1610612746,1610612758,2017,122.0,95.0,217.0,109.85,106.5,97.75,101.5,32,13,19,0.406,32,11,21,0.344,7,6,5,6,214.36,207.08,210.72000000000003
2017-12-25,1610612752,1610612755,2017,98.0,105.0,203.0,101.2,97.2,97.85,106.0,32,17,15,0.531,32,14,18,0.438,15,2,7,7,200.28,207.68,203.98000000000002
2017-12-25,1610612744,1610612739,2017,99.0,92.0,191.0,107.5,105.85,101.9,101.55,33,26,7,0.7879999999999999,33,24,9,0.727,12,14,14,10,199.04,195.48,197.26
2017-12-25,1610612738,1610612764,2017,103.0,111.0,214.0,99.65,105.5,94.7,91.35,36,27,9,0.75,33,18,15,0.545,14,13,10,8,195.08,193.0,194.04000000000002
2017-12-25,1610612760,1610612745,2017,112.0,107.0,219.0,101.8,103.4,112.7,109.85,33,18,15,0.545,31,25,6,0.8059999999999999,12,6,13,12,210.36,216.24,213.3
2017-12-25,1610612747,1610612750,2017,104.0,121.0,225.0,107.3,114.65,110.05,111.2,31,11,20,0.355,33,20,13,0.606,6,5,11,9,219.28,209.4,214.34
2017-12-23,1610612761,1610612755,2017,102.0,86.0,188.0,100.6,99.2,97.85,106.0,30,22,8,0.733,31,14,17,0.452,11,11,7,7,206.0,207.68,206.84
2017-12-23,1610612766,1610612749,2017,111.0,106.0,217.0,99.45,97.7,99.8,108.15,32,11,21,0.344,30,17,13,0.5670000000000001,9,2,11,6,194.96,200.48,197.72
2017-12-23,1610612754,1610612751,2017,123.0,119.0,242.0,92.05,92.25,96.7,98.4,32,18,14,0.563,31,12,19,0.387,10,8,7,5,187.28,196.96,192.12
2017-12-23,1610612764,1610612753,2017,130.0,103.0,233.0,94.7,91.35,96.55,103.5,32,17,15,0.531,33,11,22,0.333,9,8,6,5,193.0,203.64,198.32
2017-12-23,1610612737,1610612742,2017,112.0,107.0,219.0,96.35,95.7,104.45,102.7,32,7,25,0.219,33,9,24,0.273,4,3,7,2,199.44,213.0,206.22
2017-12-23,1610612738,1610612741,2017,117.0,92.0,209.0,99.65,105.5,94.0,91.0,35,26,9,0.743,31,10,21,0.32299999999999995,13,13,7,3,195.08,185.44,190.26
2017-12-23,1610612748,1610612740,2017,94.0,109.0,203.0,97.25,95.5,100.45,104.8,32,17,15,0.531,32,16,16,0.5,7,10,8,8,195.0,200.8,197.9
2017-12-23,1610612763,1610612746,2017,115.0,112.0,227.0,98.25,97.5,109.85,106.5,32,9,23,0.281,31,13,18,0.419,6,3,7,6,193.96,214.36,204.16000000000003
2017-12-23,1610612762,1610612760,2017,89.0,103.0,192.0,95.55,106.55,101.8,103.4,33,15,18,0.455,32,17,15,0.531,12,3,12,5,200.2,210.36,205.28
2017-12-23,1610612744,1610612743,2017,81.0,96.0,177.0,107.5,105.85,109.2,110.3,32,26,6,0.813,32,17,15,0.531,12,14,11,6,199.04,217.04,208.04
2017-12-23,1610612756,1610612750,2017,106.0,115.0,221.0,106.25,103.85,110.05,111.2,34,12,22,0.353,32,19,13,0.594,5,7,11,8,212.88,209.4,211.14
2017-12-23,1610612747,1610612757,2017,92.0,95.0,187.0,107.3,114.65,104.75,105.45,30,11,19,0.3670000000000001,32,16,16,0.5,6,5,7,9,219.28,209.44,214.36
2017-12-23,1610612758,1610612759,2017,99.0,108.0,207.0,97.75,101.5,107.75,96.55,31,11,20,0.355,33,22,11,0.667,5,6,15,7,207.08,204.12,205.60000000000002
2017-12-22,1610612765,1610612752,2017,104.0,101.0,205.0,100.85,105.95,101.2,97.2,31,17,14,0.5479999999999999,31,17,14,0.5479999999999999,9,8,15,2,206.0,200.28,203.14
2017-12-22,1610612753,1610612740,2017,97.0,111.0,208.0,96.55,103.5,100.45,104.8,32,11,21,0.344,31,15,16,0.484,6,5,8,7,203.64,200.8,202.22
2017-12-22,1610612751,1610612764,2017,119.0,84.0,203.0,96.7,98.4,94.7,91.35,30,11,19,0.3670000000000001,31,17,14,0.5479999999999999,6,5,9,8,196.96,193.0,194.98000000000002
2017-12-22,1610612748,1610612742,2017,113.0,101.0,214.0,97.25,95.5,104.45,102.7,31,16,15,0.516,32,9,23,0.281,6,10,7,2,195.0,213.0,204.0
2017-12-22,1610612745,1610612746,2017,118.0,128.0,246.0,112.7,109.85,109.85,106.5,30,25,5,0.833,30,12,18,0.4,13,12,7,5,216.24,214.36,215.3
2017-12-22,1610612749,1610612766,2017,109.0,104.0,213.0,99.8,108.15,99.45,97.7,29,16,13,0.552,31,11,20,0.355,10,6,9,2,200.48,194.96,197.72
2017-12-22,1610612760,1610612737,2017,120.0,117.0,237.0,101.8,103.4,96.35,95.7,31,16,15,0.516,31,7,24,0.226,11,5,4,3,210.36,199.44,204.9
2017-12-22,1610612757,1610612743,2017,85.0,102.0,187.0,104.75,105.45,109.2,110.3,31,16,15,0.516,31,16,15,0.516,7,9,11,5,209.44,217.04,213.24
2017-12-22,1610612744,1610612747,2017,113.0,106.0,219.0,107.5,105.85,107.3,114.65,31,25,6,0.8059999999999999,29,11,18,0.379,11,14,6,5,199.04,219.28,209.16
2017-12-21,1610612739,1610612741,2017,115.0,112.0,227.0,101.9,101.55,94.0,91.0,32,23,9,0.7190000000000001,30,10,20,0.333,13,10,7,3,195.48,185.44,190.45999999999998
2017-12-21,1610612755,1610612761,2017,109.0,114.0,223.0,97.85,106.0,100.6,99.2,30,14,16,0.467,29,21,8,0.7240000000000001,7,7,11,10,207.68,206.0,206.84
2017-12-21,1610612752,1610612738,2017,102.0,93.0,195.0,101.2,97.2,99.65,105.5,30,16,14,0.5329999999999999,34,26,8,0.765,14,2,13,13,200.28,195.08,197.68
2017-12-21,1610612756,1610612763,2017,97.0,95.0,192.0,106.25,103.85,98.25,97.5,33,11,22,0.333,31,9,22,0.29,4,7,6,3,212.88,193.96,203.42000000000002
2017-12-21,1610612762,1610612759,2017,100.0,89.0,189.0,95.55,106.55,107.75,96.55,32,14,18,0.438,32,22,10,0.688,11,3,15,7,200.2,204.12,202.16
2017-12-20,1610612766,1610612761,2017,111.0,129.0,240.0,99.45,97.7,100.6,99.2,30,11,19,0.3670000000000001,28,20,8,0.7140000000000001,9,2,11,9,194.96,206.0,200.48000000000002
2017-12-20,1610612737,1610612754,2017,95.0,105.0,200.0,96.35,95.7,92.05,92.25,30,7,23,0.233,31,17,14,0.5479999999999999,4,3,10,7,199.44,187.28,193.36
2017-12-20,1610612738,1610612748,2017,89.0,90.0,179.0,99.65,105.5,97.25,95.5,33,26,7,0.7879999999999999,30,15,15,0.5,13,13,6,9,195.08,195.0,195.04000000000002
2017-12-20,1610612751,1610612758,2017,99.0,104.0,203.0,96.7,98.4,97.75,101.5,29,11,18,0.379,30,10,20,0.333,6,5,5,5,196.96,207.08,202.02
2017-12-20,1610612741,1610612753,2017,112.0,94.0,206.0,94.0,91.0,96.55,103.5,29,9,20,0.31,31,11,20,0.355,6,3,6,5,185.44,203.64,194.54
2017-12-20,1610612745,1610612747,2017,116.0,122.0,238.0,112.7,109.85,107.3,114.65,29,25,4,0.862,28,10,18,0.35700000000000004,13,12,6,4,216.24,219.28,217.76
2017-12-20,1610612760,1610612762,2017,107.0,79.0,186.0,101.8,103.4,95.55,106.55,30,15,15,0.5,31,14,17,0.452,10,5,11,3,210.36,200.2,205.28
2017-12-20,1610612742,1610612765,2017,110.0,93.0,203.0,104.45,102.7,100.85,105.95,31,8,23,0.258,30,17,13,0.5670000000000001,6,2,9,8,213.0,206.0,209.5
2017-12-20,1610612743,1610612750,2017,104.0,112.0,216.0,109.2,110.3,110.05,111.2,30,16,14,0.5329999999999999,31,18,13,0.581,11,5,11,7,217.04,209.4,213.22
2017-12-20,1610612757,1610612759,2017,91.0,93.0,184.0,104.75,105.45,107.75,96.55,30,16,14,0.5329999999999999,31,21,10,0.677,7,9,15,6,209.44,204.12,206.78
2017-12-20,1610612744,1610612763,2017,97.0,84.0,181.0,107.5,105.85,98.25,97.5,30,24,6,0.8,30,9,21,0.3,10,14,6,3,199.04,193.96,196.5
2017-12-20,1610612746,1610612756,2017,108.0,95.0,203.0,109.85,106.5,106.25,103.85,29,11,18,0.379,32,11,21,0.344,6,5,4,7,214.36,212.88,213.62
2017-12-19,1610612755,1610612758,2017,95.0,101.0,196.0,97.85,106.0,97.75,101.5,29,14,15,0.483,29,9,20,0.31,7,7,5,4,207.68,207.08,207.38
2017-12-19,1610612764,1610612740,2017,116.0,106.0,222.0,94.7,91.35,100.45,104.8,30,16,14,0.5329999999999999,30,15,15,0.5,8,8,8,7,193.0,200.8,196.9
2017-12-19,1610612749,1610612739,2017,119.0,116.0,235.0,99.8,108.15,101.9,101.55,28,15,13,0.536,31,23,8,0.742,9,6,13,10,200.48,195.48,197.98
2017-12-18,1610612766,1610612752,2017,109.0,91.0,200.0,99.45,97.7,101.2,97.2,29,10,19,0.345,29,16,13,0.552,8,2,14,2,194.96,200.28,197.62
2017-12-18,1610612754,1610612738,2017,111.0,112.0,223.0,92.05,92.25,99.65,105.5,30,17,13,0.5670000000000001,32,25,7,0.7809999999999999,10,7,13,12,187.28,195.08,191.18
2017-12-18,1610612737,1610612748,2017,110.0,104.0,214.0,96.35,95.7,97.25,95.5,29,6,23,0.207,29,15,14,0.517,3,3,6,9,199.44,195.0,197.22
2017-12-18,1610612741,1610612755,2017,117.0,115.0,232.0,94.0,91.0,97.85,106.0,28,8,20,0.28600000000000003,28,14,14,0.5,5,3,7,7,185.44,207.68,196.56
2017-12-18,1610612745,1610612762,2017,120.0,99.0,219.0,112.7,109.85,95.55,106.55,28,24,4,0.857,30,14,16,0.467,12,12,11,3,216.24,200.2,208.22
2017-12-18,1610612750,1610612757,2017,108.0,107.0,215.0,110.05,111.2,104.75,105.45,30,17,13,0.5670000000000001,29,16,13,0.552,10,7,7,9,209.4,209.44,209.42000000000002
2017-12-18,1610612760,1610612743,2017,95.0,94.0,189.0,101.8,103.4,109.2,110.3,29,14,15,0.483,29,16,13,0.552,9,5,11,5,210.36,217.04,213.7
2017-12-18,1610612742,1610612756,2017,91.0,97.0,188.0,104.45,102.7,106.25,103.85,30,8,22,0.267,31,10,21,0.32299999999999995,6,2,4,6,213.0,212.88,212.94
2017-12-18,1610612759,1610612746,2017,109.0,91.0,200.0,107.75,96.55,109.85,106.5,30,20,10,0.667,28,11,17,0.393,14,6,6,5,204.12,214.36,209.24
2017-12-18,1610612747,1610612744,2017,114.0,116.0,230.0,107.3,114.65,107.5,105.85,27,10,17,0.37,29,23,6,0.7929999999999999,6,4,10,13,219.28,199.04,209.16
2017-12-17,1610612761,1610612758,2017,108.0,93.0,201.0,100.6,99.2,97.75,101.5,27,19,8,0.7040000000000001,28,9,19,0.321,10,9,5,4,206.0,207.08,206.54000000000002
2017-12-17,1610612765,1610612753,2017,114.0,110.0,224.0,100.85,105.95,96.55,103.5,29,16,13,0.552,30,11,19,0.3670000000000001,8,8,6,5,206.0,203.64,204.82
2017-12-17,1610612751,1610612754,2017,97.0,109.0,206.0,96.7,98.4,92.05,92.25,28,11,17,0.393,29,16,13,0.552,6,5,10,6,196.96,187.28,192.12
2017-12-17,1610612764,1610612739,2017,99.0,106.0,205.0,94.7,91.35,101.9,101.55,29,16,13,0.552,30,22,8,0.733,8,8,13,9,193.0,195.48,194.24
2017-12-16,1610612766,1610612757,2017,91.0,93.0,184.0,99.45,97.7,104.75,105.45,28,10,18,0.35700000000000004,28,15,13,0.536,8,2,7,8,194.96,209.44,202.2
2017-12-16,1610612739,1610612762,2017,109.0,100.0,209.0,101.9,101.55,95.55,106.55,29,21,8,0.7240000000000001,29,14,15,0.483,12,9,11,3,195.48,200.2,197.83999999999997
2017-12-16,1610612752,1610612760,2017,111.0,96.0,207.0,101.2,97.2,101.8,103.4,28,15,13,0.536,28,14,14,0.5,13,2,9,5,200.28,210.36,205.32
2017-12-16,1610612748,1610612746,2017,90.0,85.0,175.0,97.25,95.5,109.85,106.5,28,14,14,0.5,27,11,16,0.407,5,9,6,5,195.0,214.36,204.68
2017-12-16,1610612745,1610612749,2017,115.0,111.0,226.0,112.7,109.85,99.8,108.15,27,23,4,0.852,27,15,12,0.556,11,12,9,6,216.24,200.48,208.36
2017-12-16,1610612750,1610612756,2017,106.0,108.0,214.0,110.05,111.2,106.25,103.85,29,17,12,0.586,30,9,21,0.3,10,7,4,5,209.4,212.88,211.14
2017-12-16,1610612759,1610612742,2017,98.0,96.0,194.0,107.75,96.55,104.45,102.7,29,19,10,0.655,29,8,21,0.276,13,6,6,2,204.12,213.0,208.56
2017-12-16,1610612763,1610612738,2017,93.0,102.0,195.0,98.25,97.5,99.65,105.5,29,9,20,0.31,31,24,7,0.774,6,3,13,11,193.96,195.08,194.52
2017-12-15,1610612766,1610612748,2017,98.0,104.0,202.0,99.45,97.7,97.25,95.5,27,10,17,0.37,27,13,14,0.481,8,2,5,8,194.96,195.0,194.98000000000002
2017-12-15,1610612754,1610612765,2017,98.0,104.0,202.0,92.05,92.25,100.85,105.95,28,16,12,0.5710000000000001,28,15,13,0.536,10,6,8,7,187.28,206.0,196.64
2017-12-15,1610612753,1610612757,2017,88.0,95.0,183.0,96.55,103.5,104.75,105.45,29,11,18,0.379,27,14,13,0.519,6,5,7,7,203.64,209.44,206.54
2017-12-15,1610612755,1610612760,2017,117.0,119.0,236.0,97.85,106.0,101.8,103.4,27,14,13,0.519,27,13,14,0.481,7,7,9,4,207.68,210.36,209.02
2017-12-15,1610612764,1610612746,2017,100.0,91.0,191.0,94.7,91.35,109.85,106.5,28,15,13,0.536,26,11,15,0.423,7,8,6,5,193.0,214.36,203.68
2017-12-15,1610612738,1610612762,2017,95.0,107.0,202.0,99.65,105.5,95.55,106.55,30,24,6,0.8,28,13,15,0.464,13,11,11,2,195.08,200.2,197.64
2017-12-15,1610612761,1610612751,2017,120.0,87.0,207.0,100.6,99.2,96.7,98.4,26,18,8,0.6920000000000001,27,11,16,0.407,9,9,6,5,206.0,196.96,201.48000000000002
2017-12-15,1610612763,1610612737,2017,96.0,94.0,190.0,98.25,97.5,96.35,95.7,28,8,20,0.28600000000000003,28,6,22,0.214,5,3,3,3,193.96,199.44,196.7
2017-12-15,1610612749,1610612741,2017,109.0,115.0,224.0,99.8,108.15,94.0,91.0,26,15,11,0.5770000000000001,27,7,20,0.259,9,6,5,2,200.48,185.44,192.95999999999998
2017-12-15,1610612743,1610612740,2017,117.0,111.0,228.0,109.2,110.3,100.45,104.8,28,15,13,0.536,29,15,14,0.517,10,5,8,7,217.04,200.8,208.92000000000002
2017-12-15,1610612745,1610612759,2017,124.0,109.0,233.0,112.7,109.85,107.75,96.55,26,22,4,0.846,28,19,9,0.679,10,12,13,6,216.24,204.12,210.18
2017-12-14,1610612737,1610612765,2017,91.0,105.0,196.0,96.35,95.7,100.85,105.95,27,6,21,0.222,27,14,13,0.519,3,3,8,6,199.44,206.0,202.72
2017-12-14,1610612751,1610612752,2017,104.0,111.0,215.0,96.7,98.4,101.2,97.2,26,11,15,0.423,27,14,13,0.519,6,5,13,1,196.96,200.28,198.62
2017-12-14,1610612739,1610612747,2017,121.0,112.0,233.0,101.9,101.55,107.3,114.65,28,20,8,0.7140000000000001,26,10,16,0.385,11,9,6,4,195.48,219.28,207.38
2017-12-14,1610612750,1610612758,2017,119.0,96.0,215.0,110.05,111.2,97.75,101.5,28,16,12,0.5710000000000001,27,9,18,0.333,9,7,5,4,209.4,207.08,208.24
2017-12-14,1610612744,1610612742,2017,112.0,97.0,209.0,107.5,105.85,104.45,102.7,28,22,6,0.7859999999999999,28,8,20,0.28600000000000003,9,13,6,2,199.04,213.0,206.01999999999998
2017-12-13,1610612754,1610612760,2017,95.0,100.0,195.0,92.05,92.25,101.8,103.4,27,16,11,0.593,26,12,14,0.462,10,6,9,3,187.28,210.36,198.82
2017-12-13,1610612753,1610612746,2017,95.0,106.0,201.0,96.55,103.5,109.85,106.5,28,11,17,0.393,25,10,15,0.4,6,5,6,4,203.64,214.36,209.0
2017-12-13,1610612764,1610612763,2017,93.0,87.0,180.0,94.7,91.35,98.25,97.5,27,14,13,0.519,27,8,19,0.29600000000000004,6,8,5,3,193.0,193.96,193.48000000000002
2017-12-13,1610612738,1610612743,2017,124.0,118.0,242.0,99.65,105.5,109.2,110.3,29,23,6,0.7929999999999999,27,15,12,0.556,12,11,10,5,195.08,217.04,206.06
2017-12-13,1610612748,1610612757,2017,95.0,102.0,197.0,97.25,95.5,104.75,105.45,26,13,13,0.5,26,13,13,0.5,5,8,7,6,195.0,209.44,202.22
2017-12-13,1610612741,1610612762,2017,103.0,100.0,203.0,94.0,91.0,95.55,106.55,26,6,20,0.231,27,13,14,0.481,4,2,11,2,185.44,200.2,192.82
2017-12-13,1610612740,1610612749,2017,115.0,108.0,223.0,100.45,104.8,99.8,108.15,28,14,14,0.5,25,15,10,0.6,7,7,9,6,200.8,200.48,200.64
2017-12-13,1610612756,1610612761,2017,109.0,115.0,224.0,106.25,103.85,100.6,99.2,29,9,20,0.31,25,17,8,0.68,4,5,9,8,212.88,206.0,209.44
2017-12-13,1610612745,1610612766,2017,108.0,96.0,204.0,112.7,109.85,99.45,97.7,25,21,4,0.84,26,10,16,0.385,9,12,8,2,216.24,194.96,205.60000000000002
2017-12-12,1610612739,1610612737,2017,123.0,114.0,237.0,101.9,101.55,96.35,95.7,27,19,8,0.7040000000000001,26,6,20,0.231,10,9,3,3,195.48,199.44,197.45999999999998
2017-12-12,1610612765,1610612743,2017,84.0,103.0,187.0,100.85,105.95,109.2,110.3,26,14,12,0.5379999999999999,26,14,12,0.5379999999999999,8,6,10,4,206.0,217.04,211.51999999999998
2017-12-12,1610612752,1610612747,2017,113.0,109.0,222.0,101.2,97.2,107.3,114.65,26,13,13,0.5,25,10,15,0.4,12,1,6,4,200.28,219.28,209.78
2017-12-12,1610612751,1610612764,2017,103.0,98.0,201.0,96.7,98.4,94.7,91.35,25,10,15,0.4,26,14,12,0.5379999999999999,5,5,6,8,196.96,193.0,194.98000000000002
2017-12-12,1610612742,1610612759,2017,95.0,89.0,184.0,104.45,102.7,107.75,96.55,27,7,20,0.259,27,19,8,0.7040000000000001,5,2,13,6,213.0,204.12,208.56
2017-12-12,1610612750,1610612755,2017,112.0,118.0,230.0,110.05,111.2,97.85,106.0,27,16,11,0.593,26,13,13,0.5,9,7,7,6,209.4,207.68,208.54000000000002
2017-12-12,1610612758,1610612756,2017,99.0,92.0,191.0,97.75,101.5,106.25,103.85,26,8,18,0.308,28,9,19,0.321,4,4,4,5,207.08,212.88,209.98000000000002
2017-12-11,1610612741,1610612738,2017,108.0,85.0,193.0,94.0,91.0,99.65,105.5,25,5,20,0.2,28,23,5,0.821,3,2,12,11,185.44,195.08,190.26
2017-12-11,1610612745,1610612740,2017,130.0,123.0,253.0,112.7,109.85,100.45,104.8,24,20,4,0.833,27,14,13,0.519,8,12,7,7,216.24,200.8,208.52
2017-12-11,1610612763,1610612748,2017,82.0,107.0,189.0,98.25,97.5,97.25,95.5,26,8,18,0.308,25,12,13,0.48,5,3,5,7,193.96,195.0,194.48000000000002
2017-12-11,1610612760,1610612766,2017,103.0,116.0,219.0,101.8,103.4,99.45,97.7,25,12,13,0.48,25,9,16,0.36,9,3,8,1,210.36,194.96,202.66000000000003
2017-12-11,1610612744,1610612757,2017,111.0,104.0,215.0,107.5,105.85,104.75,105.45,27,21,6,0.778,25,13,12,0.52,8,13,7,6,199.04,209.44,204.24
2017-12-11,1610612746,1610612761,2017,96.0,91.0,187.0,109.85,106.5,100.6,99.2,24,9,15,0.375,24,17,7,0.708,5,4,9,8,214.36,206.0,210.18
2017-12-10,1610612758,1610612761,2017,87.0,102.0,189.0,97.75,101.5,100.6,99.2,25,8,17,0.32,23,16,7,0.696,4,4,9,7,207.08,206.0,206.54000000000002
2017-12-10,1610612765,1610612738,2017,81.0,91.0,172.0,100.85,105.95,99.65,105.5,25,14,11,0.56,27,22,5,0.815,8,6,12,10,206.0,195.08,200.54000000000002
2017-12-10,1610612754,1610612743,2017,126.0,116.0,242.0,92.05,92.25,109.2,110.3,26,15,11,0.5770000000000001,25,14,11,0.56,9,6,10,4,187.28,217.04,202.16
2017-12-10,1610612750,1610612742,2017,97.0,92.0,189.0,110.05,111.2,104.45,102.7,26,15,11,0.5770000000000001,26,7,19,0.269,8,7,5,2,209.4,213.0,211.2
2017-12-10,1610612740,1610612755,2017,131.0,124.0,255.0,100.45,104.8,97.85,106.0,26,13,13,0.5,25,13,12,0.52,6,7,7,6,200.8,207.68,204.24
2017-12-10,1610612752,1610612737,2017,111.0,107.0,218.0,101.2,97.2,96.35,95.7,25,12,13,0.48,25,6,19,0.24,11,1,3,3,200.28,199.44,199.86
2017-12-09,1610612746,1610612764,2017,113.0,112.0,225.0,109.85,106.5,94.7,91.35,23,8,15,0.348,25,14,11,0.56,4,4,6,8,214.36,193.0,203.68
2017-12-09,1610612751,1610612748,2017,89.0,101.0,190.0,96.7,98.4,97.25,95.5,24,10,14,0.417,24,11,13,0.458,5,5,5,6,196.96,195.0,195.98000000000002
2017-12-09,1610612766,1610612747,2017,99.0,110.0,209.0,99.45,97.7,107.3,114.65,24,9,15,0.375,24,9,15,0.375,8,1,6,3,194.96,219.28,207.12
2017-12-09,1610612737,1610612753,2017,117.0,110.0,227.0,96.35,95.7,96.55,103.5,24,5,19,0.208,27,11,16,0.407,2,3,6,5,199.44,203.64,201.54
2017-12-09,1610612739,1610612755,2017,105.0,98.0,203.0,101.9,101.55,97.85,106.0,26,18,8,0.6920000000000001,24,13,11,0.542,9,9,7,6,195.48,207.68,201.57999999999998
2017-12-09,1610612741,1610612752,2017,104.0,102.0,206.0,94.0,91.0,101.2,97.2,24,4,20,0.16699999999999998,24,12,12,0.5,2,2,11,1,185.44,200.28,192.86
2017-12-09,1610612749,1610612762,2017,117.0,100.0,217.0,99.8,108.15,95.55,106.55,24,14,10,0.583,26,13,13,0.5,8,6,11,2,200.48,200.2,200.33999999999997
2017-12-09,1610612763,1610612760,2017,101.0,102.0,203.0,98.25,97.5,101.8,103.4,25,8,17,0.32,24,11,13,0.458,5,3,9,2,193.96,210.36,202.16000000000003
2017-12-09,1610612756,1610612759,2017,101.0,104.0,205.0,106.25,103.85,107.75,96.55,27,9,18,0.333,26,18,8,0.6920000000000001,4,5,13,5,212.88,204.12,208.5
2017-12-09,1610612757,1610612745,2017,117.0,124.0,241.0,104.75,105.45,112.7,109.85,24,13,11,0.542,23,19,4,0.826,7,6,8,11,209.44,216.24,212.84
2017-12-08,1610612766,1610612741,2017,111.0,119.0,230.0,99.45,97.7,94.0,91.0,23,9,14,0.391,23,3,20,0.13,8,1,2,1,194.96,185.44,190.2
2017-12-08,1610612765,1610612744,2017,98.0,102.0,200.0,100.85,105.95,107.5,105.85,24,14,10,0.583,26,20,6,0.769,8,6,8,12,206.0,199.04,202.51999999999998
2017-12-08,1610612754,1610612739,2017,106.0,102.0,208.0,92.05,92.25,101.9,101.55,25,14,11,0.56,25,18,7,0.72,8,6,9,9,187.28,195.48,191.38
2017-12-08,1610612753,1610612743,2017,89.0,103.0,192.0,96.55,103.5,109.2,110.3,26,11,15,0.423,24,13,11,0.542,6,5,10,3,203.64,217.04,210.33999999999997
2017-12-08,1610612763,1610612761,2017,107.0,116.0,223.0,98.25,97.5,100.6,99.2,24,8,16,0.333,22,15,7,0.682,5,3,9,6,193.96,206.0,199.98000000000002
2017-12-08,1610612749,1610612742,2017,109.0,102.0,211.0,99.8,108.15,104.45,102.7,23,13,10,0.565,25,7,18,0.28,7,6,5,2,200.48,213.0,206.74
2017-12-08,1610612740,1610612758,2017,109.0,116.0,225.0,100.45,104.8,97.75,101.5,25,13,12,0.52,24,7,17,0.292,6,7,4,3,200.8,207.08,203.94
2017-12-08,1610612759,1610612738,2017,105.0,102.0,207.0,107.75,96.55,99.65,105.5,25,17,8,0.68,26,22,4,0.846,12,5,12,10,204.12,195.08,199.60000000000002
2017-12-07,1610612755,1610612747,2017,104.0,107.0,211.0,97.85,106.0,107.3,114.65,23,13,10,0.565,23,8,15,0.348,7,6,6,2,207.68,219.28,213.48000000000002
2017-12-07,1610612756,1610612764,2017,99.0,109.0,208.0,106.25,103.85,94.7,91.35,26,9,17,0.34600000000000003,24,13,11,0.542,4,5,6,7,212.88,193.0,202.94
2017-12-07,1610612751,1610612760,2017,100.0,95.0,195.0,96.7,98.4,101.8,103.4,23,9,14,0.391,23,11,12,0.478,4,5,9,2,196.96,210.36,203.66000000000003
2017-12-07,1610612762,1610612745,2017,101.0,112.0,213.0,95.55,106.55,112.7,109.85,25,13,12,0.52,22,18,4,0.818,11,2,8,10,200.2,216.24,208.22
2017-12-06,1610612739,1610612758,2017,101.0,95.0,196.0,101.9,101.55,97.75,101.5,24,17,7,0.708,23,7,16,0.304,8,9,4,3,195.48,207.08,201.28
2017-12-06,1610612754,1610612741,2017,98.0,96.0,194.0,92.05,92.25,94.0,91.0,24,13,11,0.542,22,3,19,0.136,7,6,2,1,187.28,185.44,186.36
2017-12-06,1610612753,1610612737,2017,110.0,106.0,216.0,96.55,103.5,96.35,95.7,25,10,15,0.4,23,5,18,0.217,5,5,2,3,203.64,199.44,201.54
2017-12-06,1610612738,1610612742,2017,97.0,90.0,187.0,99.65,105.5,104.45,102.7,25,21,4,0.84,24,7,17,0.292,11,10,5,2,195.08,213.0,204.04000000000002
2017-12-06,1610612752,1610612763,2017,99.0,88.0,187.0,101.2,97.2,98.25,97.5,23,11,12,0.478,23,8,15,0.348,10,1,5,3,200.28,193.96,197.12
2017-12-06,1610612766,1610612744,2017,87.0,101.0,188.0,99.45,97.7,107.5,105.85,22,9,13,0.409,25,19,6,0.76,8,1,8,11,194.96,199.04,197.0
2017-12-06,1610612749,1610612765,2017,104.0,100.0,204.0,99.8,108.15,100.85,105.95,22,12,10,0.545,23,14,9,0.609,6,6,8,6,200.48,206.0,203.24
2017-12-06,1610612740,1610612743,2017,123.0,114.0,237.0,100.45,104.8,109.2,110.3,24,12,12,0.5,23,13,10,0.565,5,7,10,3,200.8,217.04,208.92000000000002
2017-12-06,1610612759,1610612748,2017,117.0,105.0,222.0,107.75,96.55,97.25,95.5,24,16,8,0.667,23,11,12,0.478,11,5,5,6,204.12,195.0,199.56
2017-12-06,1610612746,1610612750,2017,107.0,113.0,220.0,109.85,106.5,110.05,111.2,22,8,14,0.364,25,14,11,0.56,4,4,8,6,214.36,209.4,211.88
2017-12-05,1610612761,1610612756,2017,126.0,113.0,239.0,100.6,99.2,106.25,103.85,21,14,7,0.667,25,9,16,0.36,8,6,4,5,206.0,212.88,209.44
2017-12-05,1610612760,1610612762,2017,100.0,94.0,194.0,101.8,103.4,95.55,106.55,22,10,12,0.455,24,13,11,0.542,8,2,11,2,210.36,200.2,205.28
2017-12-05,1610612757,1610612764,2017,92.0,106.0,198.0,104.75,105.45,94.7,91.35,23,13,10,0.565,23,12,11,0.522,7,6,6,6,209.44,193.0,201.22
2017-12-04,1610612766,1610612753,2017,104.0,94.0,198.0,99.45,97.7,96.55,103.5,21,8,13,0.381,24,10,14,0.417,7,1,5,5,194.96,203.64,199.3
2017-12-04,1610612754,1610612752,2017,115.0,97.0,212.0,92.05,92.25,101.2,97.2,23,12,11,0.522,22,11,11,0.5,6,6,10,1,187.28,200.28,193.78
2017-12-04,1610612755,1610612756,2017,101.0,115.0,216.0,97.85,106.0,106.25,103.85,22,13,9,0.591,24,8,16,0.333,7,6,4,4,207.68,212.88,210.28
2017-12-04,1610612737,1610612751,2017,90.0,110.0,200.0,96.35,95.7,96.7,98.4,22,5,17,0.227,22,8,14,0.364,2,3,4,4,199.44,196.96,198.2
2017-12-04,1610612738,1610612749,2017,111.0,100.0,211.0,99.65,105.5,99.8,108.15,24,20,4,0.833,21,12,9,0.5710000000000001,10,10,6,6,195.08,200.48,197.78
2017-12-04,1610612741,1610612739,2017,91.0,113.0,204.0,94.0,91.0,101.9,101.55,21,3,18,0.14300000000000002,23,16,7,0.696,2,1,8,8,185.44,195.48,190.45999999999998
2017-12-04,1610612763,1610612750,2017,95.0,92.0,187.0,98.25,97.5,110.05,111.2,22,7,15,0.318,24,14,10,0.583,4,3,8,6,193.96,209.4,201.68
2017-12-04,1610612740,1610612744,2017,115.0,125.0,240.0,100.45,104.8,107.5,105.85,23,12,11,0.522,24,18,6,0.75,5,7,8,10,200.8,199.04,199.92000000000002
2017-12-04,1610612742,1610612743,2017,122.0,105.0,227.0,104.45,102.7,109.2,110.3,23,6,17,0.261,22,13,9,0.591,4,2,10,3,213.0,217.04,215.01999999999998
2017-12-04,1610612759,1610612765,2017,96.0,93.0,189.0,107.75,96.55,100.85,105.95,23,15,8,0.652,22,14,8,0.636,10,5,8,6,204.12,206.0,205.06
2017-12-04,1610612762,1610612764,2017,116.0,69.0,185.0,95.55,106.55,94.7,91.35,23,12,11,0.522,22,12,10,0.545,10,2,6,6,200.2,193.0,196.6
2017-12-03,1610612752,1610612753,2017,100.0,105.0,205.0,101.2,97.2,96.55,103.5,21,11,10,0.524,23,9,14,0.391,10,1,5,4,200.28,203.64,201.95999999999998
2017-12-03,1610612748,1610612744,2017,95.0,123.0,218.0,97.25,95.5,107.5,105.85,22,11,11,0.5,23,17,6,0.7390000000000001,5,6,8,9,195.0,199.04,197.01999999999998
2017-12-03,1610612750,1610612746,2017,112.0,106.0,218.0,110.05,111.2,109.85,106.5,23,13,10,0.565,21,8,13,0.381,7,6,4,4,209.4,214.36,211.88
2017-12-03,1610612760,1610612759,2017,90.0,87.0,177.0,101.8,103.4,107.75,96.55,21,9,12,0.429,22,15,7,0.682,7,2,10,5,210.36,204.12,207.24
2017-12-03,1610612747,1610612745,2017,95.0,118.0,213.0,107.3,114.65,112.7,109.85,22,8,14,0.364,21,17,4,0.81,6,2,8,9,219.28,216.24,217.76
2017-12-02,1610612738,1610612756,2017,116.0,111.0,227.0,99.65,105.5,106.25,103.85,23,19,4,0.826,23,8,15,0.348,9,10,4,4,195.08,212.88,203.98000000000002
2017-12-02,1610612742,1610612746,2017,108.0,82.0,190.0,104.45,102.7,109.85,106.5,22,5,17,0.227,20,8,12,0.4,3,2,4,4,213.0,214.36,213.68
2017-12-02,1610612751,1610612737,2017,102.0,114.0,216.0,96.7,98.4,96.35,95.7,21,8,13,0.381,21,4,17,0.19,4,4,2,2,196.96,199.44,198.2
2017-12-02,1610612739,1610612763,2017,116.0,111.0,227.0,101.9,101.55,98.25,97.5,22,15,7,0.682,21,7,14,0.333,7,8,4,3,195.48,193.96,194.72
2017-12-02,1610612755,1610612765,2017,108.0,103.0,211.0,97.85,106.0,100.85,105.95,21,12,9,0.5710000000000001,21,14,7,0.667,6,6,8,6,207.68,206.0,206.84
2017-12-02,1610612749,1610612758,2017,109.0,104.0,213.0,99.8,108.15,97.75,101.5,20,11,9,0.55,22,7,15,0.318,5,6,4,3,200.48,207.08,203.78
2017-12-02,1610612743,1610612747,2017,115.0,100.0,215.0,109.2,110.3,107.3,114.65,21,12,9,0.5710000000000001,21,8,13,0.381,9,3,6,2,217.04,219.28,218.16
2017-12-02,1610612757,1610612740,2017,116.0,123.0,239.0,104.75,105.45,100.45,104.8,22,13,9,0.591,22,11,11,0.5,7,6,5,6,209.44,200.8,205.12
2017-12-01,1610612753,1610612744,2017,112.0,133.0,245.0,96.55,103.5,107.5,105.85,22,9,13,0.409,22,16,6,0.727,5,4,8,8,203.64,199.04,201.33999999999997
2017-12-01,1610612764,1610612765,2017,109.0,91.0,200.0,94.7,91.35,100.85,105.95,21,11,10,0.524,20,14,6,0.7,5,6,8,6,193.0,206.0,199.5
2017-12-01,1610612761,1610612754,2017,120.0,115.0,235.0,100.6,99.2,92.05,92.25,20,13,7,0.65,22,12,10,0.545,7,6,6,6,206.0,187.28,196.64
2017-12-01,1610612748,1610612766,2017,105.0,100.0,205.0,97.25,95.5,99.45,97.7,21,10,11,0.476,20,8,12,0.4,4,6,7,1,195.0,194.96,194.98000000000002
2017-12-01,1610612741,1610612758,2017,106.0,107.0,213.0,94.0,91.0,97.75,101.5,20,3,17,0.15,21,6,15,0.28600000000000003,2,1,4,2,185.44,207.08,196.26
2017-12-01,1610612763,1610612759,2017,79.0,95.0,174.0,98.25,97.5,107.75,96.55,20,7,13,0.35,21,14,7,0.667,4,3,10,4,193.96,204.12,199.04000000000002
2017-12-01,1610612760,1610612750,2017,111.0,107.0,218.0,101.8,103.4,110.05,111.2,20,8,12,0.4,22,13,9,0.591,6,2,7,6,210.36,209.4,209.88
2017-12-01,1610612762,1610612740,2017,114.0,108.0,222.0,95.55,106.55,100.45,104.8,22,11,11,0.5,21,11,10,0.524,9,2,5,6,200.2,200.8,200.5
2017-11-30,1610612737,1610612739,2017,114.0,121.0,235.0,96.35,95.7,101.9,101.55,20,4,16,0.2,21,14,7,0.667,2,2,7,7,199.44,195.48,197.45999999999998
2017-11-30,1610612738,1610612755,2017,108.0,97.0,205.0,99.65,105.5,97.85,106.0,22,18,4,0.818,20,12,8,0.6,8,10,6,6,195.08,207.68,201.38
2017-11-30,1610612743,1610612741,2017,111.0,110.0,221.0,109.2,110.3,94.0,91.0,20,11,9,0.55,19,3,16,0.158,8,3,2,1,217.04,185.44,201.24
2017-11-30,1610612757,1610612749,2017,91.0,103.0,194.0,104.75,105.45,99.8,108.15,21,13,8,0.619,19,10,9,0.526,7,6,5,5,209.44,200.48,204.95999999999998
2017-11-30,1610612746,1610612762,2017,107.0,126.0,233.0,109.85,106.5,95.55,106.55,19,8,11,0.421,21,10,11,0.476,4,4,9,1,214.36,200.2,207.28
2017-11-29,1610612765,1610612756,2017,131.0,107.0,238.0,100.85,105.95,106.25,103.85,19,13,6,0.684,22,8,14,0.364,7,6,4,4,206.0,212.88,209.44
2017-11-29,1610612753,1610612760,2017,121.0,108.0,229.0,96.55,103.5,101.8,103.4,21,8,13,0.381,19,8,11,0.421,4,4,6,2,203.64,210.36,207.0
2017-11-29,1610612755,1610612764,2017,118.0,113.0,231.0,97.85,106.0,94.7,91.35,19,11,8,0.579,20,11,9,0.55,5,6,5,6,207.68,193.0,200.34
2017-11-29,1610612752,1610612748,2017,115.0,86.0,201.0,101.2,97.2,97.25,95.5,20,10,10,0.5,20,10,10,0.5,9,1,4,6,200.28,195.0,197.64
2017-11-29,1610612761,1610612766,2017,126.0,113.0,239.0,100.6,99.2,99.45,97.7,19,12,7,0.632,19,8,11,0.421,6,6,7,1,206.0,194.96,200.48000000000002
2017-11-29,1610612745,1610612754,2017,118.0,97.0,215.0,112.7,109.85,92.05,92.25,20,16,4,0.8,21,12,9,0.5710000000000001,7,9,6,6,216.24,187.28,201.76
2017-11-29,1610612740,1610612750,2017,102.0,120.0,222.0,100.45,104.8,110.05,111.2,20,11,9,0.55,21,12,9,0.5710000000000001,5,6,7,5,200.8,209.4,205.10000000000002
2017-11-29,1610612742,1610612751,2017,104.0,109.0,213.0,104.45,102.7,96.7,98.4,21,5,16,0.238,20,7,13,0.35,3,2,4,3,213.0,196.96,204.98000000000002
2017-11-29,1610612759,1610612763,2017,104.0,95.0,199.0,107.75,96.55,98.25,97.5,20,13,7,0.65,19,7,12,0.368,9,4,4,3,204.12,193.96,199.04000000000002
2017-11-29,1610612747,1610612744,2017,123.0,127.0,250.0,107.3,114.65,107.5,105.85,20,8,12,0.4,21,15,6,0.7140000000000001,6,2,8,7,219.28,199.04,209.16
2017-11-28,1610612739,1610612748,2017,108.0,97.0,205.0,101.9,101.55,97.25,95.5,20,13,7,0.65,19,10,9,0.526,6,7,4,6,195.48,195.0,195.24
2017-11-28,1610612741,1610612756,2017,99.0,104.0,203.0,94.0,91.0,106.25,103.85,18,3,15,0.16699999999999998,21,7,14,0.333,2,1,4,3,185.44,212.88,199.16
2017-11-28,1610612750,1610612764,2017,89.0,92.0,181.0,110.05,111.2,94.7,91.35,20,12,8,0.6,19,10,9,0.526,7,5,5,5,209.4,193.0,201.2
2017-11-28,1610612762,1610612743,2017,106.0,77.0,183.0,95.55,106.55,109.2,110.3,20,9,11,0.45,19,11,8,0.579,8,1,8,3,200.2,217.04,208.62
2017-11-28,1610612758,1610612749,2017,87.0,112.0,199.0,97.75,101.5,99.8,108.15,20,6,14,0.3,18,9,9,0.5,4,2,5,4,207.08,200.48,203.78
2017-11-27,1610612754,1610612753,2017,121.0,109.0,230.0,92.05,92.25,96.55,103.5,20,11,9,0.55,20,8,12,0.4,5,6,4,4,187.28,203.64,195.45999999999998
2017-11-27,1610612755,1610612739,2017,91.0,113.0,204.0,97.85,106.0,101.9,101.55,18,11,7,0.611,19,12,7,0.632,5,6,6,6,207.68,195.48,201.57999999999998
2017-11-27,1610612738,1610612765,2017,108.0,118.0,226.0,99.65,105.5,100.85,105.95,21,18,3,0.857,18,12,6,0.667,8,10,7,5,195.08,206.0,200.54000000000002
2017-11-27,1610612752,1610612757,2017,91.0,103.0,194.0,101.2,97.2,104.75,105.45,19,10,9,0.526,20,12,8,0.6,9,1,7,5,200.28,209.44,204.86
2017-11-27,1610612745,1610612751,2017,117.0,103.0,220.0,112.7,109.85,96.7,98.4,19,15,4,0.789,19,7,12,0.368,6,9,4,3,216.24,196.96,206.60000000000002
2017-11-27,1610612759,1610612742,2017,115.0,108.0,223.0,107.75,96.55,104.45,102.7,19,12,7,0.632,20,5,15,0.25,8,4,3,2,204.12,213.0,208.56
2017-11-27,1610612744,1610612758,2017,106.0,110.0,216.0,107.5,105.85,97.75,101.5,20,15,5,0.75,19,5,14,0.263,8,7,4,1,199.04,207.08,203.06
2017-11-27,1610612746,1610612747,2017,120.0,115.0,235.0,109.85,106.5,107.3,114.65,18,7,11,0.389,19,8,11,0.421,3,4,6,2,214.36,219.28,216.82
2017-11-26,1610612741,1610612748,2017,93.0,100.0,193.0,94.0,91.0,97.25,95.5,17,3,14,0.17600000000000002,18,9,9,0.5,2,1,4,5,185.44,195.0,190.22
2017-11-26,1610612750,1610612756,2017,119.0,108.0,227.0,110.05,111.2,106.25,103.85,19,11,8,0.579,20,7,13,0.35,6,5,4,3,209.4,212.88,211.14
2017-11-26,1610612763,1610612751,2017,88.0,98.0,186.0,98.25,97.5,96.7,98.4,18,7,11,0.389,18,6,12,0.333,4,3,4,2,193.96,196.96,195.46
2017-11-25,1610612766,1610612759,2017,86.0,106.0,192.0,99.45,97.7,107.75,96.55,18,8,10,0.444,18,11,7,0.611,7,1,8,3,194.96,204.12,199.54000000000002
2017-11-25,1610612755,1610612753,2017,130.0,111.0,241.0,97.85,106.0,96.55,103.5,17,10,7,0.588,19,8,11,0.421,4,6,4,4,207.68,203.64,205.66
2017-11-25,1610612764,1610612757,2017,105.0,108.0,213.0,94.7,91.35,104.75,105.45,18,10,8,0.556,19,11,8,0.579,5,5,7,4,193.0,209.44,201.22
2017-11-25,1610612737,1610612761,2017,78.0,112.0,190.0,96.35,95.7,100.6,99.2,19,4,15,0.211,18,11,7,0.611,2,2,6,5,199.44,206.0,202.72
2017-11-25,1610612754,1610612738,2017,98.0,108.0,206.0,92.05,92.25,99.65,105.5,19,11,8,0.579,20,17,3,0.85,5,6,8,9,187.28,195.08,191.18
2017-11-25,1610612745,1610612752,2017,117.0,102.0,219.0,112.7,109.85,101.2,97.2,18,14,4,0.778,18,10,8,0.556,5,9,9,1,216.24,200.28,208.26
2017-11-25,1610612742,1610612760,2017,97.0,81.0,178.0,104.45,102.7,101.8,103.4,19,4,15,0.211,18,8,10,0.444,2,2,6,2,213.0,210.36,211.68
2017-11-25,1610612744,1610612740,2017,110.0,95.0,205.0,107.5,105.85,100.45,104.8,19,14,5,0.737,19,11,8,0.579,7,7,5,6,199.04,200.8,199.92000000000002
2017-11-25,1610612762,1610612749,2017,121.0,108.0,229.0,95.55,106.55,99.8,108.15,19,8,11,0.421,17,9,8,0.529,7,1,5,4,200.2,200.48,200.33999999999997
2017-11-25,1610612758,1610612746,2017,95.0,97.0,192.0,97.75,101.5,109.85,106.5,18,5,13,0.278,17,6,11,0.353,4,1,3,3,207.08,214.36,210.72000000000003
2017-11-24,1610612751,1610612757,2017,125.0,127.0,252.0,96.7,98.4,104.75,105.45,17,6,11,0.353,18,10,8,0.556,4,2,7,3,196.96,209.44,203.2
2017-11-24,1610612737,1610612752,2017,116.0,104.0,220.0,96.35,95.7,101.2,97.2,18,3,15,0.16699999999999998,17,10,7,0.588,1,2,9,1,199.44,200.28,199.86
2017-11-24,1610612738,1610612753,2017,118.0,103.0,221.0,99.65,105.5,96.55,103.5,19,16,3,0.8420000000000001,18,8,10,0.444,7,9,4,4,195.08,203.64,199.36
2017-11-24,1610612739,1610612766,2017,100.0,99.0,199.0,101.9,101.55,99.45,97.7,18,11,7,0.611,17,8,9,0.471,5,6,7,1,195.48,194.96,195.22
2017-11-24,1610612754,1610612761,2017,107.0,104.0,211.0,92.05,92.25,100.6,99.2,18,10,8,0.556,17,11,6,0.647,4,6,6,5,187.28,206.0,196.64
2017-11-24,1610612750,1610612748,2017,97.0,109.0,206.0,110.05,111.2,97.25,95.5,18,11,7,0.611,17,8,9,0.471,6,5,4,4,209.4,195.0,202.2
2017-11-24,1610612760,1610612765,2017,98.0,99.0,197.0,101.8,103.4,100.85,105.95,17,8,9,0.471,17,11,6,0.647,6,2,7,4,210.36,206.0,208.18
2017-11-24,1610612743,1610612763,2017,104.0,92.0,196.0,109.2,110.3,98.25,97.5,18,10,8,0.556,17,7,10,0.412,7,3,4,3,217.04,193.96,205.5
2017-11-24,1610612756,1610612740,2017,91.0,115.0,206.0,106.25,103.85,100.45,104.8,19,7,12,0.368,18,10,8,0.556,4,3,5,5,212.88,200.8,206.84
2017-11-24,1610612744,1610612741,2017,143.0,94.0,237.0,107.5,105.85,94.0,91.0,18,13,5,0.722,16,3,13,0.188,6,7,2,1,199.04,185.44,192.24
2017-11-22,1610612766,1610612764,2017,129.0,124.0,253.0,99.45,97.7,94.7,91.35,16,7,9,0.438,17,10,7,0.588,6,1,5,5,194.96,193.0,193.98000000000002
2017-11-22,1610612739,1610612751,2017,119.0,109.0,228.0,101.9,101.55,96.7,98.4,17,10,7,0.588,16,6,10,0.375,4,6,4,2,195.48,196.96,196.22
2017-11-22,1610612755,1610612757,2017,101.0,81.0,182.0,97.85,106.0,104.75,105.45,16,9,7,0.563,17,10,7,0.588,3,6,7,3,207.68,209.44,208.56
2017-11-22,1610612737,1610612746,2017,103.0,116.0,219.0,96.35,95.7,109.85,106.5,17,3,14,0.17600000000000002,16,5,11,0.313,1,2,3,2,199.44,214.36,206.9
2017-11-22,1610612748,1610612738,2017,104.0,98.0,202.0,97.25,95.5,99.65,105.5,16,7,9,0.438,18,16,2,0.889,3,4,7,9,195.0,195.08,195.04000000000002
2017-11-22,1610612752,1610612761,2017,108.0,100.0,208.0,101.2,97.2,100.6,99.2,16,9,7,0.563,16,11,5,0.688,8,1,6,5,200.28,206.0,203.14
2017-11-22,1610612745,1610612743,2017,125.0,95.0,220.0,112.7,109.85,109.2,110.3,17,13,4,0.765,17,10,7,0.588,4,9,7,3,216.24,217.04,216.64
2017-11-22,1610612763,1610612742,2017,94.0,95.0,189.0,98.25,97.5,104.45,102.7,16,7,9,0.438,18,3,15,0.16699999999999998,4,3,2,1,193.96,213.0,203.48000000000002
2017-11-22,1610612750,1610612753,2017,124.0,118.0,242.0,110.05,111.2,96.55,103.5,17,10,7,0.588,17,8,9,0.471,5,5,4,4,209.4,203.64,206.51999999999998
2017-11-22,1610612740,1610612759,2017,107.0,90.0,197.0,100.45,104.8,107.75,96.55,17,9,8,0.529,17,11,6,0.647,4,5,8,3,200.8,204.12,202.46
2017-11-22,1610612760,1610612744,2017,108.0,91.0,199.0,101.8,103.4,107.5,105.85,16,7,9,0.438,17,13,4,0.765,5,2,6,7,210.36,199.04,204.7
2017-11-22,1610612756,1610612749,2017,107.0,113.0,220.0,106.25,103.85,99.8,108.15,18,7,11,0.389,16,8,8,0.5,4,3,5,3,212.88,200.48,206.68
2017-11-22,1610612762,1610612741,2017,110.0,80.0,190.0,95.55,106.55,94.0,91.0,18,7,11,0.389,15,3,12,0.2,6,1,2,1,200.2,185.44,192.82
2017-11-22,1610612758,1610612747,2017,113.0,102.0,215.0,97.75,101.5,107.3,114.65,17,4,13,0.235,18,8,10,0.444,3,1,6,2,207.08,219.28,213.18
2017-11-21,1610612747,1610612741,2017,103.0,94.0,197.0,107.3,114.65,94.0,91.0,17,7,10,0.412,14,3,11,0.214,5,2,2,1,219.28,185.44,202.36
2017-11-20,1610612766,1610612750,2017,118.0,102.0,220.0,99.45,97.7,110.05,111.2,15,6,9,0.4,16,10,6,0.625,5,1,5,5,194.96,209.4,202.18
2017-11-20,1610612765,1610612739,2017,88.0,116.0,204.0,100.85,105.95,101.9,101.55,16,11,5,0.688,16,9,7,0.563,7,4,4,5,206.0,195.48,200.74
2017-11-20,1610612753,1610612754,2017,97.0,105.0,202.0,96.55,103.5,92.05,92.25,16,8,8,0.5,17,9,8,0.529,4,4,4,5,203.64,187.28,195.45999999999998
2017-11-20,1610612755,1610612762,2017,107.0,86.0,193.0,97.85,106.0,95.55,106.55,15,8,7,0.5329999999999999,17,7,10,0.412,2,6,6,1,207.68,200.2,203.94
2017-11-20,1610612752,1610612746,2017,107.0,85.0,192.0,101.2,97.2,109.85,106.5,15,8,7,0.5329999999999999,15,5,10,0.333,7,1,3,2,200.28,214.36,207.32
2017-11-20,1610612763,1610612757,2017,92.0,100.0,192.0,98.25,97.5,104.75,105.45,15,7,8,0.467,16,9,7,0.563,4,3,7,2,193.96,209.44,201.7
2017-11-20,1610612749,1610612764,2017,88.0,99.0,187.0,99.8,108.15,94.7,91.35,15,8,7,0.5329999999999999,16,9,7,0.563,5,3,5,4,200.48,193.0,196.74
2017-11-20,1610612740,1610612760,2017,114.0,107.0,221.0,100.45,104.8,101.8,103.4,16,8,8,0.5,15,7,8,0.467,3,5,5,2,200.8,210.36,205.58
2017-11-20,1610612742,1610612738,2017,102.0,110.0,212.0,104.45,102.7,99.65,105.5,17,3,14,0.17600000000000002,17,15,2,0.882,2,1,7,8,213.0,195.08,204.04000000000002
2017-11-20,1610612759,1610612737,2017,96.0,85.0,181.0,107.75,96.55,96.35,95.7,16,10,6,0.625,16,3,13,0.188,7,3,1,2,204.12,199.44,201.78
2017-11-20,1610612758,1610612743,2017,98.0,114.0,212.0,97.75,101.5,109.2,110.3,16,4,12,0.25,16,9,7,0.563,3,1,7,2,207.08,217.04,212.06
2017-11-19,1610612761,1610612764,2017,100.0,91.0,191.0,100.6,99.2,94.7,91.35,15,10,5,0.667,15,9,6,0.6,5,5,5,4,206.0,193.0,199.5
2017-11-19,1610612748,1610612754,2017,95.0,120.0,215.0,97.25,95.5,92.05,92.25,15,7,8,0.467,16,8,8,0.5,3,4,4,4,195.0,187.28,191.14
2017-11-19,1610612751,1610612744,2017,111.0,118.0,229.0,96.7,98.4,107.5,105.85,15,6,9,0.4,16,12,4,0.75,4,2,6,6,196.96,199.04,198.0
2017-11-19,1610612750,1610612765,2017,97.0,100.0,197.0,110.05,111.2,100.85,105.95,15,10,5,0.667,15,10,5,0.667,5,5,7,3,209.4,206.0,207.7
2017-11-19,1610612756,1610612741,2017,113.0,105.0,218.0,106.25,103.85,94.0,91.0,17,6,11,0.353,13,3,10,0.231,3,3,2,1,212.88,185.44,199.16
2017-11-19,1610612747,1610612743,2017,127.0,109.0,236.0,107.3,114.65,109.2,110.3,16,6,10,0.375,15,9,6,0.6,4,2,7,2,219.28,217.04,218.16
2017-11-18,1610612766,1610612746,2017,102.0,87.0,189.0,99.45,97.7,109.85,106.5,14,5,9,0.35700000000000004,14,5,9,0.35700000000000004,4,1,3,2,194.96,214.36,204.66000000000003
2017-11-18,1610612753,1610612762,2017,85.0,125.0,210.0,96.55,103.5,95.55,106.55,15,8,7,0.5329999999999999,16,6,10,0.375,4,4,6,0,203.64,200.2,201.92
2017-11-18,1610612737,1610612738,2017,99.0,110.0,209.0,96.35,95.7,99.65,105.5,15,3,12,0.2,16,14,2,0.875,1,2,7,7,199.44,195.08,197.26
2017-11-18,1610612755,1610612744,2017,116.0,124.0,240.0,97.85,106.0,107.5,105.85,14,8,6,0.5710000000000001,15,11,4,0.733,2,6,6,5,207.68,199.04,203.36
2017-11-18,1610612763,1610612745,2017,83.0,105.0,188.0,98.25,97.5,112.7,109.85,14,7,7,0.5,16,12,4,0.75,4,3,4,8,193.96,216.24,205.10000000000002
2017-11-18,1610612742,1610612749,2017,111.0,79.0,190.0,104.45,102.7,99.8,108.15,16,2,14,0.125,14,8,6,0.5710000000000001,1,1,5,3,213.0,200.48,206.74
2017-11-18,1610612757,1610612758,2017,102.0,90.0,192.0,104.75,105.45,97.75,101.5,15,8,7,0.5329999999999999,15,4,11,0.267,6,2,3,1,209.44,207.08,208.26
2017-11-17,1610612754,1610612765,2017,107.0,100.0,207.0,92.05,92.25,100.85,105.95,15,7,8,0.467,14,10,4,0.7140000000000001,3,4,7,3,187.28,206.0,196.64
2017-11-17,1610612764,1610612748,2017,88.0,91.0,179.0,94.7,91.35,97.25,95.5,14,9,5,0.643,14,6,8,0.429,5,4,3,3,193.0,195.0,194.0
2017-11-17,1610612751,1610612762,2017,118.0,107.0,225.0,96.7,98.4,95.55,106.55,14,5,9,0.35700000000000004,15,6,9,0.4,3,2,6,0,196.96,200.2,198.57999999999998
2017-11-17,1610612739,1610612746,2017,118.0,113.0,231.0,101.9,101.55,109.85,106.5,15,8,7,0.5329999999999999,13,5,8,0.385,3,5,3,2,195.48,214.36,204.92000000000002
2017-11-17,1610612761,1610612752,2017,107.0,84.0,191.0,100.6,99.2,101.2,97.2,14,9,5,0.643,14,8,6,0.5710000000000001,4,5,7,1,206.0,200.28,203.14
2017-11-17,1610612741,1610612766,2017,123.0,120.0,243.0,94.0,91.0,99.45,97.7,12,2,10,0.16699999999999998,13,5,8,0.385,1,1,4,1,185.44,194.96,190.2
2017-11-17,1610612759,1610612760,2017,104.0,101.0,205.0,107.75,96.55,101.8,103.4,15,9,6,0.6,14,7,7,0.5,6,3,5,2,204.12,210.36,207.24
2017-11-17,1610612742,1610612750,2017,87.0,111.0,198.0,104.45,102.7,110.05,111.2,15,2,13,0.133,14,9,5,0.643,1,1,5,4,213.0,209.4,211.2
2017-11-17,1610612758,1610612757,2017,86.0,82.0,168.0,97.75,101.5,104.75,105.45,14,3,11,0.214,14,8,6,0.5710000000000001,2,1,6,2,207.08,209.44,208.26
2017-11-17,1610612743,1610612740,2017,146.0,114.0,260.0,109.2,110.3,100.45,104.8,14,8,6,0.5710000000000001,15,8,7,0.5329999999999999,6,2,3,5,217.04,200.8,208.92000000000002
2017-11-17,1610612747,1610612756,2017,113.0,122.0,235.0,107.3,114.65,106.25,103.85,15,6,9,0.4,16,5,11,0.313,4,2,3,2,219.28,212.88,216.07999999999998
2017-11-16,1610612738,1610612744,2017,92.0,88.0,180.0,99.65,105.5,107.5,105.85,15,13,2,0.867,14,11,3,0.7859999999999999,6,7,6,5,195.08,199.04,197.06
2017-11-16,1610612756,1610612745,2017,116.0,142.0,258.0,106.25,103.85,112.7,109.85,15,5,10,0.333,15,11,4,0.733,3,2,4,7,212.88,216.24,214.56
2017-11-15,1610612737,1610612758,2017,126.0,80.0,206.0,96.35,95.7,97.75,101.5,14,2,12,0.14300000000000002,13,3,10,0.231,0,2,2,1,199.44,207.08,203.26
2017-11-15,1610612748,1610612764,2017,93.0,102.0,195.0,97.25,95.5,94.7,91.35,13,6,7,0.462,13,8,5,0.615,3,3,5,3,195.0,193.0,194.0
2017-11-15,1610612752,1610612762,2017,106.0,101.0,207.0,101.2,97.2,95.55,106.55,13,7,6,0.5379999999999999,14,6,8,0.429,6,1,6,0,200.28,200.2,200.24
2017-11-15,1610612766,1610612739,2017,107.0,115.0,222.0,99.45,97.7,101.9,101.55,12,5,7,0.417,14,7,7,0.5,4,1,3,4,194.96,195.48,195.22
2017-11-15,1610612763,1610612754,2017,113.0,116.0,229.0,98.25,97.5,92.05,92.25,13,7,6,0.5379999999999999,14,6,8,0.429,4,3,3,3,193.96,187.28,190.62
2017-11-15,1610612749,1610612765,2017,99.0,95.0,194.0,99.8,108.15,100.85,105.95,13,7,6,0.5379999999999999,13,10,3,0.769,4,3,7,3,200.48,206.0,203.24
2017-11-15,1610612750,1610612759,2017,98.0,86.0,184.0,110.05,111.2,107.75,96.55,13,8,5,0.615,14,9,5,0.643,4,4,6,3,209.4,204.12,206.76
2017-11-15,1610612740,1610612761,2017,116.0,125.0,241.0,100.45,104.8,100.6,99.2,14,8,6,0.5710000000000001,13,8,5,0.615,3,5,4,4,200.8,206.0,203.4
2017-11-15,1610612760,1610612741,2017,92.0,79.0,171.0,101.8,103.4,94.0,91.0,13,6,7,0.462,11,2,9,0.182,4,2,1,1,210.36,185.44,197.9
2017-11-15,1610612757,1610612753,2017,99.0,94.0,193.0,104.75,105.45,96.55,103.5,13,7,6,0.5379999999999999,14,8,6,0.5710000000000001,5,2,4,4,209.44,203.64,206.54
2017-11-15,1610612747,1610612755,2017,109.0,115.0,224.0,107.3,114.65,97.85,106.0,14,6,8,0.429,13,7,6,0.5379999999999999,4,2,2,5,219.28,207.68,213.48000000000002
2017-11-14,1610612751,1610612738,2017,102.0,109.0,211.0,96.7,98.4,99.65,105.5,13,5,8,0.385,14,12,2,0.857,3,2,6,6,196.96,195.08,196.02
2017-11-14,1610612745,1610612761,2017,113.0,129.0,242.0,112.7,109.85,100.6,99.2,14,11,3,0.7859999999999999,12,7,5,0.583,4,7,4,3,216.24,206.0,211.12
2017-11-14,1610612742,1610612759,2017,91.0,97.0,188.0,104.45,102.7,107.75,96.55,14,2,12,0.14300000000000002,13,8,5,0.615,1,1,6,2,213.0,204.12,208.56
2017-11-13,1610612764,1610612758,2017,110.0,92.0,202.0,94.7,91.35,97.75,101.5,12,7,5,0.583,12,3,9,0.25,4,3,2,1,193.0,207.08,200.04000000000002
2017-11-13,1610612752,1610612739,2017,101.0,104.0,205.0,101.2,97.2,101.9,101.55,12,7,5,0.583,13,6,7,0.462,6,1,3,3,200.28,195.48,197.88
2017-11-13,1610612749,1610612763,2017,110.0,103.0,213.0,99.8,108.15,98.25,97.5,12,6,6,0.5,12,7,5,0.583,3,3,4,3,200.48,193.96,197.22
2017-11-13,1610612740,1610612737,2017,106.0,105.0,211.0,100.45,104.8,96.35,95.7,13,7,6,0.5379999999999999,13,2,11,0.154,2,5,0,2,200.8,199.44,200.12
2017-11-13,1610612756,1610612747,2017,93.0,100.0,193.0,106.25,103.85,107.3,114.65,14,5,9,0.35700000000000004,13,5,8,0.385,3,2,4,1,212.88,219.28,216.07999999999998
2017-11-13,1610612762,1610612750,2017,98.0,109.0,207.0,95.55,106.55,110.05,111.2,13,6,7,0.462,12,7,5,0.583,6,0,4,3,200.2,209.4,204.8
2017-11-13,1610612757,1610612743,2017,99.0,82.0,181.0,104.75,105.45,109.2,110.3,12,6,6,0.5,13,8,5,0.615,4,2,6,2,209.44,217.04,213.24
2017-11-13,1610612744,1610612753,2017,110.0,100.0,210.0,107.5,105.85,96.55,103.5,13,10,3,0.769,13,8,5,0.615,5,5,4,4,199.04,203.64,201.33999999999997
2017-11-13,1610612746,1610612755,2017,105.0,109.0,214.0,109.85,106.5,97.85,106.0,12,5,7,0.417,12,6,6,0.5,3,2,2,4,214.36,207.68,211.02
2017-11-12,1610612738,1610612761,2017,95.0,94.0,189.0,99.65,105.5,100.6,99.2,13,11,2,0.846,11,7,4,0.636,5,6,4,3,195.08,206.0,200.54000000000002
2017-11-12,1610612765,1610612748,2017,112.0,103.0,215.0,100.85,105.95,97.25,95.5,12,9,3,0.75,12,6,6,0.5,6,3,3,3,206.0,195.0,200.5
2017-11-12,1610612754,1610612745,2017,95.0,118.0,213.0,92.05,92.25,112.7,109.85,13,6,7,0.462,13,10,3,0.769,3,3,4,6,187.28,216.24,201.76
2017-11-12,1610612760,1610612742,2017,112.0,99.0,211.0,101.8,103.4,104.45,102.7,12,5,7,0.417,13,2,11,0.154,3,2,1,1,210.36,213.0,211.68
2017-11-11,1610612764,1610612737,2017,113.0,94.0,207.0,94.7,91.35,96.35,95.7,11,6,5,0.545,12,2,10,0.16699999999999998,3,3,0,2,193.0,199.44,196.22
2017-11-11,1610612740,1610612746,2017,111.0,103.0,214.0,100.45,104.8,109.85,106.5,12,6,6,0.5,11,5,6,0.455,1,5,3,2,200.8,214.36,207.58
2017-11-11,1610612752,1610612758,2017,118.0,91.0,209.0,101.2,97.2,97.75,101.5,11,6,5,0.545,11,3,8,0.273,5,1,2,1,200.28,207.08,203.68
2017-11-11,1610612745,1610612763,2017,111.0,96.0,207.0,112.7,109.85,98.25,97.5,12,9,3,0.75,11,7,4,0.636,3,6,4,3,216.24,193.96,205.10000000000002
2017-11-11,1610612742,1610612739,2017,104.0,111.0,215.0,104.45,102.7,101.9,101.55,12,2,10,0.16699999999999998,12,5,7,0.417,1,1,3,2,213.0,195.48,204.24
2017-11-11,1610612749,1610612747,2017,98.0,90.0,188.0,99.8,108.15,107.3,114.65,11,5,6,0.455,12,5,7,0.417,2,3,4,1,200.48,219.28,209.88
2017-11-11,1610612759,1610612741,2017,133.0,94.0,227.0,107.75,96.55,94.0,91.0,12,7,5,0.583,10,2,8,0.2,5,2,1,1,204.12,185.44,194.78
2017-11-11,1610612744,1610612755,2017,135.0,114.0,249.0,107.5,105.85,97.85,106.0,12,9,3,0.75,11,6,5,0.545,4,5,2,4,199.04,207.68,203.36
2017-11-11,1610612743,1610612753,2017,125.0,107.0,232.0,109.2,110.3,96.55,103.5,12,7,5,0.583,12,8,4,0.667,5,2,4,4,217.04,203.64,210.33999999999997
2017-11-11,1610612756,1610612750,2017,118.0,110.0,228.0,106.25,103.85,110.05,111.2,13,4,9,0.308,11,7,4,0.636,2,2,4,3,212.88,209.4,211.14
2017-11-11,1610612762,1610612751,2017,114.0,106.0,220.0,95.55,106.55,96.7,98.4,12,5,7,0.417,12,5,7,0.417,5,0,3,2,200.2,196.96,198.57999999999998
2017-11-10,1610612765,1610612737,2017,111.0,104.0,215.0,100.85,105.95,96.35,95.7,11,8,3,0.727,11,2,9,0.182,5,3,0,2,206.0,199.44,202.72
2017-11-10,1610612738,1610612766,2017,90.0,87.0,177.0,99.65,105.5,99.45,97.7,12,10,2,0.833,11,5,6,0.455,4,6,4,1,195.08,194.96,195.02
2017-11-10,1610612741,1610612754,2017,87.0,105.0,192.0,94.0,91.0,92.05,92.25,9,2,7,0.222,12,5,7,0.417,1,1,3,2,185.44,187.28,186.36
2017-11-10,1610612760,1610612746,2017,120.0,111.0,231.0,101.8,103.4,109.85,106.5,11,4,7,0.364,10,5,5,0.5,2,2,3,2,210.36,214.36,212.36
2017-11-10,1610612759,1610612749,2017,87.0,94.0,181.0,107.75,96.55,99.8,108.15,11,7,4,0.636,10,4,6,0.4,5,2,2,2,204.12,200.48,202.3
2017-11-10,1610612756,1610612753,2017,112.0,128.0,240.0,106.25,103.85,96.55,103.5,12,4,8,0.333,11,7,4,0.636,2,2,4,3,212.88,203.64,208.26
2017-11-10,1610612762,1610612748,2017,74.0,84.0,158.0,95.55,106.55,97.25,95.5,11,5,6,0.455,11,5,6,0.455,5,0,3,2,200.2,195.0,197.6
2017-11-10,1610612757,1610612751,2017,97.0,101.0,198.0,104.75,105.45,96.7,98.4,11,6,5,0.545,11,4,7,0.364,4,2,3,1,209.44,196.96,203.2
2017-11-09,1610612764,1610612747,2017,111.0,95.0,206.0,94.7,91.35,107.3,114.65,10,5,5,0.5,11,5,6,0.455,2,3,4,1,193.0,219.28,206.14
2017-11-09,1610612761,1610612740,2017,122.0,118.0,240.0,100.6,99.2,100.45,104.8,10,6,4,0.6,11,6,5,0.545,3,3,1,5,206.0,200.8,203.4
2017-11-09,1610612745,1610612739,2017,117.0,113.0,230.0,112.7,109.85,101.9,101.55,11,8,3,0.727,11,5,6,0.455,2,6,3,2,216.24,195.48,205.86
2017-11-09,1610612758,1610612755,2017,109.0,108.0,217.0,97.75,101.5,97.85,106.0,10,2,8,0.2,10,6,4,0.6,1,1,2,4,207.08,207.68,207.38
2017-11-09,1610612743,1610612760,2017,102.0,94.0,196.0,109.2,110.3,101.8,103.4,11,6,5,0.545,10,4,6,0.4,4,2,2,2,217.04,210.36,213.7
2017-11-08,1610612765,1610612754,2017,114.0,97.0,211.0,100.85,105.95,92.05,92.25,10,7,3,0.7,11,5,6,0.455,4,3,3,2,206.0,187.28,196.64
2017-11-08,1610612753,1610612752,2017,112.0,99.0,211.0,96.55,103.5,101.2,97.2,10,6,4,0.6,10,6,4,0.6,3,3,5,1,203.64,200.28,201.95999999999998
2017-11-08,1610612738,1610612747,2017,107.0,96.0,203.0,99.65,105.5,107.3,114.65,11,9,2,0.818,10,5,5,0.5,3,6,4,1,195.08,219.28,207.18
2017-11-08,1610612756,1610612748,2017,115.0,126.0,241.0,106.25,103.85,97.25,95.5,11,4,7,0.364,10,4,6,0.4,2,2,3,1,212.88,195.0,203.94
2017-11-08,1610612744,1610612750,2017,125.0,101.0,226.0,107.5,105.85,110.05,111.2,11,8,3,0.727,10,7,3,0.7,3,5,4,3,199.04,209.4,204.22
2017-11-07,1610612739,1610612749,2017,124.0,119.0,243.0,101.9,101.55,99.8,108.15,10,4,6,0.4,9,4,5,0.444,2,2,2,2,195.48,200.48,197.98
2017-11-07,1610612754,1610612740,2017,112.0,117.0,229.0,92.05,92.25,100.45,104.8,10,5,5,0.5,10,5,5,0.5,3,2,1,4,187.28,200.8,194.04000000000002
2017-11-07,1610612764,1610612742,2017,99.0,113.0,212.0,94.7,91.35,104.45,102.7,9,5,4,0.556,11,1,10,0.091,2,3,1,0,193.0,213.0,203.0
2017-11-07,1610612752,1610612766,2017,118.0,113.0,231.0,101.2,97.2,99.45,97.7,9,5,4,0.556,10,5,5,0.5,4,1,4,1,200.28,194.96,197.62
2017-11-07,1610612761,1610612741,2017,119.0,114.0,233.0,100.6,99.2,94.0,91.0,9,5,4,0.556,8,2,6,0.25,2,3,1,1,206.0,185.44,195.72
2017-11-07,1610612759,1610612746,2017,120.0,107.0,227.0,107.75,96.55,109.85,106.5,10,6,4,0.6,9,5,4,0.556,4,2,3,2,204.12,214.36,209.24
2017-11-07,1610612743,1610612751,2017,112.0,104.0,216.0,109.2,110.3,96.7,98.4,10,5,5,0.5,10,4,6,0.4,3,2,3,1,217.04,196.96,207.0
2017-11-07,1610612762,1610612755,2017,97.0,104.0,201.0,95.55,106.55,97.85,106.0,10,5,5,0.5,9,5,4,0.556,5,0,2,3,200.2,207.68,203.94
2017-11-07,1610612757,1610612763,2017,97.0,98.0,195.0,104.75,105.45,98.25,97.5,10,6,4,0.6,10,6,4,0.6,4,2,4,2,209.44,193.96,201.7
2017-11-07,1610612758,1610612760,2017,94.0,86.0,180.0,97.75,101.5,101.8,103.4,9,1,8,0.111,9,4,5,0.444,0,1,2,2,207.08,210.36,208.72000000000003
2017-11-06,1610612737,1610612738,2017,107.0,110.0,217.0,96.35,95.7,99.65,105.5,10,2,8,0.2,10,8,2,0.8,0,2,3,5,199.44,195.08,197.26
2017-11-06,1610612756,1610612751,2017,92.0,98.0,190.0,106.25,103.85,96.7,98.4,10,4,6,0.4,9,3,6,0.333,2,2,3,0,212.88,196.96,204.92000000000002
2017-11-06,1610612744,1610612748,2017,97.0,80.0,177.0,107.5,105.85,97.25,95.5,10,7,3,0.7,9,4,5,0.444,2,5,3,1,199.04,195.0,197.01999999999998
2017-11-05,1610612739,1610612737,2017,115.0,117.0,232.0,101.9,101.55,96.35,95.7,9,4,5,0.444,9,1,8,0.111,2,2,0,1,195.48,199.44,197.45999999999998
2017-11-05,1610612746,1610612748,2017,101.0,104.0,205.0,109.85,106.5,97.25,95.5,8,5,3,0.625,8,3,5,0.375,3,2,3,0,214.36,195.0,204.68
2017-11-05,1610612753,1610612738,2017,88.0,104.0,192.0,96.55,103.5,99.65,105.5,9,6,3,0.667,9,7,2,0.778,3,3,3,4,203.64,195.08,199.36
2017-11-05,1610612761,1610612764,2017,96.0,107.0,203.0,100.6,99.2,94.7,91.35,8,5,3,0.625,8,4,4,0.5,2,3,2,2,206.0,193.0,199.5
2017-11-05,1610612745,1610612762,2017,137.0,110.0,247.0,112.7,109.85,95.55,106.55,10,7,3,0.7,9,5,4,0.556,1,6,5,0,216.24,200.2,208.22
2017-11-05,1610612759,1610612756,2017,112.0,95.0,207.0,107.75,96.55,106.25,103.85,9,5,4,0.556,9,4,5,0.444,3,2,2,2,204.12,212.88,208.5
2017-11-05,1610612752,1610612754,2017,108.0,101.0,209.0,101.2,97.2,92.05,92.25,8,4,4,0.5,9,5,4,0.556,3,1,3,2,200.28,187.28,193.78
2017-11-05,1610612750,1610612766,2017,112.0,94.0,206.0,110.05,111.2,99.45,97.7,9,6,3,0.667,9,5,4,0.556,3,3,4,1,209.4,194.96,202.18
2017-11-05,1610612757,1610612760,2017,103.0,99.0,202.0,104.75,105.45,101.8,103.4,9,5,4,0.556,8,4,4,0.5,3,2,2,2,209.44,210.36,209.9
2017-11-05,1610612747,1610612763,2017,107.0,102.0,209.0,107.3,114.65,98.25,97.5,9,4,5,0.444,9,6,3,0.667,3,1,4,2,219.28,193.96,206.62
2017-11-04,1610612746,1610612763,2017,104.0,113.0,217.0,109.85,106.5,98.25,97.5,7,5,2,0.7140000000000001,8,5,3,0.625,3,2,4,1,214.36,193.96,204.16000000000003
2017-11-04,1610612765,1610612758,2017,108.0,99.0,207.0,100.85,105.95,97.75,101.5,9,6,3,0.667,8,1,7,0.125,3,3,0,1,206.0,207.08,206.54000000000002
2017-11-04,1610612741,1610612740,2017,90.0,96.0,186.0,94.0,91.0,100.45,104.8,7,2,5,0.28600000000000003,9,4,5,0.444,1,1,1,3,185.44,200.8,193.12
2017-11-04,1610612750,1610612742,2017,112.0,99.0,211.0,110.05,111.2,104.45,102.7,8,5,3,0.625,10,1,9,0.1,2,3,1,0,209.4,213.0,211.2
2017-11-04,1610612743,1610612744,2017,108.0,127.0,235.0,109.2,110.3,107.5,105.85,9,5,4,0.556,9,6,3,0.667,3,2,2,4,217.04,199.04,208.04
2017-11-03,1610612765,1610612749,2017,105.0,96.0,201.0,100.85,105.95,99.8,108.15,8,5,3,0.625,8,4,4,0.5,2,3,2,2,206.0,200.48,203.24
2017-11-03,1610612753,1610612741,2017,83.0,105.0,188.0,96.55,103.5,94.0,91.0,8,6,2,0.75,6,1,5,0.16699999999999998,3,3,1,0,203.64,185.44,194.54
2017-11-03,1610612755,1610612754,2017,121.0,110.0,231.0,97.85,106.0,92.05,92.25,8,4,4,0.5,8,5,3,0.625,1,3,3,2,207.68,187.28,197.48000000000002
2017-11-03,1610612764,1610612739,2017,122.0,130.0,252.0,94.7,91.35,101.9,101.55,7,4,3,0.5710000000000001,8,3,5,0.375,2,2,2,1,193.0,195.48,194.24
2017-11-03,1610612737,1610612745,2017,104.0,119.0,223.0,96.35,95.7,112.7,109.85,8,1,7,0.125,9,6,3,0.667,0,1,1,5,199.44,216.24,207.84
2017-11-03,1610612752,1610612756,2017,120.0,107.0,227.0,101.2,97.2,106.25,103.85,7,3,4,0.429,8,4,4,0.5,2,1,2,2,200.28,212.88,206.57999999999998
2017-11-03,1610612742,1610612740,2017,94.0,99.0,193.0,104.45,102.7,100.45,104.8,9,1,8,0.111,8,3,5,0.375,1,0,1,2,213.0,200.8,206.9
2017-11-03,1610612759,1610612766,2017,108.0,101.0,209.0,107.75,96.55,99.45,97.7,8,4,4,0.5,8,5,3,0.625,2,2,4,1,204.12,194.96,199.54000000000002
2017-11-03,1610612743,1610612748,2017,95.0,94.0,189.0,109.2,110.3,97.25,95.5,8,4,4,0.5,7,3,4,0.429,2,2,3,0,217.04,195.0,206.01999999999998
2017-11-03,1610612762,1610612761,2017,100.0,109.0,209.0,95.55,106.55,100.6,99.2,8,5,3,0.625,7,4,3,0.5710000000000001,5,0,2,2,200.2,206.0,203.1
2017-11-03,1610612760,1610612738,2017,94.0,101.0,195.0,101.8,103.4,99.65,105.5,7,4,3,0.5710000000000001,8,6,2,0.75,2,2,3,3,210.36,195.08,202.72000000000003
2017-11-03,1610612747,1610612751,2017,124.0,112.0,236.0,107.3,114.65,96.7,98.4,8,3,5,0.375,8,3,5,0.375,2,1,3,0,219.28,196.96,208.12
2017-11-02,1610612759,1610612744,2017,92.0,112.0,204.0,107.75,96.55,107.5,105.85,7,4,3,0.5710000000000001,8,5,3,0.625,2,2,2,3,204.12,199.04,201.57999999999998
2017-11-02,1610612757,1610612747,2017,113.0,110.0,223.0,104.75,105.45,107.3,114.65,8,4,4,0.5,7,3,4,0.429,2,2,2,1,209.44,219.28,214.36
2017-11-01,1610612766,1610612749,2017,126.0,121.0,247.0,99.45,97.7,99.8,108.15,7,4,3,0.5710000000000001,7,4,3,0.5710000000000001,3,1,2,2,194.96,200.48,197.72
2017-11-01,1610612739,1610612754,2017,107.0,124.0,231.0,101.9,101.55,92.05,92.25,7,3,4,0.429,7,4,3,0.5710000000000001,2,1,3,1,195.48,187.28,191.38
2017-11-01,1610612755,1610612737,2017,119.0,109.0,228.0,97.85,106.0,96.35,95.7,7,3,4,0.429,7,1,6,0.14300000000000002,0,3,0,1,207.68,199.44,203.56
2017-11-01,1610612764,1610612756,2017,116.0,122.0,238.0,94.7,91.35,106.25,103.85,6,4,2,0.667,7,3,4,0.429,2,2,2,1,193.0,212.88,202.94
2017-11-01,1610612738,1610612758,2017,113.0,86.0,199.0,99.65,105.5,97.75,101.5,7,5,2,0.7140000000000001,7,1,6,0.14300000000000002,2,3,0,1,195.08,207.08,201.08
2017-11-01,1610612748,1610612741,2017,97.0,91.0,188.0,97.25,95.5,94.0,91.0,6,2,4,0.333,5,1,4,0.2,2,0,1,0,195.0,185.44,190.22
2017-11-01,1610612752,1610612745,2017,97.0,119.0,216.0,101.2,97.2,112.7,109.85,6,3,3,0.5,8,5,3,0.625,2,1,1,4,200.28,216.24,208.26
2017-11-01,1610612763,1610612753,2017,99.0,101.0,200.0,98.25,97.5,96.55,103.5,7,5,2,0.7140000000000001,7,5,2,0.7140000000000001,4,1,3,2,193.96,203.64,198.8
2017-11-01,1610612740,1610612750,2017,98.0,104.0,202.0,100.45,104.8,110.05,111.2,7,3,4,0.429,7,4,3,0.5710000000000001,1,2,2,2,200.8,209.4,205.10000000000002
2017-11-01,1610612743,1610612761,2017,129.0,111.0,240.0,109.2,110.3,100.6,99.2,7,3,4,0.429,6,4,2,0.667,1,2,2,2,217.04,206.0,211.51999999999998
2017-11-01,1610612762,1610612757,2017,112.0,103.0,215.0,95.55,106.55,104.75,105.45,7,4,3,0.5710000000000001,7,4,3,0.5710000000000001,4,0,2,2,200.2,209.44,204.82
2017-11-01,1610612746,1610612742,2017,119.0,98.0,217.0,109.85,106.5,104.45,102.7,6,4,2,0.667,8,1,7,0.125,2,2,1,0,214.36,213.0,213.68
2017-10-31,1610612754,1610612758,2017,101.0,83.0,184.0,92.05,92.25,97.75,101.5,6,3,3,0.5,6,1,5,0.16699999999999998,2,1,0,1,187.28,207.08,197.18
2017-10-31,1610612751,1610612756,2017,114.0,122.0,236.0,96.7,98.4,106.25,103.85,7,3,4,0.429,6,2,4,0.333,3,0,2,0,196.96,212.88,204.92000000000002
2017-10-31,1610612749,1610612760,2017,91.0,110.0,201.0,99.8,108.15,101.8,103.4,6,4,2,0.667,6,3,3,0.5,2,2,2,1,200.48,210.36,205.42000000000002
2017-10-31,1610612747,1610612765,2017,113.0,93.0,206.0,107.3,114.65,100.85,105.95,6,2,4,0.333,7,5,2,0.7140000000000001,1,1,2,3,219.28,206.0,212.64
2017-10-30,1610612738,1610612759,2017,108.0,94.0,202.0,99.65,105.5,107.75,96.55,6,4,2,0.667,6,4,2,0.667,1,3,2,2,195.08,204.12,199.60000000000002
2017-10-30,1610612748,1610612750,2017,122.0,125.0,247.0,97.25,95.5,110.05,111.2,5,2,3,0.4,6,3,3,0.5,2,0,2,1,195.0,209.4,202.2
2017-10-30,1610612752,1610612743,2017,116.0,110.0,226.0,101.2,97.2,109.2,110.3,5,2,3,0.4,6,3,3,0.5,1,1,1,2,200.28,217.04,208.66
2017-10-30,1610612745,1610612755,2017,107.0,115.0,222.0,112.7,109.85,97.85,106.0,7,5,2,0.7140000000000001,6,2,4,0.333,1,4,0,2,216.24,207.68,211.96
2017-10-30,1610612763,1610612766,2017,99.0,104.0,203.0,98.25,97.5,99.45,97.7,6,5,1,0.833,6,3,3,0.5,4,1,3,0,193.96,194.96,194.46
2017-10-30,1610612740,1610612753,2017,99.0,115.0,214.0,100.45,104.8,96.55,103.5,6,3,3,0.5,6,4,2,0.667,1,2,3,1,200.8,203.64,202.22
2017-10-30,1610612762,1610612742,2017,104.0,89.0,193.0,95.55,106.55,104.45,102.7,6,3,3,0.5,7,1,6,0.14300000000000002,3,0,1,0,200.2,213.0,206.6
2017-10-30,1610612757,1610612761,2017,85.0,99.0,184.0,104.75,105.45,100.6,99.2,6,4,2,0.667,5,3,2,0.6,2,2,2,1,209.44,206.0,207.72
2017-10-30,1610612746,1610612744,2017,113.0,141.0,254.0,109.85,106.5,107.5,105.85,5,4,1,0.8,7,4,3,0.5710000000000001,2,2,2,2,214.36,199.04,206.7
2017-10-29,1610612737,1610612749,2017,106.0,117.0,223.0,96.35,95.7,99.8,108.15,6,1,5,0.16699999999999998,5,3,2,0.6,0,1,2,1,199.44,200.48,199.95999999999998
2017-10-29,1610612754,1610612759,2017,97.0,94.0,191.0,92.05,92.25,107.75,96.55,5,2,3,0.4,5,4,1,0.8,1,1,2,2,187.28,204.12,195.7
2017-10-29,1610612751,1610612743,2017,111.0,124.0,235.0,96.7,98.4,109.2,110.3,6,3,3,0.5,5,2,3,0.4,3,0,1,1,196.96,217.04,207.0
2017-10-29,1610612766,1610612753,2017,120.0,113.0,233.0,99.45,97.7,96.55,103.5,5,2,3,0.4,5,4,1,0.8,2,0,3,1,194.96,203.64,199.3
2017-10-29,1610612758,1610612764,2017,83.0,110.0,193.0,97.75,101.5,94.7,91.35,5,1,4,0.2,5,3,2,0.6,0,1,2,1,207.08,193.0,200.04000000000002
2017-10-29,1610612739,1610612752,2017,95.0,114.0,209.0,101.9,101.55,101.2,97.2,6,3,3,0.5,4,1,3,0.25,2,1,1,0,195.48,200.28,197.88
2017-10-29,1610612744,1610612765,2017,107.0,115.0,222.0,107.5,105.85,100.85,105.95,6,4,2,0.667,6,4,2,0.667,2,2,2,2,199.04,206.0,202.51999999999998
2017-10-28,1610612740,1610612739,2017,123.0,101.0,224.0,100.45,104.8,101.9,101.55,5,2,3,0.4,5,3,2,0.6,0,2,2,1,200.8,195.48,198.14
2017-10-28,1610612748,1610612738,2017,90.0,96.0,186.0,97.25,95.5,99.65,105.5,4,2,2,0.5,5,3,2,0.6,2,0,1,2,195.0,195.08,195.04000000000002
2017-10-28,1610612741,1610612760,2017,69.0,101.0,170.0,94.0,91.0,101.8,103.4,4,1,3,0.25,5,2,3,0.4,1,0,2,0,185.44,210.36,197.9
2017-10-28,1610612763,1610612745,2017,103.0,89.0,192.0,98.25,97.5,112.7,109.85,5,4,1,0.8,6,5,1,0.833,3,1,1,4,193.96,216.24,205.10000000000002
2017-10-28,1610612742,1610612755,2017,110.0,112.0,222.0,104.45,102.7,97.85,106.0,6,1,5,0.16699999999999998,5,1,4,0.2,1,0,0,1,213.0,207.68,210.34
2017-10-28,1610612762,1610612747,2017,96.0,81.0,177.0,95.55,106.55,107.3,114.65,5,2,3,0.4,5,2,3,0.4,2,0,1,1,200.2,219.28,209.74
2017-10-28,1610612757,1610612756,2017,114.0,107.0,221.0,104.75,105.45,106.25,103.85,5,3,2,0.6,5,2,3,0.4,1,2,2,0,209.44,212.88,211.16
2017-10-28,1610612746,1610612765,2017,87.0,95.0,182.0,109.85,106.5,100.85,105.95,4,4,0,1.0,5,3,2,0.6,2,2,2,1,214.36,206.0,210.18
2017-10-27,1610612766,1610612745,2017,93.0,109.0,202.0,99.45,97.7,112.7,109.85,4,2,2,0.5,5,4,1,0.8,2,0,1,3,194.96,216.24,205.60000000000002
2017-10-27,1610612753,1610612759,2017,114.0,87.0,201.0,96.55,103.5,107.75,96.55,4,3,1,0.75,4,4,0,1.0,2,1,2,2,203.64,204.12,203.88
2017-10-27,1610612737,1610612743,2017,100.0,105.0,205.0,96.35,95.7,109.2,110.3,5,1,4,0.2,4,1,3,0.25,0,1,1,0,199.44,217.04,208.24
2017-10-27,1610612752,1610612751,2017,107.0,86.0,193.0,101.2,97.2,96.7,98.4,3,0,3,0.0,5,3,2,0.6,0,0,3,0,200.28,196.96,198.62
2017-10-27,1610612750,1610612760,2017,119.0,116.0,235.0,110.05,111.2,101.8,103.4,5,2,3,0.4,4,2,2,0.5,1,1,2,0,209.4,210.36,209.88
2017-10-27,1610612744,1610612764,2017,120.0,117.0,237.0,107.5,105.85,94.7,91.35,5,3,2,0.6,4,3,1,0.75,1,2,2,1,199.04,193.0,196.01999999999998
2017-10-27,1610612747,1610612761,2017,92.0,101.0,193.0,107.3,114.65,100.6,99.2,4,2,2,0.5,4,2,2,0.5,1,1,2,0,219.28,206.0,212.64
2017-10-26,1610612741,1610612737,2017,91.0,86.0,177.0,94.0,91.0,96.35,95.7,3,0,3,0.0,4,1,3,0.25,0,0,0,1,185.44,199.44,192.44
2017-10-26,1610612763,1610612742,2017,96.0,91.0,187.0,98.25,97.5,104.45,102.7,4,3,1,0.75,5,1,4,0.2,2,1,1,0,193.96,213.0,203.48000000000002
2017-10-26,1610612749,1610612738,2017,89.0,96.0,185.0,99.8,108.15,99.65,105.5,4,3,1,0.75,4,2,2,0.5,2,1,1,1,200.48,195.08,197.78
2017-10-26,1610612757,1610612746,2017,103.0,104.0,207.0,104.75,105.45,109.85,106.5,4,3,1,0.75,3,3,0,1.0,1,2,2,1,209.44,214.36,211.9
2017-10-26,1610612758,1610612740,2017,106.0,114.0,220.0,97.75,101.5,100.45,104.8,4,1,3,0.25,4,1,3,0.25,0,1,0,1,207.08,200.8,203.94
2017-10-25,1610612766,1610612743,2017,110.0,93.0,203.0,99.45,97.7,109.2,110.3,3,1,2,0.333,3,1,2,0.333,1,0,1,0,194.96,217.04,206.0
2017-10-25,1610612765,1610612750,2017,122.0,101.0,223.0,100.85,105.95,110.05,111.2,4,2,2,0.5,4,2,2,0.5,1,1,1,1,206.0,209.4,207.7
2017-10-25,1610612755,1610612745,2017,104.0,105.0,209.0,97.85,106.0,112.7,109.85,4,1,3,0.25,4,3,1,0.75,0,1,1,2,207.68,216.24,211.96
2017-10-25,1610612751,1610612739,2017,112.0,107.0,219.0,96.7,98.4,101.9,101.55,4,2,2,0.5,4,3,1,0.75,2,0,2,1,196.96,195.48,196.22
2017-10-25,1610612748,1610612759,2017,100.0,117.0,217.0,97.25,95.5,107.75,96.55,3,2,1,0.667,3,3,0,1.0,2,0,2,1,195.0,204.12,199.56
2017-10-25,1610612760,1610612754,2017,114.0,96.0,210.0,101.8,103.4,92.05,92.25,3,1,2,0.333,4,2,2,0.5,1,0,1,1,210.36,187.28,198.82
2017-10-25,1610612742,1610612763,2017,103.0,94.0,197.0,104.45,102.7,98.25,97.5,4,0,4,0.0,3,3,0,1.0,0,0,2,1,213.0,193.96,203.48000000000002
2017-10-25,1610612756,1610612762,2017,97.0,88.0,185.0,106.25,103.85,95.55,106.55,4,1,3,0.25,4,2,2,0.5,1,0,2,0,212.88,200.2,206.54
2017-10-25,1610612744,1610612761,2017,117.0,112.0,229.0,107.5,105.85,100.6,99.2,4,2,2,0.5,3,2,1,0.667,0,2,2,0,199.04,206.0,202.51999999999998
2017-10-25,1610612747,1610612764,2017,102.0,99.0,201.0,107.3,114.65,94.7,91.35,3,1,2,0.333,3,3,0,1.0,0,1,2,1,219.28,193.0,206.14
2017-10-24,1610612739,1610612741,2017,119.0,112.0,231.0,101.9,101.55,94.0,91.0,3,2,1,0.667,2,0,2,0.0,1,1,0,0,195.48,185.44,190.45999999999998
2017-10-24,1610612753,1610612751,2017,125.0,121.0,246.0,96.55,103.5,96.7,98.4,3,2,1,0.667,3,2,1,0.667,1,1,2,0,203.64,196.96,200.3
2017-10-24,1610612738,1610612752,2017,110.0,89.0,199.0,99.65,105.5,101.2,97.2,3,1,2,0.333,2,0,2,0.0,0,1,0,0,195.08,200.28,197.68
2017-10-24,1610612750,1610612754,2017,107.0,130.0,237.0,110.05,111.2,92.05,92.25,3,2,1,0.667,3,1,2,0.333,1,1,1,0,209.4,187.28,198.34
2017-10-24,1610612757,1610612740,2017,103.0,93.0,196.0,104.75,105.45,100.45,104.8,3,2,1,0.667,3,1,2,0.333,0,2,0,1,209.44,200.8,205.12
2017-10-24,1610612746,1610612762,2017,102.0,84.0,186.0,109.85,106.5,95.55,106.55,2,2,0,1.0,3,2,1,0.667,1,1,2,0,214.36,200.2,207.28
2017-10-23,1610612765,1610612755,2017,86.0,97.0,183.0,100.85,105.95,97.85,106.0,3,2,1,0.667,3,0,3,0.0,1,1,0,0,206.0,207.68,206.84
2017-10-23,1610612748,1610612737,2017,104.0,93.0,197.0,97.25,95.5,96.35,95.7,2,1,1,0.5,3,1,2,0.333,1,0,0,1,195.0,199.44,197.22
2017-10-23,1610612745,1610612763,2017,90.0,98.0,188.0,112.7,109.85,98.25,97.5,3,3,0,1.0,2,2,0,1.0,1,2,2,0,216.24,193.96,205.10000000000002
2017-10-23,1610612749,1610612766,2017,103.0,94.0,197.0,99.8,108.15,99.45,97.7,3,2,1,0.667,2,1,1,0.5,1,1,1,0,200.48,194.96,197.72
2017-10-23,1610612742,1610612744,2017,103.0,133.0,236.0,104.45,102.7,107.5,105.85,3,0,3,0.0,3,1,2,0.333,0,0,0,1,213.0,199.04,206.01999999999998
2017-10-23,1610612759,1610612761,2017,101.0,97.0,198.0,107.75,96.55,100.6,99.2,2,2,0,1.0,2,2,0,1.0,1,1,2,0,204.12,206.0,205.06
2017-10-23,1610612743,1610612764,2017,104.0,109.0,213.0,109.2,110.3,94.7,91.35,2,1,1,0.5,2,2,0,1.0,1,0,2,0,217.04,193.0,205.01999999999998
2017-10-23,1610612756,1610612758,2017,117.0,115.0,232.0,106.25,103.85,97.75,101.5,3,0,3,0.0,3,1,2,0.333,0,0,0,1,212.88,207.08,209.98000000000002
2017-10-22,1610612751,1610612737,2017,116.0,104.0,220.0,96.7,98.4,96.35,95.7,2,1,1,0.5,2,1,1,0.5,1,0,0,1,196.96,199.44,198.2
2017-10-22,1610612760,1610612750,2017,113.0,115.0,228.0,101.8,103.4,110.05,111.2,2,1,1,0.5,2,1,1,0.5,1,0,1,0,210.36,209.4,209.88
2017-10-22,1610612747,1610612740,2017,112.0,119.0,231.0,107.3,114.65,100.45,104.8,2,1,1,0.5,2,0,2,0.0,0,1,0,0,219.28,200.8,210.04000000000002
2017-10-21,1610612761,1610612755,2017,128.0,94.0,222.0,100.6,99.2,97.85,106.0,1,1,0,1.0,2,0,2,0.0,1,0,0,0,206.0,207.68,206.84
2017-10-21,1610612739,1610612753,2017,93.0,114.0,207.0,101.9,101.55,96.55,103.5,2,2,0,1.0,2,1,1,0.5,1,1,1,0,195.48,203.64,199.56
2017-10-21,1610612748,1610612754,2017,112.0,108.0,220.0,97.25,95.5,92.05,92.25,1,0,1,0.0,2,1,1,0.5,0,0,1,0,195.0,187.28,191.14
2017-10-21,1610612752,1610612765,2017,107.0,111.0,218.0,101.2,97.2,100.85,105.95,1,0,1,0.0,2,1,1,0.5,0,0,1,0,200.28,206.0,203.14
2017-10-21,1610612741,1610612759,2017,77.0,87.0,164.0,94.0,91.0,107.75,96.55,1,0,1,0.0,1,1,0,1.0,0,0,1,0,185.44,204.12,194.78
2017-10-21,1610612745,1610612742,2017,107.0,91.0,198.0,112.7,109.85,104.45,102.7,2,2,0,1.0,2,0,2,0.0,0,2,0,0,216.24,213.0,214.62
2017-10-21,1610612763,1610612744,2017,111.0,101.0,212.0,98.25,97.5,107.5,105.85,1,1,0,1.0,2,1,1,0.5,1,0,0,1,193.96,199.04,196.5
2017-10-21,1610612749,1610612757,2017,113.0,110.0,223.0,99.8,108.15,104.75,105.45,2,1,1,0.5,2,2,0,1.0,0,1,0,2,200.48,209.44,204.95999999999998
2017-10-21,1610612743,1610612758,2017,96.0,79.0,175.0,109.2,110.3,97.75,101.5,1,0,1,0.0,2,1,1,0.5,0,0,0,1,217.04,207.08,212.06
2017-10-21,1610612762,1610612760,2017,96.0,87.0,183.0,95.55,106.55,101.8,103.4,2,1,1,0.5,1,1,0,1.0,1,0,1,0,200.2,210.36,205.28
2017-10-21,1610612746,1610612756,2017,130.0,88.0,218.0,109.85,106.5,106.25,103.85,1,1,0,1.0,2,0,2,0.0,0,1,0,0,214.36,212.88,213.62
2017-10-20,1610612766,1610612737,2017,109.0,91.0,200.0,99.45,97.7,96.35,95.7,1,0,1,0.0,1,1,0,1.0,0,0,0,1,194.96,199.44,197.2
2017-10-20,1610612754,1610612757,2017,96.0,114.0,210.0,92.05,92.25,104.75,105.45,1,1,0,1.0,1,1,0,1.0,1,0,0,1,187.28,209.44,198.36
2017-10-20,1610612755,1610612738,2017,92.0,102.0,194.0,97.85,106.0,99.65,105.5,1,0,1,0.0,2,0,2,0.0,0,0,0,0,207.68,195.08,201.38
2017-10-20,1610612764,1610612765,2017,115.0,111.0,226.0,94.7,91.35,100.85,105.95,1,1,0,1.0,1,1,0,1.0,1,0,1,0,193.0,206.0,199.5
2017-10-20,1610612749,1610612739,2017,97.0,116.0,213.0,99.8,108.15,101.9,101.55,1,1,0,1.0,1,1,0,1.0,0,1,1,0,200.48,195.48,197.98
2017-10-20,1610612751,1610612753,2017,126.0,121.0,247.0,96.7,98.4,96.55,103.5,1,0,1,0.0,1,1,0,1.0,0,0,1,0,196.96,203.64,200.3
2017-10-20,1610612750,1610612762,2017,100.0,97.0,197.0,110.05,111.2,95.55,106.55,1,0,1,0.0,1,1,0,1.0,0,0,1,0,209.4,200.2,204.8
2017-10-20,1610612742,1610612758,2017,88.0,93.0,181.0,104.45,102.7,97.75,101.5,1,0,1,0.0,1,0,1,0.0,0,0,0,0,213.0,207.08,210.04000000000002
2017-10-20,1610612740,1610612744,2017,120.0,128.0,248.0,100.45,104.8,107.5,105.85,1,0,1,0.0,1,0,1,0.0,0,0,0,0,200.8,199.04,199.92000000000002
2017-10-20,1610612756,1610612747,2017,130.0,132.0,262.0,106.25,103.85,107.3,114.65,1,0,1,0.0,1,0,1,0.0,0,0,0,0,212.88,219.28,216.07999999999998
2017-10-19,1610612761,1610612741,2017,117.0,100.0,217.0,100.6,99.2,94.0,91.0,0,0,0,0.0,0,0,0,0.0,0,0,0,0,206.0,185.44,195.72
2017-10-19,1610612760,1610612752,2017,105.0,84.0,189.0,101.8,103.4,101.2,97.2,0,0,0,0.0,0,0,0,0.0,0,0,0,0,210.36,200.28,205.32
2017-10-19,1610612747,1610612746,2017,92.0,108.0,200.0,107.3,114.65,109.85,106.5,0,0,0,0.0,0,0,0,0.0,0,0,0,0,219.28,214.36,216.82
2017-10-18,1610612765,1610612766,2017,102.0,90.0,192.0,100.85,105.95,99.45,97.7,0,0,0,0.0,0,0,0,0.0,0,0,0,0,206.0,194.96,200.48000000000002
2017-10-18,1610612754,1610612751,2017,140.0,131.0,271.0,92.05,92.25,96.7,98.4,0,0,0,0.0,0,0,0,0.0,0,0,0,0,187.28,196.96,192.12
2017-10-18,1610612753,1610612748,2017,116.0,109.0,225.0,96.55,103.5,97.25,95.5,0,0,0,0.0,0,0,0,0.0,0,0,0,0,203.64,195.0,199.32
2017-10-18,1610612764,1610612755,2017,120.0,115.0,235.0,94.7,91.35,97.85,106.0,0,0,0,0.0,0,0,0,0.0,0,0,0,0,193.0,207.68,200.34
2017-10-18,1610612738,1610612749,2017,100.0,108.0,208.0,99.65,105.5,99.8,108.15,1,0,1,0.0,0,0,0,0.0,0,0,0,0,195.08,200.48,197.78
2017-10-18,1610612763,1610612740,2017,103.0,91.0,194.0,98.25,97.5,100.45,104.8,0,0,0,0.0,0,0,0,0.0,0,0,0,0,193.96,200.8,197.38
2017-10-18,1610612742,1610612737,2017,111.0,117.0,228.0,104.45,102.7,96.35,95.7,0,0,0,0.0,0,0,0,0.0,0,0,0,0,213.0,199.44,206.22
2017-10-18,1610612762,1610612743,2017,106.0,96.0,202.0,95.55,106.55,109.2,110.3,0,0,0,0.0,0,0,0,0.0,0,0,0,0,200.2,217.04,208.62
2017-10-18,1610612759,1610612750,2017,107.0,99.0,206.0,107.75,96.55,110.05,111.2,0,0,0,0.0,0,0,0,0.0,0,0,0,0,204.12,209.4,206.76
2017-10-18,1610612756,1610612757,2017,76.0,124.0,200.0,106.25,103.85,104.75,105.45,0,0,0,0.0,0,0,0,0.0,0,0,0,0,212.88,209.44,211.16
2017-10-18,1610612758,1610612745,2017,100.0,105.0,205.0,97.75,101.5,112.7,109.85,0,0,0,0.0,1,1,0,1.0,0,0,0,1,207.08,216.24,211.66000000000003
2017-10-17,1610612739,1610612738,2017,102.0,99.0,201.0,101.9,101.55,99.65,105.5,5,1,4,0.2,4,4,0,1.0,0,1,2,2,195.48,195.08,195.28
2017-10-17,1610612744,1610612745,2017,121.0,122.0,243.0,107.5,105.85,112.7,109.85,4,2,2,0.5,5,4,1,0.8,1,1,1,3,199.04,216.24,207.64
2017-10-13,1610612766,1610612742,2017,111.0,96.0,207.0,99.45,97.7,104.45,102.7,4,1,3,0.25,5,4,1,0.8,0,1,3,1,194.96,213.0,203.98000000000002
2017-10-13,1610612753,1610612739,2017,106.0,113.0,219.0,96.55,103.5,101.9,101.55,5,3,2,0.6,4,0,4,0.0,2,1,0,0,203.64,195.48,199.56
2017-10-13,1610612752,1610612764,2017,103.0,110.0,213.0,101.2,97.2,94.7,91.35,4,0,4,0.0,4,3,1,0.75,0,0,3,0,200.28,193.0,196.64
2017-10-13,1610612741,1610612761,2017,104.0,125.0,229.0,94.0,91.0,100.6,99.2,5,3,2,0.6,4,2,2,0.5,1,2,2,0,185.44,206.0,195.72
2017-10-13,1610612763,1610612740,2017,142.0,101.0,243.0,98.25,97.5,100.45,104.8,4,2,2,0.5,3,1,2,0.333,1,1,0,1,193.96,200.8,197.38
2017-10-13,1610612745,1610612759,2017,97.0,106.0,203.0,112.7,109.85,107.75,96.55,4,4,0,1.0,4,2,2,0.5,1,3,2,0,216.24,204.12,210.18
2017-10-13,1610612755,1610612748,2017,119.0,95.0,214.0,97.85,106.0,97.25,95.5,4,1,3,0.25,5,3,2,0.6,0,1,3,0,207.68,195.0,201.34
2017-10-13,1610612749,1610612765,2017,107.0,103.0,210.0,99.8,108.15,100.85,105.95,3,0,3,0.0,4,2,2,0.5,0,0,2,0,200.48,206.0,203.24
2017-10-13,1610612744,1610612758,2017,117.0,106.0,223.0,107.5,105.85,97.75,101.5,3,1,2,0.333,5,1,4,0.2,0,1,1,0,199.04,207.08,203.06
2017-10-13,1610612746,1610612747,2017,104.0,111.0,215.0,109.85,106.5,107.3,114.65,4,2,2,0.5,5,1,4,0.2,2,0,1,0,214.36,219.28,216.82
2017-10-12,1610612737,1610612742,2017,94.0,108.0,202.0,96.35,95.7,104.45,102.7,4,2,2,0.5,4,3,1,0.75,1,1,3,0,199.44,213.0,206.22
2017-10-12,1610612746,1610612758,2017,104.0,87.0,191.0,109.85,106.5,97.75,101.5,3,1,2,0.333,4,1,3,0.25,1,0,1,0,214.36,207.08,210.72000000000003
2017-10-11,1610612766,1610612738,2017,100.0,108.0,208.0,99.45,97.7,99.65,105.5,3,1,2,0.333,3,3,0,1.0,0,1,2,1,194.96,195.08,195.02
2017-10-11,1610612751,1610612755,2017,114.0,133.0,247.0,96.7,98.4,97.85,106.0,3,3,0,1.0,3,0,3,0.0,2,1,0,0,196.96,207.68,202.32
2017-10-11,1610612748,1610612764,2017,117.0,115.0,232.0,97.25,95.5,94.7,91.35,4,2,2,0.5,3,3,0,1.0,2,0,3,0,195.0,193.0,194.0
2017-10-11,1610612763,1610612745,2017,89.0,101.0,190.0,98.25,97.5,112.7,109.85,3,2,1,0.667,3,3,0,1.0,1,1,1,2,193.96,216.24,205.10000000000002
2017-10-11,1610612756,1610612757,2017,104.0,113.0,217.0,106.25,103.85,104.75,105.45,3,1,2,0.333,4,3,1,0.75,0,1,1,2,212.88,209.44,211.16
2017-10-10,1610612761,1610612765,2017,116.0,94.0,210.0,100.6,99.2,100.85,105.95,3,1,2,0.333,3,2,1,0.667,1,0,2,0,206.0,206.0,206.0
2017-10-10,1610612739,1610612741,2017,94.0,108.0,202.0,101.9,101.55,94.0,91.0,3,0,3,0.0,4,2,2,0.5,0,0,1,1,195.48,185.44,190.45999999999998
2017-10-10,1610612759,1610612753,2017,98.0,103.0,201.0,107.75,96.55,96.55,103.5,3,2,1,0.667,4,2,2,0.5,2,0,2,0,204.12,203.64,203.88
2017-10-10,1610612743,1610612760,2017,86.0,96.0,182.0,109.2,110.3,101.8,103.4,4,3,1,0.75,3,2,1,0.667,0,3,2,0,217.04,210.36,213.7
2017-10-10,1610612747,1610612762,2017,99.0,105.0,204.0,107.3,114.65,95.55,106.55,4,1,3,0.25,4,4,0,1.0,1,0,3,1,219.28,200.2,209.74
2017-10-09,1610612765,1610612754,2017,107.0,97.0,204.0,100.85,105.95,92.05,92.25,2,1,1,0.5,2,2,0,1.0,1,0,0,2,206.0,187.28,196.64
2017-10-09,1610612738,1610612755,2017,113.0,96.0,209.0,99.65,105.5,97.85,106.0,2,2,0,1.0,2,0,2,0.0,1,1,0,0,195.08,207.68,201.38
2017-10-09,1610612752,1610612745,2017,95.0,117.0,212.0,101.2,97.2,112.7,109.85,3,0,3,0.0,2,2,0,1.0,0,0,1,1,200.28,216.24,208.26
2017-10-09,1610612737,1610612763,2017,100.0,88.0,188.0,96.35,95.7,98.25,97.5,3,1,2,0.333,2,2,0,1.0,0,1,1,1,199.44,193.96,196.7
2017-10-09,1610612748,1610612766,2017,109.0,106.0,215.0,97.25,95.5,99.45,97.7,3,1,2,0.333,2,1,1,0.5,1,0,0,1,195.0,194.96,194.98000000000002
2017-10-09,1610612742,1610612753,2017,99.0,96.0,195.0,104.45,102.7,96.55,103.5,3,2,1,0.667,3,2,1,0.667,2,0,2,0,213.0,203.64,208.32
2017-10-09,1610612756,1610612762,2017,102.0,120.0,222.0,106.25,103.85,95.55,106.55,2,1,1,0.5,3,3,0,1.0,0,1,3,0,212.88,200.2,206.54
2017-10-09,1610612758,1610612757,2017,83.0,97.0,180.0,97.75,101.5,104.75,105.45,3,1,2,0.333,3,2,1,0.667,1,0,1,1,207.08,209.44,208.26
2017-10-08,1610612750,1610612744,2017,110.0,142.0,252.0,110.05,111.2,107.5,105.85,2,2,0,1.0,2,0,2,0.0,0,2,0,0,209.4,199.04,204.22
2017-10-08,1610612764,1610612739,2017,102.0,94.0,196.0,94.7,91.35,101.9,101.55,2,2,0,1.0,2,0,2,0.0,2,0,0,0,193.0,195.48,194.24
2017-10-08,1610612746,1610612757,2017,106.0,134.0,240.0,109.85,106.5,104.75,105.45,2,1,1,0.5,2,1,1,0.5,1,0,1,0,214.36,209.44,211.9
2017-10-08,1610612759,1610612743,2017,122.0,100.0,222.0,107.75,96.55,109.2,110.3,2,1,1,0.5,3,3,0,1.0,1,0,0,3,204.12,217.04,210.57999999999998
2017-10-08,1610612741,1610612740,2017,95.0,108.0,203.0,94.0,91.0,100.45,104.8,3,2,1,0.667,2,0,2,0.0,1,1,0,0,185.44,200.8,193.12
2017-10-08,1610612751,1610612752,2017,117.0,83.0,200.0,96.7,98.4,101.2,97.2,2,2,0,1.0,2,0,2,0.0,1,1,0,0,196.96,200.28,198.62
2017-10-08,1610612747,1610612758,2017,75.0,69.0,144.0,107.3,114.65,97.75,101.5,3,0,3,0.0,2,1,1,0.5,0,0,1,0,219.28,207.08,213.18
2017-10-07,1610612753,1610612748,2017,93.0,90.0,183.0,96.55,103.5,97.25,95.5,2,1,1,0.5,2,1,1,0.5,1,0,1,0,203.64,195.0,199.32
2017-10-06,1610612755,1610612738,2017,102.0,110.0,212.0,97.85,106.0,99.65,105.5,1,0,1,0.0,1,1,0,1.0,0,0,1,0,207.68,195.08,201.38
2017-10-06,1610612764,1610612752,2017,104.0,100.0,204.0,94.7,91.35,101.2,97.2,1,1,0,1.0,1,0,1,0.0,1,0,0,0,193.0,200.28,196.64
2017-10-06,1610612765,1610612737,2017,109.0,87.0,196.0,100.85,105.95,96.35,95.7,1,0,1,0.0,2,1,1,0.5,0,0,0,1,206.0,199.44,202.72
2017-10-06,1610612739,1610612754,2017,102.0,106.0,208.0,101.9,101.55,92.05,92.25,1,0,1,0.0,1,1,0,1.0,0,0,0,1,195.48,187.28,191.38
2017-10-06,1610612741,1610612749,2017,114.0,101.0,215.0,94.0,91.0,99.8,108.15,2,1,1,0.5,2,0,2,0.0,0,1,0,0,185.44,200.48,192.95999999999998
2017-10-06,1610612760,1610612740,2017,102.0,91.0,193.0,101.8,103.4,100.45,104.8,1,0,1,0.0,1,0,1,0.0,0,0,0,0,210.36,200.8,205.58
2017-10-06,1610612759,1610612758,2017,113.0,93.0,206.0,107.75,96.55,97.75,101.5,1,0,1,0.0,1,1,0,1.0,0,0,1,0,204.12,207.08,205.60000000000002
2017-10-06,1610612762,1610612756,2017,112.0,101.0,213.0,95.55,106.55,106.25,103.85,2,2,0,1.0,1,1,0,1.0,2,0,0,1,200.2,212.88,206.54
2017-10-05,1610612744,1610612750,2017,95.0,111.0,206.0,107.5,105.85,110.05,111.2,1,0,1,0.0,1,1,0,1.0,0,0,0,1,199.04,209.4,204.22
2017-10-05,1610612753,1610612742,2017,112.0,89.0,201.0,96.55,103.5,104.45,102.7,1,0,1,0.0,2,2,0,1.0,0,0,2,0,203.64,213.0,208.32
2017-10-05,1610612751,1610612748,2017,107.0,88.0,195.0,96.7,98.4,97.25,95.5,1,1,0,1.0,1,1,0,1.0,0,1,1,0,196.96,195.0,195.98000000000002
2017-10-05,1610612757,1610612761,2017,106.0,101.0,207.0,104.75,105.45,100.6,99.2,1,0,1,0.0,2,1,1,0.5,0,0,1,0,209.44,206.0,207.72
2017-10-04,1610612746,1610612761,2017,98.0,84.0,182.0,109.85,106.5,100.6,99.2,1,0,1,0.0,1,1,0,1.0,0,0,1,0,214.36,206.0,210.18
2017-10-04,1610612755,1610612763,2017,89.0,110.0,199.0,97.85,106.0,98.25,97.5,0,0,0,0.0,1,1,0,1.0,0,0,1,0,207.68,193.96,200.82
2017-10-04,1610612739,1610612737,2017,93.0,109.0,202.0,101.9,101.55,96.35,95.7,0,0,0,0.0,1,0,1,0.0,0,0,0,0,195.48,199.44,197.45999999999998
2017-10-04,1610612765,1610612766,2017,104.0,109.0,213.0,100.85,105.95,99.45,97.7,0,0,0,0.0,1,0,1,0.0,0,0,0,0,206.0,194.96,200.48000000000002
2017-10-04,1610612749,1610612754,2017,86.0,104.0,190.0,99.8,108.15,92.05,92.25,1,0,1,0.0,0,0,0,0.0,0,0,0,0,200.48,187.28,193.88
2017-10-04,1610612742,1610612741,2017,118.0,71.0,189.0,104.45,102.7,94.0,91.0,1,1,0,1.0,1,1,0,1.0,1,0,0,1,213.0,185.44,199.22
2017-10-04,1610612747,1610612743,2017,104.0,122.0,226.0,107.3,114.65,109.2,110.3,2,0,2,0.0,2,2,0,1.0,0,0,0,2,219.28,217.04,218.16
2017-10-03,1610612752,1610612751,2017,107.0,115.0,222.0,101.2,97.2,96.7,98.4,0,0,0,0.0,0,0,0,0.0,0,0,0,0,200.28,196.96,198.62
2017-10-03,1610612740,1610612741,2017,109.0,113.0,222.0,100.45,104.8,94.0,91.0,0,0,0,0.0,0,0,0,0.0,0,0,0,0,200.8,185.44,193.12
2017-10-03,1610612760,1610612745,2017,97.0,104.0,201.0,101.8,103.4,112.7,109.85,0,0,0,0.0,0,0,0,0.0,0,0,0,0,210.36,216.24,213.3
2017-10-03,1610612757,1610612756,2017,112.0,114.0,226.0,104.75,105.45,106.25,103.85,0,0,0,0.0,0,0,0,0.0,0,0,0,0,209.44,212.88,211.16
2017-10-02,1610612738,1610612766,2017,94.0,82.0,176.0,99.65,105.5,99.45,97.7,0,0,0,0.0,0,0,0,0.0,0,0,0,0,195.08,194.96,195.02
2017-10-02,1610612763,1610612753,2017,92.0,84.0,176.0,98.25,97.5,96.55,103.5,0,0,0,0.0,0,0,0,0.0,0,0,0,0,193.96,203.64,198.8
2017-10-02,1610612742,1610612749,2017,106.0,104.0,210.0,104.45,102.7,99.8,108.15,0,0,0,0.0,0,0,0,0.0,0,0,0,0,213.0,200.48,206.74
2017-10-02,1610612758,1610612759,2017,106.0,96.0,202.0,97.75,101.5,107.75,96.55,0,0,0,0.0,0,0,0,0.0,0,0,0,0,207.08,204.12,205.60000000000002
2017-10-02,1610612747,1610612743,2017,107.0,113.0,220.0,107.3,114.65,109.2,110.3,1,0,1,0.0,1,1,0,1.0,0,0,0,1,219.28,217.04,218.16
2017-10-01,1610612748,1610612737,2017,96.0,90.0,186.0,97.25,95.5,96.35,95.7,0,0,0,0.0,0,0,0,0.0,0,0,0,0,195.0,199.44,197.22
2017-10-01,1610612761,1610612746,2017,121.0,113.0,234.0,100.6,99.2,109.85,106.5,0,0,0,0.0,0,0,0,0.0,0,0,0,0,206.0,214.36,210.18
2017-09-30,1610612744,1610612743,2017,102.0,108.0,210.0,107.5,105.85,109.2,110.3,0,0,0,0.0,0,0,0,0.0,0,0,0,0,199.04,217.04,208.04
2017-09-30,1610612747,1610612750,2017,99.0,108.0,207.0,107.3,114.65,110.05,111.2,0,0,0,0.0,0,0,0,0.0,0,0,0,0,219.28,209.4,214.34
2017-06-12,1610612744,1610612739,2016,129.0,120.0,249.0,107.5,105.85,101.9,101.55,82,67,15,0.8170000000000001,82,51,31,0.622,36,31,31,20,199.04,195.48,197.26
2017-06-09,1610612739,1610612744,2016,137.0,116.0,253.0,101.9,101.55,107.5,105.85,82,51,31,0.622,82,67,15,0.8170000000000001,31,20,36,31,195.48,199.04,197.26
2017-06-07,1610612739,1610612744,2016,113.0,118.0,231.0,101.9,101.55,107.5,105.85,82,51,31,0.622,82,67,15,0.8170000000000001,31,20,36,31,195.48,199.04,197.26
2017-06-04,1610612744,1610612739,2016,132.0,113.0,245.0,107.5,105.85,101.9,101.55,82,67,15,0.8170000000000001,82,51,31,0.622,36,31,31,20,199.04,195.48,197.26
2017-06-01,1610612744,1610612739,2016,113.0,91.0,204.0,107.5,105.85,101.9,101.55,82,67,15,0.8170000000000001,82,51,31,0.622,36,31,31,20,199.04,195.48,197.26
2017-05-25,1610612738,1610612739,2016,102.0,135.0,237.0,99.65,105.5,101.9,101.55,82,53,29,0.6459999999999999,82,51,31,0.622,30,23,31,20,195.08,195.48,195.28
2017-05-23,1610612739,1610612738,2016,112.0,99.0,211.0,101.9,101.55,99.65,105.5,82,51,31,0.622,82,53,29,0.6459999999999999,31,20,30,23,195.48,195.08,195.28
2017-05-22,1610612759,1610612744,2016,115.0,129.0,244.0,107.75,96.55,107.5,105.85,82,61,21,0.7440000000000001,82,67,15,0.8170000000000001,31,30,36,31,204.12,199.04,201.57999999999998
2017-05-21,1610612739,1610612738,2016,108.0,111.0,219.0,101.9,101.55,99.65,105.5,82,51,31,0.622,82,53,29,0.6459999999999999,31,20,30,23,195.48,195.08,195.28
2017-05-20,1610612759,1610612744,2016,108.0,120.0,228.0,107.75,96.55,107.5,105.85,82,61,21,0.7440000000000001,82,67,15,0.8170000000000001,31,30,36,31,204.12,199.04,201.57999999999998
2017-05-19,1610612738,1610612739,2016,86.0,130.0,216.0,99.65,105.5,101.9,101.55,82,53,29,0.6459999999999999,82,51,31,0.622,30,23,31,20,195.08,195.48,195.28
2017-05-17,1610612738,1610612739,2016,104.0,117.0,221.0,99.65,105.5,101.9,101.55,82,53,29,0.6459999999999999,82,51,31,0.622,30,23,31,20,195.08,195.48,195.28
2017-05-16,1610612744,1610612759,2016,136.0,100.0,236.0,107.5,105.85,107.75,96.55,82,67,15,0.8170000000000001,82,61,21,0.7440000000000001,36,31,31,30,199.04,204.12,201.57999999999998
2017-05-15,1610612738,1610612764,2016,115.0,105.0,220.0,99.65,105.5,94.7,91.35,82,53,29,0.6459999999999999,82,49,33,0.598,30,23,30,19,195.08,193.0,194.04000000000002
2017-05-14,1610612744,1610612759,2016,113.0,111.0,224.0,107.5,105.85,107.75,96.55,82,67,15,0.8170000000000001,82,61,21,0.7440000000000001,36,31,31,30,199.04,204.12,201.57999999999998
2017-05-12,1610612764,1610612738,2016,92.0,91.0,183.0,94.7,91.35,99.65,105.5,82,49,33,0.598,82,53,29,0.6459999999999999,30,19,30,23,193.0,195.08,194.04000000000002
2017-05-11,1610612745,1610612759,2016,75.0,114.0,189.0,112.7,109.85,107.75,96.55,82,55,27,0.6709999999999999,82,61,21,0.7440000000000001,30,25,31,30,216.24,204.12,210.18
2017-05-10,1610612738,1610612764,2016,123.0,101.0,224.0,99.65,105.5,94.7,91.35,82,53,29,0.6459999999999999,82,49,33,0.598,30,23,30,19,195.08,193.0,194.04000000000002
2017-05-09,1610612759,1610612745,2016,110.0,107.0,217.0,107.75,96.55,112.7,109.85,82,61,21,0.7440000000000001,82,55,27,0.6709999999999999,31,30,30,25,204.12,216.24,210.18
2017-05-08,1610612762,1610612744,2016,95.0,121.0,216.0,95.55,106.55,107.5,105.85,82,51,31,0.622,82,67,15,0.8170000000000001,29,22,36,31,200.2,199.04,199.62
2017-05-07,1610612761,1610612739,2016,102.0,109.0,211.0,100.6,99.2,101.9,101.55,82,51,31,0.622,82,51,31,0.622,28,23,31,20,206.0,195.48,200.74
2017-05-07,1610612764,1610612738,2016,121.0,102.0,223.0,94.7,91.35,99.65,105.5,82,49,33,0.598,82,53,29,0.6459999999999999,30,19,30,23,193.0,195.08,194.04000000000002
2017-05-07,1610612745,1610612759,2016,125.0,104.0,229.0,112.7,109.85,107.75,96.55,82,55,27,0.6709999999999999,82,61,21,0.7440000000000001,30,25,31,30,216.24,204.12,210.18
2017-05-06,1610612762,1610612744,2016,91.0,102.0,193.0,95.55,106.55,107.5,105.85,82,51,31,0.622,82,67,15,0.8170000000000001,29,22,36,31,200.2,199.04,199.62
2017-05-05,1610612761,1610612739,2016,94.0,115.0,209.0,100.6,99.2,101.9,101.55,82,51,31,0.622,82,51,31,0.622,28,23,31,20,206.0,195.48,200.74
2017-05-05,1610612745,1610612759,2016,92.0,103.0,195.0,112.7,109.85,107.75,96.55,82,55,27,0.6709999999999999,82,61,21,0.7440000000000001,30,25,31,30,216.24,204.12,210.18
2017-05-04,1610612764,1610612738,2016,116.0,89.0,205.0,94.7,91.35,99.65,105.5,82,49,33,0.598,82,53,29,0.6459999999999999,30,19,30,23,193.0,195.08,194.04000000000002
2017-05-04,1610612744,1610612762,2016,115.0,104.0,219.0,107.5,105.85,95.55,106.55,82,67,15,0.8170000000000001,82,51,31,0.622,36,31,29,22,199.04,200.2,199.62
2017-05-03,1610612739,1610612761,2016,125.0,103.0,228.0,101.9,101.55,100.6,99.2,82,51,31,0.622,82,51,31,0.622,31,20,28,23,195.48,206.0,200.74
2017-05-03,1610612759,1610612745,2016,121.0,96.0,217.0,107.75,96.55,112.7,109.85,82,61,21,0.7440000000000001,82,55,27,0.6709999999999999,31,30,30,25,204.12,216.24,210.18
2017-05-02,1610612738,1610612764,2016,129.0,119.0,248.0,99.65,105.5,94.7,91.35,82,53,29,0.6459999999999999,82,49,33,0.598,30,23,30,19,195.08,193.0,194.04000000000002
2017-05-02,1610612744,1610612762,2016,106.0,94.0,200.0,107.5,105.85,95.55,106.55,82,67,15,0.8170000000000001,82,51,31,0.622,36,31,29,22,199.04,200.2,199.62
2017-05-01,1610612739,1610612761,2016,116.0,105.0,221.0,101.9,101.55,100.6,99.2,82,51,31,0.622,82,51,31,0.622,31,20,28,23,195.48,206.0,200.74
2017-05-01,1610612759,1610612745,2016,99.0,126.0,225.0,107.75,96.55,112.7,109.85,82,61,21,0.7440000000000001,82,55,27,0.6709999999999999,31,30,30,25,204.12,216.24,210.18
2017-04-30,1610612738,1610612764,2016,123.0,111.0,234.0,99.65,105.5,94.7,91.35,82,53,29,0.6459999999999999,82,49,33,0.598,30,23,30,19,195.08,193.0,194.04000000000002
2017-04-30,1610612746,1610612762,2016,91.0,104.0,195.0,109.85,106.5,95.55,106.55,82,51,31,0.622,82,51,31,0.622,29,22,29,22,214.36,200.2,207.28
2017-04-28,1610612737,1610612764,2016,99.0,115.0,214.0,96.35,95.7,94.7,91.35,82,43,39,0.524,82,49,33,0.598,23,20,30,19,199.44,193.0,196.22
2017-04-28,1610612741,1610612738,2016,83.0,105.0,188.0,94.0,91.0,99.65,105.5,82,41,41,0.5,82,53,29,0.6459999999999999,25,16,30,23,185.44,195.08,190.26
2017-04-28,1610612762,1610612746,2016,93.0,98.0,191.0,95.55,106.55,109.85,106.5,82,51,31,0.622,82,51,31,0.622,29,22,29,22,200.2,214.36,207.28
2017-04-27,1610612749,1610612761,2016,89.0,92.0,181.0,99.8,108.15,100.6,99.2,82,42,40,0.512,82,51,31,0.622,23,19,28,23,200.48,206.0,203.24
2017-04-27,1610612763,1610612759,2016,96.0,103.0,199.0,98.25,97.5,107.75,96.55,82,43,39,0.524,82,61,21,0.7440000000000001,24,19,31,30,193.96,204.12,199.04000000000002
2017-04-26,1610612764,1610612737,2016,103.0,99.0,202.0,94.7,91.35,96.35,95.7,82,49,33,0.598,82,43,39,0.524,30,19,23,20,193.0,199.44,196.22
2017-04-26,1610612738,1610612741,2016,108.0,97.0,205.0,99.65,105.5,94.0,91.0,82,53,29,0.6459999999999999,82,41,41,0.5,30,23,25,16,195.08,185.44,190.26
2017-04-25,1610612745,1610612760,2016,105.0,99.0,204.0,112.7,109.85,101.8,103.4,82,55,27,0.6709999999999999,82,47,35,0.573,30,25,28,19,216.24,210.36,213.3
2017-04-25,1610612759,1610612763,2016,116.0,103.0,219.0,107.75,96.55,98.25,97.5,82,61,21,0.7440000000000001,82,43,39,0.524,31,30,24,19,204.12,193.96,199.04000000000002
2017-04-25,1610612746,1610612762,2016,92.0,96.0,188.0,109.85,106.5,95.55,106.55,82,51,31,0.622,82,51,31,0.622,29,22,29,22,214.36,200.2,207.28
2017-04-24,1610612761,1610612749,2016,118.0,93.0,211.0,100.6,99.2,99.8,108.15,82,51,31,0.622,82,42,40,0.512,28,23,23,19,206.0,200.48,203.24
2017-04-24,1610612737,1610612764,2016,111.0,101.0,212.0,96.35,95.7,94.7,91.35,82,43,39,0.524,82,49,33,0.598,23,20,30,19,199.44,193.0,196.22
2017-04-24,1610612757,1610612744,2016,103.0,128.0,231.0,104.75,105.45,107.5,105.85,82,41,41,0.5,82,67,15,0.8170000000000001,25,16,36,31,209.44,199.04,204.24
2017-04-23,1610612754,1610612739,2016,102.0,106.0,208.0,92.05,92.25,101.9,101.55,82,42,40,0.512,82,51,31,0.622,29,13,31,20,187.28,195.48,191.38
2017-04-23,1610612760,1610612745,2016,109.0,113.0,222.0,101.8,103.4,112.7,109.85,82,47,35,0.573,82,55,27,0.6709999999999999,28,19,30,25,210.36,216.24,213.3
2017-04-23,1610612741,1610612738,2016,95.0,104.0,199.0,94.0,91.0,99.65,105.5,82,41,41,0.5,82,53,29,0.6459999999999999,25,16,30,23,185.44,195.08,190.26
2017-04-23,1610612762,1610612746,2016,105.0,98.0,203.0,95.55,106.55,109.85,106.5,82,51,31,0.622,82,51,31,0.622,29,22,29,22,200.2,214.36,207.28
2017-04-22,1610612749,1610612761,2016,76.0,87.0,163.0,99.8,108.15,100.6,99.2,82,42,40,0.512,82,51,31,0.622,23,19,28,23,200.48,206.0,203.24
2017-04-22,1610612737,1610612764,2016,116.0,98.0,214.0,96.35,95.7,94.7,91.35,82,43,39,0.524,82,49,33,0.598,23,20,30,19,199.44,193.0,196.22
2017-04-22,1610612763,1610612759,2016,110.0,108.0,218.0,98.25,97.5,107.75,96.55,82,43,39,0.524,82,61,21,0.7440000000000001,24,19,31,30,193.96,204.12,199.04000000000002
2017-04-22,1610612757,1610612744,2016,113.0,119.0,232.0,104.75,105.45,107.5,105.85,82,41,41,0.5,82,67,15,0.8170000000000001,25,16,36,31,209.44,199.04,204.24
2017-04-21,1610612741,1610612738,2016,87.0,104.0,191.0,94.0,91.0,99.65,105.5,82,41,41,0.5,82,53,29,0.6459999999999999,25,16,30,23,185.44,195.08,190.26
2017-04-21,1610612760,1610612745,2016,115.0,113.0,228.0,101.8,103.4,112.7,109.85,82,47,35,0.573,82,55,27,0.6709999999999999,28,19,30,25,210.36,216.24,213.3
2017-04-21,1610612762,1610612746,2016,106.0,111.0,217.0,95.55,106.55,109.85,106.5,82,51,31,0.622,82,51,31,0.622,29,22,29,22,200.2,214.36,207.28
2017-04-20,1610612754,1610612739,2016,114.0,119.0,233.0,92.05,92.25,101.9,101.55,82,42,40,0.512,82,51,31,0.622,29,13,31,20,187.28,195.48,191.38
2017-04-20,1610612749,1610612761,2016,104.0,77.0,181.0,99.8,108.15,100.6,99.2,82,42,40,0.512,82,51,31,0.622,23,19,28,23,200.48,206.0,203.24
2017-04-20,1610612763,1610612759,2016,105.0,94.0,199.0,98.25,97.5,107.75,96.55,82,43,39,0.524,82,61,21,0.7440000000000001,24,19,31,30,193.96,204.12,199.04000000000002
2017-04-19,1610612764,1610612737,2016,109.0,101.0,210.0,94.7,91.35,96.35,95.7,82,49,33,0.598,82,43,39,0.524,30,19,23,20,193.0,199.44,196.22
2017-04-19,1610612745,1610612760,2016,115.0,111.0,226.0,112.7,109.85,101.8,103.4,82,55,27,0.6709999999999999,82,47,35,0.573,30,25,28,19,216.24,210.36,213.3
2017-04-19,1610612744,1610612757,2016,110.0,81.0,191.0,107.5,105.85,104.75,105.45,82,67,15,0.8170000000000001,82,41,41,0.5,36,31,25,16,199.04,209.44,204.24
2017-04-18,1610612761,1610612749,2016,106.0,100.0,206.0,100.6,99.2,99.8,108.15,82,51,31,0.622,82,42,40,0.512,28,23,23,19,206.0,200.48,203.24
2017-04-18,1610612738,1610612741,2016,97.0,111.0,208.0,99.65,105.5,94.0,91.0,82,53,29,0.6459999999999999,82,41,41,0.5,30,23,25,16,195.08,185.44,190.26
2017-04-18,1610612746,1610612762,2016,99.0,91.0,190.0,109.85,106.5,95.55,106.55,82,51,31,0.622,82,51,31,0.622,29,22,29,22,214.36,200.2,207.28
2017-04-17,1610612739,1610612754,2016,117.0,111.0,228.0,101.9,101.55,92.05,92.25,82,51,31,0.622,82,42,40,0.512,31,20,29,13,195.48,187.28,191.38
2017-04-17,1610612759,1610612763,2016,96.0,82.0,178.0,107.75,96.55,98.25,97.5,82,61,21,0.7440000000000001,82,43,39,0.524,31,30,24,19,204.12,193.96,199.04000000000002
2017-04-16,1610612764,1610612737,2016,114.0,107.0,221.0,94.7,91.35,96.35,95.7,82,49,33,0.598,82,43,39,0.524,30,19,23,20,193.0,199.44,196.22
2017-04-16,1610612744,1610612757,2016,121.0,109.0,230.0,107.5,105.85,104.75,105.45,82,67,15,0.8170000000000001,82,41,41,0.5,36,31,25,16,199.04,209.44,204.24
2017-04-16,1610612738,1610612741,2016,102.0,106.0,208.0,99.65,105.5,94.0,91.0,82,53,29,0.6459999999999999,82,41,41,0.5,30,23,25,16,195.08,185.44,190.26
2017-04-16,1610612745,1610612760,2016,118.0,87.0,205.0,112.7,109.85,101.8,103.4,82,55,27,0.6709999999999999,82,47,35,0.573,30,25,28,19,216.24,210.36,213.3
2017-04-15,1610612739,1610612754,2016,109.0,108.0,217.0,101.9,101.55,92.05,92.25,82,51,31,0.622,82,42,40,0.512,31,20,29,13,195.48,187.28,191.38
2017-04-15,1610612761,1610612749,2016,83.0,97.0,180.0,100.6,99.2,99.8,108.15,82,51,31,0.622,82,42,40,0.512,28,23,23,19,206.0,200.48,203.24
2017-04-15,1610612759,1610612763,2016,111.0,82.0,193.0,107.75,96.55,98.25,97.5,82,61,21,0.7440000000000001,82,43,39,0.524,31,30,24,19,204.12,193.96,199.04000000000002
2017-04-15,1610612746,1610612762,2016,95.0,97.0,192.0,109.85,106.5,95.55,106.55,82,51,31,0.622,82,51,31,0.622,29,22,29,22,214.36,200.2,207.28
2017-04-12,1610612753,1610612765,2016,113.0,109.0,222.0,96.55,103.5,100.85,105.95,81,28,53,0.34600000000000003,81,37,44,0.457,15,13,24,13,203.64,206.0,204.82
2017-04-12,1610612739,1610612761,2016,83.0,98.0,181.0,101.9,101.55,100.6,99.2,81,51,30,0.63,81,50,31,0.617,31,20,28,22,195.48,206.0,200.74
2017-04-12,1610612738,1610612749,2016,112.0,94.0,206.0,99.65,105.5,99.8,108.15,81,52,29,0.642,81,42,39,0.519,29,23,23,19,195.08,200.48,197.78
2017-04-12,1610612752,1610612755,2016,114.0,113.0,227.0,101.2,97.2,97.85,106.0,81,30,51,0.37,81,28,53,0.34600000000000003,18,12,17,11,200.28,207.68,203.98000000000002
2017-04-12,1610612748,1610612764,2016,110.0,102.0,212.0,97.25,95.5,94.7,91.35,81,40,41,0.494,81,49,32,0.605,22,18,30,19,195.0,193.0,194.0
2017-04-12,1610612741,1610612751,2016,112.0,73.0,185.0,94.0,91.0,96.7,98.4,81,40,41,0.494,81,20,61,0.247,24,16,13,7,185.44,196.96,191.2
2017-04-12,1610612763,1610612742,2016,93.0,100.0,193.0,98.25,97.5,104.45,102.7,81,43,38,0.531,81,32,49,0.395,24,19,21,11,193.96,213.0,203.48000000000002
2017-04-12,1610612745,1610612750,2016,123.0,118.0,241.0,112.7,109.85,110.05,111.2,81,54,27,0.667,81,31,50,0.383,29,25,20,11,216.24,209.4,212.82
2017-04-12,1610612760,1610612743,2016,105.0,111.0,216.0,101.8,103.4,109.2,110.3,81,47,34,0.58,81,39,42,0.481,28,19,22,17,210.36,217.04,213.7
2017-04-12,1610612754,1610612737,2016,104.0,86.0,190.0,92.05,92.25,96.35,95.7,81,41,40,0.506,81,43,38,0.531,28,13,23,20,187.28,199.44,193.36
2017-04-12,1610612762,1610612759,2016,101.0,97.0,198.0,95.55,106.55,107.75,96.55,81,50,31,0.617,81,61,20,0.753,28,22,31,30,200.2,204.12,202.16
2017-04-12,1610612746,1610612758,2016,115.0,95.0,210.0,109.85,106.5,97.75,101.5,81,50,31,0.617,81,32,49,0.395,28,22,17,15,214.36,207.08,210.72000000000003
2017-04-12,1610612744,1610612747,2016,109.0,94.0,203.0,107.5,105.85,107.3,114.65,81,66,15,0.815,81,26,55,0.321,35,31,17,9,199.04,219.28,209.16
2017-04-12,1610612757,1610612740,2016,100.0,103.0,203.0,104.75,105.45,100.45,104.8,81,41,40,0.506,81,33,48,0.407,25,16,21,12,209.44,200.8,205.12
2017-04-11,1610612737,1610612766,2016,103.0,76.0,179.0,96.35,95.7,99.45,97.7,80,42,38,0.525,81,36,45,0.444,22,20,22,14,199.44,194.96,197.2
2017-04-11,1610612750,1610612760,2016,98.0,100.0,198.0,110.05,111.2,101.8,103.4,80,31,49,0.388,80,46,34,0.575,20,11,28,18,209.4,210.36,209.88
2017-04-11,1610612742,1610612743,2016,91.0,109.0,200.0,104.45,102.7,109.2,110.3,80,32,48,0.4,80,38,42,0.475,21,11,22,16,213.0,217.04,215.01999999999998
2017-04-11,1610612747,1610612740,2016,108.0,96.0,204.0,107.3,114.65,100.45,104.8,80,25,55,0.313,80,33,47,0.413,16,9,21,12,219.28,200.8,210.04000000000002
2017-04-11,1610612758,1610612756,2016,129.0,104.0,233.0,97.75,101.5,106.25,103.85,80,31,49,0.388,81,24,57,0.29600000000000004,16,15,15,9,207.08,212.88,209.98000000000002
2017-04-10,1610612755,1610612754,2016,111.0,120.0,231.0,97.85,106.0,92.05,92.25,80,28,52,0.35,80,40,40,0.5,17,11,28,12,207.68,187.28,197.48000000000002
2017-04-10,1610612738,1610612751,2016,114.0,105.0,219.0,99.65,105.5,96.7,98.4,80,51,29,0.638,80,20,60,0.25,28,23,13,7,195.08,196.96,196.02
2017-04-10,1610612748,1610612739,2016,124.0,121.0,245.0,97.25,95.5,101.9,101.55,80,39,41,0.488,80,51,29,0.638,21,18,31,20,195.0,195.48,195.24
2017-04-10,1610612741,1610612753,2016,122.0,75.0,197.0,94.0,91.0,96.55,103.5,80,39,41,0.488,80,28,52,0.35,23,16,15,13,185.44,203.64,194.54
2017-04-10,1610612749,1610612766,2016,89.0,79.0,168.0,99.8,108.15,99.45,97.7,80,41,39,0.513,80,36,44,0.45,22,19,22,14,200.48,194.96,197.72
2017-04-10,1610612765,1610612764,2016,101.0,105.0,206.0,100.85,105.95,94.7,91.35,80,37,43,0.463,80,48,32,0.6,24,13,30,18,206.0,193.0,199.5
2017-04-10,1610612757,1610612759,2016,99.0,98.0,197.0,104.75,105.45,107.75,96.55,80,40,40,0.5,80,61,19,0.763,24,16,31,30,209.44,204.12,206.78
2017-04-10,1610612746,1610612745,2016,125.0,96.0,221.0,109.85,106.5,112.7,109.85,80,49,31,0.613,80,54,26,0.675,27,22,29,25,214.36,216.24,215.3
2017-04-10,1610612744,1610612762,2016,99.0,105.0,204.0,107.5,105.85,95.55,106.55,80,66,14,0.825,80,49,31,0.613,35,31,28,21,199.04,200.2,199.62
2017-04-09,1610612752,1610612761,2016,97.0,110.0,207.0,101.2,97.2,100.6,99.2,80,30,50,0.375,80,49,31,0.613,18,12,28,21,200.28,206.0,203.14
2017-04-09,1610612737,1610612739,2016,126.0,125.0,251.0,96.35,95.7,101.9,101.55,79,41,38,0.519,79,51,28,0.6459999999999999,21,20,31,20,199.44,195.48,197.45999999999998
2017-04-09,1610612743,1610612760,2016,105.0,106.0,211.0,109.2,110.3,101.8,103.4,79,38,41,0.481,79,45,34,0.57,22,16,28,17,217.04,210.36,213.7
2017-04-09,1610612756,1610612742,2016,124.0,111.0,235.0,106.25,103.85,104.45,102.7,80,23,57,0.28800000000000003,79,32,47,0.405,14,9,21,11,212.88,213.0,212.94
2017-04-09,1610612758,1610612745,2016,128.0,135.0,263.0,97.75,101.5,112.7,109.85,79,31,48,0.392,79,53,26,0.6709999999999999,16,15,29,24,207.08,216.24,211.66000000000003
2017-04-09,1610612763,1610612765,2016,90.0,103.0,193.0,98.25,97.5,100.85,105.95,80,43,37,0.5379999999999999,79,36,43,0.456,24,19,24,12,193.96,206.0,199.98000000000002
2017-04-09,1610612747,1610612750,2016,110.0,109.0,219.0,107.3,114.65,110.05,111.2,79,24,55,0.304,79,31,48,0.392,15,9,20,11,219.28,209.4,214.34
2017-04-08,1610612751,1610612741,2016,107.0,106.0,213.0,96.7,98.4,94.0,91.0,79,19,60,0.241,79,39,40,0.494,12,7,23,16,196.96,185.44,191.2
2017-04-08,1610612766,1610612738,2016,114.0,121.0,235.0,99.45,97.7,99.65,105.5,79,36,43,0.456,79,50,29,0.633,22,14,28,22,194.96,195.08,195.02
2017-04-08,1610612753,1610612754,2016,112.0,127.0,239.0,96.55,103.5,92.05,92.25,79,28,51,0.354,79,39,40,0.494,15,13,28,11,203.64,187.28,195.45999999999998
2017-04-08,1610612755,1610612749,2016,82.0,90.0,172.0,97.85,106.0,99.8,108.15,79,28,51,0.354,79,40,39,0.506,17,11,22,18,207.68,200.48,204.07999999999998
2017-04-08,1610612764,1610612748,2016,103.0,106.0,209.0,94.7,91.35,97.25,95.5,79,48,31,0.608,79,38,41,0.481,30,18,21,17,193.0,195.0,194.0
2017-04-08,1610612759,1610612746,2016,87.0,98.0,185.0,107.75,96.55,109.85,106.5,79,61,18,0.772,79,48,31,0.608,31,30,27,21,204.12,214.36,209.24
2017-04-08,1610612757,1610612762,2016,101.0,86.0,187.0,104.75,105.45,95.55,106.55,79,39,40,0.494,79,49,30,0.62,23,16,28,21,209.44,200.2,204.82
2017-04-08,1610612744,1610612740,2016,123.0,101.0,224.0,107.5,105.85,100.45,104.8,79,65,14,0.823,79,33,46,0.418,34,31,21,12,199.04,200.8,199.92000000000002
2017-04-07,1610612739,1610612737,2016,100.0,114.0,214.0,101.9,101.55,96.35,95.7,78,51,27,0.654,78,40,38,0.513,31,20,21,19,195.48,199.44,197.45999999999998
2017-04-07,1610612761,1610612748,2016,96.0,94.0,190.0,100.6,99.2,97.25,95.5,79,48,31,0.608,78,38,40,0.487,27,21,21,17,206.0,195.0,200.5
2017-04-07,1610612763,1610612752,2016,101.0,88.0,189.0,98.25,97.5,101.2,97.2,79,42,37,0.532,79,30,49,0.38,23,19,18,12,193.96,200.28,197.12
2017-04-07,1610612745,1610612765,2016,109.0,114.0,223.0,112.7,109.85,100.85,105.95,78,53,25,0.679,78,35,43,0.449,29,24,24,11,216.24,206.0,211.12
2017-04-07,1610612742,1610612759,2016,89.0,102.0,191.0,104.45,102.7,107.75,96.55,78,32,46,0.41,78,60,18,0.769,21,11,31,29,213.0,204.12,208.56
2017-04-07,1610612743,1610612740,2016,122.0,106.0,228.0,109.2,110.3,100.45,104.8,78,37,41,0.474,78,33,45,0.423,21,16,21,12,217.04,200.8,208.92000000000002
2017-04-07,1610612762,1610612750,2016,120.0,113.0,233.0,95.55,106.55,110.05,111.2,78,48,30,0.615,78,31,47,0.397,27,21,20,11,200.2,209.4,204.8
2017-04-07,1610612756,1610612760,2016,120.0,99.0,219.0,106.25,103.85,101.8,103.4,79,22,57,0.278,78,45,33,0.5770000000000001,13,9,28,17,212.88,210.36,211.62
2017-04-07,1610612747,1610612758,2016,98.0,94.0,192.0,107.3,114.65,97.75,101.5,78,23,55,0.295,78,31,47,0.397,14,9,16,15,219.28,207.08,213.18
2017-04-06,1610612755,1610612741,2016,90.0,102.0,192.0,97.85,106.0,94.0,91.0,78,28,50,0.359,78,38,40,0.487,17,11,23,15,207.68,185.44,196.56
2017-04-06,1610612753,1610612751,2016,115.0,107.0,222.0,96.55,103.5,96.7,98.4,78,27,51,0.34600000000000003,78,19,59,0.244,14,13,12,7,203.64,196.96,200.3
2017-04-06,1610612754,1610612749,2016,104.0,89.0,193.0,92.05,92.25,99.8,108.15,78,38,40,0.487,78,40,38,0.513,27,11,22,18,187.28,200.48,193.88
2017-04-06,1610612752,1610612764,2016,103.0,106.0,209.0,101.2,97.2,94.7,91.35,78,30,48,0.385,78,47,31,0.603,18,12,30,17,200.28,193.0,196.64
2017-04-06,1610612737,1610612738,2016,123.0,116.0,239.0,96.35,95.7,99.65,105.5,77,39,38,0.506,78,50,28,0.6409999999999999,20,19,28,22,199.44,195.08,197.26
2017-04-06,1610612757,1610612750,2016,105.0,98.0,203.0,104.75,105.45,110.05,111.2,78,38,40,0.487,77,31,46,0.403,22,16,20,11,209.44,209.4,209.42000000000002
2017-04-05,1610612766,1610612748,2016,99.0,112.0,211.0,99.45,97.7,97.25,95.5,78,36,42,0.462,77,37,40,0.481,22,14,21,16,194.96,195.0,194.98000000000002
2017-04-05,1610612765,1610612761,2016,102.0,105.0,207.0,100.85,105.95,100.6,99.2,77,35,42,0.455,78,47,31,0.603,24,11,27,20,206.0,206.0,206.0
2017-04-05,1610612763,1610612760,2016,100.0,103.0,203.0,98.25,97.5,101.8,103.4,78,42,36,0.5379999999999999,77,44,33,0.5710000000000001,23,19,28,16,193.96,210.36,202.16000000000003
2017-04-05,1610612745,1610612743,2016,110.0,104.0,214.0,112.7,109.85,109.2,110.3,77,52,25,0.675,77,37,40,0.481,28,24,21,16,216.24,217.04,216.64
2017-04-05,1610612738,1610612739,2016,91.0,114.0,205.0,99.65,105.5,101.9,101.55,77,50,27,0.649,77,50,27,0.649,28,22,31,19,195.08,195.48,195.28
2017-04-05,1610612759,1610612747,2016,95.0,102.0,197.0,107.75,96.55,107.3,114.65,77,60,17,0.779,77,22,55,0.28600000000000003,31,29,14,8,204.12,219.28,211.7
2017-04-05,1610612756,1610612744,2016,111.0,120.0,231.0,106.25,103.85,107.5,105.85,78,22,56,0.282,78,64,14,0.821,13,9,34,30,212.88,199.04,205.95999999999998
2017-04-05,1610612746,1610612742,2016,112.0,101.0,213.0,109.85,106.5,104.45,102.7,78,47,31,0.603,77,32,45,0.416,26,21,21,11,214.36,213.0,213.68
2017-04-04,1610612755,1610612751,2016,118.0,141.0,259.0,97.85,106.0,96.7,98.4,77,28,49,0.364,77,18,59,0.234,17,11,12,6,207.68,196.96,202.32
2017-04-04,1610612764,1610612766,2016,118.0,111.0,229.0,94.7,91.35,99.45,97.7,77,46,31,0.597,77,36,41,0.468,29,17,22,14,193.0,194.96,193.98000000000002
2017-04-04,1610612739,1610612753,2016,122.0,102.0,224.0,101.9,101.55,96.55,103.5,76,49,27,0.645,77,27,50,0.35100000000000003,30,19,14,13,195.48,203.64,199.56
2017-04-04,1610612754,1610612761,2016,108.0,90.0,198.0,92.05,92.25,100.6,99.2,77,37,40,0.481,77,47,30,0.61,26,11,27,20,187.28,206.0,196.64
2017-04-04,1610612740,1610612743,2016,131.0,134.0,265.0,100.45,104.8,109.2,110.3,77,33,44,0.429,76,36,40,0.474,21,12,21,15,200.8,217.04,208.92000000000002
2017-04-04,1610612760,1610612749,2016,110.0,79.0,189.0,101.8,103.4,99.8,108.15,76,43,33,0.5660000000000001,77,40,37,0.519,27,16,22,18,210.36,200.48,205.42000000000002
2017-04-04,1610612752,1610612741,2016,100.0,91.0,191.0,101.2,97.2,94.0,91.0,77,29,48,0.377,77,38,39,0.494,17,12,23,15,200.28,185.44,192.86
2017-04-04,1610612759,1610612763,2016,95.0,89.0,184.0,107.75,96.55,98.25,97.5,76,59,17,0.7759999999999999,77,42,35,0.545,30,29,23,19,204.12,193.96,199.04000000000002
2017-04-04,1610612762,1610612757,2016,106.0,87.0,193.0,95.55,106.55,104.75,105.45,77,47,30,0.61,77,38,39,0.494,26,21,22,16,200.2,209.44,204.82
2017-04-04,1610612744,1610612750,2016,121.0,107.0,228.0,107.5,105.85,110.05,111.2,77,63,14,0.818,76,31,45,0.408,33,30,20,11,199.04,209.4,204.22
2017-04-04,1610612758,1610612742,2016,98.0,87.0,185.0,97.75,101.5,104.45,102.7,77,30,47,0.39,76,32,44,0.421,15,15,21,11,207.08,213.0,210.04000000000002
2017-04-03,1610612750,1610612757,2016,110.0,109.0,219.0,110.05,111.2,104.75,105.45,75,30,45,0.4,76,38,38,0.5,19,11,22,16,209.4,209.44,209.42000000000002
2017-04-02,1610612752,1610612738,2016,94.0,110.0,204.0,101.2,97.2,99.65,105.5,76,29,47,0.382,76,49,27,0.645,17,12,28,21,200.28,195.08,197.68
2017-04-02,1610612760,1610612766,2016,101.0,113.0,214.0,101.8,103.4,99.45,97.7,75,43,32,0.573,76,35,41,0.461,27,16,22,13,210.36,194.96,202.66000000000003
2017-04-02,1610612747,1610612763,2016,108.0,103.0,211.0,107.3,114.65,98.25,97.5,76,21,55,0.276,76,42,34,0.5529999999999999,13,8,23,19,219.28,193.96,206.62
2017-04-02,1610612749,1610612742,2016,105.0,109.0,214.0,99.8,108.15,104.45,102.7,76,40,36,0.526,75,31,44,0.413,22,18,21,10,200.48,213.0,206.74
2017-04-02,1610612759,1610612762,2016,109.0,103.0,212.0,107.75,96.55,95.55,106.55,75,58,17,0.773,76,47,29,0.618,29,29,26,21,204.12,200.2,202.16
2017-04-02,1610612740,1610612741,2016,110.0,117.0,227.0,100.45,104.8,94.0,91.0,76,33,43,0.434,76,37,39,0.487,21,12,23,14,200.8,185.44,193.12
2017-04-02,1610612761,1610612755,2016,113.0,105.0,218.0,100.6,99.2,97.85,106.0,76,46,30,0.605,76,28,48,0.368,26,20,17,11,206.0,207.68,206.84
2017-04-02,1610612751,1610612737,2016,91.0,82.0,173.0,96.7,98.4,96.35,95.7,76,17,59,0.224,76,39,37,0.513,11,6,20,19,196.96,199.44,198.2
2017-04-02,1610612748,1610612743,2016,113.0,116.0,229.0,97.25,95.5,109.2,110.3,76,37,39,0.487,75,35,40,0.467,21,16,21,14,195.0,217.04,206.01999999999998
2017-04-02,1610612739,1610612754,2016,135.0,130.0,265.0,101.9,101.55,92.05,92.25,75,48,27,0.64,76,37,39,0.487,29,19,26,11,195.48,187.28,191.38
2017-04-02,1610612744,1610612764,2016,139.0,115.0,254.0,107.5,105.85,94.7,91.35,76,62,14,0.816,76,46,30,0.605,32,30,29,17,199.04,193.0,196.01999999999998
2017-04-02,1610612756,1610612745,2016,116.0,123.0,239.0,106.25,103.85,112.7,109.85,77,22,55,0.28600000000000003,76,51,25,0.6709999999999999,13,9,28,23,212.88,216.24,214.56
2017-04-01,1610612746,1610612747,2016,115.0,104.0,219.0,109.85,106.5,107.3,114.65,77,46,31,0.597,75,21,54,0.28,25,21,13,8,214.36,219.28,216.82
2017-04-01,1610612741,1610612737,2016,106.0,104.0,210.0,94.0,91.0,96.35,95.7,75,36,39,0.48,75,39,36,0.52,22,14,20,19,185.44,199.44,192.44
2017-04-01,1610612751,1610612753,2016,121.0,111.0,232.0,96.7,98.4,96.55,103.5,75,16,59,0.213,76,27,49,0.355,10,6,14,13,196.96,203.64,200.3
2017-04-01,1610612750,1610612758,2016,117.0,123.0,240.0,110.05,111.2,97.75,101.5,74,30,44,0.405,76,29,47,0.382,19,11,15,14,209.4,207.08,208.24
2017-04-01,1610612757,1610612756,2016,130.0,117.0,247.0,104.75,105.45,106.25,103.85,75,37,38,0.493,76,22,54,0.289,21,16,13,9,209.44,212.88,211.16
2017-03-31,1610612761,1610612754,2016,111.0,100.0,211.0,100.6,99.2,92.05,92.25,75,45,30,0.6,75,37,38,0.493,25,20,26,11,206.0,187.28,196.64
2017-03-31,1610612766,1610612743,2016,122.0,114.0,236.0,99.45,97.7,109.2,110.3,75,34,41,0.453,74,35,39,0.473,21,13,21,14,194.96,217.04,206.0
2017-03-31,1610612739,1610612755,2016,122.0,105.0,227.0,101.9,101.55,97.85,106.0,74,47,27,0.635,75,28,47,0.373,28,19,17,11,195.48,207.68,201.57999999999998
2017-03-31,1610612738,1610612753,2016,117.0,116.0,233.0,99.65,105.5,96.55,103.5,75,48,27,0.64,75,27,48,0.36,27,21,14,13,195.08,203.64,199.36
2017-03-31,1610612749,1610612765,2016,108.0,105.0,213.0,99.8,108.15,100.85,105.95,75,39,36,0.52,76,35,41,0.461,21,18,24,11,200.48,206.0,203.24
2017-03-31,1610612763,1610612742,2016,99.0,90.0,189.0,98.25,97.5,104.45,102.7,75,41,34,0.547,74,31,43,0.419,22,19,21,10,193.96,213.0,203.48000000000002
2017-03-31,1610612740,1610612758,2016,117.0,89.0,206.0,100.45,104.8,97.75,101.5,75,32,43,0.4270000000000001,75,29,46,0.387,20,12,15,14,200.8,207.08,203.94
2017-03-31,1610612748,1610612752,2016,94.0,98.0,192.0,97.25,95.5,101.2,97.2,75,37,38,0.493,75,28,47,0.373,21,16,17,11,195.0,200.28,197.64
2017-03-31,1610612760,1610612759,2016,95.0,100.0,195.0,101.8,103.4,107.75,96.55,74,43,31,0.581,74,57,17,0.77,27,16,29,28,210.36,204.12,207.24
2017-03-31,1610612762,1610612764,2016,95.0,88.0,183.0,95.55,106.55,94.7,91.35,75,46,29,0.613,75,46,29,0.613,25,21,29,17,200.2,193.0,196.6
2017-03-31,1610612744,1610612745,2016,107.0,98.0,205.0,107.5,105.85,112.7,109.85,75,61,14,0.813,75,51,24,0.68,31,30,28,23,199.04,216.24,207.64
2017-03-30,1610612765,1610612751,2016,90.0,89.0,179.0,100.85,105.95,96.7,98.4,75,34,41,0.453,74,16,58,0.21600000000000005,23,11,10,6,206.0,196.96,201.48000000000002
2017-03-30,1610612741,1610612739,2016,99.0,93.0,192.0,94.0,91.0,101.9,101.55,74,35,39,0.473,73,47,26,0.644,21,14,28,19,185.44,195.48,190.45999999999998
2017-03-30,1610612750,1610612747,2016,119.0,104.0,223.0,110.05,111.2,107.3,114.65,73,29,44,0.397,74,21,53,0.284,18,11,13,8,209.4,219.28,214.34
2017-03-30,1610612756,1610612746,2016,118.0,124.0,242.0,106.25,103.85,109.85,106.5,75,22,53,0.293,76,45,31,0.5920000000000001,13,9,25,20,212.88,214.36,213.62
2017-03-30,1610612757,1610612745,2016,117.0,107.0,224.0,104.75,105.45,112.7,109.85,74,36,38,0.486,74,51,23,0.6890000000000001,20,16,28,23,209.44,216.24,212.84
2017-03-29,1610612755,1610612737,2016,92.0,99.0,191.0,97.85,106.0,96.35,95.7,74,28,46,0.378,74,38,36,0.514,17,11,20,18,207.68,199.44,203.56
2017-03-29,1610612753,1610612760,2016,106.0,114.0,220.0,96.55,103.5,101.8,103.4,74,27,47,0.365,73,42,31,0.575,14,13,27,15,203.64,210.36,207.0
2017-03-29,1610612738,1610612749,2016,100.0,103.0,203.0,99.65,105.5,99.8,108.15,74,48,26,0.649,74,38,36,0.514,27,21,21,17,195.08,200.48,197.78
2017-03-29,1610612761,1610612766,2016,106.0,110.0,216.0,100.6,99.2,99.45,97.7,74,45,29,0.608,74,33,41,0.446,25,20,21,12,206.0,194.96,200.48000000000002
2017-03-29,1610612752,1610612748,2016,88.0,105.0,193.0,101.2,97.2,97.25,95.5,74,28,46,0.378,74,36,38,0.486,17,11,21,15,200.28,195.0,197.64
2017-03-29,1610612763,1610612754,2016,110.0,97.0,207.0,98.25,97.5,92.05,92.25,74,40,34,0.541,74,37,37,0.5,21,19,26,11,193.96,187.28,190.62
2017-03-29,1610612740,1610612742,2016,121.0,118.0,239.0,100.45,104.8,104.45,102.7,74,31,43,0.419,73,31,42,0.425,19,12,21,10,200.8,213.0,206.9
2017-03-29,1610612759,1610612744,2016,98.0,110.0,208.0,107.75,96.55,107.5,105.85,73,57,16,0.7809999999999999,74,60,14,0.8109999999999999,29,28,31,29,204.12,199.04,201.57999999999998
2017-03-29,1610612746,1610612764,2016,133.0,124.0,257.0,109.85,106.5,94.7,91.35,75,44,31,0.5870000000000001,74,46,28,0.622,24,20,29,17,214.36,193.0,203.68
2017-03-29,1610612758,1610612762,2016,82.0,112.0,194.0,97.75,101.5,95.55,106.55,74,29,45,0.392,74,45,29,0.608,15,14,25,20,207.08,200.2,203.64
2017-03-28,1610612766,1610612749,2016,108.0,118.0,226.0,99.45,97.7,99.8,108.15,73,33,40,0.452,73,37,36,0.507,21,12,21,16,194.96,200.48,197.72
2017-03-28,1610612754,1610612750,2016,114.0,115.0,229.0,92.05,92.25,110.05,111.2,73,37,36,0.507,72,28,44,0.389,26,11,18,10,187.28,209.4,198.34
2017-03-28,1610612751,1610612755,2016,101.0,106.0,207.0,96.7,98.4,97.85,106.0,73,16,57,0.219,73,27,46,0.37,10,6,17,10,196.96,207.68,202.32
2017-03-28,1610612737,1610612756,2016,95.0,91.0,186.0,96.35,95.7,106.25,103.85,73,37,36,0.507,74,22,52,0.297,19,18,13,9,199.44,212.88,206.16
2017-03-28,1610612765,1610612748,2016,96.0,97.0,193.0,100.85,105.95,97.25,95.5,74,34,40,0.459,73,35,38,0.479,23,11,21,14,206.0,195.0,200.5
2017-03-28,1610612745,1610612744,2016,106.0,113.0,219.0,112.7,109.85,107.5,105.85,73,51,22,0.6990000000000001,73,59,14,0.8079999999999999,28,23,31,28,216.24,199.04,207.64
2017-03-28,1610612757,1610612743,2016,122.0,113.0,235.0,104.75,105.45,109.2,110.3,73,35,38,0.479,73,35,38,0.479,19,16,21,14,209.44,217.04,213.24
2017-03-28,1610612747,1610612764,2016,108.0,119.0,227.0,107.3,114.65,94.7,91.35,73,21,52,0.28800000000000003,73,45,28,0.616,13,8,29,16,219.28,193.0,206.14
2017-03-27,1610612761,1610612753,2016,131.0,112.0,243.0,100.6,99.2,96.55,103.5,73,44,29,0.603,73,27,46,0.37,24,20,14,13,206.0,203.64,204.82
2017-03-27,1610612752,1610612765,2016,109.0,95.0,204.0,101.2,97.2,100.85,105.95,73,27,46,0.37,73,34,39,0.466,16,11,23,11,200.28,206.0,203.14
2017-03-27,1610612759,1610612739,2016,103.0,74.0,177.0,107.75,96.55,101.9,101.55,72,56,16,0.778,72,47,25,0.653,28,28,28,19,204.12,195.48,199.8
2017-03-27,1610612742,1610612760,2016,91.0,92.0,183.0,104.45,102.7,101.8,103.4,72,31,41,0.431,72,41,31,0.569,21,10,27,14,213.0,210.36,211.68
2017-03-27,1610612758,1610612763,2016,91.0,90.0,181.0,97.75,101.5,98.25,97.5,73,28,45,0.384,73,40,33,0.5479999999999999,14,14,21,19,207.08,193.96,200.52
2017-03-27,1610612762,1610612740,2016,108.0,100.0,208.0,95.55,106.55,100.45,104.8,73,44,29,0.603,73,31,42,0.425,24,20,19,12,200.2,200.8,200.5
2017-03-26,1610612766,1610612756,2016,120.0,106.0,226.0,99.45,97.7,106.25,103.85,72,32,40,0.444,73,22,51,0.301,20,12,13,9,194.96,212.88,203.92000000000002
2017-03-26,1610612737,1610612751,2016,92.0,107.0,199.0,96.35,95.7,96.7,98.4,72,37,35,0.514,72,15,57,0.208,19,18,10,5,199.44,196.96,198.2
2017-03-26,1610612746,1610612758,2016,97.0,98.0,195.0,109.85,106.5,97.75,101.5,74,44,30,0.595,72,27,45,0.375,24,20,14,13,214.36,207.08,210.72000000000003
2017-03-26,1610612749,1610612741,2016,94.0,109.0,203.0,99.8,108.15,94.0,91.0,72,37,35,0.514,73,34,39,0.466,21,16,21,13,200.48,185.44,192.95999999999998
2017-03-26,1610612745,1610612760,2016,137.0,125.0,262.0,112.7,109.85,101.8,103.4,72,50,22,0.6940000000000001,71,41,30,0.5770000000000001,27,23,27,14,216.24,210.36,213.3
2017-03-26,1610612754,1610612755,2016,107.0,94.0,201.0,92.05,92.25,97.85,106.0,72,36,36,0.5,72,27,45,0.375,25,11,17,10,187.28,207.68,197.48000000000002
2017-03-26,1610612738,1610612748,2016,112.0,108.0,220.0,99.65,105.5,97.25,95.5,73,47,26,0.644,72,35,37,0.486,26,21,21,14,195.08,195.0,195.04000000000002
2017-03-26,1610612744,1610612763,2016,106.0,94.0,200.0,107.5,105.85,98.25,97.5,72,58,14,0.8059999999999999,72,40,32,0.556,30,28,21,19,199.04,193.96,196.5
2017-03-26,1610612743,1610612740,2016,90.0,115.0,205.0,109.2,110.3,100.45,104.8,72,35,37,0.486,72,30,42,0.417,21,14,19,11,217.04,200.8,208.92000000000002
2017-03-26,1610612747,1610612757,2016,81.0,97.0,178.0,107.3,114.65,104.75,105.45,72,21,51,0.292,72,34,38,0.472,13,8,19,15,219.28,209.44,214.36
2017-03-25,1610612746,1610612762,2016,108.0,95.0,203.0,109.85,106.5,95.55,106.55,73,43,30,0.589,72,44,28,0.611,23,20,24,20,214.36,200.2,207.28
2017-03-25,1610612739,1610612764,2016,115.0,127.0,242.0,101.9,101.55,94.7,91.35,71,47,24,0.662,72,44,28,0.611,28,19,29,15,195.48,193.0,194.24
2017-03-25,1610612742,1610612761,2016,86.0,94.0,180.0,104.45,102.7,100.6,99.2,71,31,40,0.4370000000000001,72,43,29,0.597,21,10,24,19,213.0,206.0,209.5
2017-03-25,1610612759,1610612752,2016,106.0,98.0,204.0,107.75,96.55,101.2,97.2,71,55,16,0.775,72,27,45,0.375,27,28,16,11,204.12,200.28,202.2
2017-03-25,1610612757,1610612750,2016,112.0,100.0,212.0,104.75,105.45,110.05,111.2,71,33,38,0.465,71,28,43,0.394,18,15,18,10,209.44,209.4,209.42000000000002
2017-03-24,1610612764,1610612751,2016,129.0,108.0,237.0,94.7,91.35,96.7,98.4,71,43,28,0.606,71,15,56,0.211,28,15,10,5,193.0,196.96,194.98000000000002
2017-03-24,1610612766,1610612739,2016,105.0,112.0,217.0,99.45,97.7,101.9,101.55,71,32,39,0.451,70,46,24,0.657,20,12,28,18,194.96,195.48,195.22
2017-03-24,1610612753,1610612765,2016,115.0,87.0,202.0,96.55,103.5,100.85,105.95,72,26,46,0.361,72,34,38,0.472,13,13,23,11,203.64,206.0,204.82
2017-03-24,1610612754,1610612743,2016,117.0,125.0,242.0,92.05,92.25,109.2,110.3,71,36,35,0.507,71,34,37,0.479,25,11,21,13,187.28,217.04,202.16
2017-03-24,1610612738,1610612756,2016,130.0,120.0,250.0,99.65,105.5,106.25,103.85,72,46,26,0.639,72,22,50,0.306,25,21,13,9,195.08,212.88,203.98000000000002
2017-03-24,1610612741,1610612755,2016,107.0,117.0,224.0,94.0,91.0,97.85,106.0,72,34,38,0.472,71,26,45,0.366,21,13,17,9,185.44,207.68,196.56
2017-03-24,1610612749,1610612737,2016,100.0,97.0,197.0,99.8,108.15,96.35,95.7,71,36,35,0.507,71,37,34,0.521,20,16,19,18,200.48,199.44,199.95999999999998
2017-03-24,1610612745,1610612740,2016,117.0,107.0,224.0,112.7,109.85,100.45,104.8,71,49,22,0.69,71,30,41,0.423,26,23,19,11,216.24,200.8,208.52
2017-03-24,1610612747,1610612750,2016,130.0,119.0,249.0,107.3,114.65,110.05,111.2,71,20,51,0.282,70,28,42,0.4,12,8,18,10,219.28,209.4,214.34
2017-03-24,1610612744,1610612758,2016,114.0,100.0,214.0,107.5,105.85,97.75,101.5,71,57,14,0.8029999999999999,71,27,44,0.38,29,28,14,13,199.04,207.08,203.06
2017-03-23,1610612751,1610612756,2016,126.0,98.0,224.0,96.7,98.4,106.25,103.85,70,14,56,0.2,71,22,49,0.31,9,5,13,9,196.96,212.88,204.92000000000002
2017-03-23,1610612748,1610612761,2016,84.0,101.0,185.0,97.25,95.5,100.6,99.2,71,35,36,0.493,71,42,29,0.5920000000000001,21,14,24,18,195.0,206.0,200.5
2017-03-23,1610612742,1610612746,2016,97.0,95.0,192.0,104.45,102.7,109.85,106.5,70,30,40,0.429,72,43,29,0.597,20,10,23,20,213.0,214.36,213.68
2017-03-23,1610612759,1610612763,2016,97.0,90.0,187.0,107.75,96.55,98.25,97.5,70,54,16,0.7709999999999999,71,40,31,0.563,26,28,21,19,204.12,193.96,199.04000000000002
2017-03-23,1610612757,1610612752,2016,110.0,95.0,205.0,104.75,105.45,101.2,97.2,70,32,38,0.457,71,27,44,0.38,17,15,16,11,209.44,200.28,204.86
2017-03-22,1610612753,1610612766,2016,102.0,109.0,211.0,96.55,103.5,99.45,97.7,71,26,45,0.366,70,31,39,0.443,13,13,20,11,203.64,194.96,199.3
2017-03-22,1610612738,1610612754,2016,109.0,100.0,209.0,99.65,105.5,92.05,92.25,71,45,26,0.634,70,36,34,0.514,24,21,25,11,195.08,187.28,191.18
2017-03-22,1610612741,1610612765,2016,117.0,95.0,212.0,94.0,91.0,100.85,105.95,71,33,38,0.465,71,34,37,0.479,20,13,23,11,185.44,206.0,195.72
2017-03-22,1610612760,1610612755,2016,122.0,97.0,219.0,101.8,103.4,97.85,106.0,70,40,30,0.5710000000000001,70,26,44,0.371,26,14,17,9,210.36,207.68,209.02
2017-03-22,1610612764,1610612737,2016,104.0,100.0,204.0,94.7,91.35,96.35,95.7,70,42,28,0.6,70,37,33,0.529,27,15,19,18,193.0,199.44,196.22
2017-03-22,1610612743,1610612739,2016,126.0,113.0,239.0,109.2,110.3,101.9,101.55,70,33,37,0.471,69,46,23,0.667,20,13,28,18,217.04,195.48,206.26
2017-03-22,1610612758,1610612749,2016,98.0,116.0,214.0,97.75,101.5,99.8,108.15,70,27,43,0.386,70,35,35,0.5,14,13,20,15,207.08,200.48,203.78
2017-03-22,1610612762,1610612752,2016,108.0,101.0,209.0,95.55,106.55,101.2,97.2,71,43,28,0.606,70,27,43,0.386,23,20,16,11,200.2,200.28,200.24
2017-03-21,1610612761,1610612741,2016,122.0,120.0,242.0,100.6,99.2,94.0,91.0,70,41,29,0.586,70,33,37,0.471,23,18,20,13,206.0,185.44,195.72
2017-03-21,1610612751,1610612765,2016,98.0,96.0,194.0,96.7,98.4,100.85,105.95,69,13,56,0.188,70,34,36,0.486,8,5,23,11,196.96,206.0,201.48000000000002
2017-03-21,1610612748,1610612756,2016,112.0,97.0,209.0,97.25,95.5,106.25,103.85,70,34,36,0.486,70,22,48,0.314,20,14,13,9,195.0,212.88,203.94
2017-03-21,1610612740,1610612763,2016,95.0,82.0,177.0,100.45,104.8,98.25,97.5,70,29,41,0.414,70,40,30,0.5710000000000001,18,11,21,19,200.8,193.96,197.38
2017-03-21,1610612742,1610612744,2016,87.0,112.0,199.0,104.45,102.7,107.5,105.85,69,30,39,0.435,70,56,14,0.8,20,10,29,27,213.0,199.04,206.01999999999998
2017-03-21,1610612750,1610612759,2016,93.0,100.0,193.0,110.05,111.2,107.75,96.55,69,28,41,0.406,69,53,16,0.768,18,10,26,27,209.4,204.12,206.76
2017-03-21,1610612757,1610612749,2016,90.0,93.0,183.0,104.75,105.45,99.8,108.15,69,32,37,0.464,69,34,35,0.493,17,15,20,14,209.44,200.48,204.95999999999998
2017-03-21,1610612747,1610612746,2016,109.0,133.0,242.0,107.3,114.65,109.85,106.5,70,20,50,0.28600000000000003,71,42,29,0.5920000000000001,12,8,23,19,219.28,214.36,216.82
2017-03-20,1610612766,1610612737,2016,105.0,90.0,195.0,99.45,97.7,96.35,95.7,69,30,39,0.435,69,37,32,0.536,19,11,19,18,194.96,199.44,197.2
2017-03-20,1610612753,1610612755,2016,112.0,109.0,221.0,96.55,103.5,97.85,106.0,70,25,45,0.35700000000000004,69,26,43,0.377,12,13,17,9,203.64,207.68,205.66
2017-03-20,1610612754,1610612762,2016,107.0,100.0,207.0,92.05,92.25,95.55,106.55,69,35,34,0.507,70,43,27,0.614,24,11,23,20,187.28,200.2,193.74
2017-03-20,1610612738,1610612764,2016,110.0,102.0,212.0,99.65,105.5,94.7,91.35,70,44,26,0.629,69,42,27,0.609,23,21,27,15,195.08,193.0,194.04000000000002
2017-03-20,1610612745,1610612743,2016,125.0,124.0,249.0,112.7,109.85,109.2,110.3,70,48,22,0.6859999999999999,69,33,36,0.478,25,23,20,13,216.24,217.04,216.64
2017-03-20,1610612760,1610612744,2016,95.0,111.0,206.0,101.8,103.4,107.5,105.85,69,40,29,0.58,69,55,14,0.797,26,14,29,26,210.36,199.04,204.7
2017-03-20,1610612746,1610612752,2016,114.0,105.0,219.0,109.85,106.5,101.2,97.2,70,41,29,0.586,69,27,42,0.391,22,19,16,11,214.36,200.28,207.32
2017-03-19,1610612751,1610612742,2016,104.0,111.0,215.0,96.7,98.4,104.45,102.7,68,13,55,0.191,68,29,39,0.426,8,5,20,9,196.96,213.0,204.98000000000002
2017-03-19,1610612755,1610612738,2016,105.0,99.0,204.0,97.85,106.0,99.65,105.5,68,25,43,0.368,69,44,25,0.638,16,9,23,21,207.68,195.08,201.38
2017-03-19,1610612765,1610612756,2016,112.0,95.0,207.0,100.85,105.95,106.25,103.85,69,33,36,0.478,69,22,47,0.319,22,11,13,9,206.0,212.88,209.44
2017-03-19,1610612740,1610612750,2016,123.0,109.0,232.0,100.45,104.8,110.05,111.2,69,28,41,0.406,68,28,40,0.412,17,11,18,10,200.8,209.4,205.10000000000002
2017-03-19,1610612761,1610612754,2016,116.0,91.0,207.0,100.6,99.2,92.05,92.25,69,40,29,0.58,68,35,33,0.515,22,18,24,11,206.0,187.28,196.64
2017-03-19,1610612748,1610612757,2016,104.0,115.0,219.0,97.25,95.5,104.75,105.45,69,34,35,0.493,68,31,37,0.456,20,14,17,14,195.0,209.44,202.22
2017-03-19,1610612759,1610612758,2016,118.0,102.0,220.0,107.75,96.55,97.75,101.5,68,52,16,0.765,69,27,42,0.391,25,27,14,13,204.12,207.08,205.60000000000002
2017-03-19,1610612747,1610612739,2016,120.0,125.0,245.0,107.3,114.65,101.9,101.55,69,20,49,0.29,68,45,23,0.662,12,8,28,17,219.28,195.48,207.38
2017-03-18,1610612760,1610612758,2016,110.0,94.0,204.0,101.8,103.4,97.75,101.5,68,39,29,0.574,68,27,41,0.397,25,14,14,13,210.36,207.08,208.72000000000003
2017-03-18,1610612737,1610612757,2016,97.0,113.0,210.0,96.35,95.7,104.75,105.45,68,37,31,0.544,67,30,37,0.448,19,18,17,13,199.44,209.44,204.44
2017-03-18,1610612766,1610612764,2016,98.0,93.0,191.0,99.45,97.7,94.7,91.35,68,29,39,0.426,68,42,26,0.618,18,11,27,15,194.96,193.0,193.98000000000002
2017-03-18,1610612746,1610612739,2016,108.0,78.0,186.0,109.85,106.5,101.9,101.55,69,40,29,0.58,67,45,22,0.672,21,19,28,17,214.36,195.48,204.92000000000002
2017-03-18,1610612741,1610612762,2016,95.0,86.0,181.0,94.0,91.0,95.55,106.55,69,32,37,0.464,69,43,26,0.623,19,13,23,20,185.44,200.2,192.82
2017-03-18,1610612763,1610612759,2016,104.0,96.0,200.0,98.25,97.5,107.75,96.55,69,39,30,0.565,67,52,15,0.7759999999999999,20,19,25,27,193.96,204.12,199.04000000000002
2017-03-18,1610612743,1610612745,2016,105.0,109.0,214.0,109.2,110.3,112.7,109.85,68,33,35,0.485,69,47,22,0.6809999999999999,20,13,25,22,217.04,216.24,216.64
2017-03-18,1610612744,1610612749,2016,117.0,92.0,209.0,107.5,105.85,99.8,108.15,68,54,14,0.794,68,34,34,0.5,28,26,20,14,199.04,200.48,199.76
2017-03-17,1610612755,1610612742,2016,116.0,74.0,190.0,97.85,106.0,104.45,102.7,67,24,43,0.358,67,29,38,0.433,15,9,20,9,207.68,213.0,210.34
2017-03-17,1610612764,1610612741,2016,112.0,107.0,219.0,94.7,91.35,94.0,91.0,67,41,26,0.612,68,32,36,0.471,26,15,19,13,193.0,185.44,189.22
2017-03-17,1610612751,1610612738,2016,95.0,98.0,193.0,96.7,98.4,99.65,105.5,67,13,54,0.194,68,43,25,0.632,8,5,23,20,196.96,195.08,196.02
2017-03-17,1610612765,1610612761,2016,75.0,87.0,162.0,100.85,105.95,100.6,99.2,68,33,35,0.485,68,39,29,0.574,22,11,22,17,206.0,206.0,206.0
2017-03-17,1610612740,1610612745,2016,128.0,112.0,240.0,100.45,104.8,112.7,109.85,68,27,41,0.397,68,47,21,0.691,16,11,25,22,200.8,216.24,208.52
2017-03-17,1610612748,1610612750,2016,123.0,105.0,228.0,97.25,95.5,110.05,111.2,68,33,35,0.485,67,28,39,0.418,19,14,18,10,195.0,209.4,202.2
2017-03-17,1610612756,1610612753,2016,103.0,109.0,212.0,106.25,103.85,96.55,103.5,68,22,46,0.324,69,24,45,0.348,13,9,12,12,212.88,203.64,208.26
2017-03-17,1610612747,1610612749,2016,103.0,107.0,210.0,107.3,114.65,99.8,108.15,68,20,48,0.294,67,33,34,0.493,12,8,20,13,219.28,200.48,209.88
2017-03-16,1610612739,1610612762,2016,91.0,83.0,174.0,101.9,101.55,95.55,106.55,66,44,22,0.667,68,43,25,0.632,27,17,23,20,195.48,200.2,197.83999999999997
2017-03-16,1610612761,1610612760,2016,102.0,123.0,225.0,100.6,99.2,101.8,103.4,67,39,28,0.5820000000000001,67,38,29,0.5670000000000001,22,17,25,13,206.0,210.36,208.18
2017-03-16,1610612752,1610612751,2016,110.0,121.0,231.0,101.2,97.2,96.7,98.4,68,27,41,0.397,66,12,54,0.182,16,11,8,4,200.28,196.96,198.62
2017-03-16,1610612737,1610612763,2016,91.0,103.0,194.0,96.35,95.7,98.25,97.5,67,37,30,0.552,68,38,30,0.5589999999999999,19,18,20,18,199.44,193.96,196.7
2017-03-16,1610612743,1610612746,2016,129.0,114.0,243.0,109.2,110.3,109.85,106.5,67,32,35,0.478,68,40,28,0.588,19,13,21,19,217.04,214.36,215.7
2017-03-16,1610612744,1610612753,2016,122.0,92.0,214.0,107.5,105.85,96.55,103.5,67,53,14,0.7909999999999999,68,24,44,0.353,27,26,12,12,199.04,203.64,201.33999999999997
2017-03-15,1610612764,1610612742,2016,107.0,112.0,219.0,94.7,91.35,104.45,102.7,66,41,25,0.621,66,28,38,0.424,26,15,20,8,193.0,213.0,203.0
2017-03-15,1610612754,1610612766,2016,98.0,77.0,175.0,92.05,92.25,99.45,97.7,67,34,33,0.507,67,29,38,0.433,23,11,18,11,187.28,194.96,191.12
2017-03-15,1610612738,1610612750,2016,117.0,104.0,221.0,99.65,105.5,110.05,111.2,67,42,25,0.627,66,28,38,0.424,22,20,18,10,195.08,209.4,202.24
2017-03-15,1610612748,1610612740,2016,120.0,112.0,232.0,97.25,95.5,100.45,104.8,67,32,35,0.478,67,27,40,0.403,18,14,16,11,195.0,200.8,197.9
2017-03-15,1610612765,1610612762,2016,83.0,97.0,180.0,100.85,105.95,95.55,106.55,67,33,34,0.493,67,42,25,0.627,22,11,23,19,206.0,200.2,203.1
2017-03-15,1610612741,1610612763,2016,91.0,98.0,189.0,94.0,91.0,98.25,97.5,67,32,35,0.478,67,37,30,0.552,19,13,20,17,185.44,193.96,189.7
2017-03-15,1610612745,1610612747,2016,139.0,100.0,239.0,112.7,109.85,107.3,114.65,67,46,21,0.687,67,20,47,0.299,24,22,12,8,216.24,219.28,217.76
2017-03-15,1610612759,1610612757,2016,106.0,110.0,216.0,107.75,96.55,104.75,105.45,66,52,14,0.7879999999999999,66,29,37,0.439,25,27,17,12,204.12,209.44,206.78
2017-03-15,1610612756,1610612758,2016,101.0,107.0,208.0,106.25,103.85,97.75,101.5,67,22,45,0.328,67,26,41,0.388,13,9,14,12,212.88,207.08,209.98000000000002
2017-03-15,1610612746,1610612749,2016,96.0,97.0,193.0,109.85,106.5,99.8,108.15,67,40,27,0.597,66,32,34,0.485,21,19,20,12,214.36,200.48,207.42000000000002
2017-03-14,1610612739,1610612765,2016,128.0,96.0,224.0,101.9,101.55,100.85,105.95,65,43,22,0.662,66,33,33,0.5,26,17,22,11,195.48,206.0,200.74
2017-03-14,1610612751,1610612760,2016,104.0,122.0,226.0,96.7,98.4,101.8,103.4,65,12,53,0.185,66,37,29,0.561,8,4,25,12,196.96,210.36,203.66000000000003
2017-03-14,1610612752,1610612754,2016,87.0,81.0,168.0,101.2,97.2,92.05,92.25,67,26,41,0.388,66,34,32,0.515,15,11,23,11,200.28,187.28,193.78
2017-03-14,1610612740,1610612757,2016,100.0,77.0,177.0,100.45,104.8,104.75,105.45,66,26,40,0.394,65,29,36,0.446,15,11,17,12,200.8,209.44,205.12
2017-03-14,1610612744,1610612755,2016,106.0,104.0,210.0,107.5,105.85,97.85,106.0,66,52,14,0.7879999999999999,66,24,42,0.364,26,26,15,9,199.04,207.68,203.36
2017-03-13,1610612766,1610612741,2016,109.0,115.0,224.0,99.45,97.7,94.0,91.0,66,29,37,0.439,66,31,35,0.47,18,11,19,12,194.96,185.44,190.2
2017-03-13,1610612761,1610612742,2016,100.0,78.0,178.0,100.6,99.2,104.45,102.7,66,38,28,0.5760000000000001,65,28,37,0.431,21,17,20,8,206.0,213.0,209.5
2017-03-13,1610612763,1610612749,2016,113.0,93.0,206.0,98.25,97.5,99.8,108.15,66,36,30,0.545,65,32,33,0.4920000000000001,19,17,20,12,193.96,200.48,197.22
2017-03-13,1610612759,1610612737,2016,107.0,99.0,206.0,107.75,96.55,96.35,95.7,65,51,14,0.785,66,37,29,0.561,24,27,19,18,204.12,199.44,201.78
2017-03-13,1610612750,1610612764,2016,119.0,104.0,223.0,110.05,111.2,94.7,91.35,65,27,38,0.415,65,41,24,0.631,17,10,26,15,209.4,193.0,201.2
2017-03-13,1610612762,1610612746,2016,114.0,108.0,222.0,95.55,106.55,109.85,106.5,66,41,25,0.621,66,40,26,0.606,22,19,21,19,200.2,214.36,207.28
2017-03-13,1610612758,1610612753,2016,120.0,115.0,235.0,97.75,101.5,96.55,103.5,66,25,41,0.379,67,24,43,0.358,13,12,12,12,207.08,203.64,205.36
2017-03-13,1610612743,1610612747,2016,129.0,101.0,230.0,109.2,110.3,107.3,114.65,66,31,35,0.47,66,20,46,0.303,18,13,12,8,217.04,219.28,218.16
2017-03-12,1610612738,1610612741,2016,100.0,80.0,180.0,99.65,105.5,94.0,91.0,66,41,25,0.621,65,31,34,0.477,21,20,19,12,195.08,185.44,190.26
2017-03-12,1610612751,1610612752,2016,120.0,112.0,232.0,96.7,98.4,101.2,97.2,64,11,53,0.172,66,26,40,0.394,7,4,15,11,196.96,200.28,198.62
2017-03-12,1610612754,1610612748,2016,102.0,98.0,200.0,92.05,92.25,97.25,95.5,65,33,32,0.508,66,32,34,0.485,22,11,18,14,187.28,195.0,191.14
2017-03-12,1610612756,1610612757,2016,101.0,110.0,211.0,106.25,103.85,104.75,105.45,66,22,44,0.333,64,28,36,0.438,13,9,17,11,212.88,209.44,211.16
2017-03-12,1610612745,1610612739,2016,117.0,112.0,229.0,112.7,109.85,101.9,101.55,66,45,21,0.682,64,43,21,0.672,23,22,26,17,216.24,195.48,205.86
2017-03-12,1610612747,1610612755,2016,116.0,118.0,234.0,107.3,114.65,97.85,106.0,65,20,45,0.308,65,23,42,0.354,12,8,15,8,219.28,207.68,213.48000000000002
2017-03-11,1610612760,1610612762,2016,112.0,104.0,216.0,101.8,103.4,95.55,106.55,65,36,29,0.5539999999999999,65,41,24,0.631,24,12,22,19,210.36,200.2,205.28
2017-03-11,1610612746,1610612755,2016,112.0,100.0,212.0,109.85,106.5,97.85,106.0,65,39,26,0.6,64,23,41,0.359,20,19,15,8,214.36,207.68,211.02
2017-03-11,1610612765,1610612752,2016,112.0,92.0,204.0,100.85,105.95,101.2,97.2,65,32,33,0.4920000000000001,65,26,39,0.4,21,11,15,11,206.0,200.28,203.14
2017-03-11,1610612766,1610612740,2016,122.0,125.0,247.0,99.45,97.7,100.45,104.8,65,29,36,0.446,65,25,40,0.385,18,11,15,10,194.96,200.8,197.88
2017-03-11,1610612753,1610612739,2016,104.0,116.0,220.0,96.55,103.5,101.9,101.55,66,24,42,0.364,63,42,21,0.667,12,12,26,16,203.64,195.48,199.56
2017-03-11,1610612749,1610612750,2016,102.0,95.0,197.0,99.8,108.15,110.05,111.2,64,31,33,0.484,64,27,37,0.422,19,12,17,10,200.48,209.4,204.94
2017-03-11,1610612748,1610612761,2016,104.0,89.0,193.0,97.25,95.5,100.6,99.2,65,31,34,0.477,65,38,27,0.585,17,14,21,17,195.0,206.0,200.5
2017-03-11,1610612759,1610612744,2016,107.0,85.0,192.0,107.75,96.55,107.5,105.85,64,50,14,0.7809999999999999,65,52,13,0.8,23,27,26,26,204.12,199.04,201.57999999999998
2017-03-11,1610612763,1610612737,2016,90.0,107.0,197.0,98.25,97.5,96.35,95.7,65,36,29,0.5539999999999999,65,36,29,0.5539999999999999,19,17,19,17,193.96,199.44,196.7
2017-03-11,1610612742,1610612756,2016,98.0,100.0,198.0,104.45,102.7,106.25,103.85,64,28,36,0.438,65,21,44,0.32299999999999995,20,8,13,8,213.0,212.88,212.94
2017-03-11,1610612757,1610612764,2016,124.0,125.0,249.0,104.75,105.45,94.7,91.35,63,28,35,0.444,64,40,24,0.625,17,11,26,14,209.44,193.0,201.22
2017-03-11,1610612758,1610612743,2016,92.0,105.0,197.0,97.75,101.5,109.2,110.3,65,25,40,0.385,65,30,35,0.462,13,12,18,12,207.08,217.04,212.06
2017-03-10,1610612766,1610612753,2016,121.0,81.0,202.0,99.45,97.7,96.55,103.5,64,28,36,0.438,65,24,41,0.369,17,11,12,12,194.96,203.64,199.3
2017-03-10,1610612741,1610612745,2016,94.0,115.0,209.0,94.0,91.0,112.7,109.85,64,31,33,0.484,65,44,21,0.677,19,12,23,21,185.44,216.24,200.84
2017-03-10,1610612749,1610612754,2016,99.0,85.0,184.0,99.8,108.15,92.05,92.25,63,30,33,0.476,64,33,31,0.516,18,12,22,11,200.48,187.28,193.88
2017-03-10,1610612750,1610612744,2016,103.0,102.0,205.0,110.05,111.2,107.5,105.85,63,26,37,0.413,64,52,12,0.813,16,10,26,26,209.4,199.04,204.22
2017-03-10,1610612737,1610612761,2016,105.0,99.0,204.0,96.35,95.7,100.6,99.2,64,35,29,0.547,64,38,26,0.594,18,17,21,17,199.44,206.0,202.72
2017-03-10,1610612743,1610612738,2016,119.0,99.0,218.0,109.2,110.3,99.65,105.5,64,29,35,0.453,65,41,24,0.631,17,12,21,20,217.04,195.08,206.06
2017-03-10,1610612742,1610612751,2016,105.0,96.0,201.0,104.45,102.7,96.7,98.4,63,27,36,0.429,63,11,52,0.175,19,8,7,4,213.0,196.96,204.98000000000002
2017-03-10,1610612758,1610612764,2016,122.0,130.0,252.0,97.75,101.5,94.7,91.35,64,25,39,0.391,63,39,24,0.619,13,12,26,13,207.08,193.0,200.04000000000002
2017-03-09,1610612765,1610612739,2016,106.0,101.0,207.0,100.85,105.95,101.9,101.55,64,31,33,0.484,62,42,20,0.677,20,11,26,16,206.0,195.48,200.74
2017-03-09,1610612763,1610612746,2016,98.0,114.0,212.0,98.25,97.5,109.85,106.5,64,36,28,0.563,64,38,26,0.594,19,17,20,18,193.96,214.36,204.16000000000003
2017-03-09,1610612760,1610612759,2016,102.0,92.0,194.0,101.8,103.4,107.75,96.55,64,35,29,0.547,63,50,13,0.794,23,12,23,27,210.36,204.12,207.24
2017-03-09,1610612757,1610612755,2016,114.0,108.0,222.0,104.75,105.45,97.85,106.0,62,27,35,0.435,63,23,40,0.365,16,11,15,8,209.44,207.68,208.56
2017-03-09,1610612756,1610612747,2016,110.0,122.0,232.0,106.25,103.85,107.3,114.65,64,21,43,0.328,64,19,45,0.297,13,8,12,7,212.88,219.28,216.07999999999998
2017-03-08,1610612753,1610612741,2016,98.0,91.0,189.0,96.55,103.5,94.0,91.0,64,23,41,0.359,63,31,32,0.4920000000000001,11,12,19,12,203.64,185.44,194.54
2017-03-08,1610612737,1610612751,2016,110.0,105.0,215.0,96.35,95.7,96.7,98.4,63,34,29,0.54,62,11,51,0.177,17,17,7,4,199.44,196.96,198.2
2017-03-08,1610612748,1610612766,2016,108.0,101.0,209.0,97.25,95.5,99.45,97.7,64,30,34,0.469,63,28,35,0.444,16,14,17,11,195.0,194.96,194.98000000000002
2017-03-08,1610612749,1610612752,2016,104.0,93.0,197.0,99.8,108.15,101.2,97.2,62,29,33,0.468,64,26,38,0.406,17,12,15,11,200.48,200.28,200.38
2017-03-08,1610612740,1610612761,2016,87.0,94.0,181.0,100.45,104.8,100.6,99.2,64,25,39,0.391,63,37,26,0.5870000000000001,15,10,21,16,200.8,206.0,203.4
2017-03-08,1610612745,1610612762,2016,108.0,115.0,223.0,112.7,109.85,95.55,106.55,64,44,20,0.688,64,40,24,0.625,23,21,22,18,216.24,200.2,208.22
2017-03-08,1610612750,1610612746,2016,107.0,91.0,198.0,110.05,111.2,109.85,106.5,62,25,37,0.403,63,38,25,0.603,15,10,20,18,209.4,214.36,211.88
2017-03-08,1610612754,1610612765,2016,115.0,98.0,213.0,92.05,92.25,100.85,105.95,63,32,31,0.508,63,31,32,0.4920000000000001,21,11,20,11,187.28,206.0,196.64
2017-03-08,1610612759,1610612758,2016,114.0,104.0,218.0,107.75,96.55,97.75,101.5,62,49,13,0.79,63,25,38,0.397,22,27,13,12,204.12,207.08,205.60000000000002
2017-03-08,1610612743,1610612764,2016,113.0,123.0,236.0,109.2,110.3,94.7,91.35,63,29,34,0.46,62,38,24,0.613,17,12,26,12,217.04,193.0,205.01999999999998
2017-03-08,1610612744,1610612738,2016,86.0,99.0,185.0,107.5,105.85,99.65,105.5,63,52,11,0.825,64,40,24,0.625,26,26,21,19,199.04,195.08,197.06
2017-03-07,1610612760,1610612757,2016,121.0,126.0,247.0,101.8,103.4,104.75,105.45,63,35,28,0.556,61,26,35,0.426,23,12,16,10,210.36,209.44,209.9
2017-03-07,1610612742,1610612747,2016,122.0,111.0,233.0,104.45,102.7,107.3,114.65,62,26,36,0.419,63,19,44,0.302,18,8,12,7,213.0,219.28,216.14
2017-03-07,1610612756,1610612764,2016,127.0,131.0,258.0,106.25,103.85,94.7,91.35,63,21,42,0.333,61,37,24,0.607,13,8,26,11,212.88,193.0,202.94
2017-03-06,1610612755,1610612749,2016,98.0,112.0,210.0,97.85,106.0,99.8,108.15,62,23,39,0.371,61,28,33,0.459,15,8,17,11,207.68,200.48,204.07999999999998
2017-03-06,1610612753,1610612752,2016,105.0,113.0,218.0,96.55,103.5,101.2,97.2,63,23,40,0.365,63,25,38,0.397,11,12,15,10,203.64,200.28,201.95999999999998
2017-03-06,1610612739,1610612748,2016,98.0,106.0,204.0,101.9,101.55,97.25,95.5,61,42,19,0.6890000000000001,63,29,34,0.46,26,16,16,13,195.48,195.0,195.24
2017-03-06,1610612737,1610612744,2016,111.0,119.0,230.0,96.35,95.7,107.5,105.85,62,34,28,0.5479999999999999,62,51,11,0.823,17,17,26,25,199.44,199.04,199.24
2017-03-06,1610612765,1610612741,2016,109.0,95.0,204.0,100.85,105.95,94.0,91.0,62,30,32,0.484,62,31,31,0.5,19,11,19,12,206.0,185.44,195.72
2017-03-06,1610612763,1610612751,2016,109.0,122.0,231.0,98.25,97.5,96.7,98.4,63,36,27,0.5710000000000001,61,10,51,0.16399999999999998,19,17,7,3,193.96,196.96,195.46
2017-03-06,1610612766,1610612754,2016,100.0,88.0,188.0,99.45,97.7,92.05,92.25,62,27,35,0.435,62,32,30,0.516,16,11,21,11,194.96,187.28,191.12
2017-03-06,1610612759,1610612745,2016,112.0,110.0,222.0,107.75,96.55,112.7,109.85,61,48,13,0.787,63,44,19,0.698,21,27,23,21,204.12,216.24,210.18
2017-03-06,1610612743,1610612758,2016,108.0,96.0,204.0,109.2,110.3,97.75,101.5,62,28,34,0.452,62,25,37,0.403,16,12,13,12,217.04,207.08,212.06
2017-03-06,1610612762,1610612740,2016,88.0,83.0,171.0,95.55,106.55,100.45,104.8,63,39,24,0.619,63,25,38,0.397,21,18,15,10,200.2,200.8,200.5
2017-03-06,1610612746,1610612738,2016,116.0,102.0,218.0,109.85,106.5,99.65,105.5,62,37,25,0.597,63,40,23,0.635,19,18,21,19,214.36,195.08,204.72000000000003
2017-03-05,1610612737,1610612754,2016,96.0,97.0,193.0,96.35,95.7,92.05,92.25,61,34,27,0.557,61,31,30,0.508,17,17,21,10,199.44,187.28,193.36
2017-03-05,1610612752,1610612744,2016,105.0,112.0,217.0,101.2,97.2,107.5,105.85,62,25,37,0.403,61,50,11,0.82,15,10,26,24,200.28,199.04,199.66
2017-03-05,1610612756,1610612738,2016,109.0,106.0,215.0,106.25,103.85,99.65,105.5,62,20,42,0.32299999999999995,62,40,22,0.645,12,8,21,19,212.88,195.08,203.98000000000002
2017-03-05,1610612764,1610612753,2016,115.0,114.0,229.0,94.7,91.35,96.55,103.5,60,36,24,0.6,62,23,39,0.371,25,11,11,12,193.0,203.64,198.32
2017-03-05,1610612758,1610612762,2016,109.0,110.0,219.0,97.75,101.5,95.55,106.55,61,25,36,0.41,62,38,24,0.613,13,12,21,17,207.08,200.2,203.64
2017-03-05,1610612742,1610612760,2016,104.0,89.0,193.0,104.45,102.7,101.8,103.4,61,25,36,0.41,62,35,27,0.565,17,8,23,12,213.0,210.36,211.68
2017-03-05,1610612747,1610612740,2016,97.0,105.0,202.0,107.3,114.65,100.45,104.8,62,19,43,0.306,62,24,38,0.387,12,7,15,9,219.28,200.8,210.04000000000002
2017-03-04,1610612755,1610612765,2016,106.0,136.0,242.0,97.85,106.0,100.85,105.95,61,23,38,0.377,61,29,32,0.475,15,8,19,10,207.68,206.0,206.84
2017-03-04,1610612749,1610612761,2016,101.0,94.0,195.0,99.8,108.15,100.6,99.2,60,27,33,0.45,62,37,25,0.597,16,11,21,16,200.48,206.0,203.24
2017-03-04,1610612748,1610612739,2016,120.0,92.0,212.0,97.25,95.5,101.9,101.55,62,28,34,0.452,60,42,18,0.7,15,13,26,16,195.0,195.48,195.24
2017-03-04,1610612741,1610612746,2016,91.0,101.0,192.0,94.0,91.0,109.85,106.5,61,31,30,0.508,61,36,25,0.59,19,12,19,17,185.44,214.36,199.9
2017-03-04,1610612743,1610612766,2016,102.0,112.0,214.0,109.2,110.3,99.45,97.7,61,28,33,0.459,61,26,35,0.426,16,12,16,10,217.04,194.96,206.0
2017-03-04,1610612745,1610612763,2016,123.0,108.0,231.0,112.7,109.85,98.25,97.5,62,43,19,0.6940000000000001,62,36,26,0.581,22,21,19,17,216.24,193.96,205.10000000000002
2017-03-04,1610612759,1610612750,2016,97.0,90.0,187.0,107.75,96.55,110.05,111.2,60,47,13,0.7829999999999999,61,25,36,0.41,20,27,15,10,204.12,209.4,206.76
2017-03-04,1610612757,1610612751,2016,130.0,116.0,246.0,104.75,105.45,96.7,98.4,60,25,35,0.417,60,10,50,0.16699999999999998,15,10,7,3,209.44,196.96,203.2
2017-03-03,1610612755,1610612752,2016,105.0,102.0,207.0,97.85,106.0,101.2,97.2,60,22,38,0.3670000000000001,61,25,36,0.41,14,8,15,10,207.68,200.28,203.98000000000002
2017-03-03,1610612764,1610612761,2016,106.0,114.0,220.0,94.7,91.35,100.6,99.2,59,36,23,0.61,61,36,25,0.59,25,11,21,15,193.0,206.0,199.5
2017-03-03,1610612753,1610612748,2016,110.0,99.0,209.0,96.55,103.5,97.25,95.5,61,22,39,0.361,61,28,33,0.459,10,12,15,13,203.64,195.0,199.32
2017-03-03,1610612737,1610612739,2016,130.0,135.0,265.0,96.35,95.7,101.9,101.55,60,34,26,0.5670000000000001,59,41,18,0.695,17,17,26,15,199.44,195.48,197.45999999999998
2017-03-03,1610612749,1610612746,2016,112.0,101.0,213.0,99.8,108.15,109.85,106.5,59,26,33,0.441,60,36,24,0.6,15,11,19,17,200.48,214.36,207.42000000000002
2017-03-03,1610612742,1610612763,2016,104.0,100.0,204.0,104.45,102.7,98.25,97.5,60,24,36,0.4,61,36,25,0.59,16,8,19,17,213.0,193.96,203.48000000000002
2017-03-03,1610612762,1610612751,2016,112.0,97.0,209.0,95.55,106.55,96.7,98.4,61,37,24,0.607,59,10,49,0.16899999999999998,20,17,7,3,200.2,196.96,198.57999999999998
2017-03-03,1610612756,1610612760,2016,118.0,111.0,229.0,106.25,103.85,101.8,103.4,61,19,42,0.311,61,35,26,0.574,11,8,23,12,212.88,210.36,211.62
2017-03-03,1610612740,1610612759,2016,98.0,101.0,199.0,100.45,104.8,107.75,96.55,61,24,37,0.393,59,46,13,0.78,15,9,20,26,200.8,204.12,202.46
2017-03-03,1610612747,1610612738,2016,95.0,115.0,210.0,107.3,114.65,99.65,105.5,61,19,42,0.311,61,39,22,0.639,12,7,21,18,219.28,195.08,207.18
2017-03-02,1610612741,1610612744,2016,94.0,87.0,181.0,94.0,91.0,107.5,105.85,60,30,30,0.5,60,50,10,0.833,18,12,26,24,185.44,199.04,192.24
2017-03-02,1610612756,1610612766,2016,120.0,103.0,223.0,106.25,103.85,99.45,97.7,60,18,42,0.3,60,26,34,0.433,10,8,16,10,212.88,194.96,203.92000000000002
2017-03-02,1610612757,1610612760,2016,114.0,109.0,223.0,104.75,105.45,101.8,103.4,59,24,35,0.407,60,35,25,0.583,14,10,23,12,209.44,210.36,209.9
2017-03-01,1610612753,1610612752,2016,90.0,101.0,191.0,96.55,103.5,101.2,97.2,60,22,38,0.3670000000000001,60,24,36,0.4,10,12,15,9,203.64,200.28,201.95999999999998
2017-03-01,1610612761,1610612764,2016,96.0,105.0,201.0,100.6,99.2,94.7,91.35,60,36,24,0.6,58,35,23,0.603,21,15,25,10,206.0,193.0,199.5
2017-03-01,1610612737,1610612742,2016,100.0,95.0,195.0,96.35,95.7,104.45,102.7,59,33,26,0.5589999999999999,59,24,35,0.407,16,17,16,8,199.44,213.0,206.22
2017-03-01,1610612748,1610612755,2016,125.0,98.0,223.0,97.25,95.5,97.85,106.0,60,27,33,0.45,59,22,37,0.373,14,13,14,8,195.0,207.68,201.34
2017-03-01,1610612749,1610612743,2016,98.0,110.0,208.0,99.8,108.15,109.2,110.3,58,26,32,0.448,60,27,33,0.45,15,11,16,11,200.48,217.04,208.76
2017-03-01,1610612740,1610612765,2016,109.0,86.0,195.0,100.45,104.8,100.85,105.95,60,23,37,0.383,60,29,31,0.483,14,9,19,10,200.8,206.0,203.4
2017-03-01,1610612738,1610612739,2016,103.0,99.0,202.0,99.65,105.5,101.9,101.55,60,38,22,0.633,58,41,17,0.7070000000000001,20,18,26,15,195.08,195.48,195.28
2017-03-01,1610612759,1610612754,2016,100.0,99.0,199.0,107.75,96.55,92.05,92.25,58,45,13,0.7759999999999999,60,31,29,0.517,19,26,21,10,204.12,187.28,195.7
2017-03-01,1610612762,1610612750,2016,80.0,107.0,187.0,95.55,106.55,110.05,111.2,60,37,23,0.617,60,24,36,0.4,20,17,15,9,200.2,209.4,204.8
2017-03-01,1610612746,1610612745,2016,103.0,122.0,225.0,109.85,106.5,112.7,109.85,59,36,23,0.61,61,42,19,0.6890000000000001,19,17,22,20,214.36,216.24,215.3
2017-03-01,1610612758,1610612751,2016,100.0,109.0,209.0,97.75,101.5,96.7,98.4,60,25,35,0.417,58,9,49,0.155,13,12,7,2,207.08,196.96,202.02
2017-02-28,1610612764,1610612744,2016,112.0,108.0,220.0,94.7,91.35,107.5,105.85,57,34,23,0.596,59,50,9,0.847,24,10,26,24,193.0,199.04,196.01999999999998
2017-02-28,1610612765,1610612757,2016,120.0,113.0,233.0,100.85,105.95,104.75,105.45,59,28,31,0.475,58,24,34,0.414,18,10,14,10,206.0,209.44,207.72
2017-02-28,1610612741,1610612743,2016,107.0,125.0,232.0,94.0,91.0,109.2,110.3,59,30,29,0.508,59,26,33,0.441,18,12,16,10,185.44,217.04,201.24
2017-02-28,1610612763,1610612756,2016,130.0,112.0,242.0,98.25,97.5,106.25,103.85,60,35,25,0.583,59,18,41,0.305,18,17,10,8,193.96,212.88,203.42000000000002
2017-02-28,1610612760,1610612762,2016,109.0,106.0,215.0,101.8,103.4,95.55,106.55,59,34,25,0.5760000000000001,59,37,22,0.627,22,12,20,17,210.36,200.2,205.28
2017-02-28,1610612747,1610612766,2016,104.0,109.0,213.0,107.3,114.65,99.45,97.7,60,19,41,0.317,59,25,34,0.424,12,7,16,9,219.28,194.96,207.12
2017-02-27,1610612752,1610612761,2016,91.0,92.0,183.0,101.2,97.2,100.6,99.2,59,24,35,0.407,59,35,24,0.593,15,9,21,14,200.28,206.0,203.14
2017-02-27,1610612755,1610612744,2016,108.0,119.0,227.0,97.85,106.0,107.5,105.85,58,22,36,0.379,58,49,9,0.845,14,8,26,23,207.68,199.04,203.36
2017-02-27,1610612739,1610612749,2016,102.0,95.0,197.0,101.9,101.55,99.8,108.15,57,40,17,0.7020000000000001,57,26,31,0.456,25,15,15,11,195.48,200.48,197.98
2017-02-27,1610612738,1610612737,2016,98.0,114.0,212.0,99.65,105.5,96.35,95.7,59,38,21,0.644,58,32,26,0.552,20,18,16,16,195.08,199.44,197.26
2017-02-27,1610612742,1610612748,2016,96.0,89.0,185.0,104.45,102.7,97.25,95.5,58,23,35,0.397,59,27,32,0.458,15,8,14,13,213.0,195.0,204.0
2017-02-27,1610612745,1610612754,2016,108.0,117.0,225.0,112.7,109.85,92.05,92.25,60,42,18,0.7,59,30,29,0.508,22,20,21,9,216.24,187.28,201.76
2017-02-27,1610612758,1610612750,2016,88.0,102.0,190.0,97.75,101.5,110.05,111.2,59,25,34,0.424,59,23,36,0.39,13,12,15,8,207.08,209.4,208.24
2017-02-26,1610612747,1610612759,2016,98.0,119.0,217.0,107.3,114.65,107.75,96.55,59,19,40,0.322,57,44,13,0.772,12,7,19,25,219.28,204.12,211.7
2017-02-26,1610612749,1610612756,2016,100.0,96.0,196.0,99.8,108.15,106.25,103.85,56,25,31,0.446,58,18,40,0.31,14,11,10,8,200.48,212.88,206.68
2017-02-26,1610612743,1610612763,2016,98.0,105.0,203.0,109.2,110.3,98.25,97.5,58,26,32,0.448,59,34,25,0.5760000000000001,16,10,18,16,217.04,193.96,205.5
2017-02-26,1610612764,1610612762,2016,92.0,102.0,194.0,94.7,91.35,95.55,106.55,56,34,22,0.607,58,36,22,0.621,24,10,20,16,193.0,200.2,196.6
2017-02-26,1610612761,1610612757,2016,112.0,106.0,218.0,100.6,99.2,104.75,105.45,58,34,24,0.586,57,24,33,0.421,20,14,14,10,206.0,209.44,207.72
2017-02-26,1610612765,1610612738,2016,98.0,104.0,202.0,100.85,105.95,99.65,105.5,58,28,30,0.483,58,37,21,0.638,18,10,20,17,206.0,195.08,200.54000000000002
2017-02-26,1610612760,1610612740,2016,118.0,110.0,228.0,101.8,103.4,100.45,104.8,58,33,25,0.569,59,23,36,0.39,21,12,14,9,210.36,200.8,205.58
2017-02-26,1610612746,1610612766,2016,124.0,121.0,245.0,109.85,106.5,99.45,97.7,58,35,23,0.603,58,25,33,0.431,18,17,16,9,214.36,194.96,204.66000000000003
2017-02-25,1610612758,1610612766,2016,85.0,99.0,184.0,97.75,101.5,99.45,97.7,58,25,33,0.431,57,24,33,0.421,13,12,16,8,207.08,194.96,201.02
2017-02-25,1610612753,1610612737,2016,105.0,86.0,191.0,96.55,103.5,96.35,95.7,59,21,38,0.35600000000000004,57,32,25,0.561,9,12,16,16,203.64,199.44,201.54
2017-02-25,1610612752,1610612755,2016,110.0,109.0,219.0,101.2,97.2,97.85,106.0,58,23,35,0.397,57,22,35,0.386,14,9,14,8,200.28,207.68,203.98000000000002
2017-02-25,1610612748,1610612754,2016,113.0,95.0,208.0,97.25,95.5,92.05,92.25,58,26,32,0.448,58,30,28,0.517,13,13,21,9,195.0,187.28,191.14
2017-02-25,1610612742,1610612740,2016,96.0,83.0,179.0,104.45,102.7,100.45,104.8,57,22,35,0.386,58,23,35,0.397,14,8,14,9,213.0,200.8,206.9
2017-02-25,1610612739,1610612741,2016,99.0,117.0,216.0,101.9,101.55,94.0,91.0,56,40,16,0.7140000000000001,58,29,29,0.5,25,15,18,11,195.48,185.44,190.45999999999998
2017-02-25,1610612745,1610612750,2016,142.0,130.0,272.0,112.7,109.85,110.05,111.2,59,41,18,0.695,58,23,35,0.397,21,20,15,8,216.24,209.4,212.82
2017-02-25,1610612744,1610612751,2016,112.0,95.0,207.0,107.5,105.85,96.7,98.4,57,48,9,0.8420000000000001,57,9,48,0.158,25,23,7,2,199.04,196.96,198.0
2017-02-24,1610612755,1610612764,2016,120.0,112.0,232.0,97.85,106.0,94.7,91.35,56,21,35,0.375,55,34,21,0.618,13,8,24,10,207.68,193.0,200.34
2017-02-24,1610612754,1610612763,2016,102.0,92.0,194.0,92.05,92.25,98.25,97.5,57,29,28,0.509,58,34,24,0.586,20,9,18,16,187.28,193.96,190.62
2017-02-24,1610612761,1610612738,2016,107.0,97.0,204.0,100.6,99.2,99.65,105.5,57,33,24,0.579,57,37,20,0.649,19,14,20,17,206.0,195.08,200.54000000000002
2017-02-24,1610612741,1610612756,2016,128.0,121.0,249.0,94.0,91.0,106.25,103.85,57,28,29,0.491,57,18,39,0.316,17,11,10,8,185.44,212.88,199.16
2017-02-24,1610612749,1610612762,2016,95.0,109.0,204.0,99.8,108.15,95.55,106.55,55,25,30,0.455,57,35,22,0.614,14,11,20,15,200.48,200.2,200.33999999999997
2017-02-24,1610612760,1610612747,2016,110.0,93.0,203.0,101.8,103.4,107.3,114.65,57,32,25,0.561,58,19,39,0.328,20,12,12,7,210.36,219.28,214.82
2017-02-24,1610612750,1610612742,2016,97.0,84.0,181.0,110.05,111.2,104.45,102.7,57,22,35,0.386,56,22,34,0.393,14,8,14,8,209.4,213.0,211.2
2017-02-24,1610612737,1610612748,2016,90.0,108.0,198.0,96.35,95.7,97.25,95.5,56,32,24,0.5710000000000001,57,25,32,0.439,16,16,13,12,199.44,195.0,197.22
2017-02-24,1610612743,1610612751,2016,129.0,109.0,238.0,109.2,110.3,96.7,98.4,57,25,32,0.439,56,9,47,0.161,15,10,7,2,217.04,196.96,207.0
2017-02-24,1610612746,1610612759,2016,97.0,105.0,202.0,109.85,106.5,107.75,96.55,57,35,22,0.614,56,43,13,0.768,18,17,19,24,214.36,204.12,209.24
2017-02-23,1610612753,1610612757,2016,103.0,112.0,215.0,96.55,103.5,104.75,105.45,58,21,37,0.362,56,23,33,0.411,9,12,14,9,203.64,209.44,206.54
2017-02-23,1610612765,1610612766,2016,114.0,108.0,222.0,100.85,105.95,99.45,97.7,57,27,30,0.474,56,24,32,0.429,17,10,16,8,206.0,194.96,200.48000000000002
2017-02-23,1610612740,1610612745,2016,99.0,129.0,228.0,100.45,104.8,112.7,109.85,57,23,34,0.404,58,40,18,0.69,14,9,21,19,200.8,216.24,208.52
2017-02-23,1610612739,1610612752,2016,119.0,104.0,223.0,101.9,101.55,101.2,97.2,55,39,16,0.7090000000000001,57,23,34,0.404,24,15,14,9,195.48,200.28,197.88
2017-02-23,1610612744,1610612746,2016,123.0,113.0,236.0,107.5,105.85,109.85,106.5,56,47,9,0.8390000000000001,56,35,21,0.625,24,23,18,17,199.04,214.36,206.7
2017-02-23,1610612758,1610612743,2016,116.0,100.0,216.0,97.75,101.5,109.2,110.3,57,24,33,0.421,56,25,31,0.446,12,12,15,10,207.08,217.04,212.06
2017-02-16,1610612754,1610612764,2016,98.0,111.0,209.0,92.05,92.25,94.7,91.35,56,29,27,0.518,54,33,21,0.611,20,9,24,9,187.28,193.0,190.14
2017-02-16,1610612741,1610612738,2016,104.0,103.0,207.0,94.0,91.0,99.65,105.5,56,27,29,0.482,56,37,19,0.6609999999999999,16,11,20,17,185.44,195.08,190.26
2017-02-15,1610612753,1610612759,2016,79.0,107.0,186.0,96.55,103.5,107.75,96.55,57,21,36,0.368,55,42,13,0.764,9,12,19,23,203.64,204.12,203.88
2017-02-15,1610612739,1610612754,2016,113.0,104.0,217.0,101.9,101.55,92.05,92.25,54,38,16,0.7040000000000001,55,29,26,0.527,23,15,20,9,195.48,187.28,191.38
2017-02-15,1610612738,1610612755,2016,116.0,108.0,224.0,99.65,105.5,97.85,106.0,55,36,19,0.655,55,21,34,0.382,19,17,13,8,195.08,207.68,201.38
2017-02-15,1610612761,1610612766,2016,90.0,85.0,175.0,100.6,99.2,99.45,97.7,56,32,24,0.5710000000000001,55,24,31,0.436,18,14,16,8,206.0,194.96,200.48000000000002
2017-02-15,1610612751,1610612749,2016,125.0,129.0,254.0,96.7,98.4,99.8,108.15,55,9,46,0.16399999999999998,54,24,30,0.444,7,2,14,10,196.96,200.48,198.72
2017-02-15,1610612765,1610612742,2016,98.0,91.0,189.0,100.85,105.95,104.45,102.7,56,26,30,0.464,55,22,33,0.4,16,10,14,8,206.0,213.0,209.5
2017-02-15,1610612763,1610612740,2016,91.0,95.0,186.0,98.25,97.5,100.45,104.8,57,34,23,0.596,56,22,34,0.393,18,16,14,8,193.96,200.8,197.38
2017-02-15,1610612745,1610612748,2016,109.0,117.0,226.0,112.7,109.85,97.25,95.5,57,40,17,0.7020000000000001,56,24,32,0.429,21,19,13,11,216.24,195.0,205.62
2017-02-15,1610612743,1610612750,2016,99.0,112.0,211.0,109.2,110.3,110.05,111.2,55,25,30,0.455,56,21,35,0.375,15,10,14,7,217.04,209.4,213.22
2017-02-15,1610612762,1610612757,2016,111.0,88.0,199.0,95.55,106.55,104.75,105.45,56,34,22,0.607,55,23,32,0.418,19,15,14,9,200.2,209.44,204.82
2017-02-15,1610612756,1610612747,2016,137.0,101.0,238.0,106.25,103.85,107.3,114.65,56,17,39,0.304,57,19,38,0.333,9,8,12,7,212.88,219.28,216.07999999999998
2017-02-15,1610612760,1610612752,2016,116.0,105.0,221.0,101.8,103.4,101.2,97.2,56,31,25,0.5539999999999999,56,23,33,0.411,19,12,14,9,210.36,200.28,205.32
2017-02-15,1610612746,1610612737,2016,99.0,84.0,183.0,109.85,106.5,96.35,95.7,55,34,21,0.618,55,32,23,0.5820000000000001,17,17,16,16,214.36,199.44,206.9
2017-02-15,1610612744,1610612758,2016,109.0,86.0,195.0,107.5,105.85,97.75,101.5,55,46,9,0.836,56,24,32,0.429,23,23,12,12,199.04,207.08,203.06
2017-02-14,1610612741,1610612761,2016,105.0,94.0,199.0,94.0,91.0,100.6,99.2,55,26,29,0.473,55,32,23,0.5820000000000001,15,11,18,14,185.44,206.0,195.72
2017-02-14,1610612750,1610612739,2016,108.0,116.0,224.0,110.05,111.2,101.9,101.55,55,21,34,0.382,53,37,16,0.698,14,7,23,14,209.4,195.48,202.44
2017-02-14,1610612747,1610612758,2016,96.0,97.0,193.0,107.3,114.65,97.75,101.5,56,19,37,0.339,55,23,32,0.418,12,7,12,11,219.28,207.08,213.18
2017-02-13,1610612766,1610612755,2016,99.0,105.0,204.0,99.45,97.7,97.85,106.0,54,24,30,0.444,54,20,34,0.37,16,8,13,7,194.96,207.68,201.32
2017-02-13,1610612754,1610612759,2016,106.0,110.0,216.0,92.05,92.25,107.75,96.55,54,29,25,0.537,54,41,13,0.759,20,9,19,22,187.28,204.12,195.7
2017-02-13,1610612751,1610612763,2016,103.0,112.0,215.0,96.7,98.4,98.25,97.5,54,9,45,0.16699999999999998,56,33,23,0.589,7,2,18,15,196.96,193.96,195.46
2017-02-13,1610612748,1610612753,2016,107.0,116.0,223.0,97.25,95.5,96.55,103.5,55,24,31,0.436,56,20,36,0.35700000000000004,13,11,9,11,195.0,203.64,199.32
2017-02-13,1610612764,1610612760,2016,120.0,98.0,218.0,94.7,91.35,101.8,103.4,53,32,21,0.604,55,31,24,0.564,23,9,19,12,193.0,210.36,201.68
2017-02-13,1610612749,1610612765,2016,102.0,89.0,191.0,99.8,108.15,100.85,105.95,53,23,30,0.434,55,26,29,0.473,13,10,16,10,200.48,206.0,203.24
2017-02-13,1610612742,1610612738,2016,98.0,111.0,209.0,104.45,102.7,99.65,105.5,54,22,32,0.407,54,35,19,0.648,14,8,19,16,213.0,195.08,204.04000000000002
2017-02-13,1610612743,1610612744,2016,132.0,110.0,242.0,109.2,110.3,107.5,105.85,54,24,30,0.444,54,46,8,0.852,14,10,23,23,217.04,199.04,208.04
2017-02-13,1610612762,1610612746,2016,72.0,88.0,160.0,95.55,106.55,109.85,106.5,55,34,21,0.618,54,33,21,0.611,19,15,17,16,200.2,214.36,207.28
2017-02-13,1610612756,1610612740,2016,108.0,110.0,218.0,106.25,103.85,100.45,104.8,55,17,38,0.309,55,21,34,0.382,9,8,14,7,212.88,200.8,206.84
2017-02-13,1610612757,1610612737,2016,104.0,109.0,213.0,104.75,105.45,96.35,95.7,54,23,31,0.426,54,31,23,0.574,14,9,16,15,209.44,199.44,204.44
2017-02-12,1610612750,1610612741,2016,117.0,89.0,206.0,110.05,111.2,94.0,91.0,54,20,34,0.37,54,26,28,0.481,13,7,15,11,209.4,185.44,197.42000000000002
2017-02-12,1610612752,1610612759,2016,94.0,90.0,184.0,101.2,97.2,107.75,96.55,55,22,33,0.4,53,41,12,0.774,13,9,19,22,200.28,204.12,202.2
2017-02-12,1610612761,1610612765,2016,101.0,102.0,203.0,100.6,99.2,100.85,105.95,54,32,22,0.593,54,25,29,0.463,18,14,16,9,206.0,206.0,206.0
2017-02-12,1610612758,1610612740,2016,105.0,99.0,204.0,97.75,101.5,100.45,104.8,54,22,32,0.407,54,21,33,0.389,11,11,14,7,207.08,200.8,203.94
2017-02-11,1610612766,1610612746,2016,102.0,107.0,209.0,99.45,97.7,109.85,106.5,53,24,29,0.453,53,32,21,0.604,16,8,17,15,194.96,214.36,204.66000000000003
2017-02-11,1610612754,1610612749,2016,100.0,116.0,216.0,92.05,92.25,99.8,108.15,53,29,24,0.547,52,22,30,0.423,20,9,13,9,187.28,200.48,193.88
2017-02-11,1610612755,1610612748,2016,117.0,109.0,226.0,97.85,106.0,97.25,95.5,53,19,34,0.358,54,24,30,0.444,12,7,13,11,207.68,195.0,201.34
2017-02-11,1610612739,1610612743,2016,125.0,109.0,234.0,101.9,101.55,109.2,110.3,52,36,16,0.6920000000000001,53,24,29,0.453,22,14,14,10,195.48,217.04,206.26
2017-02-11,1610612760,1610612744,2016,114.0,130.0,244.0,101.8,103.4,107.5,105.85,54,31,23,0.574,53,45,8,0.8490000000000001,19,12,23,22,210.36,199.04,204.7
2017-02-11,1610612745,1610612756,2016,133.0,102.0,235.0,112.7,109.85,106.25,103.85,56,39,17,0.696,54,17,37,0.315,20,19,9,8,216.24,212.88,214.56
2017-02-11,1610612742,1610612753,2016,112.0,80.0,192.0,104.45,102.7,96.55,103.5,53,21,32,0.396,55,20,35,0.364,13,8,9,11,213.0,203.64,208.32
2017-02-11,1610612762,1610612738,2016,104.0,112.0,216.0,95.55,106.55,99.65,105.5,54,34,20,0.63,53,34,19,0.642,19,15,19,15,200.2,195.08,197.64
2017-02-10,1610612751,1610612748,2016,99.0,108.0,207.0,96.7,98.4,97.25,95.5,53,9,44,0.17,53,23,30,0.434,7,2,13,10,196.96,195.0,195.98000000000002
2017-02-10,1610612752,1610612743,2016,123.0,131.0,254.0,101.2,97.2,109.2,110.3,54,22,32,0.407,52,23,29,0.442,13,9,14,9,200.28,217.04,208.66
2017-02-10,1610612765,1610612759,2016,92.0,103.0,195.0,100.85,105.95,107.75,96.55,53,25,28,0.472,52,40,12,0.769,16,9,19,21,206.0,204.12,205.06
2017-02-10,1610612749,1610612747,2016,114.0,122.0,236.0,99.8,108.15,107.3,114.65,51,22,29,0.431,55,18,37,0.327,13,9,12,6,200.48,219.28,209.88
2017-02-10,1610612763,1610612744,2016,107.0,122.0,229.0,98.25,97.5,107.5,105.85,55,33,22,0.6,52,44,8,0.846,18,15,23,21,193.96,199.04,196.5
2017-02-10,1610612750,1610612740,2016,106.0,122.0,228.0,110.05,111.2,100.45,104.8,53,20,33,0.377,53,20,33,0.377,13,7,14,6,209.4,200.8,205.10000000000002
2017-02-10,1610612764,1610612754,2016,112.0,107.0,219.0,94.7,91.35,92.05,92.25,52,31,21,0.596,52,29,23,0.5579999999999999,22,9,20,9,193.0,187.28,190.14
2017-02-10,1610612758,1610612737,2016,108.0,107.0,215.0,97.75,101.5,96.35,95.7,53,21,32,0.396,53,31,22,0.585,10,11,16,15,207.08,199.44,203.26
2017-02-10,1610612756,1610612741,2016,115.0,97.0,212.0,106.25,103.85,94.0,91.0,53,16,37,0.302,53,26,27,0.491,8,8,15,11,212.88,185.44,199.16
2017-02-09,1610612766,1610612745,2016,95.0,107.0,202.0,99.45,97.7,112.7,109.85,52,24,28,0.462,55,38,17,0.691,16,8,20,18,194.96,216.24,205.60000000000002
2017-02-09,1610612753,1610612755,2016,111.0,112.0,223.0,96.55,103.5,97.85,106.0,54,20,34,0.37,52,18,34,0.34600000000000003,9,11,12,6,203.64,207.68,205.66
2017-02-09,1610612760,1610612739,2016,118.0,109.0,227.0,101.8,103.4,101.9,101.55,53,30,23,0.5660000000000001,51,36,15,0.706,18,12,22,14,210.36,195.48,202.92000000000002
2017-02-09,1610612742,1610612762,2016,112.0,105.0,217.0,104.45,102.7,95.55,106.55,52,20,32,0.385,53,34,19,0.642,12,8,19,15,213.0,200.2,206.6
2017-02-09,1610612757,1610612738,2016,111.0,120.0,231.0,104.75,105.45,99.65,105.5,53,23,30,0.434,52,33,19,0.635,14,9,19,14,209.44,195.08,202.26
2017-02-08,1610612755,1610612759,2016,103.0,111.0,214.0,97.85,106.0,107.75,96.55,51,18,33,0.353,51,39,12,0.765,12,6,19,20,207.68,204.12,205.9
2017-02-08,1610612754,1610612739,2016,117.0,132.0,249.0,92.05,92.25,101.9,101.55,51,29,22,0.569,50,35,15,0.7,20,9,22,13,187.28,195.48,191.38
2017-02-08,1610612751,1610612764,2016,110.0,114.0,224.0,96.7,98.4,94.7,91.35,52,9,43,0.173,51,30,21,0.588,7,2,22,8,196.96,193.0,194.98000000000002
2017-02-08,1610612737,1610612743,2016,117.0,106.0,223.0,96.35,95.7,109.2,110.3,52,30,22,0.5770000000000001,51,23,28,0.451,15,15,14,9,199.44,217.04,208.24
2017-02-08,1610612765,1610612747,2016,121.0,102.0,223.0,100.85,105.95,107.3,114.65,52,24,28,0.462,54,18,36,0.333,15,9,12,6,206.0,219.28,212.64
2017-02-08,1610612749,1610612748,2016,88.0,106.0,194.0,99.8,108.15,97.25,95.5,50,22,28,0.44,52,22,30,0.423,13,9,13,9,200.48,195.0,197.74
2017-02-08,1610612763,1610612756,2016,110.0,91.0,201.0,98.25,97.5,106.25,103.85,54,32,22,0.593,52,16,36,0.308,17,15,8,8,193.96,212.88,203.42000000000002
2017-02-08,1610612740,1610612762,2016,94.0,127.0,221.0,100.45,104.8,95.55,106.55,52,20,32,0.385,52,33,19,0.635,14,6,19,14,200.8,200.2,200.5
2017-02-08,1610612750,1610612761,2016,112.0,109.0,221.0,110.05,111.2,100.6,99.2,52,19,33,0.365,53,32,21,0.604,12,7,18,14,209.4,206.0,207.7
2017-02-08,1610612752,1610612746,2016,115.0,119.0,234.0,101.2,97.2,109.85,106.5,53,22,31,0.415,52,31,21,0.596,13,9,17,14,200.28,214.36,207.32
2017-02-08,1610612744,1610612741,2016,123.0,92.0,215.0,107.5,105.85,94.0,91.0,51,43,8,0.843,52,26,26,0.5,22,21,15,11,199.04,185.44,192.24
2017-02-08,1610612758,1610612738,2016,108.0,92.0,200.0,97.75,101.5,99.65,105.5,52,20,32,0.385,51,33,18,0.647,9,11,19,14,207.08,195.08,201.08
2017-02-07,1610612766,1610612751,2016,111.0,107.0,218.0,99.45,97.7,96.7,98.4,51,23,28,0.451,51,9,42,0.17600000000000002,15,8,7,2,194.96,196.96,195.96
2017-02-07,1610612745,1610612753,2016,128.0,104.0,232.0,112.7,109.85,96.55,103.5,54,37,17,0.685,53,20,33,0.377,19,18,9,11,216.24,203.64,209.94
2017-02-07,1610612742,1610612757,2016,113.0,114.0,227.0,104.45,102.7,104.75,105.45,51,20,31,0.392,52,22,30,0.423,12,8,14,8,213.0,209.44,211.22
2017-02-06,1610612752,1610612747,2016,107.0,121.0,228.0,101.2,97.2,107.3,114.65,52,22,30,0.423,53,17,36,0.321,13,9,12,5,200.28,219.28,209.78
2017-02-06,1610612764,1610612739,2016,135.0,140.0,275.0,94.7,91.35,101.9,101.55,50,30,20,0.6,49,34,15,0.6940000000000001,22,8,22,12,193.0,195.48,194.24
2017-02-06,1610612754,1610612760,2016,93.0,90.0,183.0,92.05,92.25,101.8,103.4,50,28,22,0.56,52,30,22,0.5770000000000001,19,9,18,12,187.28,210.36,198.82
2017-02-06,1610612761,1610612746,2016,118.0,109.0,227.0,100.6,99.2,109.85,106.5,52,31,21,0.596,51,31,20,0.608,17,14,17,14,206.0,214.36,210.18
2017-02-06,1610612737,1610612762,2016,95.0,120.0,215.0,96.35,95.7,95.55,106.55,51,30,21,0.588,51,32,19,0.627,15,15,19,13,199.44,200.2,199.82
2017-02-06,1610612765,1610612755,2016,113.0,96.0,209.0,100.85,105.95,97.85,106.0,51,23,28,0.451,50,18,32,0.36,14,9,12,6,206.0,207.68,206.84
2017-02-06,1610612740,1610612756,2016,111.0,106.0,217.0,100.45,104.8,106.25,103.85,51,19,32,0.373,51,16,35,0.314,13,6,8,8,200.8,212.88,206.84
2017-02-06,1610612750,1610612748,2016,113.0,115.0,228.0,110.05,111.2,97.25,95.5,51,19,32,0.373,51,21,30,0.412,12,7,13,8,209.4,195.0,202.2
2017-02-06,1610612743,1610612742,2016,110.0,87.0,197.0,109.2,110.3,104.45,102.7,50,22,28,0.44,50,20,30,0.4,13,9,12,8,217.04,213.0,215.01999999999998
2017-02-06,1610612763,1610612759,2016,89.0,74.0,163.0,98.25,97.5,107.75,96.55,53,31,22,0.585,50,39,11,0.78,16,15,19,20,193.96,204.12,199.04000000000002
2017-02-06,1610612758,1610612741,2016,107.0,112.0,219.0,97.75,101.5,94.0,91.0,51,20,31,0.392,51,25,26,0.49,9,11,15,10,207.08,185.44,196.26
2017-02-05,1610612751,1610612761,2016,95.0,103.0,198.0,96.7,98.4,100.6,99.2,50,9,41,0.18,51,30,21,0.588,7,2,17,13,196.96,206.0,201.48000000000002
2017-02-05,1610612738,1610612746,2016,107.0,102.0,209.0,99.65,105.5,109.85,106.5,50,32,18,0.64,50,31,19,0.62,18,14,17,14,195.08,214.36,204.72000000000003
2017-02-05,1610612760,1610612757,2016,105.0,99.0,204.0,101.8,103.4,104.75,105.45,51,29,22,0.569,51,22,29,0.431,17,12,14,8,210.36,209.44,209.9
2017-02-04,1610612764,1610612740,2016,105.0,91.0,196.0,94.7,91.35,100.45,104.8,49,29,20,0.5920000000000001,50,19,31,0.38,21,8,13,6,193.0,200.8,196.9
2017-02-04,1610612737,1610612753,2016,113.0,86.0,199.0,96.35,95.7,96.55,103.5,50,29,21,0.58,52,20,32,0.385,14,15,9,11,199.44,203.64,201.54
2017-02-04,1610612754,1610612765,2016,105.0,84.0,189.0,92.05,92.25,100.85,105.95,49,27,22,0.551,50,23,27,0.46,18,9,14,9,187.28,206.0,196.64
2017-02-04,1610612748,1610612755,2016,125.0,102.0,227.0,97.25,95.5,97.85,106.0,50,20,30,0.4,49,18,31,0.3670000000000001,12,8,12,6,195.0,207.68,201.34
2017-02-04,1610612752,1610612739,2016,104.0,111.0,215.0,101.2,97.2,101.9,101.55,51,22,29,0.431,48,33,15,0.688,13,9,22,11,200.28,195.48,197.88
2017-02-04,1610612762,1610612766,2016,105.0,98.0,203.0,95.55,106.55,99.45,97.7,50,31,19,0.62,50,23,27,0.46,18,13,15,8,200.2,194.96,197.57999999999998
2017-02-04,1610612756,1610612749,2016,112.0,137.0,249.0,106.25,103.85,99.8,108.15,50,16,34,0.32,49,21,28,0.429,8,8,13,8,212.88,200.48,206.68
2017-02-04,1610612759,1610612743,2016,121.0,97.0,218.0,107.75,96.55,109.2,110.3,49,38,11,0.7759999999999999,49,22,27,0.449,18,20,13,9,204.12,217.04,210.57999999999998
2017-02-04,1610612750,1610612763,2016,99.0,107.0,206.0,110.05,111.2,98.25,97.5,50,19,31,0.38,52,30,22,0.5770000000000001,12,7,16,14,209.4,193.96,201.68
2017-02-04,1610612758,1610612744,2016,109.0,106.0,215.0,97.75,101.5,107.5,105.85,50,19,31,0.38,50,43,7,0.86,8,11,22,21,207.08,199.04,203.06
2017-02-03,1610612753,1610612761,2016,102.0,94.0,196.0,96.55,103.5,100.6,99.2,51,19,32,0.373,50,30,20,0.6,8,11,17,13,203.64,206.0,204.82
2017-02-03,1610612751,1610612754,2016,97.0,106.0,203.0,96.7,98.4,92.05,92.25,49,9,40,0.184,48,26,22,0.542,7,2,18,8,196.96,187.28,192.12
2017-02-03,1610612765,1610612750,2016,116.0,108.0,224.0,100.85,105.95,110.05,111.2,49,22,27,0.449,49,19,30,0.388,13,9,12,7,206.0,209.4,207.7
2017-02-03,1610612745,1610612741,2016,121.0,117.0,238.0,112.7,109.85,94.0,91.0,53,36,17,0.679,50,25,25,0.5,18,18,15,10,216.24,185.44,200.84
2017-02-03,1610612760,1610612763,2016,114.0,102.0,216.0,101.8,103.4,98.25,97.5,50,28,22,0.56,51,30,21,0.588,16,12,16,14,210.36,193.96,202.16000000000003
2017-02-03,1610612738,1610612747,2016,113.0,107.0,220.0,99.65,105.5,107.3,114.65,49,31,18,0.633,52,17,35,0.327,17,14,12,5,195.08,219.28,207.18
2017-02-03,1610612743,1610612749,2016,121.0,117.0,238.0,109.2,110.3,99.8,108.15,48,21,27,0.438,48,21,27,0.438,12,9,13,8,217.04,200.48,208.76
2017-02-03,1610612758,1610612756,2016,103.0,105.0,208.0,97.75,101.5,106.25,103.85,49,19,30,0.388,49,15,34,0.306,8,11,8,7,207.08,212.88,209.98000000000002
2017-02-03,1610612757,1610612742,2016,104.0,108.0,212.0,104.75,105.45,104.45,102.7,50,22,28,0.44,49,19,30,0.388,14,8,12,7,209.44,213.0,211.22
2017-02-02,1610612764,1610612747,2016,116.0,108.0,224.0,94.7,91.35,107.3,114.65,48,28,20,0.583,51,17,34,0.333,20,8,12,5,193.0,219.28,206.14
2017-02-02,1610612745,1610612737,2016,108.0,113.0,221.0,112.7,109.85,96.35,95.7,52,36,16,0.6920000000000001,49,28,21,0.5710000000000001,18,18,14,14,216.24,199.44,207.84
2017-02-02,1610612759,1610612755,2016,102.0,86.0,188.0,107.75,96.55,97.85,106.0,48,37,11,0.7709999999999999,48,18,30,0.375,17,20,12,6,204.12,207.68,205.9
2017-02-02,1610612746,1610612744,2016,120.0,133.0,253.0,109.85,106.5,107.5,105.85,49,31,18,0.633,49,42,7,0.857,17,14,22,20,214.36,199.04,206.7
2017-02-01,1610612753,1610612754,2016,88.0,98.0,186.0,96.55,103.5,92.05,92.25,50,19,31,0.38,47,25,22,0.532,8,11,18,7,203.64,187.28,195.45999999999998
2017-02-01,1610612739,1610612750,2016,125.0,97.0,222.0,101.9,101.55,110.05,111.2,47,32,15,0.6809999999999999,48,19,29,0.396,21,11,12,7,195.48,209.4,202.44
2017-02-01,1610612738,1610612761,2016,109.0,104.0,213.0,99.65,105.5,100.6,99.2,48,30,18,0.625,49,30,19,0.612,16,14,17,13,195.08,206.0,200.54000000000002
2017-02-01,1610612751,1610612752,2016,90.0,95.0,185.0,96.7,98.4,101.2,97.2,48,9,39,0.188,50,21,29,0.42,7,2,13,8,196.96,200.28,198.62
2017-02-01,1610612748,1610612737,2016,116.0,93.0,209.0,97.25,95.5,96.35,95.7,49,19,30,0.388,48,28,20,0.583,11,8,14,14,195.0,199.44,197.22
2017-02-01,1610612765,1610612740,2016,118.0,98.0,216.0,100.85,105.95,100.45,104.8,48,21,27,0.438,49,19,30,0.388,12,9,13,6,206.0,200.8,203.4
2017-02-01,1610612742,1610612755,2016,113.0,95.0,208.0,104.45,102.7,97.85,106.0,48,18,30,0.375,47,18,29,0.383,11,7,12,6,213.0,207.68,210.34
2017-02-01,1610612743,1610612763,2016,99.0,119.0,218.0,109.2,110.3,98.25,97.5,47,21,26,0.447,50,29,21,0.58,12,9,16,13,217.04,193.96,205.5
2017-02-01,1610612762,1610612749,2016,104.0,88.0,192.0,95.55,106.55,99.8,108.15,49,30,19,0.612,47,21,26,0.447,17,13,13,8,200.2,200.48,200.33999999999997
2017-02-01,1610612756,1610612746,2016,114.0,124.0,238.0,106.25,103.85,109.85,106.5,48,15,33,0.313,48,30,18,0.625,8,7,17,13,212.88,214.36,213.62
2017-02-01,1610612760,1610612741,2016,100.0,128.0,228.0,101.8,103.4,94.0,91.0,49,28,21,0.5710000000000001,49,24,25,0.49,16,12,15,9,210.36,185.44,197.9
2017-02-01,1610612744,1610612766,2016,126.0,111.0,237.0,107.5,105.85,99.45,97.7,48,41,7,0.8540000000000001,49,23,26,0.469,21,20,15,8,199.04,194.96,197.0
2017-01-31,1610612764,1610612752,2016,117.0,101.0,218.0,94.7,91.35,101.2,97.2,47,27,20,0.574,49,21,28,0.429,19,8,13,8,193.0,200.28,196.64
2017-01-31,1610612761,1610612740,2016,108.0,106.0,214.0,100.6,99.2,100.45,104.8,48,29,19,0.604,48,19,29,0.396,16,13,13,6,206.0,200.8,203.4
2017-01-31,1610612745,1610612758,2016,105.0,83.0,188.0,112.7,109.85,97.75,101.5,51,35,16,0.6859999999999999,48,19,29,0.396,17,18,8,11,216.24,207.08,211.66000000000003
2017-01-31,1610612759,1610612760,2016,108.0,94.0,202.0,107.75,96.55,101.8,103.4,47,36,11,0.7659999999999999,48,28,20,0.583,16,20,16,12,204.12,210.36,207.24
2017-01-31,1610612757,1610612766,2016,115.0,98.0,213.0,104.75,105.45,99.45,97.7,49,21,28,0.429,48,23,25,0.479,13,8,15,8,209.44,194.96,202.2
2017-01-31,1610612747,1610612743,2016,120.0,116.0,236.0,107.3,114.65,109.2,110.3,50,16,34,0.32,46,21,25,0.457,11,5,12,9,219.28,217.04,218.16
2017-01-30,1610612755,1610612758,2016,122.0,119.0,241.0,97.85,106.0,97.75,101.5,46,17,29,0.37,47,19,28,0.404,11,6,8,11,207.68,207.08,207.38
2017-01-30,1610612748,1610612751,2016,104.0,96.0,200.0,97.25,95.5,96.7,98.4,48,18,30,0.375,47,9,38,0.191,10,8,7,2,195.0,196.96,195.98000000000002
2017-01-30,1610612750,1610612753,2016,111.0,105.0,216.0,110.05,111.2,96.55,103.5,47,18,29,0.383,49,19,30,0.388,11,7,8,11,209.4,203.64,206.51999999999998
2017-01-30,1610612738,1610612765,2016,113.0,109.0,222.0,99.65,105.5,100.85,105.95,47,29,18,0.617,47,21,26,0.447,15,14,12,9,195.08,206.0,200.54000000000002
2017-01-30,1610612742,1610612739,2016,104.0,97.0,201.0,104.45,102.7,101.9,101.55,47,17,30,0.362,46,32,14,0.696,10,7,21,11,213.0,195.48,204.24
2017-01-30,1610612756,1610612763,2016,96.0,115.0,211.0,106.25,103.85,98.25,97.5,47,15,32,0.319,49,28,21,0.5710000000000001,8,7,16,12,212.88,193.96,203.42000000000002
2017-01-29,1610612737,1610612752,2016,142.0,139.0,281.0,96.35,95.7,101.2,97.2,47,27,20,0.574,48,21,27,0.438,13,14,13,8,199.44,200.28,199.86
2017-01-29,1610612739,1610612760,2016,107.0,91.0,198.0,101.9,101.55,101.8,103.4,45,31,14,0.6890000000000001,47,28,19,0.596,20,11,16,12,195.48,210.36,202.92000000000002
2017-01-29,1610612754,1610612745,2016,120.0,101.0,221.0,92.05,92.25,112.7,109.85,46,24,22,0.522,50,35,15,0.7,17,7,17,18,187.28,216.24,201.76
2017-01-29,1610612740,1610612764,2016,94.0,107.0,201.0,100.45,104.8,94.7,91.35,47,19,28,0.404,46,26,20,0.565,13,6,19,7,200.8,193.0,196.9
2017-01-29,1610612761,1610612753,2016,113.0,114.0,227.0,100.6,99.2,96.55,103.5,47,29,18,0.617,48,18,30,0.375,16,13,8,10,206.0,203.64,204.82
2017-01-29,1610612741,1610612755,2016,121.0,108.0,229.0,94.0,91.0,97.85,106.0,48,23,25,0.479,45,17,28,0.378,14,9,11,6,185.44,207.68,196.56
2017-01-29,1610612759,1610612742,2016,101.0,105.0,206.0,107.75,96.55,104.45,102.7,46,36,10,0.7829999999999999,46,16,30,0.348,16,20,10,6,204.12,213.0,208.56
2017-01-29,1610612757,1610612744,2016,111.0,113.0,224.0,104.75,105.45,107.5,105.85,48,21,27,0.438,47,40,7,0.851,13,8,21,19,209.44,199.04,204.24
2017-01-28,1610612766,1610612758,2016,106.0,109.0,215.0,99.45,97.7,97.75,101.5,47,23,24,0.489,46,18,28,0.391,15,8,8,10,194.96,207.08,201.02
2017-01-28,1610612748,1610612765,2016,116.0,103.0,219.0,97.25,95.5,100.85,105.95,47,17,30,0.362,46,21,25,0.457,9,8,12,9,195.0,206.0,200.5
2017-01-28,1610612749,1610612738,2016,108.0,112.0,220.0,99.8,108.15,99.65,105.5,46,21,25,0.457,46,28,18,0.609,13,8,15,13,200.48,195.08,197.78
2017-01-28,1610612744,1610612746,2016,144.0,98.0,242.0,107.5,105.85,109.85,106.5,46,39,7,0.848,47,30,17,0.638,20,19,17,13,199.04,214.36,206.7
2017-01-28,1610612762,1610612763,2016,95.0,102.0,197.0,95.55,106.55,98.25,97.5,48,30,18,0.625,48,27,21,0.563,17,13,16,11,200.2,193.96,197.07999999999998
2017-01-28,1610612756,1610612743,2016,112.0,123.0,235.0,106.25,103.85,109.2,110.3,46,15,31,0.326,45,20,25,0.444,8,7,12,8,212.88,217.04,214.95999999999998
2017-01-28,1610612750,1610612751,2016,129.0,109.0,238.0,110.05,111.2,96.7,98.4,46,17,29,0.37,46,9,37,0.196,10,7,7,2,209.4,196.96,203.18
2017-01-27,1610612754,1610612758,2016,115.0,111.0,226.0,92.05,92.25,97.75,101.5,45,23,22,0.511,45,18,27,0.4,16,7,8,10,187.28,207.08,197.18
2017-01-27,1610612739,1610612751,2016,124.0,116.0,240.0,101.9,101.55,96.7,98.4,44,30,14,0.682,45,9,36,0.2,19,11,7,2,195.48,196.96,196.22
2017-01-27,1610612738,1610612753,2016,128.0,98.0,226.0,99.65,105.5,96.55,103.5,45,27,18,0.6,47,18,29,0.383,14,13,8,10,195.08,203.64,199.36
2017-01-27,1610612761,1610612749,2016,102.0,86.0,188.0,100.6,99.2,99.8,108.15,46,28,18,0.609,45,21,24,0.467,15,13,13,8,206.0,200.48,203.24
2017-01-27,1610612752,1610612766,2016,110.0,107.0,217.0,101.2,97.2,99.45,97.7,47,20,27,0.426,46,23,23,0.5,12,8,15,8,200.28,194.96,197.62
2017-01-27,1610612755,1610612745,2016,118.0,123.0,241.0,97.85,106.0,112.7,109.85,44,17,27,0.386,49,34,15,0.6940000000000001,11,6,17,17,207.68,216.24,211.96
2017-01-27,1610612741,1610612748,2016,88.0,100.0,188.0,94.0,91.0,97.25,95.5,47,23,24,0.489,46,16,30,0.348,14,9,9,7,185.44,195.0,190.22
2017-01-27,1610612740,1610612759,2016,119.0,103.0,222.0,100.45,104.8,107.75,96.55,46,18,28,0.391,45,36,9,0.8,12,6,16,20,200.8,204.12,202.46
2017-01-27,1610612737,1610612764,2016,86.0,112.0,198.0,96.35,95.7,94.7,91.35,46,27,19,0.5870000000000001,45,25,20,0.556,13,14,19,6,199.44,193.0,196.22
2017-01-27,1610612757,1610612763,2016,112.0,109.0,221.0,104.75,105.45,98.25,97.5,47,20,27,0.426,47,27,20,0.574,12,8,16,11,209.44,193.96,201.7
2017-01-26,1610612760,1610612742,2016,109.0,98.0,207.0,101.8,103.4,104.45,102.7,46,27,19,0.5870000000000001,45,16,29,0.35600000000000004,15,12,10,6,210.36,213.0,211.68
2017-01-26,1610612750,1610612754,2016,103.0,109.0,212.0,110.05,111.2,92.05,92.25,45,17,28,0.378,44,22,22,0.5,10,7,16,6,209.4,187.28,198.34
2017-01-26,1610612743,1610612756,2016,127.0,120.0,247.0,109.2,110.3,106.25,103.85,44,19,25,0.4320000000000001,45,15,30,0.333,11,8,8,7,217.04,212.88,214.95999999999998
2017-01-26,1610612762,1610612747,2016,96.0,88.0,184.0,95.55,106.55,107.3,114.65,47,29,18,0.617,49,16,33,0.327,16,13,11,5,200.2,219.28,209.74
2017-01-25,1610612739,1610612758,2016,112.0,116.0,228.0,101.9,101.55,97.75,101.5,43,30,13,0.698,44,17,27,0.386,19,11,8,9,195.48,207.08,201.28
2017-01-25,1610612738,1610612745,2016,120.0,109.0,229.0,99.65,105.5,112.7,109.85,44,26,18,0.591,48,34,14,0.708,13,13,17,17,195.08,216.24,205.66000000000003
2017-01-25,1610612751,1610612748,2016,106.0,109.0,215.0,96.7,98.4,97.25,95.5,44,9,35,0.205,45,15,30,0.333,7,2,9,6,196.96,195.0,195.98000000000002
2017-01-25,1610612741,1610612737,2016,114.0,119.0,233.0,94.0,91.0,96.35,95.7,46,23,23,0.5,45,26,19,0.578,14,9,13,13,185.44,199.44,192.44
2017-01-25,1610612749,1610612755,2016,109.0,114.0,223.0,99.8,108.15,97.85,106.0,44,21,23,0.477,43,16,27,0.3720000000000001,13,8,11,5,200.48,207.68,204.07999999999998
2017-01-25,1610612763,1610612761,2016,101.0,99.0,200.0,98.25,97.5,100.6,99.2,46,26,20,0.565,45,28,17,0.622,15,11,15,13,193.96,206.0,199.98000000000002
2017-01-25,1610612740,1610612760,2016,105.0,114.0,219.0,100.45,104.8,101.8,103.4,45,18,27,0.4,45,26,19,0.578,12,6,15,11,200.8,210.36,205.58
2017-01-25,1610612766,1610612744,2016,103.0,113.0,216.0,99.45,97.7,107.5,105.85,45,23,22,0.511,45,38,7,0.8440000000000001,15,8,20,18,194.96,199.04,197.0
2017-01-25,1610612742,1610612752,2016,103.0,95.0,198.0,104.45,102.7,101.2,97.2,44,15,29,0.341,46,20,26,0.435,9,6,12,8,213.0,200.28,206.64
2017-01-25,1610612757,1610612747,2016,105.0,98.0,203.0,104.75,105.45,107.3,114.65,46,19,27,0.413,48,16,32,0.333,11,8,11,5,209.44,219.28,214.36
2017-01-24,1610612761,1610612759,2016,106.0,108.0,214.0,100.6,99.2,107.75,96.55,44,28,16,0.636,44,35,9,0.795,15,13,16,19,206.0,204.12,205.06
2017-01-24,1610612755,1610612746,2016,121.0,110.0,231.0,97.85,106.0,109.85,106.5,42,15,27,0.35700000000000004,46,30,16,0.652,10,5,17,13,207.68,214.36,211.02
2017-01-24,1610612764,1610612738,2016,123.0,108.0,231.0,94.7,91.35,99.65,105.5,44,24,20,0.545,43,26,17,0.605,18,6,13,13,193.0,195.08,194.04000000000002
2017-01-24,1610612753,1610612741,2016,92.0,100.0,192.0,96.55,103.5,94.0,91.0,46,18,28,0.391,45,22,23,0.489,8,10,14,8,203.64,185.44,194.54
2017-01-24,1610612743,1610612762,2016,103.0,93.0,196.0,109.2,110.3,95.55,106.55,43,18,25,0.419,46,29,17,0.63,10,8,16,13,217.04,200.2,208.62
2017-01-24,1610612756,1610612750,2016,111.0,112.0,223.0,106.25,103.85,110.05,111.2,44,15,29,0.341,44,16,28,0.364,8,7,10,6,212.88,209.4,211.14
2017-01-23,1610612766,1610612764,2016,99.0,109.0,208.0,99.45,97.7,94.7,91.35,44,23,21,0.523,43,23,20,0.535,15,8,18,5,194.96,193.0,193.98000000000002
2017-01-23,1610612751,1610612759,2016,86.0,112.0,198.0,96.7,98.4,107.75,96.55,43,9,34,0.209,43,34,9,0.7909999999999999,7,2,16,18,196.96,204.12,200.54000000000002
2017-01-23,1610612737,1610612746,2016,105.0,115.0,220.0,96.35,95.7,109.85,106.5,44,26,18,0.591,45,29,16,0.644,13,13,17,12,199.44,214.36,206.9
2017-01-23,1610612748,1610612744,2016,105.0,102.0,207.0,97.25,95.5,107.5,105.85,44,14,30,0.318,44,38,6,0.8640000000000001,8,6,20,18,195.0,199.04,197.01999999999998
2017-01-23,1610612765,1610612758,2016,104.0,109.0,213.0,100.85,105.95,97.75,101.5,45,21,24,0.467,43,16,27,0.3720000000000001,12,9,8,8,206.0,207.08,206.54000000000002
2017-01-23,1610612749,1610612745,2016,127.0,114.0,241.0,99.8,108.15,112.7,109.85,43,20,23,0.465,47,34,13,0.723,12,8,17,17,200.48,216.24,208.36
2017-01-23,1610612740,1610612739,2016,124.0,122.0,246.0,100.45,104.8,101.9,101.55,44,17,27,0.386,42,30,12,0.7140000000000001,11,6,19,11,200.8,195.48,198.14
2017-01-23,1610612754,1610612752,2016,103.0,109.0,212.0,92.05,92.25,101.2,97.2,43,22,21,0.512,45,19,26,0.422,16,6,12,7,187.28,200.28,193.78
2017-01-23,1610612762,1610612760,2016,95.0,97.0,192.0,95.55,106.55,101.8,103.4,45,29,16,0.644,44,25,19,0.568,16,13,15,10,200.2,210.36,205.28
2017-01-22,1610612753,1610612744,2016,98.0,118.0,216.0,96.55,103.5,107.5,105.85,45,18,27,0.4,43,37,6,0.86,8,10,20,17,203.64,199.04,201.33999999999997
2017-01-22,1610612742,1610612747,2016,122.0,73.0,195.0,104.45,102.7,107.3,114.65,43,14,29,0.326,47,16,31,0.34,8,6,11,5,213.0,219.28,216.14
2017-01-22,1610612761,1610612756,2016,103.0,115.0,218.0,100.6,99.2,106.25,103.85,43,28,15,0.6509999999999999,43,14,29,0.326,15,13,8,6,206.0,212.88,209.44
2017-01-22,1610612750,1610612743,2016,111.0,108.0,219.0,110.05,111.2,109.2,110.3,43,15,28,0.349,42,18,24,0.429,9,6,10,8,209.4,217.04,213.22
2017-01-21,1610612738,1610612757,2016,123.0,127.0,250.0,99.65,105.5,104.75,105.45,42,26,16,0.619,45,18,27,0.4,13,13,11,7,195.08,209.44,202.26
2017-01-21,1610612765,1610612764,2016,113.0,112.0,225.0,100.85,105.95,94.7,91.35,44,20,24,0.455,42,23,19,0.5479999999999999,11,9,18,5,206.0,193.0,199.5
2017-01-21,1610612766,1610612751,2016,112.0,105.0,217.0,99.45,97.7,96.7,98.4,43,22,21,0.512,42,9,33,0.214,14,8,7,2,194.96,196.96,195.96
2017-01-21,1610612737,1610612755,2016,110.0,93.0,203.0,96.35,95.7,97.85,106.0,43,25,18,0.581,41,15,26,0.366,12,13,10,5,199.44,207.68,203.56
2017-01-21,1610612752,1610612756,2016,105.0,107.0,212.0,101.2,97.2,106.25,103.85,44,19,25,0.4320000000000001,42,13,29,0.31,12,7,8,5,200.28,212.88,206.57999999999998
2017-01-21,1610612748,1610612749,2016,109.0,97.0,206.0,97.25,95.5,99.8,108.15,43,13,30,0.302,42,20,22,0.476,7,6,12,8,195.0,200.48,197.74
2017-01-21,1610612763,1610612745,2016,95.0,119.0,214.0,98.25,97.5,112.7,109.85,45,26,19,0.578,46,33,13,0.7170000000000001,15,11,17,16,193.96,216.24,205.10000000000002
2017-01-21,1610612739,1610612759,2016,115.0,118.0,233.0,101.9,101.55,107.75,96.55,41,30,11,0.732,42,33,9,0.7859999999999999,19,11,16,17,195.48,204.12,199.8
2017-01-21,1610612743,1610612746,2016,123.0,98.0,221.0,109.2,110.3,109.85,106.5,41,17,24,0.415,44,29,15,0.659,9,8,17,12,217.04,214.36,215.7
2017-01-21,1610612762,1610612754,2016,109.0,100.0,209.0,95.55,106.55,92.05,92.25,44,28,16,0.636,42,22,20,0.524,15,13,16,6,200.2,187.28,193.74
2017-01-21,1610612741,1610612758,2016,102.0,99.0,201.0,94.0,91.0,97.75,101.5,44,21,23,0.477,42,16,26,0.381,13,8,8,8,185.44,207.08,196.26
2017-01-20,1610612755,1610612757,2016,93.0,92.0,185.0,97.85,106.0,104.75,105.45,40,14,26,0.35,44,18,26,0.409,9,5,11,7,207.68,209.44,208.56
2017-01-20,1610612766,1610612761,2016,113.0,78.0,191.0,99.45,97.7,100.6,99.2,42,21,21,0.5,42,28,14,0.667,13,8,15,13,194.96,206.0,200.48000000000002
2017-01-20,1610612753,1610612749,2016,112.0,96.0,208.0,96.55,103.5,99.8,108.15,44,17,27,0.386,41,20,21,0.488,7,10,12,8,203.64,200.48,202.06
2017-01-20,1610612763,1610612758,2016,107.0,91.0,198.0,98.25,97.5,97.75,101.5,44,25,19,0.568,41,16,25,0.39,14,11,8,8,193.96,207.08,200.52
2017-01-20,1610612740,1610612751,2016,114.0,143.0,257.0,100.45,104.8,96.7,98.4,43,17,26,0.395,41,8,33,0.195,11,6,7,1,200.8,196.96,198.88
2017-01-20,1610612745,1610612744,2016,108.0,125.0,233.0,112.7,109.85,107.5,105.85,45,33,12,0.733,42,36,6,0.857,17,16,20,16,216.24,199.04,207.64
2017-01-20,1610612737,1610612741,2016,102.0,93.0,195.0,96.35,95.7,94.0,91.0,42,24,18,0.5710000000000001,43,21,22,0.488,11,13,13,8,199.44,185.44,192.44
2017-01-20,1610612742,1610612762,2016,107.0,112.0,219.0,104.45,102.7,95.55,106.55,42,14,28,0.333,43,27,16,0.628,8,6,15,12,213.0,200.2,206.6
2017-01-20,1610612747,1610612754,2016,108.0,95.0,203.0,107.3,114.65,92.05,92.25,46,15,31,0.326,41,22,19,0.537,10,5,16,6,219.28,187.28,203.28
2017-01-19,1610612739,1610612756,2016,118.0,103.0,221.0,101.9,101.55,106.25,103.85,40,29,11,0.725,41,13,28,0.317,18,11,8,5,195.48,212.88,204.18
2017-01-19,1610612748,1610612742,2016,99.0,95.0,194.0,97.25,95.5,104.45,102.7,42,12,30,0.28600000000000003,41,14,27,0.341,6,6,8,6,195.0,213.0,204.0
2017-01-19,1610612752,1610612764,2016,110.0,113.0,223.0,101.2,97.2,94.7,91.35,43,19,24,0.442,41,22,19,0.537,12,7,18,4,200.28,193.0,196.64
2017-01-19,1610612759,1610612743,2016,118.0,104.0,222.0,107.75,96.55,109.2,110.3,41,32,9,0.78,40,17,23,0.425,15,17,9,8,204.12,217.04,210.57999999999998
2017-01-19,1610612746,1610612750,2016,101.0,104.0,205.0,109.85,106.5,110.05,111.2,43,29,14,0.674,42,14,28,0.333,17,12,9,5,214.36,209.4,211.88
2017-01-18,1610612755,1610612761,2016,94.0,89.0,183.0,97.85,106.0,100.6,99.2,39,13,26,0.333,41,28,13,0.6829999999999999,8,5,15,13,207.68,206.0,206.84
2017-01-18,1610612764,1610612763,2016,104.0,101.0,205.0,94.7,91.35,98.25,97.5,40,21,19,0.525,43,25,18,0.581,17,4,14,11,193.0,193.96,193.48000000000002
2017-01-18,1610612766,1610612757,2016,107.0,85.0,192.0,99.45,97.7,104.75,105.45,41,20,21,0.488,43,18,25,0.419,12,8,11,7,194.96,209.44,202.2
2017-01-18,1610612738,1610612752,2016,106.0,117.0,223.0,99.65,105.5,101.2,97.2,41,26,15,0.634,42,18,24,0.429,13,13,12,6,195.08,200.28,197.68
2017-01-18,1610612740,1610612753,2016,118.0,98.0,216.0,100.45,104.8,96.55,103.5,42,16,26,0.381,43,17,26,0.395,10,6,7,10,200.8,203.64,202.22
2017-01-18,1610612745,1610612749,2016,111.0,92.0,203.0,112.7,109.85,99.8,108.15,44,32,12,0.727,40,20,20,0.5,16,16,12,8,216.24,200.48,208.36
2017-01-18,1610612765,1610612737,2016,118.0,95.0,213.0,100.85,105.95,96.35,95.7,43,19,24,0.442,41,24,17,0.585,10,9,11,13,206.0,199.44,202.72
2017-01-18,1610612744,1610612760,2016,121.0,100.0,221.0,107.5,105.85,101.8,103.4,41,35,6,0.8540000000000001,43,25,18,0.581,19,16,15,10,199.04,210.36,204.7
2017-01-18,1610612758,1610612754,2016,100.0,106.0,206.0,97.75,101.5,92.05,92.25,40,16,24,0.4,40,21,19,0.525,8,8,16,5,207.08,187.28,197.18
2017-01-17,1610612751,1610612761,2016,109.0,119.0,228.0,96.7,98.4,100.6,99.2,40,8,32,0.2,40,27,13,0.675,7,1,15,12,196.96,206.0,201.48000000000002
2017-01-17,1610612748,1610612745,2016,109.0,103.0,212.0,97.25,95.5,112.7,109.85,41,11,30,0.268,43,32,11,0.7440000000000001,5,6,16,16,195.0,216.24,205.62
2017-01-17,1610612741,1610612742,2016,98.0,99.0,197.0,94.0,91.0,104.45,102.7,42,21,21,0.5,40,13,27,0.325,13,8,8,5,185.44,213.0,199.22
2017-01-17,1610612759,1610612750,2016,122.0,114.0,236.0,107.75,96.55,110.05,111.2,40,31,9,0.775,41,14,27,0.341,14,17,9,5,204.12,209.4,206.76
2017-01-17,1610612747,1610612743,2016,121.0,127.0,248.0,107.3,114.65,109.2,110.3,45,15,30,0.333,39,16,23,0.41,10,5,9,7,219.28,217.04,218.16
2017-01-16,1610612752,1610612737,2016,107.0,108.0,215.0,101.2,97.2,96.35,95.7,41,18,23,0.439,40,23,17,0.575,12,6,11,12,200.28,199.44,199.86
2017-01-16,1610612764,1610612757,2016,120.0,101.0,221.0,94.7,91.35,104.75,105.45,39,20,19,0.513,42,18,24,0.429,16,4,11,7,193.0,209.44,201.22
2017-01-16,1610612749,1610612755,2016,104.0,113.0,217.0,99.8,108.15,97.85,106.0,39,20,19,0.513,38,12,26,0.316,12,8,8,4,200.48,207.68,204.07999999999998
2017-01-16,1610612754,1610612740,2016,98.0,95.0,193.0,92.05,92.25,100.45,104.8,39,20,19,0.513,41,16,25,0.39,15,5,10,6,187.28,200.8,194.04000000000002
2017-01-16,1610612743,1610612753,2016,125.0,112.0,237.0,109.2,110.3,96.55,103.5,38,15,23,0.395,42,17,25,0.405,8,7,7,10,217.04,203.64,210.33999999999997
2017-01-16,1610612738,1610612766,2016,108.0,98.0,206.0,99.65,105.5,99.45,97.7,40,25,15,0.625,40,20,20,0.5,12,13,12,8,195.08,194.96,195.02
2017-01-16,1610612744,1610612739,2016,126.0,91.0,217.0,107.5,105.85,101.9,101.55,40,34,6,0.85,39,29,10,0.7440000000000001,18,16,18,11,199.04,195.48,197.26
2017-01-16,1610612756,1610612762,2016,101.0,106.0,207.0,106.25,103.85,95.55,106.55,40,13,27,0.325,42,26,16,0.619,8,5,15,11,212.88,200.2,206.54
2017-01-16,1610612746,1610612760,2016,120.0,98.0,218.0,109.85,106.5,101.8,103.4,42,28,14,0.667,42,25,17,0.595,16,12,15,10,214.36,210.36,212.36
2017-01-15,1610612742,1610612750,2016,98.0,87.0,185.0,104.45,102.7,110.05,111.2,39,12,27,0.308,40,14,26,0.35,7,5,9,5,213.0,209.4,211.2
2017-01-15,1610612761,1610612752,2016,116.0,101.0,217.0,100.6,99.2,101.2,97.2,39,26,13,0.667,40,18,22,0.45,14,12,12,6,206.0,200.28,203.14
2017-01-15,1610612737,1610612749,2016,111.0,98.0,209.0,96.35,95.7,99.8,108.15,39,22,17,0.564,38,20,18,0.526,10,12,12,8,199.44,200.48,199.95999999999998
2017-01-15,1610612751,1610612745,2016,112.0,137.0,249.0,96.7,98.4,112.7,109.85,39,8,31,0.205,42,31,11,0.738,7,1,16,15,196.96,216.24,206.60000000000002
2017-01-15,1610612758,1610612760,2016,118.0,122.0,240.0,97.75,101.5,101.8,103.4,39,16,23,0.41,41,24,17,0.585,8,8,15,9,207.08,210.36,208.72000000000003
2017-01-15,1610612763,1610612741,2016,104.0,108.0,212.0,98.25,97.5,94.0,91.0,42,25,17,0.595,41,20,21,0.488,14,11,13,7,193.96,185.44,189.7
2017-01-15,1610612747,1610612765,2016,97.0,102.0,199.0,107.3,114.65,100.85,105.95,44,15,29,0.341,42,18,24,0.429,10,5,10,8,219.28,206.0,212.64
2017-01-14,1610612746,1610612747,2016,113.0,97.0,210.0,109.85,106.5,107.3,114.65,41,27,14,0.659,43,15,28,0.349,15,12,10,5,214.36,219.28,216.82
2017-01-14,1610612741,1610612740,2016,107.0,99.0,206.0,94.0,91.0,100.45,104.8,40,19,21,0.475,40,16,24,0.4,12,7,10,6,185.44,200.8,193.12
2017-01-14,1610612756,1610612759,2016,108.0,105.0,213.0,106.25,103.85,107.75,96.55,39,12,27,0.308,39,31,8,0.795,7,5,14,17,212.88,204.12,208.5
2017-01-14,1610612764,1610612755,2016,109.0,93.0,202.0,94.7,91.35,97.85,106.0,38,19,19,0.5,37,12,25,0.324,15,4,8,4,193.0,207.68,200.34
2017-01-14,1610612762,1610612753,2016,114.0,107.0,221.0,95.55,106.55,96.55,103.5,41,25,16,0.61,41,17,24,0.415,14,11,7,10,200.2,203.64,201.92
2017-01-13,1610612755,1610612766,2016,102.0,93.0,195.0,97.85,106.0,99.45,97.7,36,11,25,0.306,39,20,19,0.513,7,4,12,8,207.68,194.96,201.32
2017-01-13,1610612761,1610612751,2016,132.0,113.0,245.0,100.6,99.2,96.7,98.4,38,25,13,0.6579999999999999,38,8,30,0.211,13,12,7,1,206.0,196.96,201.48000000000002
2017-01-13,1610612749,1610612748,2016,116.0,108.0,224.0,99.8,108.15,97.25,95.5,37,19,18,0.514,40,11,29,0.275,11,8,5,6,200.48,195.0,197.74
2017-01-13,1610612745,1610612763,2016,105.0,110.0,215.0,112.7,109.85,98.25,97.5,41,31,10,0.7559999999999999,41,24,17,0.585,16,15,14,10,216.24,193.96,205.10000000000002
2017-01-13,1610612750,1610612760,2016,96.0,86.0,182.0,110.05,111.2,101.8,103.4,39,13,26,0.333,40,24,16,0.6,8,5,15,9,209.4,210.36,209.88
2017-01-13,1610612737,1610612738,2016,101.0,103.0,204.0,96.35,95.7,99.65,105.5,38,22,16,0.579,39,24,15,0.615,10,12,12,12,199.44,195.08,197.26
2017-01-13,1610612757,1610612753,2016,109.0,115.0,224.0,104.75,105.45,96.55,103.5,41,18,23,0.439,40,16,24,0.4,11,7,7,9,209.44,203.64,206.54
2017-01-13,1610612758,1610612739,2016,108.0,120.0,228.0,97.75,101.5,101.9,101.55,38,16,22,0.421,38,28,10,0.737,8,8,18,10,207.08,195.48,201.28
2017-01-13,1610612762,1610612765,2016,110.0,77.0,187.0,95.55,106.55,100.85,105.95,40,24,16,0.6,41,18,23,0.439,13,11,10,8,200.2,206.0,203.1
2017-01-12,1610612743,1610612754,2016,140.0,112.0,252.0,109.2,110.3,92.05,92.25,37,14,23,0.378,38,20,18,0.526,7,7,15,5,217.04,187.28,202.16
2017-01-12,1610612751,1610612740,2016,95.0,104.0,199.0,96.7,98.4,100.45,104.8,37,8,29,0.21600000000000005,39,15,24,0.385,7,1,10,5,196.96,200.8,198.88
2017-01-12,1610612752,1610612741,2016,104.0,89.0,193.0,101.2,97.2,94.0,91.0,39,17,22,0.436,39,19,20,0.487,11,6,12,7,200.28,185.44,192.86
2017-01-12,1610612759,1610612747,2016,134.0,94.0,228.0,107.75,96.55,107.3,114.65,38,30,8,0.789,42,15,27,0.35700000000000004,13,17,10,5,204.12,219.28,211.7
2017-01-12,1610612756,1610612742,2016,108.0,113.0,221.0,106.25,103.85,104.45,102.7,38,12,26,0.316,38,11,27,0.289,7,5,7,4,212.88,213.0,212.94
2017-01-12,1610612744,1610612765,2016,127.0,107.0,234.0,107.5,105.85,100.85,105.95,39,33,6,0.846,40,18,22,0.45,17,16,10,8,199.04,206.0,202.51999999999998
2017-01-11,1610612755,1610612752,2016,98.0,97.0,195.0,97.85,106.0,101.2,97.2,35,10,25,0.28600000000000003,38,17,21,0.447,6,4,11,6,207.68,200.28,203.98000000000002
2017-01-11,1610612760,1610612763,2016,103.0,95.0,198.0,101.8,103.4,98.25,97.5,39,23,16,0.59,40,24,16,0.6,14,9,14,10,210.36,193.96,202.16000000000003
2017-01-11,1610612750,1610612745,2016,119.0,105.0,224.0,110.05,111.2,112.7,109.85,38,12,26,0.316,40,31,9,0.775,7,5,16,15,209.4,216.24,212.82
2017-01-11,1610612738,1610612764,2016,117.0,108.0,225.0,99.65,105.5,94.7,91.35,38,23,15,0.605,37,19,18,0.514,11,12,15,4,195.08,193.0,194.04000000000002
2017-01-11,1610612746,1610612753,2016,105.0,96.0,201.0,109.85,106.5,96.55,103.5,40,26,14,0.65,39,16,23,0.41,14,12,7,9,214.36,203.64,209.0
2017-01-11,1610612757,1610612739,2016,102.0,86.0,188.0,104.75,105.45,101.9,101.55,40,17,23,0.425,37,28,9,0.757,10,7,18,10,209.44,195.48,202.45999999999998
2017-01-10,1610612764,1610612741,2016,101.0,99.0,200.0,94.7,91.35,94.0,91.0,36,18,18,0.5,38,19,19,0.5,14,4,12,7,193.0,185.44,189.22
2017-01-10,1610612761,1610612738,2016,114.0,106.0,220.0,100.6,99.2,99.65,105.5,37,24,13,0.649,37,23,14,0.622,12,12,11,12,206.0,195.08,200.54000000000002
2017-01-10,1610612751,1610612737,2016,97.0,117.0,214.0,96.7,98.4,96.35,95.7,36,8,28,0.222,37,21,16,0.568,7,1,10,11,196.96,199.44,198.2
2017-01-10,1610612745,1610612766,2016,121.0,114.0,235.0,112.7,109.85,99.45,97.7,39,30,9,0.769,38,20,18,0.526,15,15,12,8,216.24,194.96,205.60000000000002
2017-01-10,1610612759,1610612749,2016,107.0,109.0,216.0,107.75,96.55,99.8,108.15,37,30,7,0.8109999999999999,36,18,18,0.5,13,17,11,7,204.12,200.48,202.3
2017-01-10,1610612762,1610612739,2016,100.0,92.0,192.0,95.55,106.55,101.9,101.55,39,23,16,0.59,36,28,8,0.778,12,11,18,10,200.2,195.48,197.83999999999997
2017-01-10,1610612747,1610612757,2016,87.0,108.0,195.0,107.3,114.65,104.75,105.45,41,15,26,0.366,39,16,23,0.41,10,5,10,6,219.28,209.44,214.36
2017-01-10,1610612744,1610612748,2016,107.0,95.0,202.0,107.5,105.85,97.25,95.5,38,32,6,0.8420000000000001,39,11,28,0.282,16,16,5,6,199.04,195.0,197.01999999999998
2017-01-10,1610612758,1610612765,2016,100.0,94.0,194.0,97.75,101.5,100.85,105.95,37,15,22,0.405,39,18,21,0.462,7,8,10,8,207.08,206.0,206.54000000000002
2017-01-09,1610612752,1610612740,2016,96.0,110.0,206.0,101.2,97.2,100.45,104.8,37,17,20,0.459,38,14,24,0.368,11,6,10,4,200.28,200.8,200.54000000000002
2017-01-09,1610612741,1610612760,2016,94.0,109.0,203.0,94.0,91.0,101.8,103.4,37,19,18,0.514,38,22,16,0.579,12,7,14,8,185.44,210.36,197.9
2017-01-09,1610612750,1610612742,2016,101.0,92.0,193.0,110.05,111.2,104.45,102.7,37,11,26,0.297,37,11,26,0.297,6,5,7,4,209.4,213.0,211.2
2017-01-08,1610612751,1610612755,2016,95.0,105.0,200.0,96.7,98.4,97.85,106.0,35,8,27,0.229,34,9,25,0.265,7,1,6,3,196.96,207.68,202.32
2017-01-08,1610612749,1610612764,2016,101.0,107.0,208.0,99.8,108.15,94.7,91.35,35,18,17,0.514,35,17,18,0.486,11,7,14,3,200.48,193.0,196.74
2017-01-08,1610612746,1610612748,2016,98.0,86.0,184.0,109.85,106.5,97.25,95.5,39,25,14,0.6409999999999999,38,11,27,0.289,13,12,5,6,214.36,195.0,204.68
2017-01-08,1610612761,1610612745,2016,122.0,129.0,251.0,100.6,99.2,112.7,109.85,36,24,12,0.667,38,29,9,0.763,12,12,15,14,206.0,216.24,211.12
2017-01-08,1610612763,1610612762,2016,88.0,79.0,167.0,98.25,97.5,95.55,106.55,39,23,16,0.59,38,23,15,0.605,13,10,12,11,193.96,200.2,197.07999999999998
2017-01-08,1610612756,1610612739,2016,116.0,120.0,236.0,106.25,103.85,101.9,101.55,37,12,25,0.324,35,27,8,0.7709999999999999,7,5,18,9,212.88,195.48,204.18
2017-01-08,1610612757,1610612765,2016,124.0,125.0,249.0,104.75,105.45,100.85,105.95,38,16,22,0.421,38,17,21,0.447,10,6,10,7,209.44,206.0,207.72
2017-01-08,1610612758,1610612744,2016,106.0,117.0,223.0,97.75,101.5,107.5,105.85,36,15,21,0.417,37,31,6,0.838,7,8,16,15,207.08,199.04,203.06
2017-01-08,1610612747,1610612753,2016,111.0,95.0,206.0,107.3,114.65,96.55,103.5,40,14,26,0.35,38,16,22,0.421,9,5,7,9,219.28,203.64,211.45999999999998
2017-01-07,1610612754,1610612752,2016,123.0,109.0,232.0,92.05,92.25,101.2,97.2,37,19,18,0.514,36,17,19,0.472,14,5,11,6,187.28,200.28,193.78
2017-01-07,1610612738,1610612740,2016,117.0,108.0,225.0,99.65,105.5,100.45,104.8,36,22,14,0.611,37,14,23,0.378,10,12,10,4,195.08,200.8,197.94
2017-01-07,1610612741,1610612761,2016,123.0,118.0,241.0,94.0,91.0,100.6,99.2,36,18,18,0.5,35,24,11,0.6859999999999999,11,7,12,12,185.44,206.0,195.72
2017-01-07,1610612760,1610612743,2016,121.0,106.0,227.0,101.8,103.4,109.2,110.3,37,21,16,0.568,36,14,22,0.389,13,8,7,7,210.36,217.04,213.7
2017-01-07,1610612750,1610612762,2016,92.0,94.0,186.0,110.05,111.2,95.55,106.55,36,11,25,0.306,37,22,15,0.595,6,5,12,10,209.4,200.2,204.8
2017-01-07,1610612742,1610612737,2016,82.0,97.0,179.0,104.45,102.7,96.35,95.7,36,11,25,0.306,36,20,16,0.556,7,4,10,10,213.0,199.44,206.22
2017-01-07,1610612759,1610612766,2016,102.0,85.0,187.0,107.75,96.55,99.45,97.7,36,29,7,0.8059999999999999,37,20,17,0.541,12,17,12,8,204.12,194.96,199.54000000000002
2017-01-06,1610612764,1610612750,2016,112.0,105.0,217.0,94.7,91.35,110.05,111.2,34,16,18,0.471,35,11,24,0.314,13,3,6,5,193.0,209.4,201.2
2017-01-06,1610612753,1610612745,2016,93.0,100.0,193.0,96.55,103.5,112.7,109.85,37,16,21,0.4320000000000001,37,28,9,0.757,7,9,15,13,203.64,216.24,209.94
2017-01-06,1610612738,1610612755,2016,110.0,106.0,216.0,99.65,105.5,97.85,106.0,35,21,14,0.6,33,9,24,0.273,9,12,6,3,195.08,207.68,201.38
2017-01-06,1610612751,1610612739,2016,108.0,116.0,224.0,96.7,98.4,101.9,101.55,34,8,26,0.235,34,26,8,0.765,7,1,18,8,196.96,195.48,196.22
2017-01-06,1610612749,1610612752,2016,111.0,116.0,227.0,99.8,108.15,101.2,97.2,34,18,16,0.529,35,16,19,0.457,11,7,11,5,200.48,200.28,200.38
2017-01-06,1610612747,1610612748,2016,127.0,100.0,227.0,107.3,114.65,97.25,95.5,39,13,26,0.333,37,11,26,0.297,8,5,5,6,219.28,195.0,207.14
2017-01-06,1610612744,1610612763,2016,119.0,128.0,247.0,107.5,105.85,98.25,97.5,36,31,5,0.861,38,22,16,0.579,16,15,13,9,199.04,193.96,196.5
2017-01-06,1610612758,1610612746,2016,98.0,106.0,204.0,97.75,101.5,109.85,106.5,35,15,20,0.429,38,24,14,0.632,7,8,13,11,207.08,214.36,210.72000000000003
2017-01-05,1610612754,1610612751,2016,121.0,109.0,230.0,92.05,92.25,96.7,98.4,36,18,18,0.5,33,8,25,0.242,13,5,7,1,187.28,196.96,192.12
2017-01-05,1610612761,1610612762,2016,101.0,93.0,194.0,100.6,99.2,95.55,106.55,34,23,11,0.6759999999999999,36,22,14,0.611,11,12,12,10,206.0,200.2,203.1
2017-01-05,1610612765,1610612766,2016,115.0,114.0,229.0,100.85,105.95,99.45,97.7,37,16,21,0.4320000000000001,36,20,16,0.556,9,7,12,8,206.0,194.96,200.48000000000002
2017-01-05,1610612740,1610612737,2016,94.0,99.0,193.0,100.45,104.8,96.35,95.7,36,14,22,0.389,35,19,16,0.5429999999999999,10,4,10,9,200.8,199.44,200.12
2017-01-05,1610612745,1610612760,2016,118.0,116.0,234.0,112.7,109.85,101.8,103.4,36,27,9,0.75,36,21,15,0.583,14,13,13,8,216.24,210.36,213.3
2017-01-05,1610612742,1610612756,2016,95.0,102.0,197.0,104.45,102.7,106.25,103.85,35,11,24,0.314,36,11,25,0.306,7,4,7,4,213.0,212.88,212.94
2017-01-05,1610612743,1610612759,2016,99.0,127.0,226.0,109.2,110.3,107.75,96.55,35,14,21,0.4,35,28,7,0.8,7,7,12,16,217.04,204.12,210.57999999999998
2017-01-05,1610612757,1610612747,2016,118.0,109.0,227.0,104.75,105.45,107.3,114.65,37,15,22,0.405,38,13,25,0.342,9,6,8,5,209.44,219.28,214.36
2017-01-04,1610612766,1610612760,2016,123.0,112.0,235.0,99.45,97.7,101.8,103.4,35,19,16,0.5429999999999999,35,21,14,0.6,11,8,13,8,194.96,210.36,202.66000000000003
2017-01-04,1610612753,1610612737,2016,92.0,111.0,203.0,96.55,103.5,96.35,95.7,36,16,20,0.444,34,18,16,0.529,7,9,10,8,203.64,199.44,201.54
2017-01-04,1610612752,1610612749,2016,104.0,105.0,209.0,101.2,97.2,99.8,108.15,34,16,18,0.471,33,17,16,0.515,11,5,11,6,200.28,200.48,200.38
2017-01-04,1610612739,1610612741,2016,94.0,106.0,200.0,101.9,101.55,94.0,91.0,33,26,7,0.7879999999999999,35,17,18,0.486,18,8,11,6,195.48,185.44,190.45999999999998
2017-01-04,1610612746,1610612763,2016,115.0,106.0,221.0,109.85,106.5,98.25,97.5,37,23,14,0.622,37,22,15,0.595,12,11,13,9,214.36,193.96,204.16000000000003
2017-01-04,1610612744,1610612757,2016,125.0,117.0,242.0,107.5,105.85,104.75,105.45,35,30,5,0.857,36,15,21,0.417,15,15,9,6,199.04,209.44,204.24
2017-01-04,1610612758,1610612748,2016,102.0,107.0,209.0,97.75,101.5,97.25,95.5,34,15,19,0.441,36,10,26,0.278,7,8,5,5,207.08,195.0,201.04000000000002
2017-01-03,1610612755,1610612750,2016,93.0,91.0,184.0,97.85,106.0,110.05,111.2,32,8,24,0.25,34,11,23,0.324,5,3,6,5,207.68,209.4,208.54000000000002
2017-01-03,1610612738,1610612762,2016,115.0,104.0,219.0,99.65,105.5,95.55,106.55,34,20,14,0.588,35,22,13,0.629,8,12,12,10,195.08,200.2,197.64
2017-01-03,1610612765,1610612754,2016,116.0,121.0,237.0,100.85,105.95,92.05,92.25,36,16,20,0.444,35,17,18,0.486,9,7,13,4,206.0,187.28,196.64
2017-01-03,1610612742,1610612764,2016,113.0,105.0,218.0,104.45,102.7,94.7,91.35,34,10,24,0.294,33,16,17,0.485,6,4,13,3,213.0,193.0,203.0
2017-01-03,1610612759,1610612761,2016,110.0,82.0,192.0,107.75,96.55,100.6,99.2,34,27,7,0.794,33,23,10,0.6970000000000001,11,16,11,12,204.12,206.0,205.06
2017-01-03,1610612743,1610612758,2016,113.0,120.0,233.0,109.2,110.3,97.75,101.5,34,14,20,0.412,33,14,19,0.424,7,7,7,7,217.04,207.08,212.06
2017-01-03,1610612756,1610612748,2016,99.0,90.0,189.0,106.25,103.85,97.25,95.5,35,10,25,0.28600000000000003,35,10,25,0.28600000000000003,6,4,5,5,212.88,195.0,203.94
2017-01-03,1610612747,1610612763,2016,116.0,102.0,218.0,107.3,114.65,98.25,97.5,37,12,25,0.324,36,22,14,0.611,7,5,13,9,219.28,193.96,206.62
2017-01-02,1610612749,1610612760,2016,98.0,94.0,192.0,99.8,108.15,101.8,103.4,32,16,16,0.5,34,21,13,0.618,10,6,13,8,200.48,210.36,205.42000000000002
2017-01-02,1610612739,1610612740,2016,90.0,82.0,172.0,101.9,101.55,100.45,104.8,32,25,7,0.7809999999999999,35,14,21,0.4,17,8,10,4,195.48,200.8,198.14
2017-01-02,1610612751,1610612762,2016,89.0,101.0,190.0,96.7,98.4,95.55,106.55,32,8,24,0.25,34,21,13,0.618,7,1,12,9,196.96,200.2,198.57999999999998
2017-01-02,1610612752,1610612753,2016,103.0,115.0,218.0,101.2,97.2,96.55,103.5,33,16,17,0.485,35,15,20,0.429,11,5,7,8,200.28,203.64,201.95999999999998
2017-01-02,1610612741,1610612766,2016,118.0,111.0,229.0,94.0,91.0,99.45,97.7,34,16,18,0.471,34,19,15,0.5589999999999999,10,6,11,8,185.44,194.96,190.2
2017-01-02,1610612745,1610612764,2016,101.0,91.0,192.0,112.7,109.85,94.7,91.35,35,26,9,0.743,32,16,16,0.5,13,13,13,3,216.24,193.0,204.62
2017-01-02,1610612746,1610612756,2016,109.0,98.0,207.0,109.85,106.5,106.25,103.85,36,22,14,0.611,34,10,24,0.294,11,11,6,4,214.36,212.88,213.62
2017-01-02,1610612744,1610612743,2016,127.0,119.0,246.0,107.5,105.85,109.2,110.3,34,29,5,0.853,33,14,19,0.424,14,15,7,7,199.04,217.04,208.04
2017-01-01,1610612737,1610612759,2016,114.0,112.0,226.0,96.35,95.7,107.75,96.55,33,17,16,0.515,33,27,6,0.818,9,8,11,16,199.44,204.12,201.78
2017-01-01,1610612748,1610612765,2016,98.0,107.0,205.0,97.25,95.5,100.85,105.95,34,10,24,0.294,35,15,20,0.429,5,5,9,6,195.0,206.0,200.5
2017-01-01,1610612754,1610612753,2016,117.0,104.0,221.0,92.05,92.25,96.55,103.5,34,16,18,0.471,34,15,19,0.441,12,4,7,8,187.28,203.64,195.45999999999998
2017-01-01,1610612750,1610612757,2016,89.0,95.0,184.0,110.05,111.2,104.75,105.45,33,11,22,0.333,35,14,21,0.4,6,5,9,5,209.4,209.44,209.42000000000002
2017-01-01,1610612747,1610612761,2016,114.0,123.0,237.0,107.3,114.65,100.6,99.2,36,12,24,0.333,32,22,10,0.688,7,5,11,11,219.28,206.0,212.64
2016-12-31,1610612758,1610612763,2016,98.0,112.0,210.0,97.75,101.5,98.25,97.5,32,14,18,0.438,35,21,14,0.6,7,7,13,8,207.08,193.96,200.52
2016-12-31,1610612741,1610612749,2016,96.0,116.0,212.0,94.0,91.0,99.8,108.15,33,16,17,0.485,31,15,16,0.484,10,6,10,5,185.44,200.48,192.95999999999998
2016-12-31,1610612766,1610612739,2016,109.0,121.0,230.0,99.45,97.7,101.9,101.55,33,19,14,0.5760000000000001,31,24,7,0.774,11,8,17,7,194.96,195.48,195.22
2016-12-31,1610612745,1610612752,2016,129.0,122.0,251.0,112.7,109.85,101.2,97.2,34,25,9,0.735,32,16,16,0.5,12,13,11,5,216.24,200.28,208.26
2016-12-31,1610612762,1610612756,2016,91.0,86.0,177.0,95.55,106.55,106.25,103.85,33,20,13,0.606,33,10,23,0.303,11,9,6,4,200.2,212.88,206.54
2016-12-31,1610612760,1610612746,2016,114.0,88.0,202.0,101.8,103.4,109.85,106.5,33,20,13,0.606,35,22,13,0.629,12,8,11,11,210.36,214.36,212.36
2016-12-30,1610612754,1610612741,2016,111.0,101.0,212.0,92.05,92.25,94.0,91.0,33,15,18,0.455,32,16,16,0.5,11,4,10,6,187.28,185.44,186.36
2016-12-30,1610612764,1610612751,2016,118.0,95.0,213.0,94.7,91.35,96.7,98.4,31,15,16,0.484,31,8,23,0.258,12,3,7,1,193.0,196.96,194.98000000000002
2016-12-30,1610612738,1610612748,2016,117.0,114.0,231.0,99.65,105.5,97.25,95.5,33,19,14,0.5760000000000001,33,10,23,0.303,7,12,5,5,195.08,195.0,195.04000000000002
2016-12-30,1610612740,1610612752,2016,104.0,92.0,196.0,100.45,104.8,101.2,97.2,34,13,21,0.382,31,16,15,0.516,9,4,11,5,200.8,200.28,200.54000000000002
2016-12-30,1610612745,1610612746,2016,140.0,116.0,256.0,112.7,109.85,109.85,106.5,33,24,9,0.727,34,22,12,0.647,11,13,11,11,216.24,214.36,215.3
2016-12-30,1610612750,1610612749,2016,116.0,99.0,215.0,110.05,111.2,99.8,108.15,32,10,22,0.313,30,15,15,0.5,5,5,10,5,209.4,200.48,204.94
2016-12-30,1610612737,1610612765,2016,105.0,98.0,203.0,96.35,95.7,100.85,105.95,32,16,16,0.5,34,15,19,0.441,8,8,9,6,199.44,206.0,202.72
2016-12-30,1610612759,1610612757,2016,110.0,94.0,204.0,107.75,96.55,104.75,105.45,32,26,6,0.813,34,14,20,0.412,10,16,9,5,204.12,209.44,206.78
2016-12-30,1610612743,1610612755,2016,122.0,124.0,246.0,109.2,110.3,97.85,106.0,32,14,18,0.438,31,7,24,0.226,7,7,5,2,217.04,207.68,212.36
2016-12-30,1610612744,1610612742,2016,108.0,99.0,207.0,107.5,105.85,104.45,102.7,33,28,5,0.848,33,10,23,0.303,13,15,6,4,199.04,213.0,206.01999999999998
2016-12-29,1610612766,1610612748,2016,91.0,82.0,173.0,99.45,97.7,97.25,95.5,32,18,14,0.563,32,10,22,0.313,10,8,5,5,194.96,195.0,194.98000000000002
2016-12-29,1610612763,1610612760,2016,114.0,80.0,194.0,98.25,97.5,101.8,103.4,34,20,14,0.588,32,20,12,0.625,12,8,12,8,193.96,210.36,202.16000000000003
2016-12-29,1610612739,1610612738,2016,124.0,118.0,242.0,101.9,101.55,99.65,105.5,30,23,7,0.767,32,19,13,0.594,16,7,7,12,195.48,195.08,195.28
2016-12-29,1610612762,1610612755,2016,100.0,83.0,183.0,95.55,106.55,97.85,106.0,32,19,13,0.594,30,7,23,0.233,10,9,5,2,200.2,207.68,203.94
2016-12-29,1610612756,1610612761,2016,99.0,91.0,190.0,106.25,103.85,100.6,99.2,32,9,23,0.281,31,22,9,0.71,5,4,11,11,212.88,206.0,209.44
2016-12-29,1610612747,1610612742,2016,89.0,101.0,190.0,107.3,114.65,104.45,102.7,35,12,23,0.343,32,9,23,0.281,7,5,6,3,219.28,213.0,216.14
2016-12-28,1610612764,1610612754,2016,111.0,105.0,216.0,94.7,91.35,92.05,92.25,30,14,16,0.467,32,15,17,0.469,11,3,11,4,193.0,187.28,190.14
2016-12-28,1610612753,1610612766,2016,101.0,120.0,221.0,96.55,103.5,99.45,97.7,33,15,18,0.455,31,17,14,0.5479999999999999,7,8,10,7,203.64,194.96,199.3
2016-12-28,1610612737,1610612752,2016,102.0,98.0,200.0,96.35,95.7,101.2,97.2,31,15,16,0.484,30,16,14,0.5329999999999999,7,8,11,5,199.44,200.28,199.86
2016-12-28,1610612765,1610612749,2016,94.0,119.0,213.0,100.85,105.95,99.8,108.15,33,15,18,0.455,29,14,15,0.483,9,6,10,4,206.0,200.48,203.24
2016-12-28,1610612741,1610612751,2016,101.0,99.0,200.0,94.0,91.0,96.7,98.4,31,15,16,0.484,30,8,22,0.267,9,6,7,1,185.44,196.96,191.2
2016-12-28,1610612740,1610612746,2016,102.0,98.0,200.0,100.45,104.8,109.85,106.5,33,12,21,0.364,33,22,11,0.667,8,4,11,11,200.8,214.36,207.58
2016-12-28,1610612759,1610612756,2016,119.0,98.0,217.0,107.75,96.55,106.25,103.85,31,25,6,0.8059999999999999,31,9,22,0.29,9,16,5,4,204.12,212.88,208.5
2016-12-28,1610612743,1610612750,2016,105.0,103.0,208.0,109.2,110.3,110.05,111.2,31,13,18,0.419,31,10,21,0.32299999999999995,6,7,5,5,217.04,209.4,213.22
2016-12-28,1610612757,1610612758,2016,102.0,89.0,191.0,104.75,105.45,97.75,101.5,33,13,20,0.394,31,14,17,0.452,8,5,7,7,209.44,207.08,208.26
2016-12-28,1610612744,1610612761,2016,121.0,111.0,232.0,107.5,105.85,100.6,99.2,32,27,5,0.8440000000000001,30,22,8,0.733,12,15,11,11,199.04,206.0,202.51999999999998
2016-12-27,1610612738,1610612763,2016,113.0,103.0,216.0,99.65,105.5,98.25,97.5,31,18,13,0.581,33,20,13,0.606,6,12,12,8,195.08,193.96,194.52
2016-12-27,1610612748,1610612760,2016,94.0,106.0,200.0,97.25,95.5,101.8,103.4,31,10,21,0.32299999999999995,31,19,12,0.613,5,5,12,7,195.0,210.36,202.68
2016-12-27,1610612742,1610612745,2016,107.0,123.0,230.0,104.45,102.7,112.7,109.85,31,9,22,0.29,32,23,9,0.7190000000000001,6,3,11,12,213.0,216.24,214.62
2016-12-27,1610612747,1610612762,2016,100.0,102.0,202.0,107.3,114.65,95.55,106.55,34,12,22,0.353,31,18,13,0.581,7,5,10,8,219.28,200.2,209.74
2016-12-26,1610612764,1610612749,2016,107.0,102.0,209.0,94.7,91.35,99.8,108.15,29,13,16,0.448,28,14,14,0.5,10,3,10,4,193.0,200.48,196.74
2016-12-26,1610612753,1610612763,2016,112.0,102.0,214.0,96.55,103.5,98.25,97.5,32,14,18,0.438,32,20,12,0.625,6,8,12,8,203.64,193.96,198.8
2016-12-26,1610612751,1610612766,2016,120.0,118.0,238.0,96.7,98.4,99.45,97.7,29,7,22,0.241,30,17,13,0.5670000000000001,6,1,10,7,196.96,194.96,195.96
2016-12-26,1610612765,1610612739,2016,106.0,90.0,196.0,100.85,105.95,101.9,101.55,32,14,18,0.438,29,23,6,0.7929999999999999,8,6,16,7,206.0,195.48,200.74
2016-12-26,1610612741,1610612754,2016,90.0,85.0,175.0,94.0,91.0,92.05,92.25,30,14,16,0.467,31,15,16,0.484,8,6,11,4,185.44,187.28,186.36
2016-12-26,1610612740,1610612742,2016,111.0,104.0,215.0,100.45,104.8,104.45,102.7,32,11,21,0.344,30,9,21,0.3,7,4,6,3,200.8,213.0,206.9
2016-12-26,1610612745,1610612756,2016,131.0,115.0,246.0,112.7,109.85,106.25,103.85,31,22,9,0.71,30,9,21,0.3,10,12,5,4,216.24,212.88,214.56
2016-12-26,1610612750,1610612737,2016,104.0,90.0,194.0,110.05,111.2,96.35,95.7,30,9,21,0.3,30,15,15,0.5,4,5,7,8,209.4,199.44,204.42000000000002
2016-12-26,1610612757,1610612761,2016,91.0,95.0,186.0,104.75,105.45,100.6,99.2,32,13,19,0.406,29,21,8,0.7240000000000001,8,5,11,10,209.44,206.0,207.72
2016-12-26,1610612746,1610612743,2016,102.0,106.0,208.0,109.85,106.5,109.2,110.3,32,22,10,0.688,30,12,18,0.4,11,11,6,6,214.36,217.04,215.7
2016-12-26,1610612758,1610612755,2016,102.0,100.0,202.0,97.75,101.5,97.85,106.0,30,13,17,0.433,29,7,22,0.241,6,7,5,2,207.08,207.68,207.38
2016-12-25,1610612752,1610612738,2016,114.0,119.0,233.0,101.2,97.2,99.65,105.5,29,16,13,0.552,30,17,13,0.5670000000000001,11,5,6,11,200.28,195.08,197.68
2016-12-25,1610612739,1610612744,2016,109.0,108.0,217.0,101.9,101.55,107.5,105.85,28,22,6,0.7859999999999999,31,27,4,0.871,15,7,12,15,195.48,199.04,197.26
2016-12-25,1610612759,1610612741,2016,119.0,100.0,219.0,107.75,96.55,94.0,91.0,30,24,6,0.8,29,14,15,0.483,8,16,8,6,204.12,185.44,194.78
2016-12-25,1610612760,1610612750,2016,112.0,100.0,212.0,101.8,103.4,110.05,111.2,30,18,12,0.6,29,9,20,0.31,11,7,4,5,210.36,209.4,209.88
2016-12-25,1610612747,1610612746,2016,111.0,102.0,213.0,107.3,114.65,109.85,106.5,33,11,22,0.333,31,22,9,0.71,6,5,11,11,219.28,214.36,216.82
2016-12-23,1610612766,1610612741,2016,103.0,91.0,194.0,99.45,97.7,94.0,91.0,29,16,13,0.552,28,14,14,0.5,9,7,8,6,194.96,185.44,190.2
2016-12-23,1610612753,1610612747,2016,109.0,90.0,199.0,96.55,103.5,107.3,114.65,31,13,18,0.419,32,11,21,0.344,5,8,6,5,203.64,219.28,211.45999999999998
2016-12-23,1610612739,1610612751,2016,119.0,99.0,218.0,101.9,101.55,96.7,98.4,27,21,6,0.778,28,7,21,0.25,14,7,6,1,195.48,196.96,196.22
2016-12-23,1610612738,1610612760,2016,112.0,117.0,229.0,99.65,105.5,101.8,103.4,29,17,12,0.586,29,17,12,0.586,6,11,11,6,195.08,210.36,202.72000000000003
2016-12-23,1610612765,1610612744,2016,113.0,119.0,232.0,100.85,105.95,107.5,105.85,31,14,17,0.452,30,26,4,0.867,8,6,12,14,206.0,199.04,202.51999999999998
2016-12-23,1610612749,1610612764,2016,123.0,96.0,219.0,99.8,108.15,94.7,91.35,27,13,14,0.481,28,13,15,0.464,9,4,10,3,200.48,193.0,196.74
2016-12-23,1610612763,1610612745,2016,115.0,109.0,224.0,98.25,97.5,112.7,109.85,31,19,12,0.613,30,22,8,0.733,11,8,10,12,193.96,216.24,205.10000000000002
2016-12-23,1610612740,1610612748,2016,91.0,87.0,178.0,100.45,104.8,97.25,95.5,31,10,21,0.32299999999999995,30,10,20,0.333,6,4,5,5,200.8,195.0,197.9
2016-12-23,1610612750,1610612758,2016,105.0,109.0,214.0,110.05,111.2,97.75,101.5,28,9,19,0.321,29,12,17,0.414,4,5,6,6,209.4,207.08,208.24
2016-12-23,1610612743,1610612737,2016,108.0,109.0,217.0,109.2,110.3,96.35,95.7,29,12,17,0.414,29,14,15,0.483,6,6,7,7,217.04,199.44,208.24
2016-12-23,1610612762,1610612761,2016,98.0,104.0,202.0,95.55,106.55,100.6,99.2,30,18,12,0.6,28,20,8,0.7140000000000001,10,8,11,9,200.2,206.0,203.1
2016-12-23,1610612756,1610612755,2016,123.0,116.0,239.0,106.25,103.85,97.85,106.0,29,8,21,0.276,28,7,21,0.25,4,4,5,2,212.88,207.68,210.28
2016-12-23,1610612757,1610612759,2016,90.0,110.0,200.0,104.75,105.45,107.75,96.55,31,13,18,0.419,29,23,6,0.7929999999999999,8,5,8,15,209.44,204.12,206.78
2016-12-23,1610612746,1610612742,2016,88.0,90.0,178.0,109.85,106.5,104.45,102.7,30,22,8,0.733,29,8,21,0.276,11,11,6,2,214.36,213.0,213.68
2016-12-22,1610612754,1610612738,2016,102.0,109.0,211.0,92.05,92.25,99.65,105.5,30,15,15,0.5,28,16,12,0.5710000000000001,11,4,6,10,187.28,195.08,191.18
2016-12-22,1610612751,1610612744,2016,101.0,117.0,218.0,96.7,98.4,107.5,105.85,27,7,20,0.259,29,25,4,0.862,6,1,12,13,196.96,199.04,198.0
2016-12-22,1610612752,1610612753,2016,106.0,95.0,201.0,101.2,97.2,96.55,103.5,28,15,13,0.536,30,13,17,0.433,10,5,5,8,200.28,203.64,201.95999999999998
2016-12-22,1610612748,1610612747,2016,115.0,107.0,222.0,97.25,95.5,107.3,114.65,29,9,20,0.31,31,11,20,0.355,4,5,6,5,195.0,219.28,207.14
2016-12-22,1610612746,1610612759,2016,106.0,101.0,207.0,109.85,106.5,107.75,96.55,29,21,8,0.7240000000000001,28,23,5,0.821,10,11,8,15,214.36,204.12,209.24
2016-12-21,1610612739,1610612749,2016,113.0,102.0,215.0,101.9,101.55,99.8,108.15,26,20,6,0.769,26,13,13,0.5,13,7,9,4,195.48,200.48,197.98
2016-12-21,1610612737,1610612750,2016,84.0,92.0,176.0,96.35,95.7,110.05,111.2,28,14,14,0.5,27,8,19,0.29600000000000004,7,7,4,4,199.44,209.4,204.42000000000002
2016-12-21,1610612765,1610612763,2016,86.0,98.0,184.0,100.85,105.95,98.25,97.5,30,14,16,0.467,30,18,12,0.6,8,6,11,7,206.0,193.96,199.98000000000002
2016-12-21,1610612741,1610612764,2016,97.0,107.0,204.0,94.0,91.0,94.7,91.35,27,14,13,0.519,27,12,15,0.444,8,6,10,2,185.44,193.0,189.22
2016-12-21,1610612740,1610612760,2016,110.0,121.0,231.0,100.45,104.8,101.8,103.4,30,10,20,0.333,28,16,12,0.5710000000000001,6,4,11,5,200.8,210.36,205.58
2016-12-21,1610612762,1610612758,2016,93.0,94.0,187.0,95.55,106.55,97.75,101.5,29,18,11,0.621,28,11,17,0.393,10,8,6,5,200.2,207.08,203.64
2016-12-21,1610612756,1610612745,2016,111.0,125.0,236.0,106.25,103.85,112.7,109.85,28,8,20,0.28600000000000003,29,21,8,0.7240000000000001,4,4,10,11,212.88,216.24,214.56
2016-12-21,1610612757,1610612742,2016,95.0,96.0,191.0,104.75,105.45,104.45,102.7,30,13,17,0.433,28,7,21,0.25,8,5,6,1,209.44,213.0,211.22
2016-12-20,1610612755,1610612740,2016,93.0,108.0,201.0,97.85,106.0,100.45,104.8,27,7,20,0.259,29,9,20,0.31,5,2,6,3,207.68,200.8,204.24
2016-12-20,1610612766,1610612747,2016,117.0,113.0,230.0,99.45,97.7,107.3,114.65,28,15,13,0.536,30,11,19,0.3670000000000001,8,7,6,5,194.96,219.28,207.12
2016-12-20,1610612761,1610612751,2016,116.0,104.0,220.0,100.6,99.2,96.7,98.4,27,19,8,0.7040000000000001,26,7,19,0.269,10,9,6,1,206.0,196.96,201.48000000000002
2016-12-20,1610612752,1610612754,2016,118.0,111.0,229.0,101.2,97.2,92.05,92.25,27,14,13,0.519,29,15,14,0.517,9,5,11,4,200.28,187.28,193.78
2016-12-20,1610612748,1610612753,2016,130.0,136.0,266.0,97.25,95.5,96.55,103.5,28,9,19,0.321,29,12,17,0.414,4,5,5,7,195.0,203.64,199.32
2016-12-20,1610612749,1610612739,2016,108.0,114.0,222.0,99.8,108.15,101.9,101.55,25,13,12,0.52,25,19,6,0.76,9,4,13,6,200.48,195.48,197.98
2016-12-20,1610612763,1610612738,2016,109.0,112.0,221.0,98.25,97.5,99.65,105.5,29,18,11,0.621,27,15,12,0.556,11,7,6,9,193.96,195.08,194.52
2016-12-20,1610612745,1610612759,2016,100.0,102.0,202.0,112.7,109.85,107.75,96.55,28,21,7,0.75,27,22,5,0.815,10,11,8,14,216.24,204.12,210.18
2016-12-20,1610612746,1610612743,2016,119.0,102.0,221.0,109.85,106.5,109.2,110.3,28,20,8,0.7140000000000001,28,12,16,0.429,9,11,6,6,214.36,217.04,215.7
2016-12-20,1610612744,1610612762,2016,104.0,74.0,178.0,107.5,105.85,95.55,106.55,28,24,4,0.857,28,18,10,0.643,11,13,10,8,199.04,200.2,199.62
2016-12-20,1610612758,1610612757,2016,126.0,121.0,247.0,97.75,101.5,104.75,105.45,27,10,17,0.37,29,13,16,0.448,5,5,8,5,207.08,209.44,208.26
2016-12-19,1610612754,1610612764,2016,107.0,105.0,212.0,92.05,92.25,94.7,91.35,28,14,14,0.5,26,12,14,0.462,10,4,10,2,187.28,193.0,190.14
2016-12-19,1610612741,1610612765,2016,113.0,82.0,195.0,94.0,91.0,100.85,105.95,26,13,13,0.5,29,14,15,0.483,7,6,8,6,185.44,206.0,195.72
2016-12-19,1610612760,1610612737,2016,108.0,110.0,218.0,101.8,103.4,96.35,95.7,27,16,11,0.593,27,13,14,0.481,11,5,7,6,210.36,199.44,204.9
2016-12-19,1610612750,1610612756,2016,115.0,108.0,223.0,110.05,111.2,106.25,103.85,26,7,19,0.269,27,8,19,0.29600000000000004,3,4,4,4,209.4,212.88,211.14
2016-12-19,1610612743,1610612742,2016,117.0,107.0,224.0,109.2,110.3,104.45,102.7,27,11,16,0.407,27,7,20,0.259,5,6,6,1,217.04,213.0,215.01999999999998
2016-12-18,1610612764,1610612746,2016,117.0,110.0,227.0,94.7,91.35,109.85,106.5,25,11,14,0.44,27,20,7,0.741,9,2,9,11,193.0,214.36,203.68
2016-12-18,1610612742,1610612758,2016,99.0,79.0,178.0,104.45,102.7,97.75,101.5,26,6,20,0.231,26,10,16,0.385,5,1,5,5,213.0,207.08,210.04000000000002
2016-12-18,1610612763,1610612762,2016,73.0,82.0,155.0,98.25,97.5,95.55,106.55,28,18,10,0.643,27,17,10,0.63,11,7,10,7,193.96,200.2,197.07999999999998
2016-12-18,1610612755,1610612751,2016,108.0,107.0,215.0,97.85,106.0,96.7,98.4,26,6,20,0.231,25,7,18,0.28,4,2,6,1,207.68,196.96,202.32
2016-12-18,1610612753,1610612761,2016,79.0,109.0,188.0,96.55,103.5,100.6,99.2,28,12,16,0.429,26,18,8,0.6920000000000001,5,7,10,8,203.64,206.0,204.82
2016-12-18,1610612748,1610612738,2016,95.0,105.0,200.0,97.25,95.5,99.65,105.5,27,9,18,0.333,26,14,12,0.5379999999999999,4,5,6,8,195.0,195.08,195.04000000000002
2016-12-18,1610612759,1610612740,2016,113.0,100.0,213.0,107.75,96.55,100.45,104.8,26,21,5,0.8079999999999999,28,9,19,0.321,7,14,6,3,204.12,200.8,202.46
2016-12-17,1610612760,1610612756,2016,114.0,101.0,215.0,101.8,103.4,106.25,103.85,26,15,11,0.5770000000000001,26,8,18,0.308,10,5,4,4,210.36,212.88,211.62
2016-12-17,1610612765,1610612754,2016,90.0,105.0,195.0,100.85,105.95,92.05,92.25,28,14,14,0.5,27,13,14,0.481,8,6,10,3,206.0,187.28,196.64
2016-12-17,1610612737,1610612766,2016,99.0,107.0,206.0,96.35,95.7,99.45,97.7,26,13,13,0.5,27,14,13,0.519,7,6,8,6,199.44,194.96,197.2
2016-12-17,1610612739,1610612747,2016,119.0,108.0,227.0,101.9,101.55,107.3,114.65,24,18,6,0.75,29,11,18,0.379,12,6,6,5,195.48,219.28,207.38
2016-12-17,1610612750,1610612745,2016,109.0,111.0,220.0,110.05,111.2,112.7,109.85,25,7,18,0.28,27,20,7,0.741,3,4,10,10,209.4,216.24,212.82
2016-12-17,1610612743,1610612752,2016,127.0,114.0,241.0,109.2,110.3,101.2,97.2,26,10,16,0.385,26,14,12,0.5379999999999999,4,6,9,5,217.04,200.28,208.66
2016-12-17,1610612744,1610612757,2016,135.0,90.0,225.0,107.5,105.85,104.75,105.45,27,23,4,0.852,28,13,15,0.464,10,13,8,5,199.04,209.44,204.24
2016-12-16,1610612764,1610612765,2016,122.0,108.0,230.0,94.7,91.35,100.85,105.95,24,10,14,0.417,27,14,13,0.519,8,2,8,6,193.0,206.0,199.5
2016-12-16,1610612753,1610612751,2016,118.0,111.0,229.0,96.55,103.5,96.7,98.4,27,11,16,0.407,24,7,17,0.292,4,7,6,1,203.64,196.96,200.3
2016-12-16,1610612738,1610612766,2016,96.0,88.0,184.0,99.65,105.5,99.45,97.7,25,13,12,0.52,26,14,12,0.5379999999999999,5,8,8,6,195.08,194.96,195.02
2016-12-16,1610612761,1610612737,2016,121.0,125.0,246.0,100.6,99.2,96.35,95.7,25,18,7,0.72,25,12,13,0.48,10,8,7,5,206.0,199.44,202.72
2016-12-16,1610612741,1610612749,2016,69.0,95.0,164.0,94.0,91.0,99.8,108.15,25,13,12,0.52,24,12,12,0.5,7,6,9,3,185.44,200.48,192.95999999999998
2016-12-16,1610612763,1610612758,2016,92.0,96.0,188.0,98.25,97.5,97.75,101.5,27,18,9,0.667,25,9,16,0.36,11,7,5,4,193.96,207.08,200.52
2016-12-16,1610612745,1610612740,2016,122.0,100.0,222.0,112.7,109.85,100.45,104.8,26,19,7,0.731,27,9,18,0.333,9,10,6,3,216.24,200.8,208.52
2016-12-16,1610612755,1610612747,2016,89.0,100.0,189.0,97.85,106.0,107.3,114.65,25,6,19,0.24,28,10,18,0.35700000000000004,4,2,6,4,207.68,219.28,213.48000000000002
2016-12-16,1610612748,1610612746,2016,98.0,102.0,200.0,97.25,95.5,109.85,106.5,26,9,17,0.34600000000000003,26,19,7,0.731,4,5,9,10,195.0,214.36,204.68
2016-12-16,1610612762,1610612742,2016,103.0,100.0,203.0,95.55,106.55,104.45,102.7,26,16,10,0.615,25,6,19,0.24,9,7,5,1,200.2,213.0,206.6
2016-12-15,1610612749,1610612741,2016,108.0,97.0,205.0,99.8,108.15,94.0,91.0,23,11,12,0.478,24,13,11,0.542,8,3,7,6,200.48,185.44,192.95999999999998
2016-12-15,1610612740,1610612754,2016,102.0,95.0,197.0,100.45,104.8,92.05,92.25,26,8,18,0.308,26,13,13,0.5,5,3,10,3,200.8,187.28,194.04000000000002
2016-12-15,1610612743,1610612757,2016,132.0,120.0,252.0,109.2,110.3,104.75,105.45,25,9,16,0.36,27,13,14,0.481,3,6,8,5,217.04,209.44,213.24
2016-12-15,1610612756,1610612759,2016,92.0,107.0,199.0,106.25,103.85,107.75,96.55,25,8,17,0.32,25,20,5,0.8,4,4,7,13,212.88,204.12,208.5
2016-12-15,1610612744,1610612752,2016,103.0,90.0,193.0,107.5,105.85,101.2,97.2,26,22,4,0.846,25,14,11,0.56,9,13,9,5,199.04,200.28,199.66
2016-12-14,1610612755,1610612761,2016,114.0,123.0,237.0,97.85,106.0,100.6,99.2,24,6,18,0.25,24,17,7,0.708,4,2,10,7,207.68,206.0,206.84
2016-12-14,1610612764,1610612766,2016,109.0,106.0,215.0,94.7,91.35,99.45,97.7,23,9,14,0.391,25,14,11,0.56,7,2,8,6,193.0,194.96,193.98000000000002
2016-12-14,1610612753,1610612746,2016,108.0,113.0,221.0,96.55,103.5,109.85,106.5,26,11,15,0.423,25,18,7,0.72,4,7,9,9,203.64,214.36,209.0
2016-12-14,1610612748,1610612754,2016,95.0,89.0,184.0,97.25,95.5,92.05,92.25,25,8,17,0.32,25,13,12,0.52,3,5,10,3,195.0,187.28,191.14
2016-12-14,1610612751,1610612747,2016,107.0,97.0,204.0,96.7,98.4,107.3,114.65,23,6,17,0.261,27,10,17,0.37,5,1,6,4,196.96,219.28,208.12
2016-12-14,1610612763,1610612739,2016,93.0,85.0,178.0,98.25,97.5,101.9,101.55,26,17,9,0.654,23,18,5,0.7829999999999999,10,7,12,6,193.96,195.48,194.72
2016-12-14,1610612745,1610612758,2016,132.0,98.0,230.0,112.7,109.85,97.75,101.5,25,18,7,0.72,24,9,15,0.375,8,10,5,4,216.24,207.08,211.66000000000003
2016-12-14,1610612742,1610612765,2016,85.0,95.0,180.0,104.45,102.7,100.85,105.95,24,6,18,0.25,26,13,13,0.5,5,1,8,5,213.0,206.0,209.5
2016-12-14,1610612762,1610612760,2016,109.0,89.0,198.0,95.55,106.55,101.8,103.4,25,15,10,0.6,25,15,10,0.6,8,7,10,5,200.2,210.36,205.28
2016-12-14,1610612759,1610612738,2016,108.0,101.0,209.0,107.75,96.55,99.65,105.5,24,19,5,0.792,24,13,11,0.542,6,13,5,8,204.12,195.08,199.60000000000002
2016-12-13,1610612739,1610612763,2016,103.0,86.0,189.0,101.9,101.55,98.25,97.5,22,17,5,0.773,25,17,8,0.68,11,6,10,7,195.48,193.96,194.72
2016-12-13,1610612737,1610612753,2016,120.0,131.0,251.0,96.35,95.7,96.55,103.5,24,12,12,0.5,25,10,15,0.4,7,5,4,6,199.44,203.64,201.54
2016-12-13,1610612741,1610612750,2016,94.0,99.0,193.0,94.0,91.0,110.05,111.2,23,13,10,0.565,24,6,18,0.25,7,6,3,3,185.44,209.4,197.42000000000002
2016-12-13,1610612740,1610612744,2016,109.0,113.0,222.0,100.45,104.8,107.5,105.85,25,8,17,0.32,25,21,4,0.84,5,3,9,12,200.8,199.04,199.92000000000002
2016-12-13,1610612756,1610612752,2016,113.0,111.0,224.0,106.25,103.85,101.2,97.2,24,7,17,0.292,24,14,10,0.583,3,4,9,5,212.88,200.28,206.57999999999998
2016-12-13,1610612757,1610612760,2016,114.0,95.0,209.0,104.75,105.45,101.8,103.4,26,12,14,0.462,24,15,9,0.625,7,5,10,5,209.44,210.36,209.9
2016-12-12,1610612754,1610612766,2016,110.0,94.0,204.0,92.05,92.25,99.45,97.7,24,12,12,0.5,24,14,10,0.583,9,3,8,6,187.28,194.96,191.12
2016-12-12,1610612761,1610612749,2016,122.0,100.0,222.0,100.6,99.2,99.8,108.15,23,16,7,0.696,22,11,11,0.5,9,7,8,3,206.0,200.48,203.24
2016-12-12,1610612748,1610612764,2016,112.0,101.0,213.0,97.25,95.5,94.7,91.35,24,7,17,0.292,22,9,13,0.409,2,5,7,2,195.0,193.0,194.0
2016-12-12,1610612745,1610612751,2016,122.0,118.0,240.0,112.7,109.85,96.7,98.4,24,17,7,0.708,22,6,16,0.273,7,10,5,1,216.24,196.96,206.60000000000002
2016-12-12,1610612742,1610612743,2016,112.0,92.0,204.0,104.45,102.7,109.2,110.3,23,5,18,0.217,24,9,15,0.375,4,1,3,6,213.0,217.04,215.01999999999998
2016-12-12,1610612746,1610612757,2016,121.0,120.0,241.0,109.85,106.5,104.75,105.45,24,17,7,0.708,25,12,13,0.48,8,9,7,5,214.36,209.44,211.9
2016-12-12,1610612758,1610612747,2016,116.0,92.0,208.0,97.75,101.5,107.3,114.65,23,8,15,0.348,26,10,16,0.385,4,4,6,4,207.08,219.28,213.18
2016-12-11,1610612765,1610612755,2016,79.0,97.0,176.0,100.85,105.95,97.85,106.0,25,13,12,0.52,23,5,18,0.217,8,5,4,1,206.0,207.68,206.84
2016-12-11,1610612760,1610612738,2016,99.0,96.0,195.0,101.8,103.4,99.65,105.5,23,14,9,0.609,23,13,10,0.565,9,5,5,8,210.36,195.08,202.72000000000003
2016-12-11,1610612750,1610612744,2016,108.0,116.0,224.0,110.05,111.2,107.5,105.85,23,6,17,0.261,24,20,4,0.833,3,3,9,11,209.4,199.04,204.22
2016-12-11,1610612756,1610612740,2016,119.0,120.0,239.0,106.25,103.85,100.45,104.8,23,7,16,0.304,24,7,17,0.292,3,4,5,2,212.88,200.8,206.84
2016-12-11,1610612747,1610612752,2016,112.0,118.0,230.0,107.3,114.65,101.2,97.2,25,10,15,0.4,23,13,10,0.565,6,4,9,4,219.28,200.28,209.78
2016-12-10,1610612764,1610612749,2016,110.0,105.0,215.0,94.7,91.35,99.8,108.15,21,8,13,0.381,21,11,10,0.524,6,2,8,3,193.0,200.48,196.74
2016-12-10,1610612753,1610612743,2016,113.0,121.0,234.0,96.55,103.5,109.2,110.3,24,10,14,0.417,23,8,15,0.348,4,6,3,5,203.64,217.04,210.33999999999997
2016-12-10,1610612754,1610612757,2016,118.0,111.0,229.0,92.05,92.25,104.75,105.45,23,11,12,0.478,24,12,12,0.5,8,3,7,5,187.28,209.44,198.36
2016-12-10,1610612739,1610612766,2016,116.0,105.0,221.0,101.9,101.55,99.45,97.7,21,16,5,0.762,23,14,9,0.609,10,6,8,6,195.48,194.96,195.22
2016-12-10,1610612741,1610612748,2016,105.0,100.0,205.0,94.0,91.0,97.25,95.5,22,12,10,0.545,23,7,16,0.304,6,6,2,5,185.44,195.0,190.22
2016-12-10,1610612763,1610612744,2016,110.0,89.0,199.0,98.25,97.5,107.5,105.85,24,16,8,0.667,23,20,3,0.87,9,7,9,11,193.96,199.04,196.5
2016-12-10,1610612745,1610612742,2016,109.0,87.0,196.0,112.7,109.85,104.45,102.7,23,16,7,0.696,22,5,17,0.227,6,10,4,1,216.24,213.0,214.62
2016-12-10,1610612759,1610612751,2016,130.0,101.0,231.0,107.75,96.55,96.7,98.4,23,18,5,0.7829999999999999,21,6,15,0.28600000000000003,5,13,5,1,204.12,196.96,200.54000000000002
2016-12-10,1610612762,1610612758,2016,104.0,84.0,188.0,95.55,106.55,97.75,101.5,24,14,10,0.583,22,8,14,0.364,7,7,4,4,200.2,207.08,203.64
2016-12-10,1610612746,1610612740,2016,133.0,105.0,238.0,109.85,106.5,100.45,104.8,23,16,7,0.696,23,7,16,0.304,7,9,5,2,214.36,200.8,207.58
2016-12-09,1610612766,1610612753,2016,109.0,88.0,197.0,99.45,97.7,96.55,103.5,22,13,9,0.591,23,10,13,0.435,7,6,4,6,194.96,203.64,199.3
2016-12-09,1610612739,1610612748,2016,114.0,84.0,198.0,101.9,101.55,97.25,95.5,20,15,5,0.75,22,7,15,0.318,9,6,2,5,195.48,195.0,195.24
2016-12-09,1610612738,1610612761,2016,94.0,101.0,195.0,99.65,105.5,100.6,99.2,22,13,9,0.591,22,15,7,0.682,5,8,9,6,195.08,206.0,200.54000000000002
2016-12-09,1610612749,1610612737,2016,110.0,114.0,224.0,99.8,108.15,96.35,95.7,20,11,9,0.55,23,11,12,0.478,8,3,7,4,200.48,199.44,199.95999999999998
2016-12-09,1610612760,1610612745,2016,99.0,102.0,201.0,101.8,103.4,112.7,109.85,22,14,8,0.636,22,15,7,0.682,9,5,6,9,210.36,216.24,213.3
2016-12-09,1610612750,1610612765,2016,90.0,117.0,207.0,110.05,111.2,100.85,105.95,22,6,16,0.273,24,12,12,0.5,3,3,8,4,209.4,206.0,207.7
2016-12-09,1610612742,1610612754,2016,111.0,103.0,214.0,104.45,102.7,92.05,92.25,21,4,17,0.19,22,11,11,0.5,3,1,8,3,213.0,187.28,200.14
2016-12-09,1610612747,1610612756,2016,115.0,119.0,234.0,107.3,114.65,106.25,103.85,24,10,14,0.417,22,6,16,0.273,6,4,3,3,219.28,212.88,216.07999999999998
2016-12-09,1610612758,1610612752,2016,100.0,103.0,203.0,97.75,101.5,101.2,97.2,21,8,13,0.381,22,12,10,0.545,4,4,9,3,207.08,200.28,203.68
2016-12-08,1610612761,1610612750,2016,124.0,110.0,234.0,100.6,99.2,110.05,111.2,21,14,7,0.667,21,6,15,0.28600000000000003,8,6,3,3,206.0,209.4,207.7
2016-12-08,1610612764,1610612743,2016,92.0,85.0,177.0,94.7,91.35,109.2,110.3,20,7,13,0.35,22,8,14,0.364,5,2,3,5,193.0,217.04,205.01999999999998
2016-12-08,1610612763,1610612757,2016,88.0,86.0,174.0,98.25,97.5,104.75,105.45,23,15,8,0.652,23,12,11,0.522,8,7,7,5,193.96,209.44,201.7
2016-12-08,1610612740,1610612755,2016,88.0,99.0,187.0,100.45,104.8,97.85,106.0,22,7,15,0.318,22,4,18,0.182,5,2,4,0,200.8,207.68,204.24
2016-12-08,1610612762,1610612744,2016,99.0,106.0,205.0,95.55,106.55,107.5,105.85,23,14,9,0.609,22,19,3,0.8640000000000001,7,7,9,10,200.2,199.04,199.62
2016-12-08,1610612741,1610612759,2016,95.0,91.0,186.0,94.0,91.0,107.75,96.55,21,11,10,0.524,22,18,4,0.818,5,6,5,13,185.44,204.12,194.78
2016-12-07,1610612766,1610612765,2016,87.0,77.0,164.0,99.45,97.7,100.85,105.95,21,12,9,0.5710000000000001,23,12,11,0.522,6,6,8,4,194.96,206.0,200.48000000000002
2016-12-07,1610612753,1610612738,2016,87.0,117.0,204.0,96.55,103.5,99.65,105.5,22,10,12,0.455,21,12,9,0.5710000000000001,4,6,5,7,203.64,195.08,199.36
2016-12-07,1610612751,1610612743,2016,116.0,111.0,227.0,96.7,98.4,109.2,110.3,20,5,15,0.25,21,8,13,0.381,4,1,3,5,196.96,217.04,207.0
2016-12-07,1610612737,1610612748,2016,103.0,95.0,198.0,96.35,95.7,97.25,95.5,22,10,12,0.455,21,7,14,0.333,6,4,2,5,199.44,195.0,197.22
2016-12-07,1610612749,1610612757,2016,115.0,107.0,222.0,99.8,108.15,104.75,105.45,19,10,9,0.526,22,12,10,0.545,7,3,7,5,200.48,209.44,204.95999999999998
2016-12-07,1610612745,1610612747,2016,134.0,95.0,229.0,112.7,109.85,107.3,114.65,21,14,7,0.667,23,10,13,0.435,5,9,6,4,216.24,219.28,217.76
2016-12-07,1610612752,1610612739,2016,94.0,126.0,220.0,101.2,97.2,101.9,101.55,21,12,9,0.5710000000000001,19,14,5,0.737,9,3,9,5,200.28,195.48,197.88
2016-12-07,1610612742,1610612758,2016,89.0,120.0,209.0,104.45,102.7,97.75,101.5,20,4,16,0.2,20,7,13,0.35,3,1,4,3,213.0,207.08,210.04000000000002
2016-12-07,1610612756,1610612754,2016,94.0,109.0,203.0,106.25,103.85,92.05,92.25,21,6,15,0.28600000000000003,21,10,11,0.476,3,3,8,2,212.88,187.28,200.07999999999998
2016-12-07,1610612746,1610612744,2016,98.0,115.0,213.0,109.85,106.5,107.5,105.85,22,16,6,0.727,21,18,3,0.857,7,9,9,9,214.36,199.04,206.7
2016-12-06,1610612764,1610612753,2016,116.0,124.0,240.0,94.7,91.35,96.55,103.5,19,7,12,0.368,21,9,12,0.429,5,2,4,5,193.0,203.64,198.32
2016-12-06,1610612748,1610612752,2016,103.0,114.0,217.0,97.25,95.5,101.2,97.2,20,7,13,0.35,20,11,9,0.55,2,5,9,2,195.0,200.28,197.64
2016-12-06,1610612765,1610612741,2016,102.0,91.0,193.0,100.85,105.95,94.0,91.0,22,11,11,0.5,20,11,9,0.55,7,4,5,6,206.0,185.44,195.72
2016-12-06,1610612763,1610612755,2016,96.0,91.0,187.0,98.25,97.5,97.85,106.0,22,14,8,0.636,21,4,17,0.19,7,7,4,0,193.96,207.68,200.82
2016-12-06,1610612750,1610612759,2016,91.0,105.0,196.0,110.05,111.2,107.75,96.55,20,6,14,0.3,21,17,4,0.81,3,3,5,12,209.4,204.12,206.76
2016-12-06,1610612762,1610612756,2016,112.0,105.0,217.0,95.55,106.55,106.25,103.85,22,13,9,0.591,20,6,14,0.3,6,7,3,3,200.2,212.88,206.54
2016-12-05,1610612755,1610612743,2016,98.0,106.0,204.0,97.85,106.0,109.2,110.3,20,4,16,0.2,20,7,13,0.35,4,0,3,4,207.68,217.04,212.36
2016-12-05,1610612761,1610612739,2016,112.0,116.0,228.0,100.6,99.2,101.9,101.55,20,14,6,0.7,18,13,5,0.722,8,6,9,4,206.0,195.48,200.74
2016-12-05,1610612751,1610612764,2016,113.0,118.0,231.0,96.7,98.4,94.7,91.35,19,5,14,0.263,18,6,12,0.333,4,1,5,1,196.96,193.0,194.98000000000002
2016-12-05,1610612737,1610612760,2016,99.0,102.0,201.0,96.35,95.7,101.8,103.4,21,10,11,0.476,21,13,8,0.619,6,4,9,4,199.44,210.36,204.9
2016-12-05,1610612741,1610612757,2016,110.0,112.0,222.0,94.0,91.0,104.75,105.45,19,11,8,0.579,21,11,10,0.524,5,6,7,4,185.44,209.44,197.44
2016-12-05,1610612749,1610612759,2016,96.0,97.0,193.0,99.8,108.15,107.75,96.55,18,10,8,0.556,20,16,4,0.8,7,3,5,11,200.48,204.12,202.3
2016-12-05,1610612740,1610612763,2016,108.0,110.0,218.0,100.45,104.8,98.25,97.5,21,7,14,0.333,21,13,8,0.619,5,2,7,6,200.8,193.96,197.38
2016-12-05,1610612745,1610612738,2016,107.0,106.0,213.0,112.7,109.85,99.65,105.5,20,13,7,0.65,20,12,8,0.6,4,9,5,7,216.24,195.08,205.66000000000003
2016-12-05,1610612742,1610612766,2016,101.0,109.0,210.0,104.45,102.7,99.45,97.7,19,4,15,0.211,20,11,9,0.55,3,1,6,5,213.0,194.96,203.98000000000002
2016-12-05,1610612747,1610612762,2016,101.0,107.0,208.0,107.3,114.65,95.55,106.55,22,10,12,0.455,21,12,9,0.5710000000000001,6,4,6,6,219.28,200.2,209.74
2016-12-05,1610612744,1610612754,2016,142.0,106.0,248.0,107.5,105.85,92.05,92.25,20,17,3,0.85,20,10,10,0.5,8,9,8,2,199.04,187.28,193.16
2016-12-04,1610612765,1610612753,2016,92.0,98.0,190.0,100.85,105.95,96.55,103.5,21,11,10,0.524,20,8,12,0.4,7,4,4,4,206.0,203.64,204.82
2016-12-04,1610612760,1610612740,2016,101.0,92.0,193.0,101.8,103.4,100.45,104.8,20,12,8,0.6,20,7,13,0.35,8,4,5,2,210.36,200.8,205.58
2016-12-04,1610612752,1610612758,2016,106.0,98.0,204.0,101.2,97.2,97.75,101.5,19,10,9,0.526,19,7,12,0.368,8,2,4,3,200.28,207.08,203.68
2016-12-04,1610612746,1610612754,2016,102.0,111.0,213.0,109.85,106.5,92.05,92.25,21,16,5,0.762,19,9,10,0.474,7,9,8,1,214.36,187.28,200.82
2016-12-03,1610612749,1610612751,2016,112.0,103.0,215.0,99.8,108.15,96.7,98.4,17,9,8,0.529,18,5,13,0.278,6,3,4,1,200.48,196.96,198.72
2016-12-03,1610612766,1610612750,2016,120.0,125.0,245.0,99.45,97.7,110.05,111.2,19,11,8,0.579,19,5,14,0.263,6,5,3,2,194.96,209.4,202.18
2016-12-03,1610612761,1610612737,2016,128.0,84.0,212.0,100.6,99.2,96.35,95.7,19,13,6,0.684,20,10,10,0.5,7,6,6,4,206.0,199.44,202.72
2016-12-03,1610612755,1610612738,2016,106.0,107.0,213.0,97.85,106.0,99.65,105.5,19,4,15,0.211,19,11,8,0.579,4,0,5,6,207.68,195.08,201.38
2016-12-03,1610612763,1610612747,2016,103.0,100.0,203.0,98.25,97.5,107.3,114.65,20,12,8,0.6,21,10,11,0.476,6,6,6,4,193.96,219.28,206.62
2016-12-03,1610612742,1610612741,2016,107.0,82.0,189.0,104.45,102.7,94.0,91.0,18,3,15,0.16699999999999998,18,11,7,0.611,2,1,5,6,213.0,185.44,199.22
2016-12-03,1610612762,1610612743,2016,105.0,98.0,203.0,95.55,106.55,109.2,110.3,20,11,9,0.55,19,7,12,0.368,5,6,3,4,200.2,217.04,208.62
2016-12-03,1610612757,1610612748,2016,99.0,92.0,191.0,104.75,105.45,97.25,95.5,20,10,10,0.5,19,7,12,0.368,6,4,2,5,209.44,195.0,202.22
2016-12-03,1610612744,1610612756,2016,138.0,109.0,247.0,107.5,105.85,106.25,103.85,19,16,3,0.8420000000000001,19,6,13,0.316,7,9,3,3,199.04,212.88,205.95999999999998
2016-12-02,1610612755,1610612753,2016,88.0,105.0,193.0,97.85,106.0,96.55,103.5,18,4,14,0.222,19,7,12,0.368,4,0,4,3,207.68,203.64,205.66
2016-12-02,1610612738,1610612758,2016,97.0,92.0,189.0,99.65,105.5,97.75,101.5,18,10,8,0.556,18,7,11,0.389,4,6,4,3,195.08,207.08,201.08
2016-12-02,1610612761,1610612747,2016,113.0,80.0,193.0,100.6,99.2,107.3,114.65,18,12,6,0.667,20,10,10,0.5,6,6,6,4,206.0,219.28,212.64
2016-12-02,1610612752,1610612750,2016,118.0,114.0,232.0,101.2,97.2,110.05,111.2,18,9,9,0.5,18,5,13,0.278,7,2,3,2,200.28,209.4,204.84
2016-12-02,1610612741,1610612739,2016,111.0,105.0,216.0,94.0,91.0,101.9,101.55,17,10,7,0.588,17,13,4,0.765,4,6,9,4,185.44,195.48,190.45999999999998
2016-12-02,1610612740,1610612746,2016,96.0,114.0,210.0,100.45,104.8,109.85,106.5,19,7,12,0.368,20,15,5,0.75,5,2,7,8,200.8,214.36,207.58
2016-12-02,1610612737,1610612765,2016,85.0,121.0,206.0,96.35,95.7,100.85,105.95,19,10,9,0.526,20,10,10,0.5,6,4,7,3,199.44,206.0,202.72
2016-12-02,1610612759,1610612764,2016,107.0,105.0,212.0,107.75,96.55,94.7,91.35,19,15,4,0.789,17,6,11,0.353,4,11,5,1,204.12,193.0,198.56
2016-12-02,1610612743,1610612745,2016,110.0,128.0,238.0,109.2,110.3,112.7,109.85,18,7,11,0.389,19,12,7,0.632,3,4,4,8,217.04,216.24,216.64
2016-12-01,1610612766,1610612742,2016,97.0,87.0,184.0,99.45,97.7,104.45,102.7,18,10,8,0.556,17,3,14,0.17600000000000002,5,5,2,1,194.96,213.0,203.98000000000002
2016-12-01,1610612751,1610612749,2016,93.0,111.0,204.0,96.7,98.4,99.8,108.15,17,5,12,0.294,16,8,8,0.5,4,1,6,2,196.96,200.48,198.72
2016-12-01,1610612763,1610612753,2016,95.0,94.0,189.0,98.25,97.5,96.55,103.5,19,11,8,0.579,18,7,11,0.389,5,6,4,3,193.96,203.64,198.8
2016-12-01,1610612739,1610612746,2016,94.0,113.0,207.0,101.9,101.55,109.85,106.5,16,13,3,0.813,19,14,5,0.737,9,4,7,7,195.48,214.36,204.92000000000002
2016-12-01,1610612762,1610612748,2016,110.0,111.0,221.0,95.55,106.55,97.25,95.5,19,11,8,0.579,18,6,12,0.333,5,6,2,4,200.2,195.0,197.6
2016-12-01,1610612744,1610612745,2016,127.0,132.0,259.0,107.5,105.85,112.7,109.85,18,16,2,0.889,18,11,7,0.611,7,9,4,7,199.04,216.24,207.64
2016-11-30,1610612738,1610612765,2016,114.0,121.0,235.0,99.65,105.5,100.85,105.95,17,10,7,0.588,19,9,10,0.474,4,6,7,2,195.08,206.0,200.54000000000002
2016-11-30,1610612761,1610612763,2016,120.0,105.0,225.0,100.6,99.2,98.25,97.5,17,11,6,0.647,18,11,7,0.611,5,6,5,6,206.0,193.96,199.98000000000002
2016-11-30,1610612741,1610612747,2016,90.0,96.0,186.0,94.0,91.0,107.3,114.65,16,10,6,0.625,19,9,10,0.474,4,6,6,3,185.44,219.28,202.36
2016-11-30,1610612760,1610612764,2016,126.0,115.0,241.0,101.8,103.4,94.7,91.35,19,11,8,0.579,16,6,10,0.375,7,4,5,1,210.36,193.0,201.68
2016-11-30,1610612750,1610612752,2016,104.0,106.0,210.0,110.05,111.2,101.2,97.2,17,5,12,0.294,17,8,9,0.471,3,2,7,1,209.4,200.28,204.84
2016-11-30,1610612742,1610612759,2016,87.0,94.0,181.0,104.45,102.7,107.75,96.55,16,3,13,0.188,18,14,4,0.778,2,1,4,10,213.0,204.12,208.56
2016-11-30,1610612743,1610612748,2016,98.0,106.0,204.0,109.2,110.3,97.25,95.5,17,7,10,0.412,17,5,12,0.294,3,4,2,3,217.04,195.0,206.01999999999998
2016-11-30,1610612756,1610612737,2016,109.0,107.0,216.0,106.25,103.85,96.35,95.7,18,5,13,0.278,18,10,8,0.556,2,3,6,4,212.88,199.44,206.16
2016-11-30,1610612757,1610612754,2016,131.0,109.0,240.0,104.75,105.45,92.05,92.25,19,9,10,0.474,18,9,9,0.5,5,4,8,1,209.44,187.28,198.36
2016-11-29,1610612766,1610612765,2016,89.0,112.0,201.0,99.45,97.7,100.85,105.95,17,10,7,0.588,18,8,10,0.444,5,5,7,1,194.96,206.0,200.48000000000002
2016-11-29,1610612751,1610612746,2016,127.0,122.0,249.0,96.7,98.4,109.85,106.5,16,4,12,0.25,18,14,4,0.778,3,1,7,7,196.96,214.36,205.66000000000003
2016-11-29,1610612749,1610612739,2016,118.0,101.0,219.0,99.8,108.15,101.9,101.55,15,7,8,0.467,15,13,2,0.867,5,2,9,4,200.48,195.48,197.98
2016-11-29,1610612740,1610612747,2016,105.0,88.0,193.0,100.45,104.8,107.3,114.65,18,6,12,0.333,18,9,9,0.5,4,2,6,3,200.8,219.28,210.04000000000002
2016-11-29,1610612759,1610612753,2016,83.0,95.0,178.0,107.75,96.55,96.55,103.5,17,14,3,0.8240000000000001,17,6,11,0.353,4,10,4,2,204.12,203.64,203.88
2016-11-29,1610612762,1610612745,2016,120.0,101.0,221.0,95.55,106.55,112.7,109.85,18,10,8,0.556,17,11,6,0.647,4,6,4,7,200.2,216.24,208.22
2016-11-28,1610612764,1610612758,2016,101.0,95.0,196.0,94.7,91.35,97.75,101.5,15,5,10,0.333,17,7,10,0.412,4,1,4,3,193.0,207.08,200.04000000000002
2016-11-28,1610612761,1610612755,2016,122.0,95.0,217.0,100.6,99.2,97.85,106.0,16,10,6,0.625,17,4,13,0.235,4,6,4,0,206.0,207.68,206.84
2016-11-28,1610612752,1610612760,2016,103.0,112.0,215.0,101.2,97.2,101.8,103.4,16,8,8,0.5,18,10,8,0.556,7,1,7,3,200.28,210.36,205.32
2016-11-28,1610612748,1610612738,2016,104.0,112.0,216.0,97.25,95.5,99.65,105.5,16,5,11,0.313,16,9,7,0.563,2,3,4,5,195.0,195.08,195.04000000000002
2016-11-28,1610612763,1610612766,2016,85.0,104.0,189.0,98.25,97.5,99.45,97.7,17,11,6,0.647,16,9,7,0.563,5,6,5,4,193.96,194.96,194.46
2016-11-28,1610612750,1610612762,2016,103.0,112.0,215.0,110.05,111.2,95.55,106.55,16,5,11,0.313,17,9,8,0.529,3,2,4,5,209.4,200.2,204.8
2016-11-28,1610612744,1610612737,2016,105.0,100.0,205.0,107.5,105.85,96.35,95.7,17,15,2,0.882,17,10,7,0.588,6,9,6,4,199.04,199.44,199.24
2016-11-27,1610612755,1610612739,2016,108.0,112.0,220.0,97.85,106.0,101.9,101.55,16,4,12,0.25,14,12,2,0.857,4,0,9,3,207.68,195.48,201.57999999999998
2016-11-27,1610612756,1610612743,2016,114.0,120.0,234.0,106.25,103.85,109.2,110.3,17,5,12,0.294,16,6,10,0.375,2,3,3,3,212.88,217.04,214.95999999999998
2016-11-27,1610612751,1610612758,2016,105.0,122.0,227.0,96.7,98.4,97.75,101.5,15,4,11,0.267,16,6,10,0.375,3,1,4,2,196.96,207.08,202.02
2016-11-27,1610612753,1610612749,2016,96.0,104.0,200.0,96.55,103.5,99.8,108.15,16,6,10,0.375,14,6,8,0.429,4,2,5,1,203.64,200.48,202.06
2016-11-27,1610612754,1610612746,2016,91.0,70.0,161.0,92.05,92.25,109.85,106.5,17,8,9,0.471,17,14,3,0.8240000000000001,7,1,7,7,187.28,214.36,200.82
2016-11-27,1610612742,1610612740,2016,91.0,81.0,172.0,104.45,102.7,100.45,104.8,15,2,13,0.133,17,6,11,0.353,1,1,4,2,213.0,200.8,206.9
2016-11-27,1610612757,1610612745,2016,114.0,130.0,244.0,104.75,105.45,112.7,109.85,18,9,9,0.5,16,10,6,0.625,5,4,4,6,209.44,216.24,212.84
2016-11-27,1610612747,1610612737,2016,109.0,94.0,203.0,107.3,114.65,96.35,95.7,17,8,9,0.471,16,10,6,0.625,5,3,6,4,219.28,199.44,209.36
2016-11-26,1610612764,1610612759,2016,100.0,112.0,212.0,94.7,91.35,107.75,96.55,14,5,9,0.35700000000000004,16,13,3,0.813,4,1,4,9,193.0,204.12,198.56
2016-11-26,1610612766,1610612752,2016,107.0,102.0,209.0,99.45,97.7,101.2,97.2,15,8,7,0.5329999999999999,15,8,7,0.5329999999999999,4,4,7,1,194.96,200.28,197.62
2016-11-26,1610612760,1610612765,2016,106.0,88.0,194.0,101.8,103.4,100.85,105.95,17,9,8,0.529,17,8,9,0.471,6,3,7,1,210.36,206.0,208.18
2016-11-26,1610612748,1610612763,2016,107.0,110.0,217.0,97.25,95.5,98.25,97.5,15,5,10,0.333,16,10,6,0.625,2,3,5,5,195.0,193.96,194.48000000000002
2016-11-26,1610612744,1610612750,2016,115.0,102.0,217.0,107.5,105.85,110.05,111.2,16,14,2,0.875,15,5,10,0.333,5,9,3,2,199.04,209.4,204.22
2016-11-25,1610612738,1610612759,2016,103.0,109.0,212.0,99.65,105.5,107.75,96.55,15,9,6,0.6,15,12,3,0.8,4,5,4,8,195.08,204.12,199.60000000000002
2016-11-25,1610612753,1610612764,2016,91.0,94.0,185.0,96.55,103.5,94.7,91.35,15,6,9,0.4,13,4,9,0.308,4,2,4,0,203.64,193.0,198.32
2016-11-25,1610612739,1610612742,2016,128.0,90.0,218.0,101.9,101.55,104.45,102.7,13,11,2,0.846,14,2,12,0.14300000000000002,8,3,1,1,195.48,213.0,204.24
2016-11-25,1610612752,1610612766,2016,113.0,111.0,224.0,101.2,97.2,99.45,97.7,14,7,7,0.5,14,8,6,0.5710000000000001,6,1,4,4,200.28,194.96,197.62
2016-11-25,1610612755,1610612741,2016,89.0,105.0,194.0,97.85,106.0,94.0,91.0,15,4,11,0.267,15,9,6,0.6,4,0,4,5,207.68,185.44,196.56
2016-11-25,1610612765,1610612746,2016,108.0,97.0,205.0,100.85,105.95,109.85,106.5,16,7,9,0.438,16,14,2,0.875,6,1,7,7,206.0,214.36,210.18
2016-11-25,1610612762,1610612737,2016,95.0,68.0,163.0,95.55,106.55,96.35,95.7,16,8,8,0.5,15,10,5,0.667,3,5,6,4,200.2,199.44,199.82
2016-11-25,1610612749,1610612761,2016,99.0,105.0,204.0,99.8,108.15,100.6,99.2,13,6,7,0.462,15,9,6,0.6,5,1,4,5,200.48,206.0,203.24
2016-11-25,1610612763,1610612748,2016,81.0,90.0,171.0,98.25,97.5,97.25,95.5,15,10,5,0.667,14,4,10,0.28600000000000003,5,5,2,2,193.96,195.0,194.48000000000002
2016-11-25,1610612754,1610612751,2016,118.0,97.0,215.0,92.05,92.25,96.7,98.4,16,7,9,0.438,14,4,10,0.28600000000000003,6,1,3,1,187.28,196.96,192.12
2016-11-25,1610612743,1610612760,2016,129.0,132.0,261.0,109.2,110.3,101.8,103.4,15,6,9,0.4,16,8,8,0.5,3,3,6,2,217.04,210.36,213.7
2016-11-25,1610612756,1610612750,2016,85.0,98.0,183.0,106.25,103.85,110.05,111.2,16,5,11,0.313,14,4,10,0.28600000000000003,2,3,3,1,212.88,209.4,211.14
2016-11-25,1610612757,1610612740,2016,119.0,104.0,223.0,104.75,105.45,100.45,104.8,17,8,9,0.471,16,6,10,0.375,4,4,4,2,209.44,200.8,205.12
2016-11-25,1610612747,1610612744,2016,85.0,109.0,194.0,107.3,114.65,107.5,105.85,16,8,8,0.5,15,13,2,0.867,5,3,5,8,219.28,199.04,209.16
2016-11-25,1610612758,1610612745,2016,104.0,117.0,221.0,97.75,101.5,112.7,109.85,15,6,9,0.4,15,9,6,0.6,4,2,4,5,207.08,216.24,211.66000000000003
2016-11-23,1610612755,1610612763,2016,99.0,104.0,203.0,97.85,106.0,98.25,97.5,14,4,10,0.28600000000000003,14,9,5,0.643,4,0,5,4,207.68,193.96,200.82
2016-11-23,1610612766,1610612759,2016,114.0,119.0,233.0,99.45,97.7,107.75,96.55,13,8,5,0.615,14,11,3,0.7859999999999999,4,4,4,7,194.96,204.12,199.54000000000002
2016-11-23,1610612753,1610612756,2016,87.0,92.0,179.0,96.55,103.5,106.25,103.85,14,6,8,0.429,15,4,11,0.267,4,2,2,2,203.64,212.88,208.26
2016-11-23,1610612739,1610612757,2016,137.0,125.0,262.0,101.9,101.55,104.75,105.45,12,10,2,0.833,16,8,8,0.5,7,3,4,4,195.48,209.44,202.45999999999998
2016-11-23,1610612754,1610612737,2016,85.0,96.0,181.0,92.05,92.25,96.35,95.7,15,7,8,0.467,14,9,5,0.643,6,1,6,3,187.28,199.44,193.36
2016-11-23,1610612751,1610612738,2016,92.0,111.0,203.0,96.7,98.4,99.65,105.5,13,4,9,0.308,14,8,6,0.5710000000000001,3,1,4,4,196.96,195.08,196.02
2016-11-23,1610612765,1610612748,2016,107.0,84.0,191.0,100.85,105.95,97.25,95.5,15,6,9,0.4,13,4,9,0.308,5,1,2,2,206.0,195.0,200.5
2016-11-23,1610612745,1610612761,2016,102.0,115.0,217.0,112.7,109.85,100.6,99.2,14,9,5,0.643,14,8,6,0.5710000000000001,4,5,4,4,216.24,206.0,211.12
2016-11-23,1610612742,1610612746,2016,104.0,124.0,228.0,104.45,102.7,109.85,106.5,13,2,11,0.154,15,13,2,0.867,1,1,7,6,213.0,214.36,213.68
2016-11-23,1610612762,1610612743,2016,108.0,83.0,191.0,95.55,106.55,109.2,110.3,15,7,8,0.467,14,6,8,0.429,2,5,3,3,200.2,217.04,208.62
2016-11-23,1610612740,1610612750,2016,117.0,96.0,213.0,100.45,104.8,110.05,111.2,15,5,10,0.333,13,4,9,0.308,3,2,3,1,200.8,209.4,205.10000000000002
2016-11-23,1610612744,1610612747,2016,149.0,106.0,255.0,107.5,105.85,107.3,114.65,14,12,2,0.857,15,8,7,0.5329999999999999,4,8,5,3,199.04,219.28,209.16
2016-11-23,1610612758,1610612760,2016,116.0,101.0,217.0,97.75,101.5,101.8,103.4,14,5,9,0.35700000000000004,15,8,7,0.5329999999999999,3,2,6,2,207.08,210.36,208.72000000000003
2016-11-22,1610612752,1610612757,2016,107.0,103.0,210.0,101.2,97.2,104.75,105.45,13,6,7,0.462,15,8,7,0.5329999999999999,5,1,4,4,200.28,209.44,204.86
2016-11-22,1610612737,1610612740,2016,94.0,112.0,206.0,96.35,95.7,100.45,104.8,13,9,4,0.6920000000000001,14,4,10,0.28600000000000003,6,3,3,1,199.44,200.8,200.12
2016-11-22,1610612743,1610612741,2016,110.0,107.0,217.0,109.2,110.3,94.0,91.0,13,5,8,0.385,14,9,5,0.643,2,3,4,5,217.04,185.44,201.24
2016-11-22,1610612747,1610612760,2016,111.0,109.0,220.0,107.3,114.65,101.8,103.4,14,7,7,0.5,14,8,6,0.5710000000000001,4,3,6,2,219.28,210.36,214.82
2016-11-21,1610612755,1610612748,2016,101.0,94.0,195.0,97.85,106.0,97.25,95.5,13,3,10,0.231,12,4,8,0.333,3,0,2,2,207.68,195.0,201.34
2016-11-21,1610612764,1610612756,2016,106.0,101.0,207.0,94.7,91.35,106.25,103.85,12,3,9,0.25,14,4,10,0.28600000000000003,3,0,2,2,193.0,212.88,202.94
2016-11-21,1610612766,1610612763,2016,90.0,105.0,195.0,99.45,97.7,98.25,97.5,12,8,4,0.667,13,8,5,0.615,4,4,5,3,194.96,193.96,194.46
2016-11-21,1610612754,1610612744,2016,83.0,120.0,203.0,92.05,92.25,107.5,105.85,14,7,7,0.5,13,11,2,0.846,6,1,4,7,187.28,199.04,193.16
2016-11-21,1610612765,1610612745,2016,96.0,99.0,195.0,100.85,105.95,112.7,109.85,14,6,8,0.429,13,8,5,0.615,5,1,4,4,206.0,216.24,211.12
2016-11-21,1610612749,1610612753,2016,93.0,89.0,182.0,99.8,108.15,96.55,103.5,12,5,7,0.417,13,6,7,0.462,4,1,4,2,200.48,203.64,202.06
2016-11-21,1610612750,1610612738,2016,93.0,99.0,192.0,110.05,111.2,99.65,105.5,12,4,8,0.333,13,7,6,0.5379999999999999,3,1,4,3,209.4,195.08,202.24
2016-11-21,1610612759,1610612742,2016,96.0,91.0,187.0,107.75,96.55,104.45,102.7,13,10,3,0.769,12,2,10,0.16699999999999998,3,7,1,1,204.12,213.0,208.56
2016-11-21,1610612746,1610612761,2016,123.0,115.0,238.0,109.85,106.5,100.6,99.2,14,12,2,0.857,13,8,5,0.615,6,6,4,4,214.36,206.0,210.18
2016-11-20,1610612752,1610612737,2016,104.0,94.0,198.0,101.2,97.2,96.35,95.7,12,5,7,0.417,12,9,3,0.75,4,1,6,3,200.28,199.44,199.86
2016-11-20,1610612751,1610612757,2016,109.0,129.0,238.0,96.7,98.4,104.75,105.45,12,4,8,0.333,14,7,7,0.5,3,1,4,3,196.96,209.44,203.2
2016-11-20,1610612760,1610612754,2016,111.0,115.0,226.0,101.8,103.4,92.05,92.25,13,8,5,0.615,13,6,7,0.462,6,2,6,0,210.36,187.28,198.82
2016-11-20,1610612758,1610612761,2016,102.0,99.0,201.0,97.75,101.5,100.6,99.2,13,4,9,0.308,12,8,4,0.667,2,2,4,4,207.08,206.0,206.54000000000002
2016-11-20,1610612743,1610612762,2016,105.0,91.0,196.0,109.2,110.3,95.55,106.55,12,4,8,0.333,14,7,7,0.5,1,3,2,5,217.04,200.2,208.62
2016-11-20,1610612747,1610612741,2016,110.0,118.0,228.0,107.3,114.65,94.0,91.0,13,7,6,0.5379999999999999,13,8,5,0.615,4,3,4,4,219.28,185.44,202.36
2016-11-19,1610612745,1610612762,2016,111.0,102.0,213.0,112.7,109.85,95.55,106.55,12,7,5,0.583,13,7,6,0.5379999999999999,3,4,2,5,216.24,200.2,208.22
2016-11-19,1610612740,1610612766,2016,121.0,116.0,237.0,100.45,104.8,99.45,97.7,13,3,10,0.231,11,8,3,0.727,2,1,4,4,200.8,194.96,197.88
2016-11-19,1610612764,1610612748,2016,111.0,114.0,225.0,94.7,91.35,97.25,95.5,11,3,8,0.273,11,3,8,0.273,3,0,2,1,193.0,195.0,194.0
2016-11-19,1610612753,1610612742,2016,95.0,87.0,182.0,96.55,103.5,104.45,102.7,12,5,7,0.417,11,2,9,0.182,3,2,1,1,203.64,213.0,208.32
2016-11-19,1610612765,1610612738,2016,92.0,94.0,186.0,100.85,105.95,99.65,105.5,13,6,7,0.462,12,6,6,0.5,5,1,4,2,206.0,195.08,200.54000000000002
2016-11-19,1610612755,1610612756,2016,120.0,105.0,225.0,97.85,106.0,106.25,103.85,12,2,10,0.16699999999999998,13,4,9,0.308,2,0,2,2,207.68,212.88,210.28
2016-11-19,1610612763,1610612750,2016,93.0,71.0,164.0,98.25,97.5,110.05,111.2,12,7,5,0.583,11,4,7,0.364,4,3,3,1,193.96,209.4,201.68
2016-11-19,1610612749,1610612744,2016,121.0,124.0,245.0,99.8,108.15,107.5,105.85,11,5,6,0.455,12,10,2,0.833,4,1,4,6,200.48,199.04,199.76
2016-11-19,1610612746,1610612741,2016,102.0,95.0,197.0,109.85,106.5,94.0,91.0,13,11,2,0.846,12,8,4,0.667,5,6,4,4,214.36,185.44,199.9
2016-11-18,1610612766,1610612737,2016,100.0,96.0,196.0,99.45,97.7,96.35,95.7,10,7,3,0.7,11,9,2,0.818,3,4,6,3,194.96,199.44,197.2
2016-11-18,1610612754,1610612756,2016,96.0,116.0,212.0,92.05,92.25,106.25,103.85,12,6,6,0.5,12,3,9,0.25,6,0,2,1,187.28,212.88,200.07999999999998
2016-11-18,1610612739,1610612765,2016,104.0,81.0,185.0,101.9,101.55,100.85,105.95,11,9,2,0.818,12,6,6,0.5,6,3,5,1,195.48,206.0,200.74
2016-11-18,1610612740,1610612757,2016,113.0,101.0,214.0,100.45,104.8,104.75,105.45,12,2,10,0.16699999999999998,13,7,6,0.5379999999999999,1,1,4,3,200.8,209.44,205.12
2016-11-18,1610612760,1610612751,2016,124.0,105.0,229.0,101.8,103.4,96.7,98.4,12,7,5,0.583,11,4,7,0.364,5,2,3,1,210.36,196.96,203.66000000000003
2016-11-18,1610612738,1610612744,2016,88.0,104.0,192.0,99.65,105.5,107.5,105.85,11,6,5,0.545,11,9,2,0.818,4,2,4,5,195.08,199.04,197.06
2016-11-18,1610612742,1610612763,2016,64.0,80.0,144.0,104.45,102.7,98.25,97.5,10,2,8,0.2,11,6,5,0.545,1,1,4,2,213.0,193.96,203.48000000000002
2016-11-18,1610612743,1610612761,2016,111.0,113.0,224.0,109.2,110.3,100.6,99.2,11,4,7,0.364,11,7,4,0.636,1,3,4,3,217.04,206.0,211.51999999999998
2016-11-18,1610612747,1610612759,2016,107.0,116.0,223.0,107.3,114.65,107.75,96.55,12,7,5,0.583,12,9,3,0.75,4,3,3,6,219.28,204.12,211.7
2016-11-18,1610612758,1610612746,2016,115.0,121.0,236.0,97.75,101.5,109.85,106.5,12,4,8,0.333,12,10,2,0.833,2,2,5,5,207.08,214.36,210.72000000000003
2016-11-17,1610612764,1610612752,2016,119.0,112.0,231.0,94.7,91.35,101.2,97.2,10,2,8,0.2,11,5,6,0.455,2,0,4,1,193.0,200.28,196.64
2016-11-17,1610612748,1610612749,2016,96.0,73.0,169.0,97.25,95.5,99.8,108.15,10,2,8,0.2,10,5,5,0.5,1,1,4,1,195.0,200.48,197.74
2016-11-17,1610612745,1610612757,2016,126.0,109.0,235.0,112.7,109.85,104.75,105.45,11,6,5,0.545,12,7,5,0.583,2,4,4,3,216.24,209.44,212.84
2016-11-17,1610612750,1610612755,2016,110.0,86.0,196.0,110.05,111.2,97.85,106.0,10,3,7,0.3,11,2,9,0.182,2,1,2,0,209.4,207.68,208.54000000000002
2016-11-17,1610612762,1610612741,2016,77.0,85.0,162.0,95.55,106.55,94.0,91.0,12,7,5,0.583,11,7,4,0.636,2,5,4,3,200.2,185.44,192.82
2016-11-16,1610612755,1610612764,2016,109.0,102.0,211.0,97.85,106.0,94.7,91.35,10,1,9,0.1,9,2,7,0.222,1,0,2,0,207.68,193.0,200.34
2016-11-16,1610612753,1610612740,2016,89.0,82.0,171.0,96.55,103.5,100.45,104.8,11,4,7,0.364,11,2,9,0.182,2,2,1,1,203.64,200.8,202.22
2016-11-16,1610612754,1610612739,2016,103.0,93.0,196.0,92.05,92.25,101.9,101.55,11,5,6,0.455,10,9,1,0.9,5,0,6,3,187.28,195.48,191.38
2016-11-16,1610612738,1610612742,2016,90.0,83.0,173.0,99.65,105.5,104.45,102.7,10,5,5,0.5,9,2,7,0.222,3,2,1,1,195.08,213.0,204.04000000000002
2016-11-16,1610612752,1610612765,2016,105.0,102.0,207.0,101.2,97.2,100.85,105.95,10,4,6,0.4,11,6,5,0.545,3,1,5,1,200.28,206.0,203.14
2016-11-16,1610612737,1610612749,2016,107.0,100.0,207.0,96.35,95.7,99.8,108.15,10,8,2,0.8,9,5,4,0.556,5,3,4,1,199.44,200.48,199.95999999999998
2016-11-16,1610612760,1610612745,2016,105.0,103.0,208.0,101.8,103.4,112.7,109.85,11,6,5,0.545,10,6,4,0.6,4,2,2,4,210.36,216.24,213.3
2016-11-16,1610612761,1610612744,2016,121.0,127.0,248.0,100.6,99.2,107.5,105.85,10,7,3,0.7,10,8,2,0.8,4,3,4,4,206.0,199.04,202.51999999999998
2016-11-16,1610612743,1610612756,2016,120.0,104.0,224.0,109.2,110.3,106.25,103.85,10,3,7,0.3,11,3,8,0.273,0,3,2,1,217.04,212.88,214.95999999999998
2016-11-16,1610612746,1610612763,2016,107.0,111.0,218.0,109.85,106.5,98.25,97.5,11,10,1,0.909,10,5,5,0.5,5,5,4,1,214.36,193.96,204.16000000000003
2016-11-16,1610612758,1610612759,2016,105.0,110.0,215.0,97.75,101.5,107.75,96.55,11,4,7,0.364,11,8,3,0.727,2,2,3,5,207.08,204.12,205.60000000000002
2016-11-15,1610612739,1610612761,2016,121.0,117.0,238.0,101.9,101.55,100.6,99.2,9,8,1,0.889,9,7,2,0.778,5,3,4,3,195.48,206.0,200.74
2016-11-15,1610612748,1610612737,2016,90.0,93.0,183.0,97.25,95.5,96.35,95.7,9,2,7,0.222,9,7,2,0.778,1,1,5,2,195.0,199.44,197.22
2016-11-15,1610612750,1610612766,2016,108.0,115.0,223.0,110.05,111.2,99.45,97.7,9,3,6,0.333,9,6,3,0.667,2,1,3,3,209.4,194.96,202.18
2016-11-15,1610612757,1610612741,2016,88.0,113.0,201.0,104.75,105.45,94.0,91.0,11,7,4,0.636,10,6,4,0.6,4,3,4,2,209.44,185.44,197.44
2016-11-15,1610612747,1610612751,2016,125.0,118.0,243.0,107.3,114.65,96.7,98.4,11,6,5,0.545,10,4,6,0.4,3,3,3,1,219.28,196.96,208.12
2016-11-14,1610612754,1610612753,2016,88.0,69.0,157.0,92.05,92.25,96.55,103.5,10,4,6,0.4,10,4,6,0.4,4,0,2,2,187.28,203.64,195.45999999999998
2016-11-14,1610612752,1610612742,2016,93.0,77.0,170.0,101.2,97.2,104.45,102.7,9,3,6,0.333,8,2,6,0.25,2,1,1,1,200.28,213.0,206.64
2016-11-14,1610612765,1610612760,2016,104.0,88.0,192.0,100.85,105.95,101.8,103.4,10,5,5,0.5,10,6,4,0.6,4,1,4,2,206.0,210.36,208.18
2016-11-14,1610612740,1610612738,2016,106.0,105.0,211.0,100.45,104.8,99.65,105.5,10,1,9,0.1,9,5,4,0.556,0,1,3,2,200.8,195.08,197.94
2016-11-14,1610612745,1610612755,2016,115.0,88.0,203.0,112.7,109.85,97.85,106.0,9,5,4,0.556,9,1,8,0.111,1,4,1,0,216.24,207.68,211.96
2016-11-14,1610612759,1610612748,2016,94.0,90.0,184.0,107.75,96.55,97.25,95.5,10,7,3,0.7,8,2,6,0.25,2,5,1,1,204.12,195.0,199.56
2016-11-14,1610612762,1610612763,2016,96.0,102.0,198.0,95.55,106.55,98.25,97.5,11,7,4,0.636,9,4,5,0.444,2,5,4,0,200.2,193.96,197.07999999999998
2016-11-14,1610612746,1610612751,2016,127.0,95.0,222.0,109.85,106.5,96.7,98.4,10,9,1,0.9,9,4,5,0.444,4,5,3,1,214.36,196.96,205.66000000000003
2016-11-13,1610612739,1610612766,2016,100.0,93.0,193.0,101.9,101.55,99.45,97.7,8,7,1,0.875,8,6,2,0.75,4,3,3,3,195.48,194.96,195.22
2016-11-13,1610612760,1610612753,2016,117.0,119.0,236.0,101.8,103.4,96.55,103.5,9,6,3,0.667,9,3,6,0.333,4,2,2,1,210.36,203.64,207.0
2016-11-13,1610612750,1610612747,2016,125.0,99.0,224.0,110.05,111.2,107.3,114.65,8,2,6,0.25,10,6,4,0.6,1,1,3,3,209.4,219.28,214.34
2016-11-13,1610612744,1610612756,2016,133.0,120.0,253.0,107.5,105.85,106.25,103.85,9,7,2,0.778,10,3,7,0.3,3,4,2,1,199.04,212.88,205.95999999999998
2016-11-13,1610612757,1610612743,2016,112.0,105.0,217.0,104.75,105.45,109.2,110.3,10,6,4,0.6,9,3,6,0.333,3,3,0,3,209.44,217.04,213.24
2016-11-12,1610612740,1610612747,2016,99.0,126.0,225.0,100.45,104.8,107.3,114.65,9,1,8,0.111,9,5,4,0.556,0,1,3,2,200.8,219.28,210.04000000000002
2016-11-12,1610612754,1610612738,2016,99.0,105.0,204.0,92.05,92.25,99.65,105.5,9,4,5,0.444,8,4,4,0.5,4,0,3,1,187.28,195.08,191.18
2016-11-12,1610612761,1610612752,2016,118.0,107.0,225.0,100.6,99.2,101.2,97.2,8,6,2,0.75,8,3,5,0.375,3,3,2,1,206.0,200.28,203.14
2016-11-12,1610612737,1610612755,2016,117.0,96.0,213.0,96.35,95.7,97.85,106.0,8,6,2,0.75,8,1,7,0.125,4,2,1,0,199.44,207.68,203.56
2016-11-12,1610612741,1610612764,2016,106.0,95.0,201.0,94.0,91.0,94.7,91.35,9,5,4,0.556,8,2,6,0.25,3,2,2,0,185.44,193.0,189.22
2016-11-12,1610612745,1610612759,2016,100.0,106.0,206.0,112.7,109.85,107.75,96.55,8,5,3,0.625,9,6,3,0.667,1,4,2,4,216.24,204.12,210.18
2016-11-12,1610612750,1610612746,2016,105.0,119.0,224.0,110.05,111.2,109.85,106.5,7,2,5,0.28600000000000003,9,8,1,0.889,1,1,4,4,209.4,214.36,211.88
2016-11-12,1610612748,1610612762,2016,91.0,102.0,193.0,97.25,95.5,95.55,106.55,7,2,5,0.28600000000000003,10,6,4,0.6,1,1,2,4,195.0,200.2,197.6
2016-11-12,1610612749,1610612763,2016,106.0,96.0,202.0,99.8,108.15,98.25,97.5,8,4,4,0.5,8,4,4,0.5,3,1,4,0,200.48,193.96,197.22
2016-11-12,1610612743,1610612765,2016,95.0,106.0,201.0,109.2,110.3,100.85,105.95,8,3,5,0.375,9,4,5,0.444,0,3,4,0,217.04,206.0,211.51999999999998
2016-11-12,1610612756,1610612751,2016,104.0,122.0,226.0,106.25,103.85,96.7,98.4,9,3,6,0.333,8,3,5,0.375,2,1,3,0,212.88,196.96,204.92000000000002
2016-11-11,1610612755,1610612754,2016,109.0,105.0,214.0,97.85,106.0,92.05,92.25,7,0,7,0.0,8,4,4,0.5,0,0,4,0,207.68,187.28,197.48000000000002
2016-11-11,1610612764,1610612739,2016,94.0,105.0,199.0,94.7,91.35,101.9,101.55,7,2,5,0.28600000000000003,7,6,1,0.857,2,0,4,2,193.0,195.48,194.24
2016-11-11,1610612766,1610612761,2016,111.0,113.0,224.0,99.45,97.7,100.6,99.2,7,6,1,0.857,7,5,2,0.7140000000000001,3,3,3,2,194.96,206.0,200.48000000000002
2016-11-11,1610612753,1610612762,2016,74.0,87.0,161.0,96.55,103.5,95.55,106.55,8,3,5,0.375,9,5,4,0.556,2,1,2,3,203.64,200.2,201.92
2016-11-11,1610612738,1610612752,2016,115.0,87.0,202.0,99.65,105.5,101.2,97.2,7,3,4,0.429,7,3,4,0.429,2,1,2,1,195.08,200.28,197.68
2016-11-11,1610612760,1610612746,2016,108.0,110.0,218.0,101.8,103.4,109.85,106.5,8,6,2,0.75,8,7,1,0.875,4,2,4,3,210.36,214.36,212.36
2016-11-11,1610612759,1610612765,2016,96.0,86.0,182.0,107.75,96.55,100.85,105.95,8,5,3,0.625,8,4,4,0.5,1,4,4,0,204.12,206.0,205.06
2016-11-11,1610612757,1610612758,2016,122.0,120.0,242.0,104.75,105.45,97.75,101.5,9,5,4,0.556,10,4,6,0.4,2,3,2,2,209.44,207.08,208.26
2016-11-10,1610612749,1610612740,2016,106.0,112.0,218.0,99.8,108.15,100.45,104.8,7,4,3,0.5710000000000001,8,0,8,0.0,3,1,0,0,200.48,200.8,200.64
2016-11-10,1610612748,1610612741,2016,95.0,98.0,193.0,97.25,95.5,94.0,91.0,6,2,4,0.333,8,4,4,0.5,1,1,3,1,195.0,185.44,190.22
2016-11-10,1610612743,1610612744,2016,101.0,125.0,226.0,109.2,110.3,107.5,105.85,7,3,4,0.429,8,6,2,0.75,0,3,3,3,217.04,199.04,208.04
2016-11-10,1610612758,1610612747,2016,91.0,101.0,192.0,97.75,101.5,107.3,114.65,9,4,5,0.444,8,4,4,0.5,2,2,3,1,207.08,219.28,213.18
2016-11-09,1610612752,1610612751,2016,110.0,96.0,206.0,101.2,97.2,96.7,98.4,6,2,4,0.333,7,3,4,0.429,1,1,3,0,200.28,196.96,198.62
2016-11-09,1610612764,1610612738,2016,118.0,93.0,211.0,94.7,91.35,99.65,105.5,6,1,5,0.16699999999999998,6,3,3,0.5,1,0,2,1,193.0,195.08,194.04000000000002
2016-11-09,1610612766,1610612762,2016,104.0,98.0,202.0,99.45,97.7,95.55,106.55,6,5,1,0.833,8,5,3,0.625,2,3,2,3,194.96,200.2,197.57999999999998
2016-11-09,1610612753,1610612750,2016,107.0,123.0,230.0,96.55,103.5,110.05,111.2,7,3,4,0.429,6,1,5,0.16699999999999998,2,1,1,0,203.64,209.4,206.51999999999998
2016-11-09,1610612754,1610612755,2016,122.0,115.0,237.0,92.05,92.25,97.85,106.0,7,3,4,0.429,6,0,6,0.0,3,0,0,0,187.28,207.68,197.48000000000002
2016-11-09,1610612737,1610612741,2016,115.0,107.0,222.0,96.35,95.7,94.0,91.0,7,5,2,0.7140000000000001,7,4,3,0.5710000000000001,3,2,3,1,199.44,185.44,192.44
2016-11-09,1610612760,1610612761,2016,102.0,112.0,214.0,101.8,103.4,100.6,99.2,7,6,1,0.857,6,4,2,0.667,4,2,3,1,210.36,206.0,208.18
2016-11-09,1610612756,1610612765,2016,107.0,100.0,207.0,106.25,103.85,100.85,105.95,8,2,6,0.25,7,4,3,0.5710000000000001,1,1,4,0,212.88,206.0,209.44
2016-11-09,1610612759,1610612745,2016,99.0,101.0,200.0,107.75,96.55,112.7,109.85,7,5,2,0.7140000000000001,7,4,3,0.5710000000000001,1,4,1,3,204.12,216.24,210.18
2016-11-09,1610612746,1610612757,2016,111.0,80.0,191.0,109.85,106.5,104.75,105.45,7,6,1,0.857,8,5,3,0.625,3,3,2,3,214.36,209.44,211.9
2016-11-09,1610612744,1610612742,2016,116.0,95.0,211.0,107.5,105.85,104.45,102.7,7,5,2,0.7140000000000001,7,2,5,0.28600000000000003,2,3,1,1,199.04,213.0,206.01999999999998
2016-11-08,1610612739,1610612737,2016,106.0,110.0,216.0,101.9,101.55,96.35,95.7,6,6,0,1.0,6,4,2,0.667,4,2,3,1,195.48,199.44,197.45999999999998
2016-11-08,1610612751,1610612750,2016,119.0,110.0,229.0,96.7,98.4,110.05,111.2,6,2,4,0.333,5,1,4,0.2,2,0,1,0,196.96,209.4,203.18
2016-11-08,1610612763,1610612743,2016,108.0,107.0,215.0,98.25,97.5,109.2,110.3,7,3,4,0.429,6,3,3,0.5,3,0,0,3,193.96,217.04,205.5
2016-11-08,1610612757,1610612756,2016,124.0,121.0,245.0,104.75,105.45,106.25,103.85,7,4,3,0.5710000000000001,7,2,5,0.28600000000000003,1,3,1,1,209.44,212.88,211.16
2016-11-08,1610612747,1610612742,2016,97.0,109.0,206.0,107.3,114.65,104.45,102.7,7,4,3,0.5710000000000001,6,1,5,0.16699999999999998,3,1,1,0,219.28,213.0,216.14
2016-11-08,1610612758,1610612740,2016,102.0,94.0,196.0,97.75,101.5,100.45,104.8,8,3,5,0.375,7,0,7,0.0,1,2,0,0,207.08,200.8,203.94
2016-11-07,1610612755,1610612762,2016,84.0,109.0,193.0,97.85,106.0,95.55,106.55,5,0,5,0.0,7,4,3,0.5710000000000001,0,0,2,2,207.68,200.2,203.94
2016-11-07,1610612764,1610612745,2016,106.0,114.0,220.0,94.7,91.35,112.7,109.85,5,1,4,0.2,6,3,3,0.5,1,0,1,2,193.0,216.24,204.62
2016-11-07,1610612766,1610612754,2016,122.0,100.0,222.0,99.45,97.7,92.05,92.25,5,4,1,0.8,6,3,3,0.5,1,3,3,0,194.96,187.28,191.12
2016-11-07,1610612741,1610612753,2016,112.0,80.0,192.0,94.0,91.0,96.55,103.5,6,3,3,0.5,6,3,3,0.5,2,1,2,1,185.44,203.64,194.54
2016-11-07,1610612760,1610612748,2016,97.0,85.0,182.0,101.8,103.4,97.25,95.5,6,5,1,0.833,5,2,3,0.4,3,2,1,1,210.36,195.0,202.68
2016-11-07,1610612746,1610612765,2016,114.0,82.0,196.0,109.85,106.5,100.85,105.95,6,5,1,0.833,6,4,2,0.667,2,3,4,0,214.36,206.0,210.18
2016-11-07,1610612744,1610612740,2016,116.0,106.0,222.0,107.5,105.85,100.45,104.8,6,4,2,0.667,6,0,6,0.0,1,3,0,0,199.04,200.8,199.92000000000002
2016-11-06,1610612752,1610612762,2016,109.0,114.0,223.0,101.2,97.2,95.55,106.55,5,2,3,0.4,6,3,3,0.5,1,1,2,1,200.28,200.2,200.24
2016-11-06,1610612763,1610612757,2016,94.0,100.0,194.0,98.25,97.5,104.75,105.45,6,3,3,0.5,6,3,3,0.5,3,0,1,2,193.96,209.44,201.7
2016-11-06,1610612761,1610612758,2016,91.0,96.0,187.0,100.6,99.2,97.75,101.5,5,4,1,0.8,7,2,5,0.28600000000000003,3,1,1,1,206.0,207.08,206.54000000000002
2016-11-06,1610612742,1610612749,2016,86.0,75.0,161.0,104.45,102.7,99.8,108.15,5,0,5,0.0,6,4,2,0.667,0,0,3,1,213.0,200.48,206.74
2016-11-06,1610612738,1610612743,2016,107.0,123.0,230.0,99.65,105.5,109.2,110.3,5,3,2,0.6,5,2,3,0.4,2,1,0,2,195.08,217.04,206.06
2016-11-06,1610612747,1610612756,2016,119.0,108.0,227.0,107.3,114.65,106.25,103.85,6,3,3,0.5,6,2,4,0.333,2,1,1,1,219.28,212.88,216.07999999999998
2016-11-05,1610612760,1610612750,2016,112.0,92.0,204.0,101.8,103.4,110.05,111.2,5,4,1,0.8,4,1,3,0.25,2,2,1,0,210.36,209.4,209.88
2016-11-05,1610612755,1610612739,2016,101.0,102.0,203.0,97.85,106.0,101.9,101.55,4,0,4,0.0,5,5,0,1.0,0,0,4,1,207.68,195.48,201.57999999999998
2016-11-05,1610612753,1610612764,2016,88.0,86.0,174.0,96.55,103.5,94.7,91.35,5,2,3,0.4,4,1,3,0.25,1,1,1,0,203.64,193.0,198.32
2016-11-05,1610612765,1610612743,2016,103.0,86.0,189.0,100.85,105.95,109.2,110.3,5,3,2,0.6,4,2,2,0.5,3,0,0,2,206.0,217.04,211.51999999999998
2016-11-05,1610612754,1610612741,2016,111.0,94.0,205.0,92.05,92.25,94.0,91.0,5,2,3,0.4,5,3,2,0.6,2,0,2,1,187.28,185.44,186.36
2016-11-05,1610612737,1610612745,2016,112.0,97.0,209.0,96.35,95.7,112.7,109.85,5,3,2,0.6,5,3,2,0.6,2,1,1,2,199.44,216.24,207.84
2016-11-05,1610612749,1610612758,2016,117.0,91.0,208.0,99.8,108.15,97.75,101.5,5,3,2,0.6,6,2,4,0.333,2,1,1,1,200.48,207.08,203.78
2016-11-05,1610612759,1610612746,2016,92.0,116.0,208.0,107.75,96.55,109.85,106.5,6,5,1,0.833,5,4,1,0.8,1,4,2,2,204.12,214.36,209.24
2016-11-04,1610612764,1610612737,2016,95.0,92.0,187.0,94.7,91.35,96.35,95.7,3,0,3,0.0,4,3,1,0.75,0,0,2,1,193.0,199.44,196.22
2016-11-04,1610612761,1610612748,2016,96.0,87.0,183.0,100.6,99.2,97.25,95.5,4,3,1,0.75,4,2,2,0.5,2,1,1,1,206.0,195.0,200.5
2016-11-04,1610612751,1610612766,2016,95.0,99.0,194.0,96.7,98.4,99.45,97.7,5,2,3,0.4,4,3,1,0.75,2,0,1,2,196.96,194.96,195.96
2016-11-04,1610612741,1610612752,2016,104.0,117.0,221.0,94.0,91.0,101.2,97.2,4,3,1,0.75,4,1,3,0.25,2,1,1,0,185.44,200.28,192.86
2016-11-04,1610612763,1610612746,2016,88.0,99.0,187.0,98.25,97.5,109.85,106.5,5,3,2,0.6,4,3,1,0.75,3,0,2,1,193.96,214.36,204.16000000000003
2016-11-04,1610612740,1610612756,2016,111.0,112.0,223.0,100.45,104.8,106.25,103.85,5,0,5,0.0,5,1,4,0.2,0,0,1,0,200.8,212.88,206.84
2016-11-04,1610612742,1610612757,2016,95.0,105.0,200.0,104.45,102.7,104.75,105.45,4,0,4,0.0,5,2,3,0.4,0,0,1,1,213.0,209.44,211.22
2016-11-04,1610612762,1610612759,2016,86.0,100.0,186.0,95.55,106.55,107.75,96.55,5,3,2,0.6,5,4,1,0.8,2,1,1,3,200.2,204.12,202.16
2016-11-04,1610612747,1610612744,2016,117.0,97.0,214.0,107.3,114.65,107.5,105.85,5,2,3,0.4,5,4,1,0.8,1,1,1,3,219.28,199.04,209.16
2016-11-03,1610612753,1610612758,2016,102.0,94.0,196.0,96.55,103.5,97.75,101.5,4,1,3,0.25,5,2,3,0.4,0,1,1,1,203.64,207.08,205.36
2016-11-03,1610612749,1610612754,2016,125.0,107.0,232.0,99.8,108.15,92.05,92.25,4,2,2,0.5,4,2,2,0.5,1,1,2,0,200.48,187.28,193.88
2016-11-03,1610612750,1610612743,2016,99.0,102.0,201.0,110.05,111.2,109.2,110.3,3,1,2,0.333,3,1,2,0.333,1,0,0,1,209.4,217.04,213.22
2016-11-03,1610612739,1610612738,2016,128.0,122.0,250.0,101.9,101.55,99.65,105.5,4,4,0,1.0,4,3,1,0.75,3,1,2,1,195.48,195.08,195.28
2016-11-03,1610612744,1610612760,2016,122.0,96.0,218.0,107.5,105.85,101.8,103.4,4,3,1,0.75,4,4,0,1.0,0,3,2,2,199.04,210.36,204.7
2016-11-02,1610612764,1610612761,2016,103.0,113.0,216.0,94.7,91.35,100.6,99.2,2,0,2,0.0,3,2,1,0.667,0,0,2,0,193.0,206.0,199.5
2016-11-02,1610612766,1610612755,2016,109.0,93.0,202.0,99.45,97.7,97.85,106.0,3,2,1,0.667,3,0,3,0.0,0,2,0,0,194.96,207.68,201.32
2016-11-02,1610612751,1610612765,2016,109.0,101.0,210.0,96.7,98.4,100.85,105.95,4,1,3,0.25,4,3,1,0.75,1,0,3,0,196.96,206.0,201.48000000000002
2016-11-02,1610612752,1610612745,2016,99.0,118.0,217.0,101.2,97.2,112.7,109.85,3,1,2,0.333,4,2,2,0.5,1,0,1,1,200.28,216.24,208.26
2016-11-02,1610612737,1610612747,2016,116.0,123.0,239.0,96.35,95.7,107.3,114.65,3,3,0,1.0,4,1,3,0.25,2,1,1,0,199.44,219.28,209.36
2016-11-02,1610612763,1610612740,2016,89.0,83.0,172.0,98.25,97.5,100.45,104.8,4,2,2,0.5,4,0,4,0.0,2,0,0,0,193.96,200.8,197.38
2016-11-02,1610612738,1610612741,2016,107.0,100.0,207.0,99.65,105.5,94.0,91.0,3,2,1,0.667,3,3,0,1.0,1,1,2,1,195.08,185.44,190.26
2016-11-02,1610612762,1610612742,2016,97.0,81.0,178.0,95.55,106.55,104.45,102.7,4,2,2,0.5,3,0,3,0.0,1,1,0,0,200.2,213.0,206.6
2016-11-02,1610612756,1610612757,2016,118.0,115.0,233.0,106.25,103.85,104.75,105.45,4,0,4,0.0,4,2,2,0.5,0,0,1,1,212.88,209.44,211.16
2016-11-02,1610612746,1610612760,2016,83.0,85.0,168.0,109.85,106.5,101.8,103.4,3,3,0,1.0,3,3,0,1.0,2,1,2,1,214.36,210.36,212.36
2016-11-01,1610612739,1610612745,2016,128.0,120.0,248.0,101.9,101.55,112.7,109.85,3,3,0,1.0,3,2,1,0.667,2,1,1,1,195.48,216.24,205.86
2016-11-01,1610612755,1610612753,2016,101.0,103.0,204.0,97.85,106.0,96.55,103.5,2,0,2,0.0,3,0,3,0.0,0,0,0,0,207.68,203.64,205.66
2016-11-01,1610612754,1610612747,2016,115.0,108.0,223.0,92.05,92.25,107.3,114.65,3,1,2,0.333,3,1,2,0.333,1,0,1,0,187.28,219.28,203.28
2016-11-01,1610612748,1610612758,2016,108.0,96.0,204.0,97.25,95.5,97.75,101.5,3,1,2,0.333,4,2,2,0.5,0,1,1,1,195.0,207.08,201.04000000000002
2016-11-01,1610612765,1610612752,2016,102.0,89.0,191.0,100.85,105.95,101.2,97.2,3,2,1,0.667,2,1,1,0.5,2,0,1,0,206.0,200.28,203.14
2016-11-01,1610612740,1610612749,2016,113.0,117.0,230.0,100.45,104.8,99.8,108.15,3,0,3,0.0,3,1,2,0.333,0,0,1,0,200.8,200.48,200.64
2016-11-01,1610612750,1610612763,2016,116.0,80.0,196.0,110.05,111.2,98.25,97.5,2,0,2,0.0,3,2,1,0.667,0,0,2,0,209.4,193.96,201.68
2016-11-01,1610612759,1610612762,2016,91.0,106.0,197.0,107.75,96.55,95.55,106.55,4,4,0,1.0,3,1,2,0.333,1,3,1,0,204.12,200.2,202.16
2016-11-01,1610612757,1610612744,2016,104.0,127.0,231.0,104.75,105.45,107.5,105.85,3,2,1,0.667,3,2,1,0.667,1,1,0,2,209.44,199.04,204.24
2016-10-31,1610612761,1610612743,2016,105.0,102.0,207.0,100.6,99.2,109.2,110.3,2,1,1,0.5,2,1,1,0.5,1,0,0,1,206.0,217.04,211.51999999999998
2016-10-31,1610612751,1610612741,2016,88.0,118.0,206.0,96.7,98.4,94.0,91.0,3,1,2,0.333,2,2,0,1.0,1,0,2,0,196.96,185.44,191.2
2016-10-31,1610612737,1610612758,2016,106.0,95.0,201.0,96.35,95.7,97.75,101.5,2,2,0,1.0,3,2,1,0.667,1,1,1,1,199.44,207.08,203.26
2016-10-31,1610612746,1610612756,2016,116.0,98.0,214.0,109.85,106.5,106.25,103.85,2,2,0,1.0,3,0,3,0.0,1,1,0,0,214.36,212.88,213.62
2016-10-30,1610612746,1610612762,2016,88.0,75.0,163.0,109.85,106.5,95.55,106.55,1,1,0,1.0,2,1,1,0.5,0,1,1,0,214.36,200.2,207.28
2016-10-30,1610612756,1610612744,2016,100.0,106.0,206.0,106.25,103.85,107.5,105.85,2,0,2,0.0,2,1,1,0.5,0,0,0,1,212.88,199.04,205.95999999999998
2016-10-30,1610612748,1610612759,2016,99.0,106.0,205.0,97.25,95.5,107.75,96.55,2,1,1,0.5,3,3,0,1.0,0,1,1,2,195.0,204.12,199.56
2016-10-30,1610612765,1610612749,2016,98.0,83.0,181.0,100.85,105.95,99.8,108.15,2,1,1,0.5,2,1,1,0.5,1,0,1,0,206.0,200.48,203.24
2016-10-30,1610612760,1610612747,2016,113.0,96.0,209.0,101.8,103.4,107.3,114.65,2,2,0,1.0,2,1,1,0.5,1,1,1,0,210.36,219.28,214.82
2016-10-30,1610612763,1610612764,2016,112.0,103.0,215.0,98.25,97.5,94.7,91.35,2,1,1,0.5,1,0,1,0.0,1,0,0,0,193.96,193.0,193.48000000000002
2016-10-30,1610612745,1610612742,2016,93.0,92.0,185.0,112.7,109.85,104.45,102.7,2,1,1,0.5,2,0,2,0.0,0,1,0,0,216.24,213.0,214.62
2016-10-29,1610612755,1610612737,2016,72.0,104.0,176.0,97.85,106.0,96.35,95.7,1,0,1,0.0,1,1,0,1.0,0,0,1,0,207.68,199.44,203.56
2016-10-29,1610612766,1610612738,2016,98.0,104.0,202.0,99.45,97.7,99.65,105.5,2,2,0,1.0,2,1,1,0.5,0,2,1,0,194.96,195.08,195.02
2016-10-29,1610612752,1610612763,2016,111.0,104.0,215.0,101.2,97.2,98.25,97.5,1,0,1,0.0,1,1,0,1.0,0,0,1,0,200.28,193.96,197.12
2016-10-29,1610612739,1610612753,2016,105.0,99.0,204.0,101.9,101.55,96.55,103.5,2,2,0,1.0,2,0,2,0.0,1,1,0,0,195.48,203.64,199.56
2016-10-29,1610612741,1610612754,2016,118.0,101.0,219.0,94.0,91.0,92.05,92.25,1,1,0,1.0,2,1,1,0.5,1,0,1,0,185.44,187.28,186.36
2016-10-29,1610612749,1610612751,2016,110.0,108.0,218.0,99.8,108.15,96.7,98.4,1,0,1,0.0,2,1,1,0.5,0,0,1,0,200.48,196.96,198.72
2016-10-29,1610612759,1610612740,2016,98.0,79.0,177.0,107.75,96.55,100.45,104.8,2,2,0,1.0,2,0,2,0.0,0,2,0,0,204.12,200.8,202.46
2016-10-29,1610612743,1610612757,2016,113.0,115.0,228.0,109.2,110.3,104.75,105.45,1,1,0,1.0,2,1,1,0.5,0,1,1,0,217.04,209.44,213.24
2016-10-29,1610612758,1610612750,2016,106.0,103.0,209.0,97.75,101.5,110.05,111.2,2,1,1,0.5,1,0,1,0.0,0,1,0,0,207.08,209.4,208.24
2016-10-28,1610612761,1610612739,2016,91.0,94.0,185.0,100.6,99.2,101.9,101.55,1,1,0,1.0,1,1,0,1.0,1,0,1,0,206.0,195.48,200.74
2016-10-28,1610612751,1610612754,2016,103.0,94.0,197.0,96.7,98.4,92.05,92.25,1,0,1,0.0,1,1,0,1.0,0,0,1,0,196.96,187.28,192.12
2016-10-28,1610612765,1610612753,2016,108.0,82.0,190.0,100.85,105.95,96.55,103.5,1,0,1,0.0,1,0,1,0.0,0,0,0,0,206.0,203.64,204.82
2016-10-28,1610612760,1610612756,2016,113.0,110.0,223.0,101.8,103.4,106.25,103.85,1,1,0,1.0,1,0,1,0.0,0,1,0,0,210.36,212.88,211.62
2016-10-28,1610612748,1610612766,2016,91.0,97.0,188.0,97.25,95.5,99.45,97.7,1,1,0,1.0,1,1,0,1.0,0,1,0,1,195.0,194.96,194.98000000000002
2016-10-28,1610612742,1610612745,2016,98.0,106.0,204.0,104.45,102.7,112.7,109.85,1,0,1,0.0,1,0,1,0.0,0,0,0,0,213.0,216.24,214.62
2016-10-28,1610612762,1610612747,2016,96.0,89.0,185.0,95.55,106.55,107.3,114.65,1,0,1,0.0,1,1,0,1.0,0,0,1,0,200.2,219.28,209.74
2016-10-28,1610612740,1610612744,2016,114.0,122.0,236.0,100.45,104.8,107.5,105.85,1,0,1,0.0,1,0,1,0.0,0,0,0,0,200.8,199.04,199.92000000000002
2016-10-27,1610612737,1610612764,2016,114.0,99.0,213.0,96.35,95.7,94.7,91.35,0,0,0,0.0,0,0,0,0.0,0,0,0,0,199.44,193.0,196.22
2016-10-27,1610612741,1610612738,2016,105.0,99.0,204.0,94.0,91.0,99.65,105.5,0,0,0,0.0,1,1,0,1.0,0,0,1,0,185.44,195.08,190.26
2016-10-27,1610612758,1610612759,2016,94.0,102.0,196.0,97.75,101.5,107.75,96.55,1,1,0,1.0,1,1,0,1.0,0,1,0,1,207.08,204.12,205.60000000000002
2016-10-27,1610612757,1610612746,2016,106.0,114.0,220.0,104.75,105.45,109.85,106.5,1,1,0,1.0,0,0,0,0.0,1,0,0,0,209.44,214.36,211.9
2016-10-26,1610612753,1610612748,2016,96.0,108.0,204.0,96.55,103.5,97.25,95.5,0,0,0,0.0,0,0,0,0.0,0,0,0,0,203.64,195.0,199.32
2016-10-26,1610612754,1610612742,2016,130.0,121.0,251.0,92.05,92.25,104.45,102.7,0,0,0,0.0,0,0,0,0.0,0,0,0,0,187.28,213.0,200.14
2016-10-26,1610612738,1610612751,2016,122.0,117.0,239.0,99.65,105.5,96.7,98.4,0,0,0,0.0,0,0,0,0.0,0,0,0,0,195.08,196.96,196.02
2016-10-26,1610612761,1610612765,2016,109.0,91.0,200.0,100.6,99.2,100.85,105.95,0,0,0,0.0,0,0,0,0.0,0,0,0,0,206.0,206.0,206.0
2016-10-26,1610612749,1610612766,2016,96.0,107.0,203.0,99.8,108.15,99.45,97.7,0,0,0,0.0,0,0,0,0.0,0,0,0,0,200.48,194.96,197.72
2016-10-26,1610612763,1610612750,2016,102.0,98.0,200.0,98.25,97.5,110.05,111.2,0,0,0,0.0,0,0,0,0.0,0,0,0,0,193.96,209.4,201.68
2016-10-26,1610612740,1610612743,2016,102.0,107.0,209.0,100.45,104.8,109.2,110.3,0,0,0,0.0,0,0,0,0.0,0,0,0,0,200.8,217.04,208.92000000000002
2016-10-26,1610612755,1610612760,2016,97.0,103.0,200.0,97.85,106.0,101.8,103.4,0,0,0,0.0,0,0,0,0.0,0,0,0,0,207.68,210.36,209.02
2016-10-26,1610612756,1610612758,2016,94.0,113.0,207.0,106.25,103.85,97.75,101.5,0,0,0,0.0,0,0,0,0.0,0,0,0,0,212.88,207.08,209.98000000000002
2016-10-26,1610612747,1610612745,2016,120.0,114.0,234.0,107.3,114.65,112.7,109.85,0,0,0,0.0,0,0,0,0.0,0,0,0,0,219.28,216.24,217.76
2016-10-25,1610612739,1610612752,2016,117.0,88.0,205.0,101.9,101.55,101.2,97.2,6,2,4,0.333,6,4,2,0.667,2,0,2,2,195.48,200.28,197.88
2016-10-25,1610612757,1610612762,2016,113.0,104.0,217.0,104.75,105.45,95.55,106.55,7,4,3,0.5710000000000001,6,3,3,0.5,2,2,1,2,209.44,200.2,204.82
2016-10-25,1610612744,1610612759,2016,100.0,129.0,229.0,107.5,105.85,107.75,96.55,7,6,1,0.857,6,4,2,0.667,3,3,2,2,199.04,204.12,201.57999999999998
2016-10-21,1610612764,1610612761,2016,119.0,82.0,201.0,94.7,91.35,100.6,99.2,6,3,3,0.5,6,4,2,0.667,1,2,2,2,193.0,206.0,199.5
2016-10-21,1610612748,1610612755,2016,110.0,113.0,223.0,97.25,95.5,97.85,106.0,7,4,3,0.5710000000000001,6,1,5,0.16699999999999998,2,2,1,0,195.0,207.68,201.34
2016-10-21,1610612750,1610612766,2016,109.0,74.0,183.0,110.05,111.2,99.45,97.7,6,4,2,0.667,6,3,3,0.5,2,2,2,1,209.4,194.96,202.18
2016-10-21,1610612759,1610612745,2016,114.0,99.0,213.0,107.75,96.55,112.7,109.85,5,3,2,0.6,6,5,1,0.833,1,2,3,2,204.12,216.24,210.18
2016-10-21,1610612743,1610612742,2016,101.0,75.0,176.0,109.2,110.3,104.45,102.7,7,3,4,0.429,6,2,4,0.333,0,3,2,0,217.04,213.0,215.01999999999998
2016-10-21,1610612747,1610612756,2016,94.0,98.0,192.0,107.3,114.65,106.25,103.85,7,2,5,0.28600000000000003,5,3,2,0.6,2,0,2,1,219.28,212.88,216.07999999999998
2016-10-21,1610612744,1610612757,2016,107.0,96.0,203.0,107.5,105.85,104.75,105.45,6,5,1,0.833,6,4,2,0.667,2,3,2,2,199.04,209.44,204.24
2016-10-20,1610612766,1610612748,2016,96.0,88.0,184.0,99.45,97.7,97.25,95.5,5,2,3,0.4,6,4,2,0.667,1,1,2,2,194.96,195.0,194.98000000000002
2016-10-20,1610612753,1610612740,2016,114.0,111.0,225.0,96.55,103.5,100.45,104.8,6,1,5,0.16699999999999998,5,1,4,0.2,1,0,1,0,203.64,200.8,202.22
2016-10-20,1610612751,1610612752,2016,111.0,116.0,227.0,96.7,98.4,101.2,97.2,5,1,4,0.2,5,3,2,0.6,1,0,2,1,196.96,200.28,198.62
2016-10-20,1610612741,1610612737,2016,81.0,97.0,178.0,94.0,91.0,96.35,95.7,6,3,3,0.5,6,4,2,0.667,2,1,2,2,185.44,199.44,192.44
2016-10-19,1610612738,1610612752,2016,96.0,121.0,217.0,99.65,105.5,101.2,97.2,6,5,1,0.833,4,2,2,0.5,2,3,2,0,195.08,200.28,197.68
2016-10-19,1610612765,1610612761,2016,92.0,103.0,195.0,100.85,105.95,100.6,99.2,5,3,2,0.6,5,3,2,0.6,1,2,2,1,206.0,206.0,206.0
2016-10-19,1610612749,1610612754,2016,111.0,103.0,214.0,99.8,108.15,92.05,92.25,5,2,3,0.4,5,3,2,0.6,1,1,2,1,200.48,187.28,193.88
2016-10-19,1610612750,1610612763,2016,101.0,94.0,195.0,110.05,111.2,98.25,97.5,5,3,2,0.6,5,4,1,0.8,1,2,2,2,209.4,193.96,201.68
2016-10-19,1610612742,1610612745,2016,91.0,106.0,197.0,104.45,102.7,112.7,109.85,5,2,3,0.4,5,4,1,0.8,2,0,3,1,213.0,216.24,214.62
2016-10-19,1610612762,1610612757,2016,84.0,88.0,172.0,95.55,106.55,104.75,105.45,5,3,2,0.6,5,3,2,0.6,1,2,2,1,200.2,209.44,204.82
2016-10-19,1610612747,1610612744,2016,112.0,123.0,235.0,107.3,114.65,107.5,105.85,6,2,4,0.333,5,4,1,0.8,2,0,2,2,219.28,199.04,209.16
2016-10-18,1610612739,1610612764,2016,91.0,96.0,187.0,101.9,101.55,94.7,91.35,5,2,3,0.4,5,2,3,0.4,2,0,1,1,195.48,193.0,194.24
2016-10-18,1610612737,1610612740,2016,96.0,89.0,185.0,96.35,95.7,100.45,104.8,5,3,2,0.6,4,1,3,0.25,1,2,1,0,199.44,200.8,200.12
2016-10-18,1610612748,1610612753,2016,107.0,77.0,184.0,97.25,95.5,96.55,103.5,5,3,2,0.6,5,1,4,0.2,1,2,1,0,195.0,203.64,199.32
2016-10-18,1610612760,1610612743,2016,97.0,87.0,184.0,101.8,103.4,109.2,110.3,5,2,3,0.4,6,3,3,0.5,1,1,0,3,210.36,217.04,213.7
2016-10-18,1610612758,1610612746,2016,89.0,92.0,181.0,97.75,101.5,109.85,106.5,5,3,2,0.6,5,2,3,0.4,2,1,2,0,207.08,214.36,210.72000000000003
2016-10-17,1610612738,1610612751,2016,120.0,99.0,219.0,99.65,105.5,96.7,98.4,5,4,1,0.8,4,1,3,0.25,1,3,1,0,195.08,196.96,196.02
2016-10-17,1610612765,1610612749,2016,102.0,78.0,180.0,100.85,105.95,99.8,108.15,4,2,2,0.5,4,2,2,0.5,0,2,1,1,206.0,200.48,203.24
2016-10-17,1610612741,1610612766,2016,104.0,108.0,212.0,94.0,91.0,99.45,97.7,5,3,2,0.6,4,1,3,0.25,2,1,1,0,185.44,194.96,190.2
2016-10-17,1610612762,1610612746,2016,104.0,78.0,182.0,95.55,106.55,109.85,106.5,4,2,2,0.5,4,2,2,0.5,0,2,2,0,200.2,214.36,207.28
2016-10-16,1610612753,1610612737,2016,98.0,105.0,203.0,96.55,103.5,96.35,95.7,4,1,3,0.25,4,2,2,0.5,1,0,1,1,203.64,199.44,201.54
2016-10-16,1610612760,1610612750,2016,112.0,94.0,206.0,101.8,103.4,110.05,111.2,4,1,3,0.25,4,3,1,0.75,0,1,1,2,210.36,209.4,209.88
2016-10-16,1610612757,1610612743,2016,97.0,106.0,203.0,104.75,105.45,109.2,110.3,4,3,1,0.75,5,2,3,0.4,2,1,0,2,209.44,217.04,213.24
2016-10-15,1610612755,1610612765,2016,76.0,97.0,173.0,97.85,106.0,100.85,105.95,5,1,4,0.2,3,1,2,0.333,1,0,0,1,207.68,206.0,206.84
2016-10-15,1610612758,1610612764,2016,124.0,119.0,243.0,97.75,101.5,94.7,91.35,4,2,2,0.5,4,2,2,0.5,1,1,1,1,207.08,193.0,200.04000000000002
2016-10-15,1610612752,1610612738,2016,107.0,119.0,226.0,101.2,97.2,99.65,105.5,3,2,1,0.667,4,3,1,0.75,2,0,1,2,200.28,195.08,197.68
2016-10-15,1610612748,1610612750,2016,96.0,101.0,197.0,97.25,95.5,110.05,111.2,4,3,1,0.75,3,2,1,0.667,1,2,1,1,195.0,209.4,202.2
2016-10-15,1610612745,1610612763,2016,125.0,134.0,259.0,112.7,109.85,98.25,97.5,4,4,0,1.0,4,3,1,0.75,3,1,2,1,216.24,193.96,205.10000000000002
2016-10-15,1610612749,1610612741,2016,86.0,107.0,193.0,99.8,108.15,94.0,91.0,3,2,1,0.667,4,2,2,0.5,1,1,2,0,200.48,185.44,192.95999999999998
2016-10-15,1610612747,1610612744,2016,107.0,112.0,219.0,107.3,114.65,107.5,105.85,5,2,3,0.4,4,3,1,0.75,2,0,2,1,219.28,199.04,209.16
2016-10-14,1610612753,1610612754,2016,114.0,106.0,220.0,96.55,103.5,92.05,92.25,3,0,3,0.0,4,3,1,0.75,0,0,2,1,203.64,187.28,195.45999999999998
2016-10-14,1610612741,1610612739,2016,118.0,108.0,226.0,94.0,91.0,101.9,101.55,3,1,2,0.333,4,2,2,0.5,1,0,2,0,185.44,195.48,190.45999999999998
2016-10-14,1610612759,1610612748,2016,100.0,108.0,208.0,107.75,96.55,97.25,95.5,4,3,1,0.75,3,2,1,0.667,1,2,1,1,204.12,195.0,199.56
2016-10-14,1610612743,1610612744,2016,128.0,129.0,257.0,109.2,110.3,107.5,105.85,4,2,2,0.5,3,2,1,0.667,0,2,2,0,217.04,199.04,208.04
2016-10-14,1610612756,1610612742,2016,112.0,107.0,219.0,106.25,103.85,104.45,102.7,4,2,2,0.5,4,2,2,0.5,1,1,2,0,212.88,213.0,212.94
2016-10-13,1610612764,1610612755,2016,100.0,79.0,179.0,94.7,91.35,97.85,106.0,3,1,2,0.333,4,1,3,0.25,0,1,1,0,193.0,207.68,200.34
2016-10-13,1610612751,1610612738,2016,97.0,100.0,197.0,96.7,98.4,99.65,105.5,3,1,2,0.333,3,2,1,0.667,1,0,1,1,196.96,195.08,196.02
2016-10-13,1610612737,1610612765,2016,94.0,99.0,193.0,96.35,95.7,100.85,105.95,3,2,1,0.667,2,0,2,0.0,1,1,0,0,199.44,206.0,202.72
2016-10-13,1610612760,1610612763,2016,94.0,110.0,204.0,101.8,103.4,98.25,97.5,3,1,2,0.333,3,2,1,0.667,0,1,2,0,210.36,193.96,202.16000000000003
2016-10-13,1610612739,1610612761,2016,94.0,119.0,213.0,101.9,101.55,100.6,99.2,3,2,1,0.667,3,1,2,0.333,2,0,1,0,195.48,206.0,200.74
2016-10-13,1610612746,1610612757,2016,109.0,108.0,217.0,109.85,106.5,104.75,105.45,3,1,2,0.333,3,3,0,1.0,1,0,2,1,214.36,209.44,211.9
2016-10-13,1610612747,1610612758,2016,104.0,116.0,220.0,107.3,114.65,97.75,101.5,4,2,2,0.5,3,1,2,0.333,2,0,1,0,219.28,207.08,213.18
2016-10-12,1610612740,1610612745,2016,104.0,116.0,220.0,100.45,104.8,112.7,109.85,3,1,2,0.333,3,3,0,1.0,1,0,3,0,200.8,216.24,208.52
2016-10-12,1610612753,1610612759,2016,89.0,95.0,184.0,96.55,103.5,107.75,96.55,2,0,2,0.0,3,2,1,0.667,0,0,1,1,203.64,204.12,203.88
2016-10-12,1610612754,1610612749,2016,101.0,83.0,184.0,92.05,92.25,99.8,108.15,3,2,1,0.667,2,2,0,1.0,1,1,1,1,187.28,200.48,193.88
2016-10-12,1610612750,1610612743,2016,105.0,88.0,193.0,110.05,111.2,109.2,110.3,2,1,1,0.5,3,2,1,0.667,0,1,0,2,209.4,217.04,213.22
2016-10-12,1610612762,1610612756,2016,110.0,111.0,221.0,95.55,106.55,106.25,103.85,3,2,1,0.667,3,1,2,0.333,0,2,1,0,200.2,212.88,206.54
2016-10-11,1610612748,1610612751,2016,121.0,100.0,221.0,97.25,95.5,96.7,98.4,2,1,1,0.5,2,1,1,0.5,0,1,1,0,195.0,196.96,195.98000000000002
2016-10-11,1610612763,1610612755,2016,121.0,91.0,212.0,98.25,97.5,97.85,106.0,2,1,1,0.5,3,1,2,0.333,1,0,1,0,193.96,207.68,200.82
2016-10-11,1610612742,1610612760,2016,114.0,109.0,223.0,104.45,102.7,101.8,103.4,3,1,2,0.333,2,1,1,0.5,1,0,0,1,213.0,210.36,211.68
2016-10-11,1610612747,1610612757,2016,106.0,109.0,215.0,107.3,114.65,104.75,105.45,3,2,1,0.667,2,2,0,1.0,2,0,2,0,219.28,209.44,214.36
2016-10-10,1610612766,1610612750,2016,98.0,86.0,184.0,99.45,97.7,110.05,111.2,3,0,3,0.0,1,1,0,1.0,0,0,0,1,194.96,209.4,202.18
2016-10-10,1610612752,1610612764,2016,90.0,88.0,178.0,101.2,97.2,94.7,91.35,2,1,1,0.5,2,1,1,0.5,1,0,0,1,200.28,193.0,196.64
2016-10-10,1610612737,1610612739,2016,99.0,93.0,192.0,96.35,95.7,101.9,101.55,2,1,1,0.5,2,2,0,1.0,0,1,2,0,199.44,195.48,197.45999999999998
2016-10-10,1610612765,1610612759,2016,81.0,86.0,167.0,100.85,105.95,107.75,96.55,1,0,1,0.0,2,1,1,0.5,0,0,1,0,206.0,204.12,205.06
2016-10-10,1610612746,1610612762,2016,94.0,96.0,190.0,109.85,106.5,95.55,106.55,2,1,1,0.5,2,1,1,0.5,1,0,0,1,214.36,200.2,207.28
2016-10-09,1610612745,1610612740,2016,123.0,117.0,240.0,112.7,109.85,100.45,104.8,2,2,0,1.0,2,1,1,0.5,2,0,1,0,216.24,200.8,208.52
2016-10-09,1610612747,1610612743,2016,124.0,115.0,239.0,107.3,114.65,109.2,110.3,2,1,1,0.5,2,2,0,1.0,1,0,0,2,219.28,217.04,218.16
2016-10-08,1610612738,1610612766,2016,104.0,86.0,190.0,99.65,105.5,99.45,97.7,2,1,1,0.5,2,0,2,0.0,0,1,0,0,195.08,194.96,195.02
2016-10-08,1610612752,1610612751,2016,116.0,98.0,214.0,101.2,97.2,96.7,98.4,1,0,1,0.0,1,1,0,1.0,0,0,1,0,200.28,196.96,198.62
2016-10-08,1610612739,1610612755,2016,108.0,105.0,213.0,101.9,101.55,97.85,106.0,1,1,0,1.0,2,1,1,0.5,1,0,1,0,195.48,207.68,201.57999999999998
2016-10-08,1610612741,1610612754,2016,121.0,105.0,226.0,94.0,91.0,92.05,92.25,2,0,2,0.0,2,2,0,1.0,0,0,1,1,185.44,187.28,186.36
2016-10-08,1610612748,1610612750,2016,100.0,109.0,209.0,97.25,95.5,110.05,111.2,1,1,0,1.0,0,0,0,0.0,0,1,0,0,195.0,209.4,202.2
2016-10-08,1610612749,1610612742,2016,88.0,74.0,162.0,99.8,108.15,104.45,102.7,1,1,0,1.0,2,1,1,0.5,0,1,1,0,200.48,213.0,206.74
2016-10-08,1610612759,1610612737,2016,102.0,91.0,193.0,107.75,96.55,96.35,95.7,1,0,1,0.0,1,1,0,1.0,0,0,0,1,204.12,199.44,201.78
2016-10-07,1610612757,1610612756,2016,115.0,110.0,225.0,104.75,105.45,106.25,103.85,1,1,0,1.0,2,1,1,0.5,1,0,1,0,209.44,212.88,211.16
2016-10-07,1610612747,1610612743,2016,97.0,101.0,198.0,107.3,114.65,109.2,110.3,1,1,0,1.0,1,1,0,1.0,1,0,0,1,219.28,217.04,218.16
2016-10-06,1610612755,1610612764,2016,119.0,125.0,244.0,97.85,106.0,94.7,91.35,1,1,0,1.0,1,0,1,0.0,1,0,0,0,207.68,193.0,200.34
2016-10-06,1610612754,1610612741,2016,115.0,108.0,223.0,92.05,92.25,94.0,91.0,1,1,0,1.0,1,0,1,0.0,0,1,0,0,187.28,185.44,186.36
2016-10-06,1610612751,1610612765,2016,101.0,94.0,195.0,96.7,98.4,100.85,105.95,0,0,0,0.0,0,0,0,0.0,0,0,0,0,196.96,206.0,201.48000000000002
2016-10-06,1610612766,1610612738,2016,92.0,107.0,199.0,99.45,97.7,99.65,105.5,1,0,1,0.0,1,0,1,0.0,0,0,0,0,194.96,195.08,195.02
2016-10-06,1610612763,1610612737,2016,83.0,104.0,187.0,98.25,97.5,96.35,95.7,1,1,0,1.0,0,0,0,0.0,1,0,0,0,193.96,199.44,196.7
2016-10-06,1610612744,1610612758,2016,105.0,96.0,201.0,107.5,105.85,97.75,101.5,2,1,1,0.5,1,0,1,0.0,1,0,0,0,199.04,207.08,203.06
2016-10-05,1610612739,1610612753,2016,117.0,102.0,219.0,101.9,101.55,96.55,103.5,0,0,0,0.0,1,0,1,0.0,0,0,0,0,195.48,203.64,199.56
2016-10-05,1610612756,1610612762,2016,99.0,104.0,203.0,106.25,103.85,95.55,106.55,1,1,0,1.0,1,0,1,0.0,1,0,0,0,212.88,200.2,206.54
2016-10-05,1610612746,1610612761,2016,104.0,98.0,202.0,109.85,106.5,100.6,99.2,1,0,1,0.0,2,1,1,0.5,0,0,1,0,214.36,206.0,210.18
2016-10-04,1610612755,1610612738,2016,92.0,89.0,181.0,97.85,106.0,99.65,105.5,0,0,0,0.0,0,0,0,0.0,0,0,0,0,207.68,195.08,201.38
2016-10-04,1610612764,1610612748,2016,95.0,106.0,201.0,94.7,91.35,97.25,95.5,0,0,0,0.0,0,0,0,0.0,0,0,0,0,193.0,195.0,194.0
2016-10-04,1610612740,1610612754,2016,96.0,113.0,209.0,100.45,104.8,92.05,92.25,1,1,0,1.0,0,0,0,0.0,1,0,0,0,200.8,187.28,194.04000000000002
2016-10-04,1610612745,1610612752,2016,130.0,103.0,233.0,112.7,109.85,101.2,97.2,1,1,0,1.0,0,0,0,0.0,1,0,0,0,216.24,200.28,208.26
2016-10-04,1610612747,1610612758,2016,103.0,84.0,187.0,107.3,114.65,97.75,101.5,0,0,0,0.0,0,0,0,0.0,0,0,0,0,219.28,207.08,213.18
2016-10-04,1610612744,1610612746,2016,120.0,75.0,195.0,107.5,105.85,109.85,106.5,1,0,1,0.0,0,0,0,0.0,0,0,0,0,199.04,214.36,206.7
2016-10-03,1610612741,1610612749,2016,91.0,93.0,184.0,94.0,91.0,99.8,108.15,0,0,0,0.0,0,0,0,0.0,0,0,0,0,185.44,200.48,192.95999999999998
2016-10-03,1610612763,1610612753,2016,102.0,97.0,199.0,98.25,97.5,96.55,103.5,0,0,0,0.0,0,0,0,0.0,0,0,0,0,193.96,203.64,198.8
2016-10-03,1610612742,1610612766,2016,95.0,88.0,183.0,104.45,102.7,99.45,97.7,1,0,1,0.0,0,0,0,0.0,0,0,0,0,213.0,194.96,203.98000000000002
2016-10-03,1610612761,1610612743,2016,106.0,108.0,214.0,100.6,99.2,109.2,110.3,1,1,0,1.0,0,0,0,0.0,1,0,0,0,206.0,217.04,211.51999999999998
2016-10-03,1610612756,1610612759,2016,91.0,86.0,177.0,106.25,103.85,107.75,96.55,0,0,0,0.0,0,0,0,0.0,0,0,0,0,212.88,204.12,208.5
2016-10-01,1610612761,1610612744,2016,97.0,93.0,190.0,100.6,99.2,107.5,105.85,0,0,0,0.0,0,0,0,0.0,0,0,0,0,206.0,199.04,202.51999999999998
2016-10-01,1610612740,1610612742,2016,116.0,102.0,218.0,100.45,104.8,104.45,102.7,0,0,0,0.0,0,0,0,0.0,0,0,0,0,200.8,213.0,206.9
2016-06-19,1610612744,1610612739,2015,89.0,93.0,182.0,107.5,105.85,101.9,101.55,82,73,9,0.89,82,57,25,0.695,39,34,33,24,199.04,195.48,197.26
2016-06-16,1610612739,1610612744,2015,115.0,101.0,216.0,101.9,101.55,107.5,105.85,82,57,25,0.695,82,73,9,0.89,33,24,39,34,195.48,199.04,197.26
2016-06-13,1610612744,1610612739,2015,97.0,112.0,209.0,107.5,105.85,101.9,101.55,82,73,9,0.89,82,57,25,0.695,39,34,33,24,199.04,195.48,197.26
2016-06-10,1610612739,1610612744,2015,97.0,108.0,205.0,101.9,101.55,107.5,105.85,82,57,25,0.695,82,73,9,0.89,33,24,39,34,195.48,199.04,197.26
2016-06-08,1610612739,1610612744,2015,120.0,90.0,210.0,101.9,101.55,107.5,105.85,82,57,25,0.695,82,73,9,0.89,33,24,39,34,195.48,199.04,197.26
2016-06-05,1610612744,1610612739,2015,110.0,77.0,187.0,107.5,105.85,101.9,101.55,82,73,9,0.89,82,57,25,0.695,39,34,33,24,199.04,195.48,197.26
2016-06-02,1610612744,1610612739,2015,104.0,89.0,193.0,107.5,105.85,101.9,101.55,82,73,9,0.89,82,57,25,0.695,39,34,33,24,199.04,195.48,197.26
2016-05-30,1610612744,1610612760,2015,96.0,88.0,184.0,107.5,105.85,101.8,103.4,82,73,9,0.89,82,55,27,0.6709999999999999,39,34,32,23,199.04,210.36,204.7
2016-05-28,1610612760,1610612744,2015,101.0,108.0,209.0,101.8,103.4,107.5,105.85,82,55,27,0.6709999999999999,82,73,9,0.89,32,23,39,34,210.36,199.04,204.7
2016-05-27,1610612761,1610612739,2015,87.0,113.0,200.0,100.6,99.2,101.9,101.55,82,56,26,0.6829999999999999,82,57,25,0.695,32,24,33,24,206.0,195.48,200.74
2016-05-26,1610612744,1610612760,2015,120.0,111.0,231.0,107.5,105.85,101.8,103.4,82,73,9,0.89,82,55,27,0.6709999999999999,39,34,32,23,199.04,210.36,204.7
2016-05-25,1610612739,1610612761,2015,116.0,78.0,194.0,101.9,101.55,100.6,99.2,82,57,25,0.695,82,56,26,0.6829999999999999,33,24,32,24,195.48,206.0,200.74
2016-05-24,1610612760,1610612744,2015,118.0,94.0,212.0,101.8,103.4,107.5,105.85,82,55,27,0.6709999999999999,82,73,9,0.89,32,23,39,34,210.36,199.04,204.7
2016-05-23,1610612761,1610612739,2015,105.0,99.0,204.0,100.6,99.2,101.9,101.55,82,56,26,0.6829999999999999,82,57,25,0.695,32,24,33,24,206.0,195.48,200.74
2016-05-22,1610612760,1610612744,2015,133.0,105.0,238.0,101.8,103.4,107.5,105.85,82,55,27,0.6709999999999999,82,73,9,0.89,32,23,39,34,210.36,199.04,204.7
2016-05-21,1610612761,1610612739,2015,99.0,84.0,183.0,100.6,99.2,101.9,101.55,82,56,26,0.6829999999999999,82,57,25,0.695,32,24,33,24,206.0,195.48,200.74
2016-05-19,1610612739,1610612761,2015,108.0,89.0,197.0,101.9,101.55,100.6,99.2,82,57,25,0.695,82,56,26,0.6829999999999999,33,24,32,24,195.48,206.0,200.74
2016-05-18,1610612744,1610612760,2015,118.0,91.0,209.0,107.5,105.85,101.8,103.4,82,73,9,0.89,82,55,27,0.6709999999999999,39,34,32,23,199.04,210.36,204.7
2016-05-17,1610612739,1610612761,2015,115.0,84.0,199.0,101.9,101.55,100.6,99.2,82,57,25,0.695,82,56,26,0.6829999999999999,33,24,32,24,195.48,206.0,200.74
2016-05-16,1610612744,1610612760,2015,102.0,108.0,210.0,107.5,105.85,101.8,103.4,82,73,9,0.89,82,55,27,0.6709999999999999,39,34,32,23,199.04,210.36,204.7
2016-05-15,1610612761,1610612748,2015,116.0,89.0,205.0,100.6,99.2,97.25,95.5,82,56,26,0.6829999999999999,82,48,34,0.585,32,24,28,20,206.0,195.0,200.5
2016-05-13,1610612748,1610612761,2015,103.0,91.0,194.0,97.25,95.5,100.6,99.2,82,48,34,0.585,82,56,26,0.6829999999999999,28,20,32,24,195.0,206.0,200.5
2016-05-12,1610612760,1610612759,2015,113.0,99.0,212.0,101.8,103.4,107.75,96.55,82,55,27,0.6709999999999999,82,67,15,0.8170000000000001,32,23,40,27,210.36,204.12,207.24
2016-05-11,1610612761,1610612748,2015,99.0,91.0,190.0,100.6,99.2,97.25,95.5,82,56,26,0.6829999999999999,82,48,34,0.585,32,24,28,20,206.0,195.0,200.5
2016-05-11,1610612744,1610612757,2015,125.0,121.0,246.0,107.5,105.85,104.75,105.45,82,73,9,0.89,82,44,38,0.537,39,34,28,16,199.04,209.44,204.24
2016-05-10,1610612759,1610612760,2015,91.0,95.0,186.0,107.75,96.55,101.8,103.4,82,67,15,0.8170000000000001,82,55,27,0.6709999999999999,40,27,32,23,204.12,210.36,207.24
2016-05-09,1610612748,1610612761,2015,94.0,87.0,181.0,97.25,95.5,100.6,99.2,82,48,34,0.585,82,56,26,0.6829999999999999,28,20,32,24,195.0,206.0,200.5
2016-05-09,1610612757,1610612744,2015,125.0,132.0,257.0,104.75,105.45,107.5,105.85,82,44,38,0.537,82,73,9,0.89,28,16,39,34,209.44,199.04,204.24
2016-05-08,1610612737,1610612739,2015,99.0,100.0,199.0,96.35,95.7,101.9,101.55,82,48,34,0.585,82,57,25,0.695,27,21,33,24,199.44,195.48,197.45999999999998
2016-05-08,1610612760,1610612759,2015,111.0,97.0,208.0,101.8,103.4,107.75,96.55,82,55,27,0.6709999999999999,82,67,15,0.8170000000000001,32,23,40,27,210.36,204.12,207.24
2016-05-07,1610612748,1610612761,2015,91.0,95.0,186.0,97.25,95.5,100.6,99.2,82,48,34,0.585,82,56,26,0.6829999999999999,28,20,32,24,195.0,206.0,200.5
2016-05-07,1610612757,1610612744,2015,120.0,108.0,228.0,104.75,105.45,107.5,105.85,82,44,38,0.537,82,73,9,0.89,28,16,39,34,209.44,199.04,204.24
2016-05-06,1610612737,1610612739,2015,108.0,121.0,229.0,96.35,95.7,101.9,101.55,82,48,34,0.585,82,57,25,0.695,27,21,33,24,199.44,195.48,197.45999999999998
2016-05-06,1610612760,1610612759,2015,96.0,100.0,196.0,101.8,103.4,107.75,96.55,82,55,27,0.6709999999999999,82,67,15,0.8170000000000001,32,23,40,27,210.36,204.12,207.24
2016-05-05,1610612761,1610612748,2015,96.0,92.0,188.0,100.6,99.2,97.25,95.5,82,56,26,0.6829999999999999,82,48,34,0.585,32,24,28,20,206.0,195.0,200.5
2016-05-04,1610612739,1610612737,2015,123.0,98.0,221.0,101.9,101.55,96.35,95.7,82,57,25,0.695,82,48,34,0.585,33,24,27,21,195.48,199.44,197.45999999999998
2016-05-03,1610612761,1610612748,2015,96.0,102.0,198.0,100.6,99.2,97.25,95.5,82,56,26,0.6829999999999999,82,48,34,0.585,32,24,28,20,206.0,195.0,200.5
2016-05-03,1610612744,1610612757,2015,110.0,99.0,209.0,107.5,105.85,104.75,105.45,82,73,9,0.89,82,44,38,0.537,39,34,28,16,199.04,209.44,204.24
2016-05-02,1610612739,1610612737,2015,104.0,93.0,197.0,101.9,101.55,96.35,95.7,82,57,25,0.695,82,48,34,0.585,33,24,27,21,195.48,199.44,197.45999999999998
2016-05-02,1610612759,1610612760,2015,97.0,98.0,195.0,107.75,96.55,101.8,103.4,82,67,15,0.8170000000000001,82,55,27,0.6709999999999999,40,27,32,23,204.12,210.36,207.24
2016-05-01,1610612748,1610612766,2015,106.0,73.0,179.0,97.25,95.5,99.45,97.7,82,48,34,0.585,82,48,34,0.585,28,20,30,18,195.0,194.96,194.98000000000002
2016-05-01,1610612744,1610612757,2015,118.0,106.0,224.0,107.5,105.85,104.75,105.45,82,73,9,0.89,82,44,38,0.537,39,34,28,16,199.04,209.44,204.24
2016-05-01,1610612761,1610612754,2015,89.0,84.0,173.0,100.6,99.2,92.05,92.25,82,56,26,0.6829999999999999,82,45,37,0.5489999999999999,32,24,26,19,206.0,187.28,196.64
2016-04-30,1610612759,1610612760,2015,124.0,92.0,216.0,107.75,96.55,101.8,103.4,82,67,15,0.8170000000000001,82,55,27,0.6709999999999999,40,27,32,23,204.12,210.36,207.24
2016-04-29,1610612754,1610612761,2015,101.0,83.0,184.0,92.05,92.25,100.6,99.2,82,45,37,0.5489999999999999,82,56,26,0.6829999999999999,26,19,32,24,187.28,206.0,196.64
2016-04-29,1610612766,1610612748,2015,90.0,97.0,187.0,99.45,97.7,97.25,95.5,82,48,34,0.585,82,48,34,0.585,30,18,28,20,194.96,195.0,194.98000000000002
2016-04-29,1610612757,1610612746,2015,106.0,103.0,209.0,104.75,105.45,109.85,106.5,82,44,38,0.537,82,53,29,0.6459999999999999,28,16,29,24,209.44,214.36,211.9
2016-04-28,1610612738,1610612737,2015,92.0,104.0,196.0,99.65,105.5,96.35,95.7,82,48,34,0.585,82,48,34,0.585,28,20,27,21,195.08,199.44,197.26
2016-04-27,1610612748,1610612766,2015,88.0,90.0,178.0,97.25,95.5,99.45,97.7,82,48,34,0.585,82,48,34,0.585,28,20,30,18,195.0,194.96,194.98000000000002
2016-04-27,1610612746,1610612757,2015,98.0,108.0,206.0,109.85,106.5,104.75,105.45,82,53,29,0.6459999999999999,82,44,38,0.537,29,24,28,16,214.36,209.44,211.9
2016-04-27,1610612744,1610612745,2015,114.0,81.0,195.0,107.5,105.85,112.7,109.85,82,73,9,0.89,82,41,41,0.5,39,34,23,18,199.04,216.24,207.64
2016-04-26,1610612761,1610612754,2015,102.0,99.0,201.0,100.6,99.2,92.05,92.25,82,56,26,0.6829999999999999,82,45,37,0.5489999999999999,32,24,26,19,206.0,187.28,196.64
2016-04-26,1610612737,1610612738,2015,110.0,83.0,193.0,96.35,95.7,99.65,105.5,82,48,34,0.585,82,48,34,0.585,27,21,28,20,199.44,195.08,197.26
2016-04-25,1610612766,1610612748,2015,89.0,85.0,174.0,99.45,97.7,97.25,95.5,82,48,34,0.585,82,48,34,0.585,30,18,28,20,194.96,195.0,194.98000000000002
2016-04-25,1610612760,1610612742,2015,118.0,104.0,222.0,101.8,103.4,104.45,102.7,82,55,27,0.6709999999999999,82,42,40,0.512,32,23,23,19,210.36,213.0,211.68
2016-04-25,1610612757,1610612746,2015,98.0,84.0,182.0,104.75,105.45,109.85,106.5,82,44,38,0.537,82,53,29,0.6459999999999999,28,16,29,24,209.44,214.36,211.9
2016-04-24,1610612763,1610612759,2015,95.0,116.0,211.0,98.25,97.5,107.75,96.55,82,42,40,0.512,82,67,15,0.8170000000000001,26,16,40,27,193.96,204.12,199.04000000000002
2016-04-24,1610612745,1610612744,2015,94.0,121.0,215.0,112.7,109.85,107.5,105.85,82,41,41,0.5,82,73,9,0.89,23,18,39,34,216.24,199.04,207.64
2016-04-24,1610612738,1610612737,2015,104.0,95.0,199.0,99.65,105.5,96.35,95.7,82,48,34,0.585,82,48,34,0.585,28,20,27,21,195.08,199.44,197.26
2016-04-24,1610612765,1610612739,2015,98.0,100.0,198.0,100.85,105.95,101.9,101.55,82,44,38,0.537,82,57,25,0.695,26,18,33,24,206.0,195.48,200.74
2016-04-23,1610612754,1610612761,2015,100.0,83.0,183.0,92.05,92.25,100.6,99.2,82,45,37,0.5489999999999999,82,56,26,0.6829999999999999,26,19,32,24,187.28,206.0,196.64
2016-04-23,1610612766,1610612748,2015,96.0,80.0,176.0,99.45,97.7,97.25,95.5,82,48,34,0.585,82,48,34,0.585,30,18,28,20,194.96,195.0,194.98000000000002
2016-04-23,1610612742,1610612760,2015,108.0,119.0,227.0,104.45,102.7,101.8,103.4,82,42,40,0.512,82,55,27,0.6709999999999999,23,19,32,23,213.0,210.36,211.68
2016-04-23,1610612757,1610612746,2015,96.0,88.0,184.0,104.75,105.45,109.85,106.5,82,44,38,0.537,82,53,29,0.6459999999999999,28,16,29,24,209.44,214.36,211.9
2016-04-22,1610612765,1610612739,2015,91.0,101.0,192.0,100.85,105.95,101.9,101.55,82,44,38,0.537,82,57,25,0.695,26,18,33,24,206.0,195.48,200.74
2016-04-22,1610612738,1610612737,2015,111.0,103.0,214.0,99.65,105.5,96.35,95.7,82,48,34,0.585,82,48,34,0.585,28,20,27,21,195.08,199.44,197.26
2016-04-22,1610612763,1610612759,2015,87.0,96.0,183.0,98.25,97.5,107.75,96.55,82,42,40,0.512,82,67,15,0.8170000000000001,26,16,40,27,193.96,204.12,199.04000000000002
2016-04-21,1610612742,1610612760,2015,102.0,131.0,233.0,104.45,102.7,101.8,103.4,82,42,40,0.512,82,55,27,0.6709999999999999,23,19,32,23,213.0,210.36,211.68
2016-04-21,1610612754,1610612761,2015,85.0,101.0,186.0,92.05,92.25,100.6,99.2,82,45,37,0.5489999999999999,82,56,26,0.6829999999999999,26,19,32,24,187.28,206.0,196.64
2016-04-21,1610612745,1610612744,2015,97.0,96.0,193.0,112.7,109.85,107.5,105.85,82,41,41,0.5,82,73,9,0.89,23,18,39,34,216.24,199.04,207.64
2016-04-20,1610612748,1610612766,2015,115.0,103.0,218.0,97.25,95.5,99.45,97.7,82,48,34,0.585,82,48,34,0.585,28,20,30,18,195.0,194.96,194.98000000000002
2016-04-20,1610612739,1610612765,2015,107.0,90.0,197.0,101.9,101.55,100.85,105.95,82,57,25,0.695,82,44,38,0.537,33,24,26,18,195.48,206.0,200.74
2016-04-20,1610612746,1610612757,2015,102.0,81.0,183.0,109.85,106.5,104.75,105.45,82,53,29,0.6459999999999999,82,44,38,0.537,29,24,28,16,214.36,209.44,211.9
2016-04-19,1610612737,1610612738,2015,89.0,72.0,161.0,96.35,95.7,99.65,105.5,82,48,34,0.585,82,48,34,0.585,27,21,28,20,199.44,195.08,197.26
2016-04-19,1610612759,1610612763,2015,94.0,68.0,162.0,107.75,96.55,98.25,97.5,82,67,15,0.8170000000000001,82,42,40,0.512,40,27,26,16,204.12,193.96,199.04000000000002
2016-04-18,1610612761,1610612754,2015,98.0,87.0,185.0,100.6,99.2,92.05,92.25,82,56,26,0.6829999999999999,82,45,37,0.5489999999999999,32,24,26,19,206.0,187.28,196.64
2016-04-18,1610612760,1610612742,2015,84.0,85.0,169.0,101.8,103.4,104.45,102.7,82,55,27,0.6709999999999999,82,42,40,0.512,32,23,23,19,210.36,213.0,211.68
2016-04-18,1610612744,1610612745,2015,115.0,106.0,221.0,107.5,105.85,112.7,109.85,82,73,9,0.89,82,41,41,0.5,39,34,23,18,199.04,216.24,207.64
2016-04-17,1610612739,1610612765,2015,106.0,101.0,207.0,101.9,101.55,100.85,105.95,82,57,25,0.695,82,44,38,0.537,33,24,26,18,195.48,206.0,200.74
2016-04-17,1610612748,1610612766,2015,123.0,91.0,214.0,97.25,95.5,99.45,97.7,82,48,34,0.585,82,48,34,0.585,28,20,30,18,195.0,194.96,194.98000000000002
2016-04-17,1610612759,1610612763,2015,106.0,74.0,180.0,107.75,96.55,98.25,97.5,82,67,15,0.8170000000000001,82,42,40,0.512,40,27,26,16,204.12,193.96,199.04000000000002
2016-04-17,1610612746,1610612757,2015,115.0,95.0,210.0,109.85,106.5,104.75,105.45,82,53,29,0.6459999999999999,82,44,38,0.537,29,24,28,16,214.36,209.44,211.9
2016-04-16,1610612761,1610612754,2015,90.0,100.0,190.0,100.6,99.2,92.05,92.25,82,56,26,0.6829999999999999,82,45,37,0.5489999999999999,32,24,26,19,206.0,187.28,196.64
2016-04-16,1610612744,1610612745,2015,104.0,78.0,182.0,107.5,105.85,112.7,109.85,82,73,9,0.89,82,41,41,0.5,39,34,23,18,199.04,216.24,207.64
2016-04-16,1610612737,1610612738,2015,102.0,101.0,203.0,96.35,95.7,99.65,105.5,82,48,34,0.585,82,48,34,0.585,27,21,28,20,199.44,195.08,197.26
2016-04-16,1610612760,1610612742,2015,108.0,70.0,178.0,101.8,103.4,104.45,102.7,82,55,27,0.6709999999999999,82,42,40,0.512,32,23,23,19,210.36,213.0,211.68
2016-04-13,1610612738,1610612748,2015,98.0,88.0,186.0,99.65,105.5,97.25,95.5,81,47,34,0.58,81,48,33,0.593,27,20,28,20,195.08,195.0,195.04000000000002
2016-04-13,1610612751,1610612761,2015,96.0,103.0,199.0,96.7,98.4,100.6,99.2,81,21,60,0.259,81,55,26,0.679,14,7,32,23,196.96,206.0,201.48000000000002
2016-04-13,1610612766,1610612753,2015,117.0,103.0,220.0,99.45,97.7,96.55,103.5,81,47,34,0.58,81,35,46,0.4320000000000001,29,18,23,12,194.96,203.64,199.3
2016-04-13,1610612739,1610612765,2015,110.0,112.0,222.0,101.9,101.55,100.85,105.95,81,57,24,0.7040000000000001,81,43,38,0.531,33,24,26,17,195.48,206.0,200.74
2016-04-13,1610612764,1610612737,2015,109.0,98.0,207.0,94.7,91.35,96.35,95.7,81,40,41,0.494,81,48,33,0.593,21,19,27,21,193.0,199.44,196.22
2016-04-13,1610612741,1610612755,2015,115.0,105.0,220.0,94.0,91.0,97.85,106.0,81,41,40,0.506,81,10,71,0.123,25,16,7,3,185.44,207.68,196.56
2016-04-13,1610612742,1610612759,2015,91.0,96.0,187.0,104.45,102.7,107.75,96.55,81,42,39,0.519,81,66,15,0.815,23,19,40,26,213.0,204.12,208.56
2016-04-13,1610612745,1610612758,2015,116.0,81.0,197.0,112.7,109.85,97.75,101.5,81,40,41,0.494,81,33,48,0.407,22,18,18,15,216.24,207.08,211.66000000000003
2016-04-13,1610612749,1610612754,2015,92.0,97.0,189.0,99.8,108.15,92.05,92.25,81,33,48,0.407,81,44,37,0.5429999999999999,23,10,26,18,200.48,187.28,193.88
2016-04-13,1610612750,1610612740,2015,144.0,109.0,253.0,110.05,111.2,100.45,104.8,81,28,53,0.34600000000000003,81,30,51,0.37,13,15,21,9,209.4,200.8,205.10000000000002
2016-04-13,1610612744,1610612763,2015,125.0,104.0,229.0,107.5,105.85,98.25,97.5,81,72,9,0.889,81,42,39,0.519,38,34,26,16,199.04,193.96,196.5
2016-04-13,1610612747,1610612762,2015,101.0,96.0,197.0,107.3,114.65,95.55,106.55,81,16,65,0.198,81,40,41,0.494,11,5,24,16,219.28,200.2,209.74
2016-04-13,1610612756,1610612746,2015,114.0,105.0,219.0,106.25,103.85,109.85,106.5,81,22,59,0.272,81,53,28,0.654,13,9,29,24,212.88,214.36,213.62
2016-04-13,1610612757,1610612743,2015,107.0,99.0,206.0,104.75,105.45,109.2,110.3,81,43,38,0.531,81,33,48,0.407,27,16,18,15,209.44,217.04,213.24
2016-04-12,1610612754,1610612752,2015,102.0,90.0,192.0,92.05,92.25,101.2,97.2,80,43,37,0.5379999999999999,81,32,49,0.395,25,18,18,14,187.28,200.28,193.78
2016-04-12,1610612765,1610612748,2015,93.0,99.0,192.0,100.85,105.95,97.25,95.5,80,43,37,0.5379999999999999,80,47,33,0.588,26,17,28,19,206.0,195.0,200.5
2016-04-12,1610612761,1610612755,2015,122.0,98.0,220.0,100.6,99.2,97.85,106.0,80,54,26,0.675,80,10,70,0.125,31,23,7,3,206.0,207.68,206.84
2016-04-12,1610612759,1610612760,2015,102.0,98.0,200.0,107.75,96.55,101.8,103.4,80,65,15,0.813,81,55,26,0.679,39,26,32,23,204.12,210.36,207.24
2016-04-12,1610612746,1610612763,2015,110.0,84.0,194.0,109.85,106.5,98.25,97.5,80,52,28,0.65,80,42,38,0.525,28,24,26,16,214.36,193.96,204.16000000000003
2016-04-11,1610612739,1610612737,2015,109.0,94.0,203.0,101.9,101.55,96.35,95.7,80,56,24,0.7,80,48,32,0.6,32,24,27,21,195.48,199.44,197.45999999999998
2016-04-11,1610612753,1610612749,2015,107.0,98.0,205.0,96.55,103.5,99.8,108.15,80,34,46,0.425,80,33,47,0.413,22,12,23,10,203.64,200.48,202.06
2016-04-11,1610612738,1610612766,2015,100.0,114.0,214.0,99.65,105.5,99.45,97.7,80,47,33,0.588,80,46,34,0.575,27,20,29,17,195.08,194.96,195.02
2016-04-11,1610612751,1610612764,2015,111.0,120.0,231.0,96.7,98.4,94.7,91.35,80,21,59,0.263,80,39,41,0.488,14,7,21,18,196.96,193.0,194.98000000000002
2016-04-11,1610612750,1610612745,2015,105.0,129.0,234.0,110.05,111.2,112.7,109.85,80,28,52,0.35,80,39,41,0.488,13,15,22,17,209.4,216.24,212.82
2016-04-11,1610612740,1610612741,2015,116.0,121.0,237.0,100.45,104.8,94.0,91.0,80,30,50,0.375,80,40,40,0.5,21,9,25,15,200.8,185.44,193.12
2016-04-11,1610612760,1610612747,2015,112.0,79.0,191.0,101.8,103.4,107.3,114.65,80,54,26,0.675,80,16,64,0.2,31,23,11,5,210.36,219.28,214.82
2016-04-11,1610612762,1610612742,2015,92.0,101.0,193.0,95.55,106.55,104.45,102.7,80,40,40,0.5,80,41,39,0.513,24,16,23,18,200.2,213.0,206.6
2016-04-11,1610612756,1610612758,2015,101.0,105.0,206.0,106.25,103.85,97.75,101.5,80,22,58,0.275,80,32,48,0.4,13,9,18,14,212.88,207.08,209.98000000000002
2016-04-10,1610612764,1610612766,2015,113.0,98.0,211.0,94.7,91.35,99.45,97.7,79,38,41,0.481,79,46,33,0.5820000000000001,20,18,29,17,193.0,194.96,193.98000000000002
2016-04-10,1610612745,1610612747,2015,130.0,110.0,240.0,112.7,109.85,107.3,114.65,79,38,41,0.481,79,16,63,0.203,21,17,11,5,216.24,219.28,217.76
2016-04-10,1610612746,1610612742,2015,98.0,91.0,189.0,109.85,106.5,104.45,102.7,79,51,28,0.6459999999999999,79,41,38,0.519,27,24,23,18,214.36,213.0,213.68
2016-04-10,1610612755,1610612749,2015,108.0,109.0,217.0,97.85,106.0,99.8,108.15,79,10,69,0.127,79,32,47,0.405,7,3,23,9,207.68,200.48,204.07999999999998
2016-04-10,1610612743,1610612762,2015,84.0,100.0,184.0,109.2,110.3,95.55,106.55,80,33,47,0.413,79,39,40,0.494,18,15,24,15,217.04,200.2,208.62
2016-04-10,1610612754,1610612751,2015,129.0,105.0,234.0,92.05,92.25,96.7,98.4,79,42,37,0.532,79,21,58,0.266,24,18,14,7,187.28,196.96,192.12
2016-04-10,1610612748,1610612753,2015,118.0,96.0,214.0,97.25,95.5,96.55,103.5,79,46,33,0.5820000000000001,79,34,45,0.43,27,19,22,12,195.0,203.64,199.32
2016-04-10,1610612759,1610612744,2015,86.0,92.0,178.0,107.75,96.55,107.5,105.85,79,65,14,0.823,80,71,9,0.888,39,26,38,33,204.12,199.04,201.57999999999998
2016-04-10,1610612752,1610612761,2015,89.0,93.0,182.0,101.2,97.2,100.6,99.2,80,32,48,0.4,79,53,26,0.6709999999999999,18,14,31,22,200.28,206.0,203.14
2016-04-09,1610612740,1610612756,2015,100.0,121.0,221.0,100.45,104.8,106.25,103.85,79,30,49,0.38,79,21,58,0.266,21,9,13,8,200.8,212.88,206.84
2016-04-09,1610612737,1610612738,2015,118.0,107.0,225.0,96.35,95.7,99.65,105.5,79,47,32,0.595,79,47,32,0.595,26,21,27,20,199.44,195.08,197.26
2016-04-09,1610612763,1610612744,2015,99.0,100.0,199.0,98.25,97.5,107.5,105.85,79,42,37,0.532,79,70,9,0.8859999999999999,26,16,38,32,193.96,199.04,196.5
2016-04-09,1610612741,1610612739,2015,105.0,102.0,207.0,94.0,91.0,101.9,101.55,79,39,40,0.494,79,56,23,0.7090000000000001,24,15,32,24,185.44,195.48,190.45999999999998
2016-04-09,1610612757,1610612750,2015,105.0,106.0,211.0,104.75,105.45,110.05,111.2,80,43,37,0.5379999999999999,79,27,52,0.342,27,16,13,14,209.44,209.4,209.42000000000002
2016-04-09,1610612758,1610612760,2015,114.0,112.0,226.0,97.75,101.5,101.8,103.4,79,31,48,0.392,79,54,25,0.684,17,14,31,23,207.08,210.36,208.72000000000003
2016-04-08,1610612766,1610612751,2015,113.0,99.0,212.0,99.45,97.7,96.7,98.4,78,45,33,0.5770000000000001,78,21,57,0.269,28,17,14,7,194.96,196.96,195.96
2016-04-08,1610612753,1610612748,2015,112.0,109.0,221.0,96.55,103.5,97.25,95.5,78,33,45,0.423,78,46,32,0.59,21,12,27,19,203.64,195.0,199.32
2016-04-08,1610612755,1610612752,2015,102.0,109.0,211.0,97.85,106.0,101.2,97.2,78,10,68,0.128,79,31,48,0.392,7,3,18,13,207.68,200.28,203.98000000000002
2016-04-08,1610612738,1610612749,2015,124.0,109.0,233.0,99.65,105.5,99.8,108.15,78,46,32,0.59,78,32,46,0.41,26,20,23,9,195.08,200.48,197.78
2016-04-08,1610612765,1610612764,2015,112.0,99.0,211.0,100.85,105.95,94.7,91.35,79,42,37,0.532,78,38,40,0.487,25,17,20,18,206.0,193.0,199.5
2016-04-08,1610612761,1610612754,2015,111.0,98.0,209.0,100.6,99.2,92.05,92.25,78,52,26,0.667,78,42,36,0.5379999999999999,30,22,24,18,206.0,187.28,196.64
2016-04-08,1610612740,1610612747,2015,110.0,102.0,212.0,100.45,104.8,107.3,114.65,78,29,49,0.3720000000000001,78,16,62,0.205,20,9,11,5,200.8,219.28,210.04000000000002
2016-04-08,1610612742,1610612763,2015,103.0,93.0,196.0,104.45,102.7,98.25,97.5,78,40,38,0.513,78,42,36,0.5379999999999999,22,18,26,16,213.0,193.96,203.48000000000002
2016-04-08,1610612743,1610612759,2015,102.0,98.0,200.0,109.2,110.3,107.75,96.55,79,32,47,0.405,78,65,13,0.833,17,15,39,26,217.04,204.12,210.57999999999998
2016-04-08,1610612762,1610612746,2015,99.0,102.0,201.0,95.55,106.55,109.85,106.5,78,39,39,0.5,78,50,28,0.6409999999999999,24,15,27,23,200.2,214.36,207.28
2016-04-07,1610612737,1610612761,2015,95.0,87.0,182.0,96.35,95.7,100.6,99.2,78,46,32,0.59,77,52,25,0.675,25,21,30,22,199.44,206.0,202.72
2016-04-07,1610612748,1610612741,2015,106.0,98.0,204.0,97.25,95.5,94.0,91.0,77,45,32,0.584,78,39,39,0.5,26,19,24,15,195.0,185.44,190.22
2016-04-07,1610612745,1610612756,2015,115.0,124.0,239.0,112.7,109.85,106.25,103.85,78,38,40,0.487,78,20,58,0.256,21,17,13,7,216.24,212.88,214.56
2016-04-07,1610612758,1610612750,2015,97.0,105.0,202.0,97.75,101.5,110.05,111.2,78,31,47,0.397,78,26,52,0.333,17,14,13,13,207.08,209.4,208.24
2016-04-07,1610612744,1610612759,2015,112.0,101.0,213.0,107.5,105.85,107.75,96.55,78,69,9,0.885,77,65,12,0.8440000000000001,37,32,39,26,199.04,204.12,201.57999999999998
2016-04-06,1610612754,1610612739,2015,123.0,109.0,232.0,92.05,92.25,101.9,101.55,77,41,36,0.532,78,56,22,0.718,23,18,32,24,187.28,195.48,191.38
2016-04-06,1610612753,1610612765,2015,104.0,108.0,212.0,96.55,103.5,100.85,105.95,77,33,44,0.429,78,41,37,0.526,21,12,25,16,203.64,206.0,204.82
2016-04-06,1610612764,1610612751,2015,121.0,103.0,224.0,94.7,91.35,96.7,98.4,77,37,40,0.481,77,21,56,0.273,19,18,14,7,193.0,196.96,194.98000000000002
2016-04-06,1610612738,1610612740,2015,104.0,97.0,201.0,99.65,105.5,100.45,104.8,77,45,32,0.584,77,29,48,0.377,25,20,20,9,195.08,200.8,197.94
2016-04-06,1610612752,1610612766,2015,97.0,111.0,208.0,101.2,97.2,99.45,97.7,78,31,47,0.397,77,44,33,0.5710000000000001,18,13,28,16,200.28,194.96,197.62
2016-04-06,1610612742,1610612745,2015,88.0,86.0,174.0,104.45,102.7,112.7,109.85,77,39,38,0.506,77,38,39,0.494,21,18,21,17,213.0,216.24,214.62
2016-04-06,1610612757,1610612760,2015,120.0,115.0,235.0,104.75,105.45,101.8,103.4,79,42,37,0.532,78,54,24,0.6920000000000001,26,16,31,23,209.44,210.36,209.9
2016-04-06,1610612747,1610612746,2015,81.0,91.0,172.0,107.3,114.65,109.85,106.5,77,16,61,0.208,77,49,28,0.636,11,5,27,22,219.28,214.36,216.82
2016-04-05,1610612755,1610612740,2015,107.0,93.0,200.0,97.85,106.0,100.45,104.8,77,9,68,0.117,76,29,47,0.382,6,3,20,9,207.68,200.8,204.24
2016-04-05,1610612761,1610612766,2015,96.0,90.0,186.0,100.6,99.2,99.45,97.7,76,51,25,0.6709999999999999,76,44,32,0.579,29,22,28,16,206.0,194.96,200.48000000000002
2016-04-05,1610612748,1610612765,2015,107.0,89.0,196.0,97.25,95.5,100.85,105.95,76,44,32,0.579,77,41,36,0.532,25,19,25,16,195.0,206.0,200.5
2016-04-05,1610612737,1610612756,2015,103.0,90.0,193.0,96.35,95.7,106.25,103.85,77,45,32,0.584,77,20,57,0.26,24,21,13,7,199.44,212.88,206.16
2016-04-05,1610612763,1610612741,2015,108.0,92.0,200.0,98.25,97.5,94.0,91.0,77,41,36,0.532,77,39,38,0.506,25,16,24,15,193.96,185.44,189.7
2016-04-05,1610612749,1610612739,2015,80.0,109.0,189.0,99.8,108.15,101.9,101.55,77,32,45,0.416,77,55,22,0.7140000000000001,23,9,32,23,200.48,195.48,197.98
2016-04-05,1610612743,1610612760,2015,102.0,124.0,226.0,109.2,110.3,101.8,103.4,78,32,46,0.41,77,53,24,0.688,17,15,31,22,217.04,210.36,213.7
2016-04-05,1610612762,1610612759,2015,86.0,88.0,174.0,95.55,106.55,107.75,96.55,77,39,38,0.506,76,64,12,0.8420000000000001,24,15,39,25,200.2,204.12,202.16
2016-04-05,1610612758,1610612757,2015,107.0,115.0,222.0,97.75,101.5,104.75,105.45,77,31,46,0.403,78,41,37,0.526,17,14,26,15,207.08,209.44,208.26
2016-04-05,1610612744,1610612750,2015,117.0,124.0,241.0,107.5,105.85,110.05,111.2,77,69,8,0.8959999999999999,77,25,52,0.325,37,32,13,12,199.04,209.4,204.22
2016-04-05,1610612746,1610612747,2015,103.0,81.0,184.0,109.85,106.5,107.3,114.65,76,48,28,0.632,76,16,60,0.211,26,22,11,5,214.36,219.28,216.82
2016-04-03,1610612751,1610612740,2015,87.0,106.0,193.0,96.7,98.4,100.45,104.8,76,21,55,0.276,75,28,47,0.373,14,7,20,8,196.96,200.8,198.88
2016-04-03,1610612739,1610612766,2015,112.0,103.0,215.0,101.9,101.55,99.45,97.7,76,54,22,0.711,75,44,31,0.5870000000000001,31,23,28,16,195.48,194.96,195.22
2016-04-03,1610612745,1610612760,2015,118.0,110.0,228.0,112.7,109.85,101.8,103.4,76,37,39,0.487,76,53,23,0.6970000000000001,20,17,31,22,216.24,210.36,213.3
2016-04-03,1610612750,1610612742,2015,78.0,88.0,166.0,110.05,111.2,104.45,102.7,76,25,51,0.329,76,38,38,0.5,13,12,21,17,209.4,213.0,211.2
2016-04-03,1610612746,1610612764,2015,114.0,109.0,223.0,109.85,106.5,94.7,91.35,75,47,28,0.627,76,37,39,0.487,25,22,19,18,214.36,193.0,203.68
2016-04-03,1610612753,1610612763,2015,119.0,107.0,226.0,96.55,103.5,98.25,97.5,76,32,44,0.421,76,41,35,0.539,20,12,25,16,203.64,193.96,198.8
2016-04-03,1610612756,1610612762,2015,86.0,101.0,187.0,106.25,103.85,95.55,106.55,76,20,56,0.263,76,38,38,0.5,13,7,24,14,212.88,200.2,206.54
2016-04-03,1610612749,1610612741,2015,98.0,102.0,200.0,99.8,108.15,94.0,91.0,76,32,44,0.421,76,38,38,0.5,23,9,24,14,200.48,185.44,192.95999999999998
2016-04-03,1610612752,1610612754,2015,87.0,92.0,179.0,101.2,97.2,92.05,92.25,77,31,46,0.403,76,40,36,0.526,18,13,23,17,200.28,187.28,193.78
2016-04-03,1610612744,1610612757,2015,136.0,111.0,247.0,107.5,105.85,104.75,105.45,76,68,8,0.895,77,41,36,0.532,36,32,26,15,199.04,209.44,204.24
2016-04-03,1610612747,1610612738,2015,100.0,107.0,207.0,107.3,114.65,99.65,105.5,75,16,59,0.213,76,44,32,0.579,11,5,25,19,219.28,195.08,207.18
2016-04-02,1610612755,1610612754,2015,102.0,115.0,217.0,97.85,106.0,92.05,92.25,76,9,67,0.118,75,39,36,0.52,6,3,23,16,207.68,187.28,197.48000000000002
2016-04-02,1610612741,1610612765,2015,90.0,94.0,184.0,94.0,91.0,100.85,105.95,75,38,37,0.507,76,40,36,0.526,24,14,25,15,185.44,206.0,195.72
2016-04-02,1610612759,1610612761,2015,102.0,95.0,197.0,107.75,96.55,100.6,99.2,75,63,12,0.84,75,51,24,0.68,38,25,29,22,204.12,206.0,205.06
2016-04-02,1610612743,1610612758,2015,106.0,115.0,221.0,109.2,110.3,97.75,101.5,77,32,45,0.416,76,30,46,0.395,17,15,17,13,217.04,207.08,212.06
2016-04-02,1610612757,1610612748,2015,110.0,93.0,203.0,104.75,105.45,97.25,95.5,76,40,36,0.526,75,44,31,0.5870000000000001,25,15,25,19,209.44,195.0,202.22
2016-04-01,1610612766,1610612755,2015,100.0,91.0,191.0,99.45,97.7,97.85,106.0,74,43,31,0.581,75,9,66,0.12,27,16,6,3,194.96,207.68,201.32
2016-04-01,1610612765,1610612742,2015,89.0,98.0,187.0,100.85,105.95,104.45,102.7,75,40,35,0.5329999999999999,75,37,38,0.493,25,15,21,16,206.0,213.0,209.5
2016-04-01,1610612752,1610612751,2015,105.0,91.0,196.0,101.2,97.2,96.7,98.4,76,30,46,0.395,75,21,54,0.28,17,13,14,7,200.28,196.96,198.62
2016-04-01,1610612737,1610612739,2015,108.0,110.0,218.0,96.35,95.7,101.9,101.55,76,45,31,0.5920000000000001,75,53,22,0.7070000000000001,24,21,31,22,199.44,195.48,197.45999999999998
2016-04-01,1610612763,1610612761,2015,95.0,99.0,194.0,98.25,97.5,100.6,99.2,75,41,34,0.547,74,50,24,0.6759999999999999,25,16,29,21,193.96,206.0,199.98000000000002
2016-04-01,1610612749,1610612753,2015,113.0,110.0,223.0,99.8,108.15,96.55,103.5,75,31,44,0.413,75,32,43,0.4270000000000001,22,9,20,12,200.48,203.64,202.06
2016-04-01,1610612762,1610612750,2015,98.0,85.0,183.0,95.55,106.55,110.05,111.2,75,37,38,0.493,75,25,50,0.333,23,14,13,12,200.2,209.4,204.8
2016-04-01,1610612758,1610612748,2015,106.0,112.0,218.0,97.75,101.5,97.25,95.5,75,30,45,0.4,74,43,31,0.581,17,13,25,18,207.08,195.0,201.04000000000002
2016-04-01,1610612744,1610612738,2015,106.0,109.0,215.0,107.5,105.85,99.65,105.5,75,68,7,0.907,75,43,32,0.573,36,32,25,18,199.04,195.08,197.06
2016-04-01,1610612756,1610612764,2015,99.0,106.0,205.0,106.25,103.85,94.7,91.35,75,20,55,0.267,75,36,39,0.48,13,7,19,17,212.88,193.0,202.94
2016-03-31,1610612739,1610612751,2015,107.0,87.0,194.0,101.9,101.55,96.7,98.4,74,52,22,0.703,74,21,53,0.284,30,22,14,7,195.48,196.96,196.22
2016-03-31,1610612754,1610612753,2015,94.0,114.0,208.0,92.05,92.25,96.55,103.5,74,39,35,0.527,74,31,43,0.419,23,16,20,11,187.28,203.64,195.45999999999998
2016-03-31,1610612745,1610612741,2015,100.0,103.0,203.0,112.7,109.85,94.0,91.0,75,37,38,0.493,74,37,37,0.5,20,17,24,13,216.24,185.44,200.84
2016-03-31,1610612740,1610612743,2015,101.0,95.0,196.0,100.45,104.8,109.2,110.3,74,27,47,0.365,76,32,44,0.421,19,8,17,15,200.8,217.04,208.92000000000002
2016-03-31,1610612760,1610612746,2015,119.0,117.0,236.0,101.8,103.4,109.85,106.5,75,52,23,0.693,74,47,27,0.635,30,22,25,22,210.36,214.36,212.36
2016-03-31,1610612757,1610612738,2015,116.0,109.0,225.0,104.75,105.45,99.65,105.5,75,39,36,0.52,74,43,31,0.581,24,15,25,18,209.44,195.08,202.26
2016-03-30,1610612761,1610612737,2015,105.0,97.0,202.0,100.6,99.2,96.35,95.7,73,49,24,0.6709999999999999,75,45,30,0.6,28,21,24,21,206.0,199.44,202.72
2016-03-30,1610612763,1610612743,2015,105.0,109.0,214.0,98.25,97.5,109.2,110.3,74,41,33,0.5539999999999999,75,31,44,0.413,25,16,17,14,193.96,217.04,205.5
2016-03-30,1610612749,1610612756,2015,105.0,94.0,199.0,99.8,108.15,106.25,103.85,74,30,44,0.405,74,20,54,0.27,21,9,13,7,200.48,212.88,206.68
2016-03-30,1610612750,1610612746,2015,79.0,99.0,178.0,110.05,111.2,109.85,106.5,74,25,49,0.338,73,46,27,0.63,13,12,25,21,209.4,214.36,211.88
2016-03-30,1610612742,1610612752,2015,91.0,89.0,180.0,104.45,102.7,101.2,97.2,74,36,38,0.486,75,30,45,0.4,20,16,17,13,213.0,200.28,206.64
2016-03-30,1610612759,1610612740,2015,100.0,92.0,192.0,107.75,96.55,100.45,104.8,74,62,12,0.838,73,27,46,0.37,37,25,19,8,204.12,200.8,202.46
2016-03-30,1610612762,1610612744,2015,96.0,103.0,199.0,95.55,106.55,107.5,105.85,74,37,37,0.5,74,67,7,0.905,23,14,36,31,200.2,199.04,199.62
2016-03-30,1610612758,1610612764,2015,120.0,111.0,231.0,97.75,101.5,94.7,91.35,74,29,45,0.392,74,36,38,0.486,16,13,19,17,207.08,193.0,200.04000000000002
2016-03-30,1610612747,1610612748,2015,102.0,100.0,202.0,107.3,114.65,97.25,95.5,74,15,59,0.203,73,43,30,0.589,10,5,25,18,219.28,195.0,207.14
2016-03-29,1610612754,1610612741,2015,96.0,98.0,194.0,92.05,92.25,94.0,91.0,73,39,34,0.534,73,36,37,0.493,23,16,24,12,187.28,185.44,186.36
2016-03-29,1610612753,1610612751,2015,139.0,105.0,244.0,96.55,103.5,96.7,98.4,73,30,43,0.411,73,21,52,0.28800000000000003,19,11,14,7,203.64,196.96,200.3
2016-03-29,1610612755,1610612766,2015,85.0,100.0,185.0,97.85,106.0,99.45,97.7,74,9,65,0.122,73,42,31,0.575,6,3,27,15,207.68,194.96,201.32
2016-03-29,1610612765,1610612760,2015,88.0,82.0,170.0,100.85,105.95,101.8,103.4,74,39,35,0.527,74,52,22,0.703,24,15,30,22,206.0,210.36,208.18
2016-03-29,1610612739,1610612745,2015,100.0,106.0,206.0,101.9,101.55,112.7,109.85,73,52,21,0.7120000000000001,74,36,38,0.486,30,22,20,16,195.48,216.24,205.86
2016-03-29,1610612744,1610612764,2015,102.0,94.0,196.0,107.5,105.85,94.7,91.35,73,66,7,0.904,73,36,37,0.493,35,31,19,17,199.04,193.0,196.01999999999998
2016-03-28,1610612748,1610612751,2015,110.0,99.0,209.0,97.25,95.5,96.7,98.4,72,42,30,0.583,72,21,51,0.292,24,18,14,7,195.0,196.96,195.98000000000002
2016-03-28,1610612761,1610612760,2015,100.0,119.0,219.0,100.6,99.2,101.8,103.4,72,49,23,0.6809999999999999,73,51,22,0.6990000000000001,28,21,30,21,206.0,210.36,208.18
2016-03-28,1610612741,1610612737,2015,100.0,102.0,202.0,94.0,91.0,96.35,95.7,72,36,36,0.5,74,44,30,0.595,24,12,24,20,185.44,199.44,192.44
2016-03-28,1610612763,1610612759,2015,87.0,101.0,188.0,98.25,97.5,107.75,96.55,73,41,32,0.562,73,61,12,0.836,25,16,37,24,193.96,204.12,199.04000000000002
2016-03-28,1610612750,1610612756,2015,121.0,116.0,237.0,110.05,111.2,106.25,103.85,73,24,49,0.329,73,20,53,0.274,12,12,13,7,209.4,212.88,211.14
2016-03-28,1610612740,1610612752,2015,99.0,91.0,190.0,100.45,104.8,101.2,97.2,72,26,46,0.361,74,30,44,0.405,18,8,17,13,200.8,200.28,200.54000000000002
2016-03-28,1610612743,1610612742,2015,88.0,97.0,185.0,109.2,110.3,104.45,102.7,74,31,43,0.419,73,35,38,0.479,17,14,20,15,217.04,213.0,215.01999999999998
2016-03-28,1610612762,1610612747,2015,123.0,75.0,198.0,95.55,106.55,107.3,114.65,73,36,37,0.493,73,15,58,0.205,22,14,10,5,200.2,219.28,209.74
2016-03-28,1610612757,1610612758,2015,105.0,93.0,198.0,104.75,105.45,97.75,101.5,74,38,36,0.514,73,29,44,0.397,23,15,16,13,209.44,207.08,208.26
2016-03-28,1610612746,1610612738,2015,114.0,90.0,204.0,109.85,106.5,99.65,105.5,72,45,27,0.625,73,43,30,0.589,24,21,25,18,214.36,195.08,204.72000000000003
2016-03-27,1610612746,1610612743,2015,105.0,90.0,195.0,109.85,106.5,109.2,110.3,71,44,27,0.62,73,31,42,0.425,23,21,17,14,214.36,217.04,215.7
2016-03-27,1610612754,1610612745,2015,104.0,101.0,205.0,92.05,92.25,112.7,109.85,72,38,34,0.528,73,36,37,0.493,22,16,20,16,187.28,216.24,201.76
2016-03-27,1610612758,1610612742,2015,133.0,111.0,244.0,97.75,101.5,104.45,102.7,72,28,44,0.389,72,35,37,0.486,15,13,20,15,207.08,213.0,210.04000000000002
2016-03-27,1610612744,1610612755,2015,117.0,105.0,222.0,107.5,105.85,97.85,106.0,72,65,7,0.903,73,9,64,0.123,34,31,6,3,199.04,207.68,203.36
2016-03-27,1610612747,1610612764,2015,88.0,101.0,189.0,107.3,114.65,94.7,91.35,72,15,57,0.208,72,35,37,0.486,10,5,19,16,219.28,193.0,206.14
2016-03-26,1610612751,1610612754,2015,120.0,110.0,230.0,96.7,98.4,92.05,92.25,71,20,51,0.282,71,38,33,0.535,13,7,22,16,196.96,187.28,192.12
2016-03-26,1610612753,1610612741,2015,111.0,89.0,200.0,96.55,103.5,94.0,91.0,72,29,43,0.403,71,36,35,0.507,18,11,24,12,203.64,185.44,194.54
2016-03-26,1610612740,1610612761,2015,91.0,115.0,206.0,100.45,104.8,100.6,99.2,71,26,45,0.366,71,48,23,0.6759999999999999,18,8,28,20,200.8,206.0,203.4
2016-03-26,1610612765,1610612737,2015,95.0,112.0,207.0,100.85,105.95,96.35,95.7,73,39,34,0.534,73,43,30,0.589,24,15,24,19,206.0,199.44,202.72
2016-03-26,1610612752,1610612739,2015,93.0,107.0,200.0,101.2,97.2,101.9,101.55,73,30,43,0.411,72,51,21,0.708,17,13,30,21,200.28,195.48,197.88
2016-03-26,1610612750,1610612762,2015,84.0,93.0,177.0,110.05,111.2,95.55,106.55,72,24,48,0.333,72,35,37,0.486,12,12,22,13,209.4,200.2,204.8
2016-03-26,1610612760,1610612759,2015,111.0,92.0,203.0,101.8,103.4,107.75,96.55,72,50,22,0.6940000000000001,72,61,11,0.847,29,21,37,24,210.36,204.12,207.24
2016-03-26,1610612749,1610612766,2015,91.0,115.0,206.0,99.8,108.15,99.45,97.7,73,30,43,0.411,72,41,31,0.569,21,9,27,14,200.48,194.96,197.72
2016-03-26,1610612756,1610612738,2015,99.0,102.0,201.0,106.25,103.85,99.65,105.5,72,20,52,0.278,72,42,30,0.583,13,7,25,17,212.88,195.08,203.98000000000002
2016-03-26,1610612757,1610612755,2015,108.0,105.0,213.0,104.75,105.45,97.85,106.0,73,37,36,0.507,72,9,63,0.125,22,15,6,3,209.44,207.68,208.56
2016-03-25,1610612764,1610612750,2015,129.0,132.0,261.0,94.7,91.35,110.05,111.2,71,35,36,0.493,71,23,48,0.324,19,16,12,11,193.0,209.4,201.2
2016-03-25,1610612765,1610612766,2015,112.0,105.0,217.0,100.85,105.95,99.45,97.7,72,38,34,0.528,71,41,30,0.5770000000000001,23,15,27,14,206.0,194.96,200.48000000000002
2016-03-25,1610612748,1610612753,2015,108.0,97.0,205.0,97.25,95.5,96.55,103.5,71,41,30,0.5770000000000001,71,29,42,0.408,23,18,18,11,195.0,203.64,199.32
2016-03-25,1610612737,1610612749,2015,101.0,90.0,191.0,96.35,95.7,99.8,108.15,72,42,30,0.583,72,30,42,0.417,23,19,21,9,199.44,200.48,199.95999999999998
2016-03-25,1610612745,1610612761,2015,112.0,109.0,221.0,112.7,109.85,100.6,99.2,72,35,37,0.486,70,48,22,0.6859999999999999,19,16,28,20,216.24,206.0,211.12
2016-03-25,1610612759,1610612763,2015,110.0,104.0,214.0,107.75,96.55,98.25,97.5,71,60,11,0.845,72,41,31,0.569,36,24,25,16,204.12,193.96,199.04000000000002
2016-03-25,1610612758,1610612756,2015,116.0,94.0,210.0,97.75,101.5,106.25,103.85,71,27,44,0.38,71,20,51,0.282,14,13,13,7,207.08,212.88,209.98000000000002
2016-03-25,1610612744,1610612742,2015,128.0,120.0,248.0,107.5,105.85,104.45,102.7,71,64,7,0.901,71,35,36,0.493,33,31,20,15,199.04,213.0,206.01999999999998
2016-03-25,1610612747,1610612743,2015,105.0,116.0,221.0,107.3,114.65,109.2,110.3,71,15,56,0.211,72,30,42,0.417,10,5,17,13,219.28,217.04,218.16
2016-03-24,1610612754,1610612740,2015,92.0,84.0,176.0,92.05,92.25,100.45,104.8,70,37,33,0.529,70,26,44,0.371,21,16,18,8,187.28,200.8,194.04000000000002
2016-03-24,1610612751,1610612739,2015,104.0,95.0,199.0,96.7,98.4,101.9,101.55,70,19,51,0.271,71,51,20,0.718,12,7,30,21,196.96,195.48,196.22
2016-03-24,1610612752,1610612741,2015,106.0,94.0,200.0,101.2,97.2,94.0,91.0,72,29,43,0.403,70,36,34,0.514,16,13,24,12,200.28,185.44,192.86
2016-03-24,1610612760,1610612762,2015,113.0,91.0,204.0,101.8,103.4,95.55,106.55,71,49,22,0.69,71,35,36,0.493,28,21,22,13,210.36,200.2,205.28
2016-03-24,1610612746,1610612757,2015,96.0,94.0,190.0,109.85,106.5,104.75,105.45,70,43,27,0.614,72,37,35,0.514,22,21,22,15,214.36,209.44,211.9
2016-03-23,1610612764,1610612737,2015,101.0,122.0,223.0,94.7,91.35,96.35,95.7,70,35,35,0.5,71,41,30,0.5770000000000001,19,16,23,18,193.0,199.44,196.22
2016-03-23,1610612739,1610612749,2015,113.0,104.0,217.0,101.9,101.55,99.8,108.15,70,50,20,0.7140000000000001,71,30,41,0.423,29,21,21,9,195.48,200.48,197.98
2016-03-23,1610612738,1610612761,2015,91.0,79.0,170.0,99.65,105.5,100.6,99.2,71,41,30,0.5770000000000001,69,48,21,0.696,24,17,28,20,195.08,206.0,200.54000000000002
2016-03-23,1610612765,1610612753,2015,118.0,102.0,220.0,100.85,105.95,96.55,103.5,71,37,34,0.521,70,29,41,0.414,22,15,18,11,206.0,203.64,204.82
2016-03-23,1610612741,1610612752,2015,107.0,115.0,222.0,94.0,91.0,101.2,97.2,69,36,33,0.522,71,28,43,0.394,24,12,16,12,185.44,200.28,192.86
2016-03-23,1610612745,1610612762,2015,87.0,89.0,176.0,112.7,109.85,95.55,106.55,71,35,36,0.493,70,34,36,0.486,19,16,22,12,216.24,200.2,208.22
2016-03-23,1610612750,1610612758,2015,113.0,104.0,217.0,110.05,111.2,97.75,101.5,70,22,48,0.314,70,27,43,0.386,11,11,14,13,209.4,207.08,208.24
2016-03-23,1610612759,1610612748,2015,112.0,88.0,200.0,107.75,96.55,97.25,95.5,70,59,11,0.843,70,41,29,0.586,35,24,23,18,204.12,195.0,199.56
2016-03-23,1610612743,1610612755,2015,104.0,103.0,207.0,109.2,110.3,97.85,106.0,71,29,42,0.408,71,9,62,0.127,16,13,6,3,217.04,207.68,212.36
2016-03-23,1610612756,1610612747,2015,119.0,107.0,226.0,106.25,103.85,107.3,114.65,70,19,51,0.271,70,15,55,0.214,12,7,10,5,212.88,219.28,216.07999999999998
2016-03-23,1610612757,1610612742,2015,109.0,103.0,212.0,104.75,105.45,104.45,102.7,71,36,35,0.507,70,35,35,0.5,21,15,20,15,209.44,213.0,211.22
2016-03-23,1610612744,1610612746,2015,114.0,98.0,212.0,107.5,105.85,109.85,106.5,70,63,7,0.9,69,43,26,0.623,32,31,22,21,199.04,214.36,206.7
2016-03-22,1610612751,1610612766,2015,100.0,105.0,205.0,96.7,98.4,99.45,97.7,69,19,50,0.275,70,40,30,0.5710000000000001,12,7,27,13,196.96,194.96,195.96
2016-03-22,1610612740,1610612748,2015,99.0,113.0,212.0,100.45,104.8,97.25,95.5,69,26,43,0.377,69,40,29,0.58,18,8,23,17,200.8,195.0,197.9
2016-03-22,1610612760,1610612745,2015,111.0,107.0,218.0,101.8,103.4,112.7,109.85,70,48,22,0.6859999999999999,70,35,35,0.5,27,21,19,16,210.36,216.24,213.3
2016-03-22,1610612747,1610612763,2015,107.0,100.0,207.0,107.3,114.65,98.25,97.5,69,14,55,0.203,71,41,30,0.5770000000000001,9,5,25,16,219.28,193.96,206.62
2016-03-21,1610612766,1610612759,2015,91.0,88.0,179.0,99.45,97.7,107.75,96.55,69,39,30,0.565,69,59,10,0.855,26,13,35,24,194.96,204.12,199.54000000000002
2016-03-21,1610612739,1610612743,2015,124.0,91.0,215.0,101.9,101.55,109.2,110.3,69,49,20,0.71,70,29,41,0.414,28,21,16,13,195.48,217.04,206.26
2016-03-21,1610612754,1610612755,2015,91.0,75.0,166.0,92.05,92.25,97.85,106.0,69,36,33,0.522,70,9,61,0.129,20,16,6,3,187.28,207.68,197.48000000000002
2016-03-21,1610612738,1610612753,2015,107.0,96.0,203.0,99.65,105.5,96.55,103.5,70,40,30,0.5710000000000001,69,29,40,0.42,23,17,18,11,195.08,203.64,199.36
2016-03-21,1610612765,1610612749,2015,92.0,91.0,183.0,100.85,105.95,99.8,108.15,70,36,34,0.514,70,30,40,0.429,21,15,21,9,206.0,200.48,203.24
2016-03-21,1610612737,1610612764,2015,102.0,117.0,219.0,96.35,95.7,94.7,91.35,70,41,29,0.586,69,34,35,0.493,23,18,19,15,199.44,193.0,196.22
2016-03-21,1610612741,1610612758,2015,109.0,102.0,211.0,94.0,91.0,97.75,101.5,68,35,33,0.515,69,27,42,0.391,23,12,14,13,185.44,207.08,196.26
2016-03-21,1610612750,1610612744,2015,104.0,109.0,213.0,110.05,111.2,107.5,105.85,69,22,47,0.319,69,62,7,0.899,11,11,32,30,209.4,199.04,204.22
2016-03-21,1610612756,1610612763,2015,97.0,103.0,200.0,106.25,103.85,98.25,97.5,69,19,50,0.275,70,40,30,0.5710000000000001,12,7,25,15,212.88,193.96,203.42000000000002
2016-03-20,1610612742,1610612757,2015,132.0,120.0,252.0,104.45,102.7,104.75,105.45,69,34,35,0.493,70,36,34,0.514,19,15,21,15,213.0,209.44,211.22
2016-03-20,1610612761,1610612753,2015,105.0,100.0,205.0,100.6,99.2,96.55,103.5,68,47,21,0.691,68,29,39,0.426,27,20,18,11,206.0,203.64,204.82
2016-03-20,1610612755,1610612738,2015,105.0,120.0,225.0,97.85,106.0,99.65,105.5,69,9,60,0.13,69,39,30,0.565,6,3,23,16,207.68,195.08,201.38
2016-03-20,1610612740,1610612746,2015,109.0,105.0,214.0,100.45,104.8,109.85,106.5,68,25,43,0.368,68,43,25,0.632,17,8,22,21,200.8,214.36,207.58
2016-03-20,1610612749,1610612762,2015,85.0,94.0,179.0,99.8,108.15,95.55,106.55,69,30,39,0.435,69,33,36,0.478,21,9,22,11,200.48,200.2,200.33999999999997
2016-03-20,1610612752,1610612758,2015,80.0,88.0,168.0,101.2,97.2,97.75,101.5,70,28,42,0.4,68,26,42,0.382,16,12,14,12,200.28,207.08,203.68
2016-03-19,1610612766,1610612743,2015,93.0,101.0,194.0,99.45,97.7,109.2,110.3,68,39,29,0.574,69,28,41,0.406,26,13,16,12,194.96,217.04,206.0
2016-03-19,1610612765,1610612751,2015,115.0,103.0,218.0,100.85,105.95,96.7,98.4,69,35,34,0.507,68,19,49,0.279,20,15,12,7,206.0,196.96,201.48000000000002
2016-03-19,1610612754,1610612760,2015,111.0,115.0,226.0,92.05,92.25,101.8,103.4,68,36,32,0.529,69,47,22,0.6809999999999999,20,16,27,20,187.28,210.36,198.82
2016-03-19,1610612764,1610612752,2015,99.0,89.0,188.0,94.7,91.35,101.2,97.2,68,33,35,0.485,69,28,41,0.406,18,15,16,12,193.0,200.28,196.64
2016-03-19,1610612737,1610612745,2015,109.0,97.0,206.0,96.35,95.7,112.7,109.85,69,40,29,0.58,69,35,34,0.507,22,18,19,16,199.44,216.24,207.84
2016-03-19,1610612748,1610612739,2015,122.0,101.0,223.0,97.25,95.5,101.9,101.55,68,39,29,0.574,68,49,19,0.721,22,17,28,21,195.0,195.48,195.24
2016-03-19,1610612741,1610612762,2015,92.0,85.0,177.0,94.0,91.0,95.55,106.55,67,34,33,0.507,68,33,35,0.485,22,12,22,11,185.44,200.2,192.82
2016-03-19,1610612763,1610612746,2015,113.0,102.0,215.0,98.25,97.5,109.85,106.5,69,39,30,0.565,67,43,24,0.642,24,15,22,21,193.96,214.36,204.16000000000003
2016-03-19,1610612759,1610612744,2015,87.0,79.0,166.0,107.75,96.55,107.5,105.85,68,58,10,0.853,68,62,6,0.912,34,24,32,30,204.12,199.04,201.57999999999998
2016-03-18,1610612753,1610612739,2015,103.0,109.0,212.0,96.55,103.5,101.9,101.55,67,29,38,0.433,67,48,19,0.716,18,11,28,20,203.64,195.48,199.56
2016-03-18,1610612755,1610612760,2015,97.0,111.0,208.0,97.85,106.0,101.8,103.4,68,9,59,0.132,68,46,22,0.6759999999999999,6,3,27,19,207.68,210.36,209.02
2016-03-18,1610612765,1610612758,2015,115.0,108.0,223.0,100.85,105.95,97.75,101.5,68,34,34,0.5,67,26,41,0.388,19,15,14,12,206.0,207.08,206.54000000000002
2016-03-18,1610612761,1610612738,2015,105.0,91.0,196.0,100.6,99.2,99.65,105.5,67,46,21,0.687,68,39,29,0.574,26,20,23,16,206.0,195.08,200.54000000000002
2016-03-18,1610612745,1610612750,2015,116.0,111.0,227.0,112.7,109.85,110.05,111.2,68,34,34,0.5,68,22,46,0.324,18,16,11,11,216.24,209.4,212.82
2016-03-18,1610612740,1610612757,2015,112.0,117.0,229.0,100.45,104.8,104.75,105.45,67,25,42,0.373,69,35,34,0.507,17,8,21,14,200.8,209.44,205.12
2016-03-18,1610612742,1610612744,2015,112.0,130.0,242.0,104.45,102.7,107.5,105.85,68,34,34,0.5,67,61,6,0.91,19,15,32,29,213.0,199.04,206.01999999999998
2016-03-18,1610612747,1610612756,2015,90.0,95.0,185.0,107.3,114.65,106.25,103.85,68,14,54,0.206,68,18,50,0.265,9,5,12,6,219.28,212.88,216.07999999999998
2016-03-17,1610612754,1610612761,2015,94.0,101.0,195.0,92.05,92.25,100.6,99.2,67,36,31,0.537,66,45,21,0.682,20,16,26,19,187.28,206.0,196.64
2016-03-17,1610612755,1610612764,2015,94.0,99.0,193.0,97.85,106.0,94.7,91.35,67,9,58,0.134,67,32,35,0.478,6,3,18,14,207.68,193.0,200.34
2016-03-17,1610612748,1610612766,2015,106.0,109.0,215.0,97.25,95.5,99.45,97.7,67,39,28,0.5820000000000001,67,38,29,0.5670000000000001,22,17,26,12,195.0,194.96,194.98000000000002
2016-03-17,1610612737,1610612743,2015,116.0,98.0,214.0,96.35,95.7,109.2,110.3,68,39,29,0.574,68,28,40,0.412,21,18,16,12,199.44,217.04,208.24
2016-03-17,1610612741,1610612751,2015,118.0,102.0,220.0,94.0,91.0,96.7,98.4,66,33,33,0.5,67,19,48,0.284,21,12,12,7,185.44,196.96,191.2
2016-03-17,1610612749,1610612763,2015,96.0,86.0,182.0,99.8,108.15,98.25,97.5,68,29,39,0.426,68,39,29,0.574,20,9,24,15,200.48,193.96,197.22
2016-03-17,1610612759,1610612757,2015,118.0,110.0,228.0,107.75,96.55,104.75,105.45,67,57,10,0.851,68,35,33,0.515,33,24,21,14,204.12,209.44,206.78
2016-03-17,1610612762,1610612756,2015,103.0,69.0,172.0,95.55,106.55,106.25,103.85,67,32,35,0.478,67,18,49,0.269,21,11,12,6,200.2,212.88,206.54
2016-03-16,1610612738,1610612760,2015,109.0,130.0,239.0,99.65,105.5,101.8,103.4,67,39,28,0.5820000000000001,67,45,22,0.672,23,16,27,18,195.08,210.36,202.72000000000003
2016-03-16,1610612766,1610612753,2015,107.0,99.0,206.0,99.45,97.7,96.55,103.5,66,37,29,0.561,66,29,37,0.439,25,12,18,11,194.96,203.64,199.3
2016-03-16,1610612739,1610612742,2015,99.0,98.0,197.0,101.9,101.55,104.45,102.7,66,47,19,0.7120000000000001,67,34,33,0.507,27,20,19,15,195.48,213.0,204.24
2016-03-16,1610612764,1610612741,2015,117.0,96.0,213.0,94.7,91.35,94.0,91.0,66,31,35,0.47,65,33,32,0.508,17,14,21,12,193.0,185.44,189.22
2016-03-16,1610612765,1610612737,2015,114.0,118.0,232.0,100.85,105.95,96.35,95.7,67,34,33,0.507,67,38,29,0.5670000000000001,19,15,21,17,206.0,199.44,202.72
2016-03-16,1610612763,1610612750,2015,108.0,114.0,222.0,98.25,97.5,110.05,111.2,67,39,28,0.5820000000000001,67,21,46,0.313,24,15,11,10,193.96,209.4,201.68
2016-03-16,1610612745,1610612746,2015,106.0,122.0,228.0,112.7,109.85,109.85,106.5,67,34,33,0.507,66,42,24,0.636,18,16,22,20,216.24,214.36,215.3
2016-03-16,1610612758,1610612740,2015,108.0,123.0,231.0,97.75,101.5,100.45,104.8,66,26,40,0.394,66,24,42,0.364,14,12,17,7,207.08,200.8,203.94
2016-03-16,1610612744,1610612752,2015,121.0,85.0,206.0,107.5,105.85,101.2,97.2,66,60,6,0.909,68,28,40,0.412,31,29,16,12,199.04,200.28,199.66
2016-03-15,1610612754,1610612738,2015,103.0,98.0,201.0,92.05,92.25,99.65,105.5,66,35,31,0.53,66,39,27,0.591,19,16,23,16,187.28,195.08,191.18
2016-03-15,1610612753,1610612743,2015,116.0,110.0,226.0,96.55,103.5,109.2,110.3,65,28,37,0.431,67,28,39,0.418,17,11,16,12,203.64,217.04,210.33999999999997
2016-03-15,1610612751,1610612755,2015,131.0,114.0,245.0,96.7,98.4,97.85,106.0,66,18,48,0.273,66,9,57,0.136,11,7,6,3,196.96,207.68,202.32
2016-03-15,1610612749,1610612761,2015,89.0,107.0,196.0,99.8,108.15,100.6,99.2,67,29,38,0.433,65,44,21,0.677,20,9,26,18,200.48,206.0,203.24
2016-03-15,1610612759,1610612746,2015,108.0,87.0,195.0,107.75,96.55,109.85,106.5,66,56,10,0.848,65,42,23,0.6459999999999999,32,24,22,20,204.12,214.36,209.24
2016-03-15,1610612747,1610612758,2015,98.0,106.0,204.0,107.3,114.65,97.75,101.5,67,14,53,0.209,65,25,40,0.385,9,5,14,11,219.28,207.08,213.18
2016-03-14,1610612766,1610612742,2015,96.0,107.0,203.0,99.45,97.7,104.45,102.7,65,37,28,0.569,66,33,33,0.5,25,12,19,14,194.96,213.0,203.98000000000002
2016-03-14,1610612748,1610612743,2015,124.0,119.0,243.0,97.25,95.5,109.2,110.3,66,38,28,0.5760000000000001,66,28,38,0.424,21,17,16,12,195.0,217.04,206.01999999999998
2016-03-14,1610612761,1610612741,2015,107.0,109.0,216.0,100.6,99.2,94.0,91.0,64,44,20,0.688,64,32,32,0.5,26,18,21,11,206.0,185.44,195.72
2016-03-14,1610612764,1610612765,2015,124.0,81.0,205.0,94.7,91.35,100.85,105.95,65,30,35,0.462,66,34,32,0.515,16,14,19,15,193.0,206.0,199.5
2016-03-14,1610612745,1610612763,2015,130.0,81.0,211.0,112.7,109.85,98.25,97.5,66,33,33,0.5,66,39,27,0.591,17,16,24,15,216.24,193.96,205.10000000000002
2016-03-14,1610612760,1610612757,2015,128.0,94.0,222.0,101.8,103.4,104.75,105.45,66,44,22,0.667,67,35,32,0.522,26,18,21,14,210.36,209.44,209.9
2016-03-14,1610612756,1610612750,2015,107.0,104.0,211.0,106.25,103.85,110.05,111.2,66,17,49,0.258,66,21,45,0.318,11,6,11,10,212.88,209.4,211.14
2016-03-14,1610612762,1610612739,2015,94.0,85.0,179.0,95.55,106.55,101.9,101.55,66,31,35,0.47,65,47,18,0.723,20,11,27,20,200.2,195.48,197.83999999999997
2016-03-14,1610612744,1610612740,2015,125.0,107.0,232.0,107.5,105.85,100.45,104.8,65,59,6,0.908,65,24,41,0.369,30,29,17,7,199.04,200.8,199.92000000000002
2016-03-13,1610612746,1610612739,2015,90.0,114.0,204.0,109.85,106.5,101.9,101.55,64,42,22,0.6559999999999999,64,46,18,0.7190000000000001,22,20,27,19,214.36,195.48,204.92000000000002
2016-03-13,1610612737,1610612754,2015,104.0,75.0,179.0,96.35,95.7,92.05,92.25,66,37,29,0.561,65,35,30,0.5379999999999999,20,17,19,16,199.44,187.28,193.36
2016-03-13,1610612758,1610612762,2015,99.0,108.0,207.0,97.75,101.5,95.55,106.55,64,25,39,0.391,65,30,35,0.462,14,11,20,10,207.08,200.2,203.64
2016-03-13,1610612751,1610612749,2015,100.0,109.0,209.0,96.7,98.4,99.8,108.15,65,18,47,0.277,66,28,38,0.424,11,7,20,8,196.96,200.48,198.72
2016-03-13,1610612747,1610612752,2015,87.0,90.0,177.0,107.3,114.65,101.2,97.2,66,14,52,0.212,67,27,40,0.403,9,5,16,11,219.28,200.28,209.78
2016-03-12,1610612742,1610612754,2015,105.0,112.0,217.0,104.45,102.7,92.05,92.25,65,33,32,0.508,64,34,30,0.531,19,14,19,15,213.0,187.28,200.14
2016-03-12,1610612766,1610612745,2015,125.0,109.0,234.0,99.45,97.7,112.7,109.85,64,36,28,0.563,65,33,32,0.508,24,12,17,16,194.96,216.24,205.60000000000002
2016-03-12,1610612755,1610612765,2015,111.0,125.0,236.0,97.85,106.0,100.85,105.95,65,9,56,0.138,65,33,32,0.508,6,3,19,14,207.68,206.0,206.84
2016-03-12,1610612761,1610612748,2015,112.0,104.0,216.0,100.6,99.2,97.25,95.5,63,43,20,0.6829999999999999,65,38,27,0.585,25,18,21,17,206.0,195.0,200.5
2016-03-12,1610612737,1610612763,2015,95.0,83.0,178.0,96.35,95.7,98.25,97.5,65,36,29,0.5539999999999999,65,39,26,0.6,19,17,24,15,199.44,193.96,196.7
2016-03-12,1610612749,1610612740,2015,103.0,92.0,195.0,99.8,108.15,100.45,104.8,65,27,38,0.415,64,24,40,0.375,19,8,17,7,200.48,200.8,200.64
2016-03-12,1610612759,1610612760,2015,93.0,85.0,178.0,107.75,96.55,101.8,103.4,65,55,10,0.846,65,44,21,0.677,31,24,26,18,204.12,210.36,207.24
2016-03-12,1610612743,1610612764,2015,116.0,100.0,216.0,109.2,110.3,94.7,91.35,65,27,38,0.415,64,30,34,0.469,15,12,16,14,217.04,193.0,205.01999999999998
2016-03-12,1610612744,1610612756,2015,123.0,116.0,239.0,107.5,105.85,106.25,103.85,64,58,6,0.906,65,17,48,0.262,29,29,11,6,199.04,212.88,205.95999999999998
2016-03-12,1610612757,1610612753,2015,121.0,84.0,205.0,104.75,105.45,96.55,103.5,66,34,32,0.515,64,28,36,0.438,20,14,17,11,209.44,203.64,206.54
2016-03-11,1610612766,1610612765,2015,118.0,103.0,221.0,99.45,97.7,100.85,105.95,63,35,28,0.556,64,33,31,0.516,23,12,19,14,194.96,206.0,200.48000000000002
2016-03-11,1610612755,1610612751,2015,95.0,89.0,184.0,97.85,106.0,96.7,98.4,64,8,56,0.125,64,18,46,0.281,5,3,11,7,207.68,196.96,202.32
2016-03-11,1610612738,1610612745,2015,98.0,102.0,200.0,99.65,105.5,112.7,109.85,65,39,26,0.6,64,32,32,0.5,23,16,17,15,195.08,216.24,205.66000000000003
2016-03-11,1610612741,1610612748,2015,96.0,118.0,214.0,94.0,91.0,97.25,95.5,63,32,31,0.508,64,37,27,0.578,21,11,21,16,185.44,195.0,190.22
2016-03-11,1610612763,1610612740,2015,121.0,114.0,235.0,98.25,97.5,100.45,104.8,64,38,26,0.594,63,24,39,0.381,23,15,17,7,193.96,200.8,197.38
2016-03-11,1610612760,1610612750,2015,96.0,99.0,195.0,101.8,103.4,110.05,111.2,64,44,20,0.688,65,20,45,0.308,26,18,11,9,210.36,209.4,209.88
2016-03-11,1610612762,1610612764,2015,114.0,93.0,207.0,95.55,106.55,94.7,91.35,64,29,35,0.453,63,30,33,0.476,19,10,16,14,200.2,193.0,196.6
2016-03-11,1610612758,1610612753,2015,100.0,107.0,207.0,97.75,101.5,96.55,103.5,63,25,38,0.397,63,27,36,0.429,14,11,17,10,207.08,203.64,205.36
2016-03-11,1610612744,1610612757,2015,128.0,112.0,240.0,107.5,105.85,104.75,105.45,63,57,6,0.905,65,34,31,0.523,28,29,20,14,199.04,209.44,204.24
2016-03-11,1610612746,1610612752,2015,101.0,94.0,195.0,109.85,106.5,101.2,97.2,63,41,22,0.6509999999999999,66,27,39,0.409,21,20,16,11,214.36,200.28,207.32
2016-03-10,1610612761,1610612737,2015,104.0,96.0,200.0,100.6,99.2,96.35,95.7,62,42,20,0.677,64,36,28,0.563,24,18,19,17,206.0,199.44,202.72
2016-03-10,1610612759,1610612741,2015,109.0,101.0,210.0,107.75,96.55,94.0,91.0,64,54,10,0.8440000000000001,62,32,30,0.516,30,24,21,11,204.12,185.44,194.78
2016-03-10,1610612743,1610612756,2015,116.0,98.0,214.0,109.2,110.3,106.25,103.85,64,26,38,0.406,64,17,47,0.266,14,12,11,6,217.04,212.88,214.95999999999998
2016-03-10,1610612747,1610612739,2015,108.0,120.0,228.0,107.3,114.65,101.9,101.55,65,14,51,0.215,63,45,18,0.7140000000000001,9,5,27,18,219.28,195.48,207.38
2016-03-09,1610612766,1610612740,2015,122.0,113.0,235.0,99.45,97.7,100.45,104.8,62,34,28,0.5479999999999999,62,24,38,0.387,22,12,17,7,194.96,200.8,197.88
2016-03-09,1610612755,1610612745,2015,104.0,118.0,222.0,97.85,106.0,112.7,109.85,63,8,55,0.127,63,31,32,0.4920000000000001,5,3,17,14,207.68,216.24,211.96
2016-03-09,1610612738,1610612763,2015,116.0,96.0,212.0,99.65,105.5,98.25,97.5,64,38,26,0.594,63,38,25,0.603,22,16,23,15,195.08,193.96,194.52
2016-03-09,1610612749,1610612748,2015,114.0,108.0,222.0,99.8,108.15,97.25,95.5,64,26,38,0.406,63,37,26,0.5870000000000001,18,8,21,16,200.48,195.0,197.74
2016-03-09,1610612742,1610612765,2015,96.0,102.0,198.0,104.45,102.7,100.85,105.95,64,33,31,0.516,63,32,31,0.508,19,14,19,13,213.0,206.0,209.5
2016-03-09,1610612756,1610612752,2015,97.0,128.0,225.0,106.25,103.85,101.2,97.2,63,17,46,0.27,65,26,39,0.4,11,6,16,10,212.88,200.28,206.57999999999998
2016-03-09,1610612760,1610612746,2015,120.0,108.0,228.0,101.8,103.4,109.85,106.5,63,43,20,0.6829999999999999,62,41,21,0.6609999999999999,25,18,21,20,210.36,214.36,212.36
2016-03-09,1610612758,1610612739,2015,111.0,120.0,231.0,97.75,101.5,101.9,101.55,62,25,37,0.403,62,44,18,0.71,14,11,27,17,207.08,195.48,201.28
2016-03-09,1610612744,1610612762,2015,115.0,94.0,209.0,107.5,105.85,95.55,106.55,62,56,6,0.903,63,29,34,0.46,27,29,19,10,199.04,200.2,199.62
2016-03-08,1610612761,1610612751,2015,104.0,99.0,203.0,100.6,99.2,96.7,98.4,61,41,20,0.672,63,18,45,0.28600000000000003,23,18,11,7,206.0,196.96,201.48000000000002
2016-03-08,1610612750,1610612759,2015,91.0,116.0,207.0,110.05,111.2,107.75,96.55,64,20,44,0.313,63,53,10,0.841,11,9,30,23,209.4,204.12,206.76
2016-03-08,1610612743,1610612752,2015,110.0,94.0,204.0,109.2,110.3,101.2,97.2,63,25,38,0.397,64,26,38,0.406,13,12,16,10,217.04,200.28,208.66
2016-03-08,1610612762,1610612737,2015,84.0,91.0,175.0,95.55,106.55,96.35,95.7,62,29,33,0.468,63,35,28,0.556,19,10,19,16,200.2,199.44,199.82
2016-03-08,1610612757,1610612764,2015,116.0,109.0,225.0,104.75,105.45,94.7,91.35,64,33,31,0.516,62,30,32,0.484,19,14,16,14,209.44,193.0,201.22
2016-03-08,1610612747,1610612753,2015,107.0,98.0,205.0,107.3,114.65,96.55,103.5,64,13,51,0.203,62,27,35,0.435,8,5,17,10,219.28,203.64,211.45999999999998
2016-03-07,1610612766,1610612750,2015,108.0,103.0,211.0,99.45,97.7,110.05,111.2,61,33,28,0.541,63,20,43,0.317,21,12,11,9,194.96,209.4,202.18
2016-03-07,1610612739,1610612763,2015,103.0,106.0,209.0,101.9,101.55,98.25,97.5,61,44,17,0.721,62,37,25,0.597,27,17,23,14,195.48,193.96,194.72
2016-03-07,1610612754,1610612759,2015,99.0,91.0,190.0,92.05,92.25,107.75,96.55,63,33,30,0.524,62,53,9,0.855,18,15,30,23,187.28,204.12,195.7
2016-03-07,1610612741,1610612749,2015,100.0,90.0,190.0,94.0,91.0,99.8,108.15,61,31,30,0.508,63,26,37,0.413,20,11,18,8,185.44,200.48,192.95999999999998
2016-03-07,1610612740,1610612758,2015,115.0,112.0,227.0,100.45,104.8,97.75,101.5,61,23,38,0.377,61,25,36,0.41,16,7,14,11,200.8,207.08,203.94
2016-03-07,1610612742,1610612746,2015,90.0,109.0,199.0,104.45,102.7,109.85,106.5,63,33,30,0.524,61,40,21,0.6559999999999999,19,14,21,19,213.0,214.36,213.68
2016-03-07,1610612744,1610612753,2015,119.0,113.0,232.0,107.5,105.85,96.55,103.5,61,55,6,0.902,61,27,34,0.443,26,29,17,10,199.04,203.64,201.33999999999997
2016-03-06,1610612749,1610612760,2015,96.0,104.0,200.0,99.8,108.15,101.8,103.4,62,26,36,0.419,62,42,20,0.677,18,8,25,17,200.48,210.36,205.42000000000002
2016-03-06,1610612747,1610612744,2015,112.0,95.0,207.0,107.3,114.65,107.5,105.85,63,12,51,0.19,60,55,5,0.917,7,5,26,29,219.28,199.04,209.16
2016-03-06,1610612763,1610612756,2015,100.0,109.0,209.0,98.25,97.5,106.25,103.85,61,37,24,0.607,62,16,46,0.258,23,14,11,5,193.96,212.88,203.42000000000002
2016-03-06,1610612743,1610612742,2015,116.0,114.0,230.0,109.2,110.3,104.45,102.7,62,24,38,0.387,62,33,29,0.532,12,12,19,14,217.04,213.0,215.01999999999998
2016-03-06,1610612765,1610612757,2015,123.0,103.0,226.0,100.85,105.95,104.75,105.45,62,31,31,0.5,63,33,30,0.524,18,13,19,14,206.0,209.44,207.72
2016-03-06,1610612748,1610612755,2015,103.0,98.0,201.0,97.25,95.5,97.85,106.0,62,36,26,0.581,62,8,54,0.129,20,16,5,3,195.0,207.68,201.34
2016-03-06,1610612761,1610612745,2015,107.0,113.0,220.0,100.6,99.2,112.7,109.85,60,41,19,0.6829999999999999,62,30,32,0.484,23,18,17,13,206.0,216.24,211.12
2016-03-05,1610612739,1610612738,2015,120.0,103.0,223.0,101.9,101.55,99.65,105.5,60,43,17,0.7170000000000001,63,38,25,0.603,26,17,22,16,195.48,195.08,195.28
2016-03-05,1610612752,1610612765,2015,102.0,89.0,191.0,101.2,97.2,100.85,105.95,63,25,38,0.397,61,31,30,0.508,15,10,18,13,200.28,206.0,203.14
2016-03-05,1610612764,1610612754,2015,99.0,100.0,199.0,94.7,91.35,92.05,92.25,61,30,31,0.4920000000000001,62,32,30,0.516,16,14,18,14,193.0,187.28,190.14
2016-03-05,1610612740,1610612762,2015,94.0,106.0,200.0,100.45,104.8,95.55,106.55,60,23,37,0.383,61,28,33,0.459,16,7,19,9,200.8,200.2,200.5
2016-03-05,1610612750,1610612751,2015,132.0,118.0,250.0,110.05,111.2,96.7,98.4,62,19,43,0.306,62,18,44,0.29,10,9,11,7,209.4,196.96,203.18
2016-03-05,1610612741,1610612745,2015,108.0,100.0,208.0,94.0,91.0,112.7,109.85,60,30,30,0.5,61,30,31,0.4920000000000001,19,11,17,13,185.44,216.24,200.84
2016-03-05,1610612759,1610612758,2015,104.0,94.0,198.0,107.75,96.55,97.75,101.5,61,52,9,0.852,60,25,35,0.417,29,23,14,11,204.12,207.08,205.60000000000002
2016-03-05,1610612746,1610612737,2015,97.0,107.0,204.0,109.85,106.5,96.35,95.7,60,40,20,0.667,62,34,28,0.5479999999999999,21,19,19,15,214.36,199.44,206.9
2016-03-04,1610612766,1610612754,2015,108.0,101.0,209.0,99.45,97.7,92.05,92.25,60,32,28,0.5329999999999999,61,32,29,0.525,20,12,18,14,194.96,187.28,191.12
2016-03-04,1610612753,1610612756,2015,84.0,102.0,186.0,96.55,103.5,106.25,103.85,60,27,33,0.45,61,15,46,0.246,17,10,11,4,203.64,212.88,208.26
2016-03-04,1610612755,1610612748,2015,102.0,112.0,214.0,97.85,106.0,97.25,95.5,61,8,53,0.131,61,35,26,0.574,5,3,20,15,207.68,195.0,201.34
2016-03-04,1610612738,1610612752,2015,105.0,104.0,209.0,99.65,105.5,101.2,97.2,62,37,25,0.597,62,25,37,0.403,21,16,15,10,195.08,200.28,197.68
2016-03-04,1610612761,1610612757,2015,117.0,115.0,232.0,100.6,99.2,104.75,105.45,59,40,19,0.6779999999999999,62,33,29,0.532,22,18,19,14,206.0,209.44,207.72
2016-03-04,1610612739,1610612764,2015,108.0,83.0,191.0,101.9,101.55,94.7,91.35,59,42,17,0.7120000000000001,60,30,30,0.5,25,17,16,14,195.48,193.0,194.24
2016-03-04,1610612763,1610612762,2015,94.0,88.0,182.0,98.25,97.5,95.55,106.55,60,36,24,0.6,60,28,32,0.467,22,14,19,9,193.96,200.2,197.07999999999998
2016-03-04,1610612749,1610612750,2015,116.0,101.0,217.0,99.8,108.15,110.05,111.2,61,25,36,0.41,61,19,42,0.311,17,8,10,9,200.48,209.4,204.94
2016-03-04,1610612743,1610612751,2015,120.0,121.0,241.0,109.2,110.3,96.7,98.4,61,24,37,0.393,61,17,44,0.279,12,12,11,6,217.04,196.96,207.0
2016-03-04,1610612747,1610612737,2015,77.0,106.0,183.0,107.3,114.65,96.35,95.7,62,12,50,0.194,61,33,28,0.541,7,5,19,14,219.28,199.44,209.36
2016-03-03,1610612748,1610612756,2015,108.0,92.0,200.0,97.25,95.5,106.25,103.85,60,34,26,0.5670000000000001,60,15,45,0.25,19,15,11,4,195.0,212.88,203.94
2016-03-03,1610612740,1610612759,2015,86.0,94.0,180.0,100.45,104.8,107.75,96.55,59,23,36,0.39,60,51,9,0.85,16,7,29,22,200.8,204.12,202.46
2016-03-03,1610612742,1610612758,2015,101.0,104.0,205.0,104.45,102.7,97.75,101.5,61,33,28,0.541,59,24,35,0.407,19,14,14,10,213.0,207.08,210.04000000000002
2016-03-03,1610612744,1610612760,2015,121.0,106.0,227.0,107.5,105.85,101.8,103.4,59,54,5,0.915,61,42,19,0.6890000000000001,25,29,25,17,199.04,210.36,204.7
2016-03-02,1610612753,1610612741,2015,102.0,89.0,191.0,96.55,103.5,94.0,91.0,59,26,33,0.441,59,30,29,0.508,16,10,19,11,203.64,185.44,194.54
2016-03-02,1610612755,1610612766,2015,99.0,119.0,218.0,97.85,106.0,99.45,97.7,60,8,52,0.133,59,31,28,0.525,5,3,20,11,207.68,194.96,201.32
2016-03-02,1610612738,1610612757,2015,116.0,93.0,209.0,99.65,105.5,104.75,105.45,61,36,25,0.59,61,33,28,0.541,20,16,19,14,195.08,209.44,202.26
2016-03-02,1610612761,1610612762,2015,104.0,94.0,198.0,100.6,99.2,95.55,106.55,58,39,19,0.672,59,28,31,0.475,21,18,19,9,206.0,200.2,203.1
2016-03-02,1610612745,1610612740,2015,100.0,95.0,195.0,112.7,109.85,100.45,104.8,60,29,31,0.483,58,23,35,0.397,16,13,16,7,216.24,200.8,208.52
2016-03-02,1610612763,1610612758,2015,104.0,98.0,202.0,98.25,97.5,97.75,101.5,59,35,24,0.593,58,24,34,0.414,21,14,14,10,193.96,207.08,200.52
2016-03-02,1610612749,1610612754,2015,99.0,104.0,203.0,99.8,108.15,92.05,92.25,60,25,35,0.417,60,31,29,0.517,17,8,18,13,200.48,187.28,193.88
2016-03-02,1610612750,1610612764,2015,98.0,104.0,202.0,110.05,111.2,94.7,91.35,60,19,41,0.317,59,29,30,0.4920000000000001,10,9,16,13,209.4,193.0,201.2
2016-03-02,1610612759,1610612765,2015,97.0,81.0,178.0,107.75,96.55,100.85,105.95,59,50,9,0.847,60,31,29,0.517,28,22,18,13,204.12,206.0,205.06
2016-03-02,1610612743,1610612747,2015,117.0,107.0,224.0,109.2,110.3,107.3,114.65,60,23,37,0.383,61,12,49,0.197,11,12,7,5,217.04,219.28,218.16
2016-03-02,1610612746,1610612760,2015,103.0,98.0,201.0,109.85,106.5,101.8,103.4,59,39,20,0.6609999999999999,60,42,18,0.7,20,19,25,17,214.36,210.36,212.36
2016-03-01,1610612766,1610612756,2015,126.0,92.0,218.0,99.45,97.7,106.25,103.85,58,30,28,0.517,59,15,44,0.254,19,11,11,4,194.96,212.88,203.92000000000002
2016-03-01,1610612748,1610612741,2015,129.0,111.0,240.0,97.25,95.5,94.0,91.0,59,33,26,0.5589999999999999,58,30,28,0.517,18,15,19,11,195.0,185.44,190.22
2016-03-01,1610612752,1610612757,2015,85.0,104.0,189.0,101.2,97.2,104.75,105.45,61,25,36,0.41,60,32,28,0.5329999999999999,15,10,19,13,200.28,209.44,204.86
2016-03-01,1610612742,1610612753,2015,121.0,108.0,229.0,104.45,102.7,96.55,103.5,60,32,28,0.5329999999999999,58,26,32,0.448,18,14,16,10,213.0,203.64,208.32
2016-03-01,1610612744,1610612737,2015,109.0,105.0,214.0,107.5,105.85,96.35,95.7,58,53,5,0.914,60,33,27,0.55,24,29,19,14,199.04,199.44,199.24
2016-03-01,1610612747,1610612751,2015,107.0,101.0,208.0,107.3,114.65,96.7,98.4,60,11,49,0.183,60,17,43,0.28300000000000003,6,5,11,6,219.28,196.96,208.12
2016-02-29,1610612739,1610612754,2015,100.0,96.0,196.0,101.9,101.55,92.05,92.25,58,41,17,0.7070000000000001,59,31,28,0.525,24,17,18,13,195.48,187.28,191.38
2016-02-29,1610612764,1610612755,2015,116.0,108.0,224.0,94.7,91.35,97.85,106.0,58,28,30,0.483,59,8,51,0.136,15,13,5,3,193.0,207.68,200.34
2016-02-29,1610612738,1610612762,2015,100.0,95.0,195.0,99.65,105.5,95.55,106.55,60,35,25,0.583,58,28,30,0.483,19,16,19,9,195.08,200.2,197.64
2016-02-29,1610612749,1610612745,2015,128.0,121.0,249.0,99.8,108.15,112.7,109.85,59,24,35,0.407,59,29,30,0.4920000000000001,16,8,16,13,200.48,216.24,208.36
2016-02-29,1610612743,1610612763,2015,96.0,103.0,199.0,109.2,110.3,98.25,97.5,59,23,36,0.39,58,34,24,0.586,11,12,21,13,217.04,193.96,205.5
2016-02-29,1610612758,1610612760,2015,116.0,131.0,247.0,97.75,101.5,101.8,103.4,57,24,33,0.421,59,41,18,0.695,14,10,25,16,207.08,210.36,208.72000000000003
2016-02-29,1610612746,1610612751,2015,105.0,95.0,200.0,109.85,106.5,96.7,98.4,58,38,20,0.655,59,17,42,0.28800000000000003,19,19,11,6,214.36,196.96,205.66000000000003
2016-02-28,1610612764,1610612739,2015,113.0,99.0,212.0,94.7,91.35,101.9,101.55,57,27,30,0.474,57,41,16,0.7190000000000001,14,13,24,17,193.0,195.48,194.24
2016-02-28,1610612737,1610612766,2015,87.0,76.0,163.0,96.35,95.7,99.45,97.7,59,32,27,0.542,57,30,27,0.526,18,14,19,11,199.44,194.96,197.2
2016-02-28,1610612765,1610612761,2015,114.0,101.0,215.0,100.85,105.95,100.6,99.2,59,30,29,0.508,57,39,18,0.684,17,13,21,18,206.0,206.0,206.0
2016-02-28,1610612754,1610612757,2015,102.0,111.0,213.0,92.05,92.25,104.75,105.45,58,31,27,0.534,59,31,28,0.525,18,13,19,12,187.28,209.44,198.36
2016-02-28,1610612753,1610612755,2015,130.0,116.0,246.0,96.55,103.5,97.85,106.0,57,25,32,0.439,58,8,50,0.138,15,10,5,3,203.64,207.68,205.66
2016-02-28,1610612742,1610612750,2015,128.0,101.0,229.0,104.45,102.7,110.05,111.2,59,31,28,0.525,59,19,40,0.322,17,14,10,9,213.0,209.4,211.2
2016-02-28,1610612752,1610612748,2015,81.0,98.0,179.0,101.2,97.2,97.25,95.5,60,25,35,0.417,58,32,26,0.552,15,10,18,14,200.28,195.0,197.64
2016-02-27,1610612738,1610612748,2015,101.0,89.0,190.0,99.65,105.5,97.25,95.5,59,34,25,0.5760000000000001,57,32,25,0.561,18,16,18,14,195.08,195.0,195.04000000000002
2016-02-27,1610612740,1610612750,2015,110.0,112.0,222.0,100.45,104.8,110.05,111.2,57,23,34,0.404,58,18,40,0.31,16,7,10,8,200.8,209.4,205.10000000000002
2016-02-27,1610612741,1610612757,2015,95.0,103.0,198.0,94.0,91.0,104.75,105.45,57,30,27,0.526,58,30,28,0.517,19,11,19,11,185.44,209.44,197.44
2016-02-27,1610612745,1610612759,2015,94.0,104.0,198.0,112.7,109.85,107.75,96.55,58,29,29,0.5,58,49,9,0.845,16,13,28,21,216.24,204.12,210.18
2016-02-27,1610612749,1610612765,2015,91.0,102.0,193.0,99.8,108.15,100.85,105.95,58,24,34,0.414,58,29,29,0.5,16,8,17,12,200.48,206.0,203.24
2016-02-27,1610612760,1610612744,2015,118.0,121.0,239.0,101.8,103.4,107.5,105.85,58,41,17,0.7070000000000001,57,52,5,0.912,25,16,24,28,210.36,199.04,204.7
2016-02-27,1610612756,1610612763,2015,111.0,106.0,217.0,106.25,103.85,98.25,97.5,58,14,44,0.241,57,34,23,0.596,10,4,21,13,212.88,193.96,203.42000000000002
2016-02-27,1610612762,1610612751,2015,96.0,98.0,194.0,95.55,106.55,96.7,98.4,57,28,29,0.491,58,16,42,0.276,19,9,11,5,200.2,196.96,198.57999999999998
2016-02-26,1610612754,1610612766,2015,95.0,96.0,191.0,92.05,92.25,99.45,97.7,57,31,26,0.544,56,29,27,0.518,18,13,19,10,187.28,194.96,191.12
2016-02-26,1610612755,1610612764,2015,94.0,103.0,197.0,97.85,106.0,94.7,91.35,57,8,49,0.14,56,26,30,0.464,5,3,14,12,207.68,193.0,200.34
2016-02-26,1610612752,1610612753,2015,108.0,95.0,203.0,101.2,97.2,96.55,103.5,59,24,35,0.407,56,25,31,0.446,14,10,15,10,200.28,203.64,201.95999999999998
2016-02-26,1610612761,1610612739,2015,99.0,97.0,196.0,100.6,99.2,101.9,101.55,56,38,18,0.679,56,41,15,0.732,20,18,24,17,206.0,195.48,200.74
2016-02-26,1610612737,1610612741,2015,103.0,88.0,191.0,96.35,95.7,94.0,91.0,58,31,27,0.534,56,30,26,0.536,17,14,19,11,199.44,185.44,192.44
2016-02-26,1610612742,1610612743,2015,122.0,116.0,238.0,104.45,102.7,109.2,110.3,58,30,28,0.517,58,23,35,0.397,16,14,11,12,213.0,217.04,215.01999999999998
2016-02-26,1610612758,1610612746,2015,107.0,117.0,224.0,97.75,101.5,109.85,106.5,56,24,32,0.429,57,37,20,0.649,14,10,19,18,207.08,214.36,210.72000000000003
2016-02-26,1610612747,1610612763,2015,95.0,112.0,207.0,107.3,114.65,98.25,97.5,59,11,48,0.18600000000000005,56,33,23,0.589,6,5,21,12,219.28,193.96,206.62
2016-02-25,1610612753,1610612744,2015,114.0,130.0,244.0,96.55,103.5,107.5,105.85,55,25,30,0.455,56,51,5,0.911,15,10,24,27,203.64,199.04,201.33999999999997
2016-02-25,1610612738,1610612749,2015,112.0,107.0,219.0,99.65,105.5,99.8,108.15,58,33,25,0.569,57,24,33,0.421,17,16,16,8,195.08,200.48,197.78
2016-02-25,1610612740,1610612760,2015,123.0,119.0,242.0,100.45,104.8,101.8,103.4,56,22,34,0.393,57,41,16,0.7190000000000001,15,7,25,16,200.8,210.36,205.58
2016-02-25,1610612756,1610612751,2015,106.0,116.0,222.0,106.25,103.85,96.7,98.4,57,14,43,0.246,57,15,42,0.263,10,4,11,4,212.88,196.96,204.92000000000002
2016-02-25,1610612757,1610612745,2015,105.0,119.0,224.0,104.75,105.45,112.7,109.85,57,30,27,0.526,57,28,29,0.491,19,11,16,12,209.44,216.24,212.84
2016-02-25,1610612762,1610612759,2015,78.0,96.0,174.0,95.55,106.55,107.75,96.55,56,28,28,0.5,57,48,9,0.8420000000000001,19,9,28,20,200.2,204.12,202.16
2016-02-24,1610612739,1610612766,2015,114.0,103.0,217.0,101.9,101.55,99.45,97.7,55,40,15,0.727,55,29,26,0.527,23,17,19,10,195.48,194.96,195.22
2016-02-24,1610612754,1610612752,2015,108.0,105.0,213.0,92.05,92.25,101.2,97.2,56,30,26,0.536,58,24,34,0.414,17,13,14,10,187.28,200.28,193.78
2016-02-24,1610612765,1610612755,2015,111.0,91.0,202.0,100.85,105.95,97.85,106.0,57,28,29,0.491,56,8,48,0.14300000000000002,16,12,5,3,206.0,207.68,206.84
2016-02-24,1610612748,1610612744,2015,112.0,118.0,230.0,97.25,95.5,107.5,105.85,56,32,24,0.5710000000000001,55,50,5,0.909,18,14,24,26,195.0,199.04,197.01999999999998
2016-02-24,1610612761,1610612750,2015,114.0,105.0,219.0,100.6,99.2,110.05,111.2,55,37,18,0.6729999999999999,57,18,39,0.316,19,18,10,8,206.0,209.4,207.7
2016-02-24,1610612741,1610612764,2015,109.0,104.0,213.0,94.0,91.0,94.7,91.35,55,29,26,0.527,55,26,29,0.473,18,11,14,12,185.44,193.0,189.22
2016-02-24,1610612763,1610612747,2015,128.0,119.0,247.0,98.25,97.5,107.3,114.65,55,32,23,0.5820000000000001,58,11,47,0.19,20,12,6,5,193.96,219.28,206.62
2016-02-24,1610612742,1610612760,2015,103.0,116.0,219.0,104.45,102.7,101.8,103.4,57,30,27,0.526,56,40,16,0.7140000000000001,16,14,25,15,213.0,210.36,211.68
2016-02-24,1610612746,1610612743,2015,81.0,87.0,168.0,109.85,106.5,109.2,110.3,56,37,19,0.6609999999999999,57,22,35,0.386,19,18,11,11,214.36,217.04,215.7
2016-02-24,1610612758,1610612759,2015,92.0,108.0,200.0,97.75,101.5,107.75,96.55,55,24,31,0.436,56,47,9,0.8390000000000001,14,10,28,19,207.08,204.12,205.60000000000002
2016-02-23,1610612755,1610612753,2015,115.0,124.0,239.0,97.85,106.0,96.55,103.5,55,8,47,0.145,54,24,30,0.444,5,3,15,9,207.68,203.64,205.66
2016-02-23,1610612764,1610612740,2015,109.0,89.0,198.0,94.7,91.35,100.45,104.8,54,25,29,0.463,55,22,33,0.4,13,12,15,7,193.0,200.8,196.9
2016-02-23,1610612743,1610612758,2015,110.0,114.0,224.0,109.2,110.3,97.75,101.5,56,22,34,0.393,54,23,31,0.426,11,11,14,9,217.04,207.08,212.06
2016-02-23,1610612762,1610612745,2015,117.0,114.0,231.0,95.55,106.55,112.7,109.85,55,27,28,0.491,56,28,28,0.5,18,9,16,12,200.2,216.24,208.22
2016-02-23,1610612757,1610612751,2015,112.0,104.0,216.0,104.75,105.45,96.7,98.4,56,29,27,0.518,56,15,41,0.268,18,11,11,4,209.44,196.96,203.2
2016-02-22,1610612739,1610612765,2015,88.0,96.0,184.0,101.9,101.55,100.85,105.95,54,40,14,0.741,56,27,29,0.482,23,17,16,11,195.48,206.0,200.74
2016-02-22,1610612748,1610612754,2015,101.0,93.0,194.0,97.25,95.5,92.05,92.25,55,31,24,0.564,55,30,25,0.545,17,14,17,13,195.0,187.28,191.14
2016-02-22,1610612752,1610612761,2015,95.0,122.0,217.0,101.2,97.2,100.6,99.2,57,24,33,0.421,54,36,18,0.667,14,10,19,17,200.28,206.0,203.14
2016-02-22,1610612737,1610612744,2015,92.0,102.0,194.0,96.35,95.7,107.5,105.85,57,31,26,0.544,54,49,5,0.907,17,14,24,25,199.44,199.04,199.24
2016-02-22,1610612749,1610612747,2015,108.0,101.0,209.0,99.8,108.15,107.3,114.65,56,23,33,0.411,57,11,46,0.193,15,8,6,5,200.48,219.28,209.88
2016-02-22,1610612750,1610612738,2015,124.0,122.0,246.0,110.05,111.2,99.65,105.5,56,17,39,0.304,57,33,24,0.579,9,8,17,16,209.4,195.08,202.24
2016-02-22,1610612746,1610612756,2015,124.0,84.0,208.0,109.85,106.5,106.25,103.85,55,36,19,0.655,56,14,42,0.25,18,18,10,4,214.36,212.88,213.62
2016-02-21,1610612765,1610612740,2015,106.0,111.0,217.0,100.85,105.95,100.45,104.8,55,27,28,0.491,54,21,33,0.389,16,11,15,6,206.0,200.8,203.4
2016-02-21,1610612760,1610612739,2015,92.0,115.0,207.0,101.8,103.4,101.9,101.55,55,40,15,0.727,53,39,14,0.736,25,15,23,16,210.36,195.48,202.92000000000002
2016-02-21,1610612743,1610612738,2015,101.0,121.0,222.0,109.2,110.3,99.65,105.5,55,22,33,0.4,56,32,24,0.5710000000000001,11,11,17,15,217.04,195.08,206.06
2016-02-21,1610612756,1610612759,2015,111.0,118.0,229.0,106.25,103.85,107.75,96.55,55,14,41,0.255,55,46,9,0.836,10,4,28,18,212.88,204.12,208.5
2016-02-21,1610612751,1610612766,2015,96.0,104.0,200.0,96.7,98.4,99.45,97.7,55,15,40,0.273,54,28,26,0.519,11,4,19,9,196.96,194.96,195.96
2016-02-21,1610612753,1610612754,2015,102.0,105.0,207.0,96.55,103.5,92.05,92.25,53,24,29,0.453,54,29,25,0.537,15,9,17,12,203.64,187.28,195.45999999999998
2016-02-21,1610612761,1610612763,2015,98.0,85.0,183.0,100.6,99.2,98.25,97.5,53,35,18,0.66,54,32,22,0.593,18,17,20,12,206.0,193.96,199.98000000000002
2016-02-21,1610612742,1610612755,2015,129.0,103.0,232.0,104.45,102.7,97.85,106.0,56,29,27,0.518,54,8,46,0.14800000000000002,15,14,5,3,213.0,207.68,210.34
2016-02-21,1610612741,1610612747,2015,126.0,115.0,241.0,94.0,91.0,107.3,114.65,54,28,26,0.519,56,11,45,0.196,17,11,6,5,185.44,219.28,202.36
2016-02-21,1610612757,1610612762,2015,115.0,111.0,226.0,104.75,105.45,95.55,106.55,55,28,27,0.509,54,27,27,0.5,17,11,18,9,209.44,200.2,204.82
2016-02-20,1610612737,1610612749,2015,109.0,117.0,226.0,96.35,95.7,99.8,108.15,56,31,25,0.5539999999999999,55,22,33,0.4,17,14,15,7,199.44,200.48,199.95999999999998
2016-02-20,1610612748,1610612764,2015,114.0,94.0,208.0,97.25,95.5,94.7,91.35,54,30,24,0.556,53,25,28,0.472,16,14,13,12,195.0,193.0,194.0
2016-02-20,1610612750,1610612752,2015,95.0,103.0,198.0,110.05,111.2,101.2,97.2,55,17,38,0.309,56,23,33,0.411,9,8,14,9,209.4,200.28,204.84
2016-02-20,1610612746,1610612744,2015,112.0,115.0,227.0,109.85,106.5,107.5,105.85,54,36,18,0.667,53,48,5,0.906,18,18,24,24,214.36,199.04,206.7
2016-02-19,1610612753,1610612742,2015,110.0,104.0,214.0,96.55,103.5,104.45,102.7,52,23,29,0.442,55,29,26,0.527,14,9,15,14,203.64,213.0,208.32
2016-02-19,1610612764,1610612765,2015,98.0,86.0,184.0,94.7,91.35,100.85,105.95,52,24,28,0.462,54,27,27,0.5,12,12,16,11,193.0,206.0,199.5
2016-02-19,1610612751,1610612752,2015,109.0,98.0,207.0,96.7,98.4,101.2,97.2,54,14,40,0.259,55,23,32,0.418,10,4,14,9,196.96,200.28,198.62
2016-02-19,1610612737,1610612748,2015,111.0,115.0,226.0,96.35,95.7,97.25,95.5,55,31,24,0.564,53,29,24,0.547,17,14,16,13,199.44,195.0,197.22
2016-02-19,1610612741,1610612761,2015,116.0,106.0,222.0,94.0,91.0,100.6,99.2,53,27,26,0.509,52,35,17,0.6729999999999999,16,11,18,17,185.44,206.0,195.72
2016-02-19,1610612763,1610612750,2015,109.0,104.0,213.0,98.25,97.5,110.05,111.2,53,31,22,0.585,54,17,37,0.315,19,12,9,8,193.96,209.4,201.68
2016-02-19,1610612740,1610612755,2015,121.0,114.0,235.0,100.45,104.8,97.85,106.0,53,20,33,0.377,53,8,45,0.151,14,6,5,3,200.8,207.68,204.24
2016-02-19,1610612760,1610612754,2015,98.0,101.0,199.0,101.8,103.4,92.05,92.25,54,40,14,0.741,53,28,25,0.528,25,15,17,11,210.36,187.28,198.82
2016-02-19,1610612749,1610612766,2015,95.0,98.0,193.0,99.8,108.15,99.45,97.7,54,22,32,0.407,53,27,26,0.509,15,7,19,8,200.48,194.96,197.72
2016-02-19,1610612756,1610612745,2015,100.0,116.0,216.0,106.25,103.85,112.7,109.85,54,14,40,0.259,55,27,28,0.491,10,4,16,11,212.88,216.24,214.56
2016-02-19,1610612757,1610612744,2015,137.0,105.0,242.0,104.75,105.45,107.5,105.85,54,27,27,0.5,52,48,4,0.923,16,11,24,24,209.44,199.04,204.24
2016-02-19,1610612758,1610612743,2015,116.0,110.0,226.0,97.75,101.5,109.2,110.3,53,22,31,0.415,54,22,32,0.407,13,9,11,11,207.08,217.04,212.06
2016-02-19,1610612762,1610612738,2015,111.0,93.0,204.0,95.55,106.55,99.65,105.5,53,26,27,0.491,55,32,23,0.5820000000000001,17,9,17,15,200.2,195.08,197.64
2016-02-19,1610612747,1610612759,2015,113.0,119.0,232.0,107.3,114.65,107.75,96.55,55,11,44,0.2,54,45,9,0.833,6,5,28,17,219.28,204.12,211.7
2016-02-18,1610612764,1610612762,2015,103.0,89.0,192.0,94.7,91.35,95.55,106.55,51,23,28,0.451,52,26,26,0.5,11,12,17,9,193.0,200.2,196.6
2016-02-18,1610612739,1610612741,2015,106.0,95.0,201.0,101.9,101.55,94.0,91.0,52,38,14,0.731,52,27,25,0.519,22,16,16,11,195.48,185.44,190.45999999999998
2016-02-18,1610612746,1610612759,2015,105.0,86.0,191.0,109.85,106.5,107.75,96.55,53,35,18,0.66,53,45,8,0.8490000000000001,17,18,28,17,214.36,204.12,209.24
2016-02-11,1610612749,1610612764,2015,99.0,92.0,191.0,99.8,108.15,94.7,91.35,53,21,32,0.396,50,23,27,0.46,14,7,11,12,200.48,193.0,196.74
2016-02-11,1610612760,1610612740,2015,121.0,95.0,216.0,101.8,103.4,100.45,104.8,53,39,14,0.736,52,20,32,0.385,24,15,14,6,210.36,200.8,205.58
2016-02-10,1610612754,1610612766,2015,95.0,117.0,212.0,92.05,92.25,99.45,97.7,52,28,24,0.5379999999999999,52,26,26,0.5,17,11,19,7,187.28,194.96,191.12
2016-02-10,1610612753,1610612759,2015,96.0,98.0,194.0,96.55,103.5,107.75,96.55,51,23,28,0.451,52,44,8,0.846,14,9,28,16,203.64,204.12,203.88
2016-02-10,1610612755,1610612758,2015,110.0,114.0,224.0,97.85,106.0,97.75,101.5,52,8,44,0.154,52,21,31,0.404,5,3,13,8,207.68,207.08,207.38
2016-02-10,1610612738,1610612746,2015,139.0,134.0,273.0,99.65,105.5,109.85,106.5,54,31,23,0.574,52,35,17,0.6729999999999999,16,15,17,18,195.08,214.36,204.72000000000003
2016-02-10,1610612751,1610612763,2015,90.0,109.0,199.0,96.7,98.4,98.25,97.5,53,14,39,0.264,52,30,22,0.5770000000000001,10,4,19,11,196.96,193.96,195.46
2016-02-10,1610612765,1610612743,2015,92.0,103.0,195.0,100.85,105.95,109.2,110.3,53,27,26,0.509,53,21,32,0.396,16,11,11,10,206.0,217.04,211.51999999999998
2016-02-10,1610612739,1610612747,2015,120.0,111.0,231.0,101.9,101.55,107.3,114.65,51,37,14,0.725,54,11,43,0.204,21,16,6,5,195.48,219.28,207.38
2016-02-10,1610612741,1610612737,2015,90.0,113.0,203.0,94.0,91.0,96.35,95.7,51,27,24,0.529,54,30,24,0.556,16,11,17,13,185.44,199.44,192.44
2016-02-10,1610612750,1610612761,2015,117.0,112.0,229.0,110.05,111.2,100.6,99.2,53,16,37,0.302,51,35,16,0.6859999999999999,8,8,18,17,209.4,206.0,207.7
2016-02-10,1610612740,1610612762,2015,100.0,96.0,196.0,100.45,104.8,95.55,106.55,51,19,32,0.373,51,26,25,0.51,13,6,17,9,200.8,200.2,200.5
2016-02-10,1610612756,1610612744,2015,104.0,112.0,216.0,106.25,103.85,107.5,105.85,53,14,39,0.264,51,47,4,0.922,10,4,24,23,212.88,199.04,205.95999999999998
2016-02-10,1610612757,1610612745,2015,116.0,103.0,219.0,104.75,105.45,112.7,109.85,53,26,27,0.491,54,27,27,0.5,15,11,16,11,209.44,216.24,212.84
2016-02-09,1610612748,1610612759,2015,101.0,119.0,220.0,97.25,95.5,107.75,96.55,52,29,23,0.5579999999999999,51,43,8,0.843,16,13,28,15,195.0,204.12,199.56
2016-02-09,1610612752,1610612764,2015,108.0,111.0,219.0,101.2,97.2,94.7,91.35,54,23,31,0.426,49,22,27,0.449,14,9,11,11,200.28,193.0,196.64
2016-02-09,1610612749,1610612738,2015,112.0,111.0,223.0,99.8,108.15,99.65,105.5,52,20,32,0.385,53,31,22,0.585,13,7,16,15,200.48,195.08,197.78
2016-02-09,1610612742,1610612762,2015,119.0,121.0,240.0,104.45,102.7,95.55,106.55,54,29,25,0.537,50,25,25,0.5,15,14,17,8,213.0,200.2,206.6
2016-02-09,1610612744,1610612745,2015,123.0,110.0,233.0,107.5,105.85,112.7,109.85,50,46,4,0.92,53,27,26,0.509,23,23,16,11,199.04,216.24,207.64
2016-02-08,1610612766,1610612741,2015,108.0,91.0,199.0,99.45,97.7,94.0,91.0,51,25,26,0.49,50,27,23,0.54,18,7,16,11,194.96,185.44,190.2
2016-02-08,1610612739,1610612758,2015,120.0,100.0,220.0,101.9,101.55,97.75,101.5,50,36,14,0.72,51,21,30,0.412,20,16,13,8,195.48,207.08,201.28
2016-02-08,1610612754,1610612747,2015,89.0,87.0,176.0,92.05,92.25,107.3,114.65,51,27,24,0.529,53,11,42,0.208,16,11,6,5,187.28,219.28,203.28
2016-02-08,1610612755,1610612746,2015,92.0,98.0,190.0,97.85,106.0,109.85,106.5,51,8,43,0.157,51,34,17,0.667,5,3,17,17,207.68,214.36,211.02
2016-02-08,1610612751,1610612743,2015,105.0,104.0,209.0,96.7,98.4,109.2,110.3,52,13,39,0.25,52,21,31,0.404,9,4,11,10,196.96,217.04,207.0
2016-02-08,1610612765,1610612761,2015,89.0,103.0,192.0,100.85,105.95,100.6,99.2,52,27,25,0.519,50,34,16,0.68,16,11,18,16,206.0,206.0,206.0
2016-02-08,1610612737,1610612753,2015,110.0,117.0,227.0,96.35,95.7,96.55,103.5,53,30,23,0.5660000000000001,50,22,28,0.44,17,13,14,8,199.44,203.64,201.54
2016-02-08,1610612763,1610612757,2015,106.0,112.0,218.0,98.25,97.5,104.75,105.45,51,30,21,0.588,52,25,27,0.481,19,11,15,10,193.96,209.44,201.7
2016-02-08,1610612750,1610612740,2015,102.0,116.0,218.0,110.05,111.2,100.45,104.8,52,16,36,0.308,50,18,32,0.36,8,8,13,5,209.4,200.8,205.10000000000002
2016-02-08,1610612756,1610612760,2015,106.0,122.0,228.0,106.25,103.85,101.8,103.4,52,14,38,0.269,52,38,14,0.731,10,4,24,14,212.88,210.36,211.62
2016-02-07,1610612752,1610612743,2015,96.0,101.0,197.0,101.2,97.2,109.2,110.3,53,23,30,0.434,51,20,31,0.392,14,9,11,9,200.28,217.04,208.66
2016-02-07,1610612753,1610612737,2015,96.0,94.0,190.0,96.55,103.5,96.35,95.7,49,21,28,0.429,52,30,22,0.5770000000000001,13,8,17,13,203.64,199.44,201.54
2016-02-07,1610612738,1610612758,2015,128.0,119.0,247.0,99.65,105.5,97.75,101.5,52,30,22,0.5770000000000001,50,21,29,0.42,15,15,13,8,195.08,207.08,201.08
2016-02-07,1610612748,1610612746,2015,93.0,100.0,193.0,97.25,95.5,109.85,106.5,51,29,22,0.569,50,33,17,0.66,16,13,17,16,195.0,214.36,204.68
2016-02-06,1610612745,1610612757,2015,79.0,96.0,175.0,112.7,109.85,104.75,105.45,52,27,25,0.519,51,24,27,0.471,16,11,15,9,216.24,209.44,212.84
2016-02-06,1610612766,1610612764,2015,108.0,104.0,212.0,99.45,97.7,94.7,91.35,50,24,26,0.48,48,22,26,0.458,17,7,11,11,194.96,193.0,193.98000000000002
2016-02-06,1610612754,1610612765,2015,112.0,104.0,216.0,92.05,92.25,100.85,105.95,50,26,24,0.52,51,27,24,0.529,15,11,16,11,187.28,206.0,196.64
2016-02-06,1610612739,1610612740,2015,99.0,84.0,183.0,101.9,101.55,100.45,104.8,49,35,14,0.7140000000000001,49,18,31,0.3670000000000001,19,16,13,5,195.48,200.8,198.14
2016-02-06,1610612755,1610612751,2015,103.0,98.0,201.0,97.85,106.0,96.7,98.4,50,7,43,0.14,51,13,38,0.255,4,3,9,4,207.68,196.96,202.32
2016-02-06,1610612763,1610612742,2015,110.0,114.0,224.0,98.25,97.5,104.45,102.7,50,30,20,0.6,53,28,25,0.528,19,11,15,13,193.96,213.0,203.48000000000002
2016-02-06,1610612750,1610612741,2015,112.0,105.0,217.0,110.05,111.2,94.0,91.0,51,15,36,0.294,49,27,22,0.551,7,8,16,11,209.4,185.44,197.42000000000002
2016-02-06,1610612759,1610612747,2015,106.0,102.0,208.0,107.75,96.55,107.3,114.65,50,42,8,0.84,52,11,41,0.212,27,15,6,5,204.12,219.28,211.7
2016-02-06,1610612756,1610612762,2015,89.0,98.0,187.0,106.25,103.85,95.55,106.55,51,14,37,0.275,49,24,25,0.49,10,4,17,7,212.88,200.2,206.54
2016-02-06,1610612744,1610612760,2015,116.0,108.0,224.0,107.5,105.85,101.8,103.4,49,45,4,0.918,51,38,13,0.745,22,23,24,14,199.04,210.36,204.7
2016-02-05,1610612737,1610612754,2015,102.0,96.0,198.0,96.35,95.7,92.05,92.25,51,29,22,0.569,49,26,23,0.531,16,13,15,11,199.44,187.28,193.36
2016-02-05,1610612766,1610612748,2015,95.0,98.0,193.0,99.45,97.7,97.25,95.5,49,24,25,0.49,50,28,22,0.56,17,7,16,12,194.96,195.0,194.98000000000002
2016-02-05,1610612753,1610612746,2015,93.0,107.0,200.0,96.55,103.5,109.85,106.5,48,21,27,0.438,49,32,17,0.653,13,8,17,15,203.64,214.36,209.0
2016-02-05,1610612764,1610612755,2015,106.0,94.0,200.0,94.7,91.35,97.85,106.0,47,21,26,0.447,49,7,42,0.14300000000000002,10,11,4,3,193.0,207.68,200.34
2016-02-05,1610612751,1610612758,2015,128.0,119.0,247.0,96.7,98.4,97.75,101.5,50,12,38,0.24,49,21,28,0.429,8,4,13,8,196.96,207.08,202.02
2016-02-05,1610612739,1610612738,2015,103.0,104.0,207.0,101.9,101.55,99.65,105.5,48,35,13,0.7290000000000001,51,29,22,0.569,19,16,15,14,195.48,195.08,195.28
2016-02-05,1610612752,1610612763,2015,85.0,91.0,176.0,101.2,97.2,98.25,97.5,52,23,29,0.442,49,29,20,0.5920000000000001,14,9,19,10,200.28,193.96,197.12
2016-02-05,1610612743,1610612741,2015,115.0,110.0,225.0,109.2,110.3,94.0,91.0,50,19,31,0.38,48,27,21,0.563,10,9,16,11,217.04,185.44,201.24
2016-02-05,1610612762,1610612749,2015,84.0,81.0,165.0,95.55,106.55,99.8,108.15,48,23,25,0.479,51,20,31,0.392,16,7,13,7,200.2,200.48,200.33999999999997
2016-02-05,1610612742,1610612759,2015,90.0,116.0,206.0,104.45,102.7,107.75,96.55,52,28,24,0.5379999999999999,49,41,8,0.8370000000000001,15,13,27,14,213.0,204.12,208.56
2016-02-04,1610612765,1610612752,2015,111.0,105.0,216.0,100.85,105.95,101.2,97.2,50,26,24,0.52,51,23,28,0.451,15,11,14,9,206.0,200.28,203.14
2016-02-04,1610612756,1610612745,2015,105.0,111.0,216.0,106.25,103.85,112.7,109.85,50,14,36,0.28,51,26,25,0.51,10,4,16,10,212.88,216.24,214.56
2016-02-04,1610612740,1610612747,2015,96.0,99.0,195.0,100.45,104.8,107.3,114.65,48,18,30,0.375,51,10,41,0.196,13,5,6,4,200.8,219.28,210.04000000000002
2016-02-04,1610612757,1610612761,2015,103.0,110.0,213.0,104.75,105.45,100.6,99.2,50,24,26,0.48,49,33,16,0.6729999999999999,15,9,18,15,209.44,206.0,207.72
2016-02-03,1610612766,1610612739,2015,106.0,97.0,203.0,99.45,97.7,101.9,101.55,48,23,25,0.479,47,35,12,0.745,16,7,19,16,194.96,195.48,195.22
2016-02-03,1610612755,1610612737,2015,86.0,124.0,210.0,97.85,106.0,96.35,95.7,48,7,41,0.146,50,28,22,0.56,4,3,16,12,207.68,199.44,203.56
2016-02-03,1610612738,1610612765,2015,102.0,95.0,197.0,99.65,105.5,100.85,105.95,50,28,22,0.56,49,26,23,0.531,14,14,15,11,195.08,206.0,200.54000000000002
2016-02-03,1610612751,1610612754,2015,100.0,114.0,214.0,96.7,98.4,92.05,92.25,49,12,37,0.245,48,25,23,0.521,8,4,15,10,196.96,187.28,192.12
2016-02-03,1610612764,1610612744,2015,121.0,134.0,255.0,94.7,91.35,107.5,105.85,46,21,25,0.457,48,44,4,0.917,10,11,22,22,193.0,199.04,196.01999999999998
2016-02-03,1610612760,1610612753,2015,117.0,114.0,231.0,101.8,103.4,96.55,103.5,50,37,13,0.74,47,21,26,0.447,23,14,13,8,210.36,203.64,207.0
2016-02-03,1610612742,1610612748,2015,90.0,93.0,183.0,104.45,102.7,97.25,95.5,51,28,23,0.5489999999999999,49,27,22,0.551,15,13,16,11,213.0,195.0,204.0
2016-02-03,1610612759,1610612740,2015,110.0,97.0,207.0,107.75,96.55,100.45,104.8,48,40,8,0.833,47,18,29,0.383,26,14,13,5,204.12,200.8,202.46
2016-02-03,1610612762,1610612743,2015,85.0,81.0,166.0,95.55,106.55,109.2,110.3,47,22,25,0.468,49,19,30,0.388,15,7,10,9,200.2,217.04,208.62
2016-02-03,1610612758,1610612741,2015,102.0,107.0,209.0,97.75,101.5,94.0,91.0,48,21,27,0.438,47,26,21,0.5529999999999999,13,8,16,10,207.08,185.44,196.26
2016-02-03,1610612746,1610612750,2015,102.0,108.0,210.0,109.85,106.5,110.05,111.2,48,32,16,0.667,50,14,36,0.28,17,15,7,7,214.36,209.4,211.88
2016-02-02,1610612752,1610612738,2015,89.0,97.0,186.0,101.2,97.2,99.65,105.5,50,23,27,0.46,49,27,22,0.551,14,9,14,13,200.28,195.08,197.68
2016-02-02,1610612745,1610612748,2015,115.0,102.0,217.0,112.7,109.85,97.25,95.5,50,25,25,0.5,48,27,21,0.563,15,10,16,11,216.24,195.0,205.62
2016-02-02,1610612756,1610612761,2015,97.0,104.0,201.0,106.25,103.85,100.6,99.2,49,14,35,0.28600000000000003,48,32,16,0.667,10,4,18,14,212.88,206.0,209.44
2016-02-02,1610612757,1610612749,2015,107.0,95.0,202.0,104.75,105.45,99.8,108.15,49,23,26,0.469,50,20,30,0.4,14,9,13,7,209.44,200.48,204.95999999999998
2016-02-02,1610612747,1610612750,2015,119.0,115.0,234.0,107.3,114.65,110.05,111.2,50,9,41,0.18,49,14,35,0.28600000000000003,5,4,7,7,219.28,209.4,214.34
2016-02-01,1610612754,1610612739,2015,106.0,111.0,217.0,92.05,92.25,101.9,101.55,47,25,22,0.532,46,34,12,0.7390000000000001,15,10,19,15,187.28,195.48,191.38
2016-02-01,1610612751,1610612765,2015,100.0,105.0,205.0,96.7,98.4,100.85,105.95,48,12,36,0.25,48,25,23,0.521,8,4,15,10,196.96,206.0,201.48000000000002
2016-02-01,1610612737,1610612742,2015,112.0,97.0,209.0,96.35,95.7,104.45,102.7,49,27,22,0.551,50,28,22,0.56,15,12,15,13,199.44,213.0,206.22
2016-02-01,1610612740,1610612763,2015,95.0,110.0,205.0,100.45,104.8,98.25,97.5,46,18,28,0.391,48,28,20,0.583,13,5,19,9,200.8,193.96,197.38
2016-02-01,1610612760,1610612764,2015,114.0,98.0,212.0,101.8,103.4,94.7,91.35,49,36,13,0.735,45,21,24,0.467,22,14,10,11,210.36,193.0,201.68
2016-02-01,1610612759,1610612753,2015,107.0,92.0,199.0,107.75,96.55,96.55,103.5,47,39,8,0.83,46,21,25,0.457,25,14,13,8,204.12,203.64,203.88
2016-02-01,1610612743,1610612761,2015,112.0,93.0,205.0,109.2,110.3,100.6,99.2,48,18,30,0.375,47,32,15,0.6809999999999999,9,9,18,14,217.04,206.0,211.51999999999998
2016-02-01,1610612762,1610612741,2015,105.0,96.0,201.0,95.55,106.55,94.0,91.0,46,21,25,0.457,46,26,20,0.565,14,7,16,10,200.2,185.44,192.82
2016-02-01,1610612758,1610612749,2015,111.0,104.0,215.0,97.75,101.5,99.8,108.15,47,20,27,0.426,49,20,29,0.408,12,8,13,7,207.08,200.48,203.78
2016-01-31,1610612746,1610612741,2015,120.0,93.0,213.0,109.85,106.5,94.0,91.0,47,31,16,0.66,45,26,19,0.578,16,15,16,10,214.36,185.44,199.9
2016-01-31,1610612748,1610612737,2015,105.0,87.0,192.0,97.25,95.5,96.35,95.7,47,26,21,0.5529999999999999,48,27,21,0.563,15,11,15,12,195.0,199.44,197.22
2016-01-31,1610612753,1610612738,2015,119.0,114.0,233.0,96.55,103.5,99.65,105.5,45,20,25,0.444,48,27,21,0.563,12,8,14,13,203.64,195.08,199.36
2016-01-31,1610612742,1610612756,2015,91.0,78.0,169.0,104.45,102.7,106.25,103.85,49,27,22,0.551,48,14,34,0.292,14,13,10,4,213.0,212.88,212.94
2016-01-31,1610612752,1610612744,2015,95.0,116.0,211.0,101.2,97.2,107.5,105.85,49,23,26,0.469,47,43,4,0.915,14,9,22,21,200.28,199.04,199.66
2016-01-31,1610612757,1610612750,2015,96.0,93.0,189.0,104.75,105.45,110.05,111.2,48,22,26,0.458,48,14,34,0.292,13,9,7,7,209.44,209.4,209.42000000000002
2016-01-31,1610612747,1610612766,2015,82.0,101.0,183.0,107.3,114.65,99.45,97.7,49,9,40,0.184,47,22,25,0.468,5,4,16,6,219.28,194.96,207.12
2016-01-30,1610612755,1610612744,2015,105.0,108.0,213.0,97.85,106.0,107.5,105.85,47,7,40,0.149,46,42,4,0.913,4,3,22,20,207.68,199.04,203.36
2016-01-30,1610612761,1610612765,2015,111.0,107.0,218.0,100.6,99.2,100.85,105.95,46,31,15,0.674,47,25,22,0.532,17,14,15,10,206.0,206.0,206.0
2016-01-30,1610612754,1610612743,2015,109.0,105.0,214.0,92.05,92.25,109.2,110.3,46,24,22,0.522,47,18,29,0.383,14,10,9,9,187.28,217.04,202.16
2016-01-30,1610612740,1610612751,2015,105.0,103.0,208.0,100.45,104.8,96.7,98.4,45,17,28,0.378,47,12,35,0.255,12,5,8,4,200.8,196.96,198.88
2016-01-30,1610612745,1610612764,2015,122.0,123.0,245.0,112.7,109.85,94.7,91.35,49,25,24,0.51,44,20,24,0.455,15,10,10,10,216.24,193.0,204.62
2016-01-30,1610612763,1610612758,2015,121.0,117.0,238.0,98.25,97.5,97.75,101.5,47,27,20,0.574,46,20,26,0.435,18,9,12,8,193.96,207.08,200.52
2016-01-30,1610612739,1610612759,2015,117.0,103.0,220.0,101.9,101.55,107.75,96.55,45,33,12,0.733,46,39,7,0.848,18,15,25,14,195.48,204.12,199.8
2016-01-29,1610612738,1610612753,2015,113.0,94.0,207.0,99.65,105.5,96.55,103.5,47,26,21,0.5529999999999999,44,20,24,0.455,13,13,12,8,195.08,203.64,199.36
2016-01-29,1610612765,1610612739,2015,106.0,114.0,220.0,100.85,105.95,101.9,101.55,46,25,21,0.5429999999999999,44,32,12,0.727,15,10,18,14,206.0,195.48,200.74
2016-01-29,1610612752,1610612756,2015,102.0,84.0,186.0,101.2,97.2,106.25,103.85,48,22,26,0.458,47,14,33,0.298,13,9,10,4,200.28,212.88,206.57999999999998
2016-01-29,1610612760,1610612745,2015,116.0,108.0,224.0,101.8,103.4,112.7,109.85,48,35,13,0.7290000000000001,48,25,23,0.521,21,14,15,10,210.36,216.24,213.3
2016-01-29,1610612749,1610612748,2015,103.0,107.0,210.0,99.8,108.15,97.25,95.5,48,20,28,0.417,46,25,21,0.5429999999999999,13,7,15,10,200.48,195.0,197.74
2016-01-29,1610612742,1610612751,2015,91.0,79.0,170.0,104.45,102.7,96.7,98.4,48,26,22,0.542,46,12,34,0.261,13,13,8,4,213.0,196.96,204.98000000000002
2016-01-29,1610612762,1610612750,2015,103.0,90.0,193.0,95.55,106.55,110.05,111.2,45,20,25,0.444,47,14,33,0.298,13,7,7,7,200.2,209.4,204.8
2016-01-29,1610612757,1610612766,2015,109.0,91.0,200.0,104.75,105.45,99.45,97.7,47,21,26,0.447,46,22,24,0.478,12,9,16,6,209.44,194.96,202.2
2016-01-29,1610612746,1610612747,2015,105.0,93.0,198.0,109.85,106.5,107.3,114.65,46,30,16,0.652,48,9,39,0.188,15,15,5,4,214.36,219.28,216.82
2016-01-28,1610612754,1610612737,2015,111.0,92.0,203.0,92.05,92.25,96.35,95.7,45,23,22,0.511,47,27,20,0.574,13,10,15,12,187.28,199.44,193.36
2016-01-28,1610612764,1610612743,2015,113.0,117.0,230.0,94.7,91.35,109.2,110.3,43,20,23,0.465,46,17,29,0.37,10,10,9,8,193.0,217.04,205.01999999999998
2016-01-28,1610612761,1610612752,2015,103.0,93.0,196.0,100.6,99.2,101.2,97.2,45,30,15,0.667,47,22,25,0.468,16,14,13,9,206.0,200.28,203.14
2016-01-28,1610612763,1610612749,2015,103.0,83.0,186.0,98.25,97.5,99.8,108.15,46,26,20,0.565,47,20,27,0.426,17,9,13,7,193.96,200.48,197.22
2016-01-28,1610612740,1610612758,2015,114.0,105.0,219.0,100.45,104.8,97.75,101.5,44,16,28,0.364,45,20,25,0.444,11,5,12,8,200.8,207.08,203.94
2016-01-28,1610612747,1610612741,2015,91.0,114.0,205.0,107.3,114.65,94.0,91.0,47,9,38,0.191,44,25,19,0.568,5,4,16,9,219.28,185.44,202.36
2016-01-27,1610612739,1610612756,2015,115.0,93.0,208.0,101.9,101.55,106.25,103.85,43,31,12,0.721,46,14,32,0.304,17,14,10,4,195.48,212.88,204.18
2016-01-27,1610612738,1610612743,2015,111.0,103.0,214.0,99.65,105.5,109.2,110.3,46,25,21,0.5429999999999999,45,17,28,0.378,12,13,9,8,195.08,217.04,206.06
2016-01-27,1610612765,1610612755,2015,110.0,97.0,207.0,100.85,105.95,97.85,106.0,45,24,21,0.5329999999999999,46,7,39,0.152,14,10,4,3,206.0,207.68,206.84
2016-01-27,1610612737,1610612746,2015,83.0,85.0,168.0,96.35,95.7,109.85,106.5,46,27,19,0.5870000000000001,45,29,16,0.644,15,12,15,14,199.44,214.36,206.9
2016-01-27,1610612750,1610612760,2015,123.0,126.0,249.0,110.05,111.2,101.8,103.4,46,14,32,0.304,47,34,13,0.723,7,7,21,13,209.4,210.36,209.88
2016-01-27,1610612759,1610612745,2015,130.0,99.0,229.0,107.75,96.55,112.7,109.85,45,38,7,0.8440000000000001,47,25,22,0.532,24,14,15,10,204.12,216.24,210.18
2016-01-27,1610612762,1610612766,2015,102.0,73.0,175.0,95.55,106.55,99.45,97.7,44,19,25,0.4320000000000001,45,22,23,0.489,12,7,16,6,200.2,194.96,197.57999999999998
2016-01-27,1610612744,1610612742,2015,127.0,107.0,234.0,107.5,105.85,104.45,102.7,45,41,4,0.911,47,26,21,0.5529999999999999,21,20,13,13,199.04,213.0,206.01999999999998
2016-01-26,1610612754,1610612746,2015,89.0,91.0,180.0,92.05,92.25,109.85,106.5,44,23,21,0.523,44,28,16,0.636,13,10,15,13,187.28,214.36,200.82
2016-01-26,1610612755,1610612756,2015,113.0,103.0,216.0,97.85,106.0,106.25,103.85,45,6,39,0.133,45,14,31,0.311,3,3,10,4,207.68,212.88,210.28
2016-01-26,1610612751,1610612748,2015,98.0,102.0,200.0,96.7,98.4,97.25,95.5,45,12,33,0.267,45,24,21,0.5329999999999999,8,4,15,9,196.96,195.0,195.98000000000002
2016-01-26,1610612752,1610612760,2015,122.0,128.0,250.0,101.2,97.2,101.8,103.4,46,22,24,0.478,46,33,13,0.7170000000000001,13,9,21,12,200.28,210.36,205.32
2016-01-26,1610612761,1610612764,2015,106.0,89.0,195.0,100.6,99.2,94.7,91.35,44,29,15,0.659,42,20,22,0.476,15,14,10,10,206.0,193.0,199.5
2016-01-26,1610612749,1610612753,2015,107.0,100.0,207.0,99.8,108.15,96.55,103.5,46,19,27,0.413,43,20,23,0.465,12,7,12,8,200.48,203.64,202.06
2016-01-26,1610612757,1610612758,2015,112.0,97.0,209.0,104.75,105.45,97.75,101.5,46,20,26,0.435,44,20,24,0.455,11,9,12,8,209.44,207.08,208.26
2016-01-26,1610612747,1610612742,2015,90.0,92.0,182.0,107.3,114.65,104.45,102.7,46,9,37,0.196,46,25,21,0.5429999999999999,5,4,13,12,219.28,213.0,216.14
2016-01-25,1610612739,1610612750,2015,114.0,107.0,221.0,101.9,101.55,110.05,111.2,42,30,12,0.7140000000000001,45,14,31,0.311,16,14,7,7,195.48,209.4,202.44
2016-01-25,1610612764,1610612738,2015,91.0,116.0,207.0,94.7,91.35,99.65,105.5,41,20,21,0.488,45,24,21,0.5329999999999999,10,10,12,12,193.0,195.08,194.04000000000002
2016-01-25,1610612741,1610612748,2015,84.0,89.0,173.0,94.0,91.0,97.25,95.5,43,25,18,0.581,44,23,21,0.523,16,9,15,8,185.44,195.0,190.22
2016-01-25,1610612763,1610612753,2015,108.0,102.0,210.0,98.25,97.5,96.55,103.5,45,25,20,0.556,42,20,22,0.476,16,9,12,8,193.96,203.64,198.8
2016-01-25,1610612740,1610612745,2015,111.0,112.0,223.0,100.45,104.8,112.7,109.85,43,16,27,0.3720000000000001,46,24,22,0.522,11,5,15,9,200.8,216.24,208.52
2016-01-25,1610612743,1610612737,2015,105.0,119.0,224.0,109.2,110.3,96.35,95.7,44,17,27,0.386,45,26,19,0.578,9,8,15,11,217.04,199.44,208.24
2016-01-25,1610612762,1610612765,2015,92.0,95.0,187.0,95.55,106.55,100.85,105.95,43,19,24,0.442,44,23,21,0.523,12,7,14,9,200.2,206.0,203.1
2016-01-25,1610612758,1610612766,2015,128.0,129.0,257.0,97.75,101.5,99.45,97.7,43,20,23,0.465,44,21,23,0.477,12,8,16,5,207.08,194.96,201.02
2016-01-25,1610612744,1610612759,2015,120.0,90.0,210.0,107.5,105.85,107.75,96.55,44,40,4,0.909,44,38,6,0.8640000000000001,20,20,24,14,199.04,204.12,201.57999999999998
2016-01-24,1610612745,1610612742,2015,115.0,104.0,219.0,112.7,109.85,104.45,102.7,45,23,22,0.511,45,25,20,0.556,14,9,13,12,216.24,213.0,214.62
2016-01-24,1610612761,1610612746,2015,112.0,94.0,206.0,100.6,99.2,109.85,106.5,43,28,15,0.6509999999999999,43,28,15,0.6509999999999999,14,14,15,13,206.0,214.36,210.18
2016-01-24,1610612755,1610612738,2015,92.0,112.0,204.0,97.85,106.0,99.65,105.5,44,6,38,0.136,44,23,21,0.523,3,3,12,11,207.68,195.08,201.38
2016-01-24,1610612751,1610612760,2015,116.0,106.0,222.0,96.7,98.4,101.8,103.4,44,11,33,0.25,45,33,12,0.733,7,4,21,12,196.96,210.36,203.66000000000003
2016-01-23,1610612766,1610612752,2015,97.0,84.0,181.0,99.45,97.7,101.2,97.2,43,20,23,0.465,45,22,23,0.489,15,5,13,9,194.96,200.28,197.62
2016-01-23,1610612740,1610612749,2015,116.0,99.0,215.0,100.45,104.8,99.8,108.15,42,15,27,0.35700000000000004,45,19,26,0.422,10,5,12,7,200.8,200.48,200.64
2016-01-23,1610612750,1610612763,2015,106.0,101.0,207.0,110.05,111.2,98.25,97.5,44,13,31,0.295,44,25,19,0.568,6,7,16,9,209.4,193.96,201.68
2016-01-23,1610612739,1610612741,2015,83.0,96.0,179.0,101.9,101.55,94.0,91.0,41,30,11,0.732,42,24,18,0.5710000000000001,16,14,16,8,195.48,185.44,190.45999999999998
2016-01-23,1610612756,1610612737,2015,98.0,95.0,193.0,106.25,103.85,96.35,95.7,44,13,31,0.295,44,26,18,0.591,9,4,15,11,212.88,199.44,206.16
2016-01-23,1610612743,1610612765,2015,104.0,101.0,205.0,109.2,110.3,100.85,105.95,43,16,27,0.3720000000000001,43,23,20,0.535,8,8,14,9,217.04,206.0,211.51999999999998
2016-01-23,1610612757,1610612747,2015,121.0,103.0,224.0,104.75,105.45,107.3,114.65,45,19,26,0.422,45,9,36,0.2,10,9,5,4,209.44,219.28,214.36
2016-01-23,1610612758,1610612754,2015,108.0,97.0,205.0,97.75,101.5,92.05,92.25,42,19,23,0.452,43,23,20,0.535,11,8,13,10,207.08,187.28,197.18
2016-01-22,1610612753,1610612766,2015,116.0,120.0,236.0,96.55,103.5,99.45,97.7,41,20,21,0.488,42,19,23,0.452,12,8,15,4,203.64,194.96,199.3
2016-01-22,1610612738,1610612741,2015,110.0,101.0,211.0,99.65,105.5,94.0,91.0,43,22,21,0.512,41,24,17,0.585,11,11,16,8,195.08,185.44,190.26
2016-01-22,1610612751,1610612762,2015,86.0,108.0,194.0,96.7,98.4,95.55,106.55,43,11,32,0.256,42,18,24,0.429,7,4,12,6,196.96,200.2,198.57999999999998
2016-01-22,1610612752,1610612746,2015,88.0,116.0,204.0,101.2,97.2,109.85,106.5,44,22,22,0.5,42,27,15,0.643,13,9,15,12,200.28,214.36,207.32
2016-01-22,1610612761,1610612748,2015,101.0,81.0,182.0,100.6,99.2,97.25,95.5,42,27,15,0.643,43,23,20,0.535,13,14,15,8,206.0,195.0,200.5
2016-01-22,1610612745,1610612749,2015,102.0,98.0,200.0,112.7,109.85,99.8,108.15,44,22,22,0.5,44,19,25,0.4320000000000001,13,9,12,7,216.24,200.48,208.36
2016-01-22,1610612742,1610612760,2015,106.0,109.0,215.0,104.45,102.7,101.8,103.4,44,25,19,0.568,44,32,12,0.727,13,12,21,11,213.0,210.36,211.68
2016-01-22,1610612744,1610612754,2015,122.0,110.0,232.0,107.5,105.85,92.05,92.25,43,39,4,0.907,42,23,19,0.5479999999999999,19,20,13,10,199.04,187.28,193.16
2016-01-22,1610612747,1610612759,2015,95.0,108.0,203.0,107.3,114.65,107.75,96.55,44,9,35,0.205,43,37,6,0.86,5,4,24,13,219.28,204.12,211.7
2016-01-21,1610612739,1610612746,2015,115.0,102.0,217.0,101.9,101.55,109.85,106.5,40,29,11,0.725,41,27,14,0.659,15,14,15,12,195.48,214.36,204.92000000000002
2016-01-21,1610612740,1610612765,2015,115.0,99.0,214.0,100.45,104.8,100.85,105.95,41,14,27,0.341,42,23,19,0.5479999999999999,9,5,14,9,200.8,206.0,203.4
2016-01-21,1610612743,1610612763,2015,101.0,102.0,203.0,109.2,110.3,98.25,97.5,42,16,26,0.381,43,24,19,0.5579999999999999,8,8,16,8,217.04,193.96,205.5
2016-01-21,1610612758,1610612737,2015,91.0,88.0,179.0,97.75,101.5,96.35,95.7,41,18,23,0.439,43,26,17,0.605,10,8,15,11,207.08,199.44,203.26
2016-01-21,1610612756,1610612759,2015,89.0,117.0,206.0,106.25,103.85,107.75,96.55,43,13,30,0.302,42,36,6,0.857,9,4,24,12,212.88,204.12,208.5
2016-01-20,1610612753,1610612755,2015,87.0,96.0,183.0,96.55,103.5,97.85,106.0,40,20,20,0.5,43,5,38,0.116,12,8,3,2,203.64,207.68,205.66
2016-01-20,1610612764,1610612748,2015,106.0,87.0,193.0,94.7,91.35,97.25,95.5,40,19,21,0.475,42,23,19,0.5479999999999999,9,10,15,8,193.0,195.0,194.0
2016-01-20,1610612751,1610612739,2015,78.0,91.0,169.0,96.7,98.4,101.9,101.55,42,11,31,0.262,39,28,11,0.718,7,4,15,13,196.96,195.48,196.22
2016-01-20,1610612752,1610612762,2015,118.0,111.0,229.0,101.2,97.2,95.55,106.55,43,21,22,0.488,41,18,23,0.439,12,9,12,6,200.28,200.2,200.24
2016-01-20,1610612761,1610612738,2015,115.0,109.0,224.0,100.6,99.2,99.65,105.5,41,26,15,0.634,42,22,20,0.524,12,14,11,11,206.0,195.08,200.54000000000002
2016-01-20,1610612741,1610612744,2015,94.0,125.0,219.0,94.0,91.0,107.5,105.85,40,24,16,0.6,42,38,4,0.905,16,8,19,19,185.44,199.04,192.24
2016-01-20,1610612745,1610612765,2015,114.0,123.0,237.0,112.7,109.85,100.85,105.95,43,22,21,0.512,41,22,19,0.537,13,9,14,8,216.24,206.0,211.12
2016-01-20,1610612760,1610612766,2015,109.0,95.0,204.0,101.8,103.4,99.45,97.7,43,31,12,0.721,41,19,22,0.463,20,11,15,4,210.36,194.96,202.66000000000003
2016-01-20,1610612742,1610612750,2015,106.0,94.0,200.0,104.45,102.7,110.05,111.2,43,24,19,0.5579999999999999,43,13,30,0.302,12,12,6,7,213.0,209.4,211.2
2016-01-20,1610612747,1610612758,2015,93.0,112.0,205.0,107.3,114.65,97.75,101.5,43,9,34,0.209,40,17,23,0.425,5,4,10,7,219.28,207.08,213.18
2016-01-20,1610612757,1610612737,2015,98.0,104.0,202.0,104.75,105.45,96.35,95.7,44,19,25,0.4320000000000001,42,25,17,0.595,10,9,15,10,209.44,199.44,204.44
2016-01-19,1610612748,1610612749,2015,79.0,91.0,170.0,97.25,95.5,99.8,108.15,41,23,18,0.561,43,18,25,0.419,15,8,12,6,195.0,200.48,197.74
2016-01-19,1610612740,1610612750,2015,114.0,99.0,213.0,100.45,104.8,110.05,111.2,40,13,27,0.325,42,13,29,0.31,8,5,6,7,200.8,209.4,205.10000000000002
2016-01-19,1610612743,1610612760,2015,104.0,110.0,214.0,109.2,110.3,101.8,103.4,41,16,25,0.39,42,30,12,0.7140000000000001,8,8,20,10,217.04,210.36,213.7
2016-01-19,1610612756,1610612754,2015,94.0,97.0,191.0,106.25,103.85,92.05,92.25,42,13,29,0.31,41,22,19,0.537,9,4,13,9,212.88,187.28,200.07999999999998
2016-01-18,1610612752,1610612755,2015,119.0,113.0,232.0,101.2,97.2,97.85,106.0,42,20,22,0.476,42,5,37,0.119,11,9,3,2,200.28,207.68,203.98000000000002
2016-01-18,1610612766,1610612762,2015,124.0,119.0,243.0,99.45,97.7,95.55,106.55,40,18,22,0.45,40,18,22,0.45,14,4,12,6,194.96,200.2,197.57999999999998
2016-01-18,1610612764,1610612757,2015,98.0,108.0,206.0,94.7,91.35,104.75,105.45,39,19,20,0.487,43,18,25,0.419,9,10,10,8,193.0,209.44,201.22
2016-01-18,1610612763,1610612740,2015,101.0,99.0,200.0,98.25,97.5,100.45,104.8,42,23,19,0.5479999999999999,39,13,26,0.333,15,8,8,5,193.96,200.8,197.38
2016-01-18,1610612765,1610612741,2015,101.0,111.0,212.0,100.85,105.95,94.0,91.0,40,22,18,0.55,39,23,16,0.59,14,8,16,7,206.0,185.44,195.72
2016-01-18,1610612737,1610612753,2015,98.0,81.0,179.0,96.35,95.7,96.55,103.5,41,24,17,0.585,39,20,19,0.513,14,10,12,8,199.44,203.64,201.54
2016-01-18,1610612761,1610612751,2015,112.0,100.0,212.0,100.6,99.2,96.7,98.4,40,25,15,0.625,41,11,30,0.268,11,14,7,4,206.0,196.96,201.48000000000002
2016-01-18,1610612739,1610612744,2015,98.0,132.0,230.0,101.9,101.55,107.5,105.85,38,28,10,0.737,41,37,4,0.902,15,13,19,18,195.48,199.04,197.26
2016-01-18,1610612742,1610612738,2015,118.0,113.0,231.0,104.45,102.7,99.65,105.5,42,23,19,0.5479999999999999,41,22,19,0.537,11,12,11,11,213.0,195.08,204.04000000000002
2016-01-18,1610612746,1610612745,2015,140.0,132.0,272.0,109.85,106.5,112.7,109.85,40,26,14,0.65,42,22,20,0.524,14,12,13,9,214.36,216.24,215.3
2016-01-17,1610612750,1610612756,2015,117.0,87.0,204.0,110.05,111.2,106.25,103.85,41,12,29,0.293,41,13,28,0.317,5,7,9,4,209.4,212.88,211.14
2016-01-17,1610612760,1610612748,2015,99.0,74.0,173.0,101.8,103.4,97.25,95.5,41,29,12,0.7070000000000001,40,23,17,0.575,19,10,15,8,210.36,195.0,202.68
2016-01-17,1610612759,1610612742,2015,112.0,83.0,195.0,107.75,96.55,104.45,102.7,41,35,6,0.8540000000000001,41,23,18,0.561,23,12,11,12,204.12,213.0,208.56
2016-01-17,1610612743,1610612754,2015,129.0,126.0,255.0,109.2,110.3,92.05,92.25,40,15,25,0.375,40,22,18,0.55,7,8,13,9,217.04,187.28,202.16
2016-01-17,1610612747,1610612745,2015,95.0,112.0,207.0,107.3,114.65,112.7,109.85,42,9,33,0.214,41,21,20,0.512,5,4,13,8,219.28,216.24,217.76
2016-01-16,1610612766,1610612749,2015,92.0,105.0,197.0,99.45,97.7,99.8,108.15,39,18,21,0.462,42,17,25,0.405,14,4,12,5,194.96,200.48,197.72
2016-01-16,1610612737,1610612751,2015,114.0,86.0,200.0,96.35,95.7,96.7,98.4,40,23,17,0.575,40,11,29,0.275,13,10,7,4,199.44,196.96,198.2
2016-01-16,1610612764,1610612738,2015,117.0,119.0,236.0,94.7,91.35,99.65,105.5,38,19,19,0.5,40,21,19,0.525,9,10,11,10,193.0,195.08,194.04000000000002
2016-01-16,1610612765,1610612744,2015,113.0,95.0,208.0,100.85,105.95,107.5,105.85,39,21,18,0.5379999999999999,40,37,3,0.925,13,8,19,18,206.0,199.04,202.51999999999998
2016-01-16,1610612755,1610612757,2015,114.0,89.0,203.0,97.85,106.0,104.75,105.45,41,4,37,0.098,42,18,24,0.429,2,2,10,8,207.68,209.44,208.56
2016-01-16,1610612763,1610612752,2015,103.0,95.0,198.0,98.25,97.5,101.2,97.2,41,22,19,0.537,41,20,21,0.488,14,8,11,9,193.96,200.28,197.12
2016-01-16,1610612762,1610612747,2015,109.0,82.0,191.0,95.55,106.55,107.3,114.65,39,17,22,0.436,41,9,32,0.22,11,6,5,4,200.2,219.28,209.74
2016-01-16,1610612746,1610612758,2015,103.0,110.0,213.0,109.85,106.5,97.75,101.5,39,26,13,0.667,39,16,23,0.41,14,12,10,6,214.36,207.08,210.72000000000003
2016-01-15,1610612754,1610612764,2015,104.0,118.0,222.0,92.05,92.25,94.7,91.35,39,22,17,0.564,37,18,19,0.486,13,9,9,9,187.28,193.0,190.14
2016-01-15,1610612760,1610612750,2015,113.0,93.0,206.0,101.8,103.4,110.05,111.2,40,28,12,0.7,40,12,28,0.3,18,10,5,7,210.36,209.4,209.88
2016-01-15,1610612738,1610612756,2015,117.0,103.0,220.0,99.65,105.5,106.25,103.85,39,20,19,0.513,40,13,27,0.325,10,10,9,4,195.08,212.88,203.98000000000002
2016-01-15,1610612751,1610612757,2015,104.0,116.0,220.0,96.7,98.4,104.75,105.45,39,11,28,0.282,41,17,24,0.415,7,4,10,7,196.96,209.44,203.2
2016-01-15,1610612741,1610612742,2015,77.0,83.0,160.0,94.0,91.0,104.45,102.7,38,23,15,0.605,40,22,18,0.55,16,7,11,11,185.44,213.0,199.22
2016-01-15,1610612740,1610612766,2015,109.0,107.0,216.0,100.45,104.8,99.45,97.7,38,12,26,0.316,38,18,20,0.474,7,5,14,4,200.8,194.96,197.88
2016-01-15,1610612749,1610612737,2015,108.0,101.0,209.0,99.8,108.15,96.35,95.7,41,16,25,0.39,39,23,16,0.59,11,5,13,10,200.48,199.44,199.95999999999998
2016-01-15,1610612743,1610612748,2015,95.0,98.0,193.0,109.2,110.3,97.25,95.5,39,15,24,0.385,39,22,17,0.564,7,8,15,7,217.04,195.0,206.01999999999998
2016-01-15,1610612745,1610612739,2015,77.0,91.0,168.0,112.7,109.85,101.9,101.55,40,21,19,0.525,37,27,10,0.73,13,8,15,12,216.24,195.48,205.86
2016-01-14,1610612753,1610612761,2015,103.0,106.0,209.0,96.55,103.5,100.6,99.2,38,20,18,0.526,39,24,15,0.615,12,8,11,13,203.64,206.0,204.82
2016-01-14,1610612755,1610612741,2015,111.0,115.0,226.0,97.85,106.0,94.0,91.0,40,4,36,0.1,37,22,15,0.595,2,2,16,6,207.68,185.44,196.56
2016-01-14,1610612763,1610612765,2015,103.0,101.0,204.0,98.25,97.5,100.85,105.95,40,21,19,0.525,38,21,17,0.5529999999999999,13,8,13,8,193.96,206.0,199.98000000000002
2016-01-14,1610612759,1610612739,2015,99.0,95.0,194.0,107.75,96.55,101.9,101.55,40,34,6,0.85,36,27,9,0.75,22,12,15,12,204.12,195.48,199.8
2016-01-14,1610612762,1610612758,2015,101.0,103.0,204.0,95.55,106.55,97.75,101.5,38,17,21,0.447,38,15,23,0.395,11,6,10,5,200.2,207.08,203.64
2016-01-14,1610612744,1610612747,2015,116.0,98.0,214.0,107.5,105.85,107.3,114.65,39,36,3,0.923,40,9,31,0.225,18,18,5,4,199.04,219.28,209.16
2016-01-13,1610612766,1610612737,2015,107.0,84.0,191.0,99.45,97.7,96.35,95.7,37,17,20,0.459,38,23,15,0.605,13,4,13,10,194.96,199.44,197.2
2016-01-13,1610612764,1610612749,2015,106.0,101.0,207.0,94.7,91.35,99.8,108.15,36,17,19,0.472,40,16,24,0.4,8,9,11,5,193.0,200.48,196.74
2016-01-13,1610612751,1610612752,2015,110.0,104.0,214.0,96.7,98.4,101.2,97.2,38,10,28,0.263,40,20,20,0.5,6,4,11,9,196.96,200.28,198.62
2016-01-13,1610612738,1610612754,2015,103.0,94.0,197.0,99.65,105.5,92.05,92.25,38,19,19,0.5,38,22,16,0.579,9,10,13,9,195.08,187.28,191.18
2016-01-13,1610612745,1610612750,2015,107.0,104.0,211.0,112.7,109.85,110.05,111.2,39,20,19,0.513,39,12,27,0.308,12,8,5,7,216.24,209.4,212.82
2016-01-13,1610612760,1610612742,2015,108.0,89.0,197.0,101.8,103.4,104.45,102.7,39,27,12,0.6920000000000001,39,22,17,0.564,17,10,11,11,210.36,213.0,211.68
2016-01-13,1610612743,1610612744,2015,112.0,110.0,222.0,109.2,110.3,107.5,105.85,38,14,24,0.368,38,36,2,0.947,6,8,18,18,217.04,199.04,208.04
2016-01-13,1610612757,1610612762,2015,99.0,85.0,184.0,104.75,105.45,95.55,106.55,40,16,24,0.4,37,17,20,0.459,9,7,11,6,209.44,200.2,204.82
2016-01-13,1610612758,1610612740,2015,97.0,109.0,206.0,97.75,101.5,100.45,104.8,37,15,22,0.405,37,11,26,0.297,10,5,7,4,207.08,200.8,203.94
2016-01-13,1610612746,1610612748,2015,104.0,90.0,194.0,109.85,106.5,97.25,95.5,38,25,13,0.6579999999999999,38,22,16,0.579,13,12,15,7,214.36,195.0,204.68
2016-01-12,1610612754,1610612756,2015,116.0,97.0,213.0,92.05,92.25,106.25,103.85,37,21,16,0.568,39,13,26,0.333,12,9,9,4,187.28,212.88,200.07999999999998
2016-01-12,1610612765,1610612759,2015,99.0,109.0,208.0,100.85,105.95,107.75,96.55,37,21,16,0.568,39,33,6,0.846,13,8,22,11,206.0,204.12,205.06
2016-01-12,1610612752,1610612738,2015,120.0,114.0,234.0,101.2,97.2,99.65,105.5,39,19,20,0.487,37,19,18,0.514,10,9,9,10,200.28,195.08,197.68
2016-01-12,1610612763,1610612745,2015,91.0,107.0,198.0,98.25,97.5,112.7,109.85,39,21,18,0.5379999999999999,38,19,19,0.5,13,8,12,7,193.96,216.24,205.10000000000002
2016-01-12,1610612749,1610612741,2015,106.0,101.0,207.0,99.8,108.15,94.0,91.0,39,15,24,0.385,36,22,14,0.611,10,5,16,6,200.48,185.44,192.95999999999998
2016-01-12,1610612750,1610612760,2015,96.0,101.0,197.0,110.05,111.2,101.8,103.4,38,12,26,0.316,38,26,12,0.684,5,7,17,9,209.4,210.36,209.88
2016-01-12,1610612742,1610612739,2015,107.0,110.0,217.0,104.45,102.7,101.9,101.55,38,22,16,0.579,35,26,9,0.743,11,11,15,11,213.0,195.48,204.24
2016-01-12,1610612747,1610612740,2015,95.0,91.0,186.0,107.3,114.65,100.45,104.8,39,8,31,0.205,36,11,25,0.306,4,4,7,4,219.28,200.8,210.04000000000002
2016-01-11,1610612751,1610612759,2015,79.0,106.0,185.0,96.7,98.4,107.75,96.55,37,10,27,0.27,38,32,6,0.8420000000000001,6,4,22,10,196.96,204.12,200.54000000000002
2016-01-11,1610612741,1610612764,2015,100.0,114.0,214.0,94.0,91.0,94.7,91.35,35,22,13,0.629,35,16,19,0.457,16,6,8,8,185.44,193.0,189.22
2016-01-11,1610612744,1610612748,2015,111.0,103.0,214.0,107.5,105.85,97.25,95.5,37,35,2,0.946,37,22,15,0.595,17,18,15,7,199.04,195.0,197.01999999999998
2016-01-10,1610612746,1610612740,2015,114.0,111.0,225.0,109.85,106.5,100.45,104.8,37,24,13,0.649,35,11,24,0.314,12,12,7,4,214.36,200.8,207.58
2016-01-10,1610612750,1610612742,2015,87.0,93.0,180.0,110.05,111.2,104.45,102.7,37,12,25,0.324,37,21,16,0.568,5,7,11,10,209.4,213.0,211.2
2016-01-10,1610612755,1610612739,2015,85.0,95.0,180.0,97.85,106.0,101.9,101.55,39,4,35,0.103,34,25,9,0.735,2,2,15,10,207.68,195.48,201.57999999999998
2016-01-10,1610612763,1610612738,2015,101.0,98.0,199.0,98.25,97.5,99.65,105.5,38,20,18,0.526,36,19,17,0.528,12,8,9,10,193.96,195.08,194.52
2016-01-10,1610612745,1610612754,2015,107.0,103.0,210.0,112.7,109.85,92.05,92.25,37,18,19,0.486,36,21,15,0.583,11,7,12,9,216.24,187.28,201.76
2016-01-10,1610612752,1610612749,2015,100.0,88.0,188.0,101.2,97.2,99.8,108.15,38,18,20,0.474,38,15,23,0.395,9,9,10,5,200.28,200.48,200.38
2016-01-10,1610612743,1610612766,2015,95.0,92.0,187.0,109.2,110.3,99.45,97.7,37,13,24,0.35100000000000003,36,17,19,0.472,5,8,13,4,217.04,194.96,206.0
2016-01-10,1610612757,1610612760,2015,115.0,110.0,225.0,104.75,105.45,101.8,103.4,39,15,24,0.385,37,26,11,0.703,8,7,17,9,209.44,210.36,209.9
2016-01-10,1610612747,1610612762,2015,74.0,86.0,160.0,107.3,114.65,95.55,106.55,38,8,30,0.211,36,16,20,0.444,4,4,11,5,219.28,200.2,209.74
2016-01-09,1610612746,1610612766,2015,97.0,83.0,180.0,109.85,106.5,99.45,97.7,36,23,13,0.639,35,17,18,0.486,11,12,13,4,214.36,194.96,204.66000000000003
2016-01-09,1610612737,1610612741,2015,120.0,105.0,225.0,96.35,95.7,94.0,91.0,37,22,15,0.595,34,22,12,0.647,12,10,16,6,199.44,185.44,192.44
2016-01-09,1610612753,1610612764,2015,99.0,105.0,204.0,96.55,103.5,94.7,91.35,37,20,17,0.541,34,15,19,0.441,12,8,8,7,203.64,193.0,198.32
2016-01-09,1610612765,1610612751,2015,103.0,89.0,192.0,100.85,105.95,96.7,98.4,36,20,16,0.556,36,10,26,0.278,12,8,6,4,206.0,196.96,201.48000000000002
2016-01-09,1610612755,1610612761,2015,95.0,108.0,203.0,97.85,106.0,100.6,99.2,38,4,34,0.105,38,23,15,0.605,2,2,11,12,207.68,206.0,206.84
2016-01-09,1610612762,1610612748,2015,98.0,83.0,181.0,95.55,106.55,97.25,95.5,35,15,20,0.429,36,22,14,0.611,10,5,15,7,200.2,195.0,197.6
2016-01-09,1610612758,1610612744,2015,116.0,128.0,244.0,97.75,101.5,107.5,105.85,36,15,21,0.417,36,34,2,0.944,10,5,17,17,207.08,199.04,203.06
2016-01-08,1610612764,1610612761,2015,88.0,97.0,185.0,94.7,91.35,100.6,99.2,33,15,18,0.455,37,22,15,0.595,8,7,11,11,193.0,206.0,199.5
2016-01-08,1610612751,1610612753,2015,77.0,83.0,160.0,96.7,98.4,96.55,103.5,35,10,25,0.28600000000000003,36,19,17,0.528,6,4,12,7,196.96,203.64,200.3
2016-01-08,1610612763,1610612743,2015,91.0,84.0,175.0,98.25,97.5,109.2,110.3,37,19,18,0.514,36,13,23,0.361,11,8,5,8,193.96,217.04,205.5
2016-01-08,1610612750,1610612739,2015,99.0,125.0,224.0,110.05,111.2,101.9,101.55,36,12,24,0.333,33,24,9,0.727,5,7,15,9,209.4,195.48,202.44
2016-01-08,1610612740,1610612754,2015,86.0,91.0,177.0,100.45,104.8,92.05,92.25,34,11,23,0.324,35,20,15,0.5710000000000001,7,4,12,8,200.8,187.28,194.04000000000002
2016-01-08,1610612749,1610612742,2015,96.0,95.0,191.0,99.8,108.15,104.45,102.7,37,14,23,0.378,36,21,15,0.583,9,5,11,10,200.48,213.0,206.74
2016-01-08,1610612759,1610612752,2015,100.0,99.0,199.0,107.75,96.55,101.2,97.2,37,31,6,0.838,37,18,19,0.486,21,10,9,9,204.12,200.28,202.2
2016-01-08,1610612756,1610612748,2015,95.0,103.0,198.0,106.25,103.85,97.25,95.5,38,13,25,0.342,35,21,14,0.6,9,4,15,6,212.88,195.0,203.94
2016-01-08,1610612757,1610612744,2015,108.0,128.0,236.0,104.75,105.45,107.5,105.85,38,15,23,0.395,35,33,2,0.943,8,7,17,16,209.44,199.04,204.24
2016-01-08,1610612747,1610612760,2015,113.0,117.0,230.0,107.3,114.65,101.8,103.4,37,8,29,0.21600000000000005,36,25,11,0.6940000000000001,4,4,17,8,219.28,210.36,214.82
2016-01-07,1610612755,1610612737,2015,98.0,126.0,224.0,97.85,106.0,96.35,95.7,37,4,33,0.108,36,21,15,0.583,2,2,12,9,207.68,199.44,203.56
2016-01-07,1610612741,1610612738,2015,101.0,92.0,193.0,94.0,91.0,99.65,105.5,33,21,12,0.636,35,19,16,0.5429999999999999,15,6,9,10,185.44,195.08,190.26
2016-01-07,1610612745,1610612762,2015,103.0,94.0,197.0,112.7,109.85,95.55,106.55,36,17,19,0.472,34,15,19,0.441,10,7,10,5,216.24,200.2,208.22
2016-01-07,1610612758,1610612747,2015,118.0,115.0,233.0,97.75,101.5,107.3,114.65,35,14,21,0.4,36,8,28,0.222,9,5,4,4,207.08,219.28,213.18
2016-01-06,1610612748,1610612752,2015,90.0,98.0,188.0,97.25,95.5,101.2,97.2,34,21,13,0.618,36,17,19,0.472,15,6,9,8,195.0,200.28,197.64
2016-01-06,1610612753,1610612754,2015,86.0,95.0,181.0,96.55,103.5,92.05,92.25,35,19,16,0.5429999999999999,34,19,15,0.5589999999999999,12,7,12,7,203.64,187.28,195.45999999999998
2016-01-06,1610612764,1610612739,2015,115.0,121.0,236.0,94.7,91.35,101.9,101.55,32,15,17,0.469,32,23,9,0.7190000000000001,8,7,15,8,193.0,195.48,194.24
2016-01-06,1610612738,1610612765,2015,94.0,99.0,193.0,99.65,105.5,100.85,105.95,34,19,15,0.5589999999999999,35,19,16,0.5429999999999999,9,10,12,7,195.08,206.0,200.54000000000002
2016-01-06,1610612751,1610612761,2015,74.0,91.0,165.0,96.7,98.4,100.6,99.2,34,10,24,0.294,36,21,15,0.583,6,4,11,10,196.96,206.0,201.48000000000002
2016-01-06,1610612750,1610612743,2015,74.0,78.0,152.0,110.05,111.2,109.2,110.3,35,12,23,0.343,35,12,23,0.343,5,7,5,7,209.4,217.04,213.22
2016-01-06,1610612740,1610612742,2015,91.0,100.0,191.0,100.45,104.8,104.45,102.7,33,11,22,0.333,35,20,15,0.5710000000000001,7,4,11,9,200.8,213.0,206.9
2016-01-06,1610612759,1610612762,2015,123.0,98.0,221.0,107.75,96.55,95.55,106.55,36,30,6,0.833,33,15,18,0.455,20,10,10,5,204.12,200.2,202.16
2016-01-06,1610612756,1610612766,2015,111.0,102.0,213.0,106.25,103.85,99.45,97.7,37,12,25,0.324,34,17,17,0.5,8,4,13,4,212.88,194.96,203.92000000000002
2016-01-06,1610612760,1610612763,2015,112.0,94.0,206.0,101.8,103.4,98.25,97.5,35,24,11,0.6859999999999999,36,19,17,0.528,16,8,11,8,210.36,193.96,202.16000000000003
2016-01-06,1610612757,1610612746,2015,98.0,109.0,207.0,104.75,105.45,109.85,106.5,37,15,22,0.405,35,22,13,0.629,8,7,11,11,209.44,214.36,211.9
2016-01-05,1610612737,1610612752,2015,101.0,107.0,208.0,96.35,95.7,101.2,97.2,35,21,14,0.6,35,16,19,0.457,12,9,9,7,199.44,200.28,199.86
2016-01-05,1610612741,1610612749,2015,117.0,106.0,223.0,94.0,91.0,99.8,108.15,32,20,12,0.625,36,14,22,0.389,14,6,9,5,185.44,200.48,192.95999999999998
2016-01-05,1610612742,1610612758,2015,117.0,116.0,233.0,104.45,102.7,97.75,101.5,34,19,15,0.5589999999999999,34,14,20,0.412,10,9,9,5,213.0,207.08,210.04000000000002
2016-01-05,1610612747,1610612744,2015,88.0,109.0,197.0,107.3,114.65,107.5,105.85,35,8,27,0.229,34,32,2,0.941,4,4,17,15,219.28,199.04,209.16
2016-01-04,1610612739,1610612761,2015,122.0,100.0,222.0,101.9,101.55,100.6,99.2,31,22,9,0.71,35,21,14,0.6,14,8,11,10,195.48,206.0,200.74
2016-01-04,1610612755,1610612750,2015,109.0,99.0,208.0,97.85,106.0,110.05,111.2,36,3,33,0.083,34,12,22,0.353,1,2,5,7,207.68,209.4,208.54000000000002
2016-01-04,1610612751,1610612738,2015,94.0,103.0,197.0,96.7,98.4,99.65,105.5,33,10,23,0.303,33,18,15,0.545,6,4,9,9,196.96,195.08,196.02
2016-01-04,1610612765,1610612753,2015,115.0,89.0,204.0,100.85,105.95,96.55,103.5,34,18,16,0.529,34,19,15,0.5589999999999999,11,7,12,7,206.0,203.64,204.82
2016-01-04,1610612748,1610612754,2015,103.0,100.0,203.0,97.25,95.5,92.05,92.25,33,20,13,0.606,33,19,14,0.5760000000000001,14,6,12,7,195.0,187.28,191.14
2016-01-04,1610612749,1610612759,2015,98.0,123.0,221.0,99.8,108.15,107.75,96.55,35,14,21,0.4,35,29,6,0.8290000000000001,9,5,20,9,200.48,204.12,202.3
2016-01-04,1610612760,1610612758,2015,104.0,116.0,220.0,101.8,103.4,97.75,101.5,34,24,10,0.706,33,13,20,0.394,16,8,9,4,210.36,207.08,208.72000000000003
2016-01-04,1610612762,1610612745,2015,91.0,93.0,184.0,95.55,106.55,112.7,109.85,32,15,17,0.469,35,16,19,0.457,10,5,10,6,200.2,216.24,208.22
2016-01-04,1610612757,1610612763,2015,78.0,91.0,169.0,104.75,105.45,98.25,97.5,36,15,21,0.417,35,18,17,0.514,8,7,11,7,209.44,193.96,201.7
2016-01-04,1610612744,1610612766,2015,111.0,101.0,212.0,107.5,105.85,99.45,97.7,33,31,2,0.939,33,17,16,0.515,16,15,13,4,199.04,194.96,197.0
2016-01-03,1610612752,1610612737,2015,111.0,97.0,208.0,101.2,97.2,96.35,95.7,34,15,19,0.441,34,21,13,0.618,8,7,12,9,200.28,199.44,199.86
2016-01-03,1610612761,1610612741,2015,113.0,115.0,228.0,100.6,99.2,94.0,91.0,34,21,13,0.618,31,19,12,0.613,11,10,14,5,206.0,185.44,195.72
2016-01-03,1610612764,1610612748,2015,75.0,97.0,172.0,94.7,91.35,97.25,95.5,31,15,16,0.484,32,19,13,0.594,8,7,14,5,193.0,195.0,194.0
2016-01-03,1610612743,1610612757,2015,106.0,112.0,218.0,109.2,110.3,104.75,105.45,34,12,22,0.353,35,14,21,0.4,5,7,8,6,217.04,209.44,213.24
2016-01-03,1610612747,1610612756,2015,97.0,77.0,174.0,107.3,114.65,106.25,103.85,34,7,27,0.206,36,12,24,0.333,3,4,8,4,219.28,212.88,216.07999999999998
2016-01-02,1610612738,1610612751,2015,97.0,100.0,197.0,99.65,105.5,96.7,98.4,32,18,14,0.563,32,9,23,0.281,9,9,6,3,195.08,196.96,196.02
2016-01-02,1610612758,1610612756,2015,142.0,119.0,261.0,97.75,101.5,106.25,103.85,32,12,20,0.375,35,12,23,0.343,8,4,8,4,207.08,212.88,209.98000000000002
2016-01-02,1610612766,1610612760,2015,90.0,109.0,199.0,99.45,97.7,101.8,103.4,32,17,15,0.531,33,23,10,0.6970000000000001,13,4,16,7,194.96,210.36,202.66000000000003
2016-01-02,1610612754,1610612765,2015,94.0,82.0,176.0,92.05,92.25,100.85,105.95,32,18,14,0.563,33,18,15,0.545,11,7,11,7,187.28,206.0,196.64
2016-01-02,1610612739,1610612753,2015,104.0,79.0,183.0,101.9,101.55,96.55,103.5,30,21,9,0.7,33,19,14,0.5760000000000001,13,8,12,7,195.48,203.64,199.56
2016-01-02,1610612750,1610612749,2015,85.0,95.0,180.0,110.05,111.2,99.8,108.15,33,12,21,0.364,34,13,21,0.382,5,7,9,4,209.4,200.48,204.94
2016-01-02,1610612742,1610612740,2015,98.0,105.0,203.0,104.45,102.7,100.45,104.8,33,19,14,0.5760000000000001,32,10,22,0.313,10,9,7,3,213.0,200.8,206.9
2016-01-02,1610612759,1610612745,2015,121.0,103.0,224.0,107.75,96.55,112.7,109.85,34,28,6,0.8240000000000001,34,16,18,0.471,19,9,10,6,204.12,216.24,210.18
2016-01-02,1610612762,1610612763,2015,92.0,87.0,179.0,95.55,106.55,98.25,97.5,31,14,17,0.452,34,18,16,0.529,9,5,11,7,200.2,193.96,197.07999999999998
2016-01-02,1610612744,1610612743,2015,111.0,108.0,219.0,107.5,105.85,109.2,110.3,32,30,2,0.938,33,12,21,0.364,15,15,5,7,199.04,217.04,208.04
2016-01-02,1610612746,1610612755,2015,130.0,99.0,229.0,109.85,106.5,97.85,106.0,34,21,13,0.618,35,3,32,0.086,10,11,1,2,214.36,207.68,211.02
2016-01-01,1610612764,1610612753,2015,103.0,91.0,194.0,94.7,91.35,96.55,103.5,30,14,16,0.467,32,19,13,0.594,7,7,12,7,193.0,203.64,198.32
2016-01-01,1610612748,1610612742,2015,106.0,82.0,188.0,97.25,95.5,104.45,102.7,31,18,13,0.581,32,19,13,0.594,13,5,10,9,195.0,213.0,204.0
2016-01-01,1610612761,1610612766,2015,104.0,94.0,198.0,100.6,99.2,99.45,97.7,33,20,13,0.606,31,17,14,0.5479999999999999,10,10,13,4,206.0,194.96,200.48000000000002
2016-01-01,1610612741,1610612752,2015,108.0,81.0,189.0,94.0,91.0,101.2,97.2,30,18,12,0.6,33,15,18,0.455,13,5,8,7,185.44,200.28,192.86
2016-01-01,1610612747,1610612755,2015,93.0,84.0,177.0,107.3,114.65,97.85,106.0,33,6,27,0.182,34,3,31,0.08800000000000001,2,4,1,2,219.28,207.68,213.48000000000002
2015-12-31,1610612754,1610612749,2015,116.0,120.0,236.0,92.05,92.25,99.8,108.15,31,18,13,0.581,33,12,21,0.364,11,7,9,3,187.28,200.48,193.88
2015-12-31,1610612765,1610612750,2015,115.0,90.0,205.0,100.85,105.95,110.05,111.2,32,17,15,0.531,32,12,20,0.375,10,7,5,7,206.0,209.4,207.7
2015-12-31,1610612745,1610612744,2015,110.0,114.0,224.0,112.7,109.85,107.5,105.85,33,16,17,0.485,31,29,2,0.935,10,6,15,14,216.24,199.04,207.64
2015-12-31,1610612740,1610612746,2015,89.0,95.0,184.0,100.45,104.8,109.85,106.5,31,10,21,0.32299999999999995,33,20,13,0.606,7,3,10,10,200.8,214.36,207.58
2015-12-31,1610612760,1610612756,2015,110.0,106.0,216.0,101.8,103.4,106.25,103.85,32,22,10,0.688,34,12,22,0.353,15,7,8,4,210.36,212.88,211.62
2015-12-31,1610612762,1610612757,2015,109.0,96.0,205.0,95.55,106.55,104.75,105.45,30,13,17,0.433,34,14,20,0.412,8,5,8,6,200.2,209.44,204.82
2015-12-30,1610612766,1610612746,2015,117.0,122.0,239.0,99.45,97.7,109.85,106.5,30,17,13,0.5670000000000001,32,19,13,0.594,13,4,10,9,194.96,214.36,204.66000000000003
2015-12-30,1610612753,1610612751,2015,100.0,93.0,193.0,96.55,103.5,96.7,98.4,31,18,13,0.581,31,9,22,0.29,11,7,6,3,203.64,196.96,200.3
2015-12-30,1610612738,1610612747,2015,104.0,112.0,216.0,99.65,105.5,107.3,114.65,31,18,13,0.581,32,5,27,0.156,9,9,2,3,195.08,219.28,207.18
2015-12-30,1610612761,1610612764,2015,94.0,91.0,185.0,100.6,99.2,94.7,91.35,32,19,13,0.594,29,14,15,0.483,9,10,7,7,206.0,193.0,199.5
2015-12-30,1610612741,1610612754,2015,102.0,100.0,202.0,94.0,91.0,92.05,92.25,29,17,12,0.586,30,18,12,0.6,12,5,11,7,185.44,187.28,186.36
2015-12-30,1610612750,1610612762,2015,94.0,80.0,174.0,110.05,111.2,95.55,106.55,31,11,20,0.355,29,13,16,0.448,4,7,8,5,209.4,200.2,204.8
2015-12-30,1610612742,1610612744,2015,114.0,91.0,205.0,104.45,102.7,107.5,105.85,31,18,13,0.581,30,29,1,0.967,9,9,15,14,213.0,199.04,206.01999999999998
2015-12-30,1610612759,1610612756,2015,112.0,79.0,191.0,107.75,96.55,106.25,103.85,33,27,6,0.818,33,12,21,0.364,18,9,8,4,204.12,212.88,208.5
2015-12-30,1610612757,1610612743,2015,110.0,103.0,213.0,104.75,105.45,109.2,110.3,33,13,20,0.394,32,12,20,0.375,7,6,5,7,209.44,217.04,213.24
2015-12-30,1610612758,1610612755,2015,105.0,110.0,215.0,97.75,101.5,97.85,106.0,31,12,19,0.387,33,2,31,0.061,8,4,1,1,207.08,207.68,207.38
2015-12-29,1610612752,1610612765,2015,108.0,96.0,204.0,101.2,97.2,100.85,105.95,32,14,18,0.438,31,17,14,0.5479999999999999,7,7,10,7,200.28,206.0,203.14
2015-12-29,1610612745,1610612737,2015,115.0,121.0,236.0,112.7,109.85,96.35,95.7,32,16,16,0.5,33,20,13,0.606,10,6,12,8,216.24,199.44,207.84
2015-12-29,1610612763,1610612748,2015,99.0,90.0,189.0,98.25,97.5,97.25,95.5,33,17,16,0.515,30,18,12,0.6,10,7,13,5,193.96,195.0,194.48000000000002
2015-12-29,1610612760,1610612749,2015,131.0,123.0,254.0,101.8,103.4,99.8,108.15,31,21,10,0.677,32,12,20,0.375,14,7,9,3,210.36,200.48,205.42000000000002
2015-12-29,1610612743,1610612739,2015,87.0,93.0,180.0,109.2,110.3,101.9,101.55,31,12,19,0.387,29,20,9,0.69,5,7,13,7,217.04,195.48,206.26
2015-12-28,1610612766,1610612747,2015,108.0,98.0,206.0,99.45,97.7,107.3,114.65,29,16,13,0.552,31,5,26,0.161,12,4,2,3,194.96,219.28,207.12
2015-12-28,1610612754,1610612737,2015,93.0,87.0,180.0,92.05,92.25,96.35,95.7,29,17,12,0.586,32,20,12,0.625,10,7,12,8,187.28,199.44,193.36
2015-12-28,1610612753,1610612740,2015,104.0,89.0,193.0,96.55,103.5,100.45,104.8,30,17,13,0.5670000000000001,30,10,20,0.333,10,7,7,3,203.64,200.8,202.22
2015-12-28,1610612764,1610612746,2015,91.0,108.0,199.0,94.7,91.35,109.85,106.5,28,14,14,0.5,31,18,13,0.581,7,7,10,8,193.0,214.36,203.68
2015-12-28,1610612748,1610612751,2015,105.0,111.0,216.0,97.25,95.5,96.7,98.4,29,18,11,0.621,30,8,22,0.267,13,5,6,2,195.0,196.96,195.98000000000002
2015-12-28,1610612741,1610612761,2015,104.0,97.0,201.0,94.0,91.0,100.6,99.2,28,16,12,0.5710000000000001,31,19,12,0.613,11,5,9,10,185.44,206.0,195.72
2015-12-28,1610612742,1610612749,2015,103.0,93.0,196.0,104.45,102.7,99.8,108.15,30,17,13,0.5670000000000001,31,12,19,0.387,8,9,9,3,213.0,200.48,206.74
2015-12-28,1610612759,1610612750,2015,101.0,95.0,196.0,107.75,96.55,110.05,111.2,32,26,6,0.813,30,11,19,0.3670000000000001,17,9,4,7,204.12,209.4,206.76
2015-12-28,1610612756,1610612739,2015,97.0,101.0,198.0,106.25,103.85,101.9,101.55,32,12,20,0.375,28,19,9,0.679,8,4,13,6,212.88,195.48,204.18
2015-12-28,1610612762,1610612755,2015,95.0,91.0,186.0,95.55,106.55,97.85,106.0,28,12,16,0.429,32,2,30,0.063,7,5,1,1,200.2,207.68,203.94
2015-12-28,1610612744,1610612758,2015,122.0,103.0,225.0,107.5,105.85,97.75,101.5,29,28,1,0.966,30,12,18,0.4,14,14,8,4,199.04,207.08,203.06
2015-12-27,1610612763,1610612747,2015,112.0,96.0,208.0,98.25,97.5,107.3,114.65,32,16,16,0.5,30,5,25,0.16699999999999998,9,7,2,3,193.96,219.28,206.62
2015-12-27,1610612738,1610612752,2015,100.0,91.0,191.0,99.65,105.5,101.2,97.2,30,17,13,0.5670000000000001,31,14,17,0.452,8,9,7,7,195.08,200.28,197.68
2015-12-27,1610612760,1610612743,2015,122.0,112.0,234.0,101.8,103.4,109.2,110.3,30,20,10,0.667,30,12,18,0.4,13,7,5,7,210.36,217.04,213.7
2015-12-27,1610612758,1610612757,2015,94.0,98.0,192.0,97.75,101.5,104.75,105.45,29,12,17,0.414,32,12,20,0.375,8,4,7,5,207.08,209.44,208.26
2015-12-26,1610612751,1610612764,2015,96.0,111.0,207.0,96.7,98.4,94.7,91.35,29,8,21,0.276,27,13,14,0.481,6,2,7,6,196.96,193.0,194.98000000000002
2015-12-26,1610612749,1610612761,2015,90.0,111.0,201.0,99.8,108.15,100.6,99.2,30,12,18,0.4,30,18,12,0.6,9,3,9,9,200.48,206.0,203.24
2015-12-26,1610612766,1610612763,2015,98.0,92.0,190.0,99.45,97.7,98.25,97.5,28,15,13,0.536,31,16,15,0.516,11,4,9,7,194.96,193.96,194.46
2015-12-26,1610612753,1610612748,2015,101.0,108.0,209.0,96.55,103.5,97.25,95.5,29,17,12,0.586,28,17,11,0.607,10,7,13,4,203.64,195.0,199.32
2015-12-26,1610612740,1610612745,2015,110.0,108.0,218.0,100.45,104.8,112.7,109.85,29,9,20,0.31,31,16,15,0.516,6,3,10,6,200.8,216.24,208.52
2015-12-26,1610612737,1610612752,2015,117.0,98.0,215.0,96.35,95.7,101.2,97.2,31,19,12,0.613,30,14,16,0.467,11,8,7,7,199.44,200.28,199.86
2015-12-26,1610612765,1610612738,2015,93.0,99.0,192.0,100.85,105.95,99.65,105.5,30,17,13,0.5670000000000001,29,16,13,0.552,10,7,8,8,206.0,195.08,200.54000000000002
2015-12-26,1610612750,1610612754,2015,88.0,102.0,190.0,110.05,111.2,92.05,92.25,29,11,18,0.379,28,16,12,0.5710000000000001,4,7,10,6,209.4,187.28,198.34
2015-12-26,1610612742,1610612741,2015,118.0,111.0,229.0,104.45,102.7,94.0,91.0,29,16,13,0.552,27,16,11,0.593,7,9,11,5,213.0,185.44,199.22
2015-12-26,1610612759,1610612743,2015,101.0,86.0,187.0,107.75,96.55,109.2,110.3,31,25,6,0.8059999999999999,29,12,17,0.414,16,9,5,7,204.12,217.04,210.57999999999998
2015-12-26,1610612756,1610612755,2015,104.0,111.0,215.0,106.25,103.85,97.85,106.0,31,12,19,0.387,31,1,30,0.032,8,4,1,0,212.88,207.68,210.28
2015-12-26,1610612762,1610612746,2015,104.0,109.0,213.0,95.55,106.55,109.85,106.5,27,12,15,0.444,30,17,13,0.5670000000000001,7,5,10,7,200.2,214.36,207.28
2015-12-26,1610612757,1610612739,2015,105.0,76.0,181.0,104.75,105.45,101.9,101.55,31,11,20,0.355,27,19,8,0.7040000000000001,6,5,13,6,209.44,195.48,202.45999999999998
2015-12-25,1610612748,1610612740,2015,94.0,88.0,182.0,97.25,95.5,100.45,104.8,27,16,11,0.593,28,9,19,0.321,12,4,6,3,195.0,200.8,197.9
2015-12-25,1610612760,1610612741,2015,96.0,105.0,201.0,101.8,103.4,94.0,91.0,29,20,9,0.69,26,15,11,0.5770000000000001,13,7,11,4,210.36,185.44,197.9
2015-12-25,1610612744,1610612739,2015,89.0,83.0,172.0,107.5,105.85,101.9,101.55,28,27,1,0.964,26,19,7,0.731,13,14,13,6,199.04,195.48,197.26
2015-12-25,1610612745,1610612759,2015,88.0,84.0,172.0,112.7,109.85,107.75,96.55,30,15,15,0.5,30,25,5,0.833,9,6,16,9,216.24,204.12,210.18
2015-12-25,1610612747,1610612746,2015,84.0,94.0,178.0,107.3,114.65,109.85,106.5,29,5,24,0.172,29,16,13,0.552,2,3,10,6,219.28,214.36,216.82
2015-12-23,1610612766,1610612738,2015,89.0,102.0,191.0,99.45,97.7,99.65,105.5,27,15,12,0.556,28,15,13,0.536,11,4,8,7,194.96,195.08,195.02
2015-12-23,1610612739,1610612752,2015,91.0,84.0,175.0,101.9,101.55,101.2,97.2,25,18,7,0.72,29,14,15,0.483,12,6,7,7,195.48,200.28,197.88
2015-12-23,1610612754,1610612758,2015,106.0,108.0,214.0,92.05,92.25,97.75,101.5,27,16,11,0.593,28,11,17,0.393,10,6,8,3,187.28,207.08,197.18
2015-12-23,1610612753,1610612745,2015,104.0,101.0,205.0,96.55,103.5,112.7,109.85,28,16,12,0.5710000000000001,29,15,14,0.517,9,7,9,6,203.64,216.24,209.94
2015-12-23,1610612764,1610612763,2015,100.0,91.0,191.0,94.7,91.35,98.25,97.5,26,12,14,0.462,30,16,14,0.5329999999999999,6,6,9,7,193.0,193.96,193.48000000000002
2015-12-23,1610612751,1610612742,2015,118.0,119.0,237.0,96.7,98.4,104.45,102.7,28,8,20,0.28600000000000003,28,15,13,0.536,6,2,7,8,196.96,213.0,204.98000000000002
2015-12-23,1610612737,1610612765,2015,107.0,100.0,207.0,96.35,95.7,100.85,105.95,30,18,12,0.6,29,17,12,0.586,10,8,10,7,199.44,206.0,202.72
2015-12-23,1610612749,1610612755,2015,113.0,100.0,213.0,99.8,108.15,97.85,106.0,29,11,18,0.379,30,1,29,0.033,8,3,1,0,200.48,207.68,204.07999999999998
2015-12-23,1610612750,1610612759,2015,83.0,108.0,191.0,110.05,111.2,107.75,96.55,28,11,17,0.393,29,24,5,0.828,4,7,16,8,209.4,204.12,206.76
2015-12-23,1610612740,1610612757,2015,115.0,89.0,204.0,100.45,104.8,104.75,105.45,27,8,19,0.29600000000000004,30,11,19,0.3670000000000001,5,3,6,5,200.8,209.44,205.12
2015-12-23,1610612756,1610612743,2015,96.0,104.0,200.0,106.25,103.85,109.2,110.3,30,12,18,0.4,28,11,17,0.393,8,4,5,6,212.88,217.04,214.95999999999998
2015-12-23,1610612744,1610612762,2015,103.0,85.0,188.0,107.5,105.85,95.55,106.55,27,26,1,0.963,26,12,14,0.462,12,14,7,5,199.04,200.2,199.62
2015-12-23,1610612747,1610612760,2015,85.0,120.0,205.0,107.3,114.65,101.8,103.4,28,5,23,0.179,28,19,9,0.679,2,3,13,6,219.28,210.36,214.82
2015-12-22,1610612755,1610612763,2015,90.0,104.0,194.0,97.85,106.0,98.25,97.5,29,1,28,0.034,29,15,14,0.517,1,0,9,6,207.68,193.96,200.82
2015-12-22,1610612748,1610612765,2015,92.0,93.0,185.0,97.25,95.5,100.85,105.95,26,16,10,0.615,28,16,12,0.5710000000000001,12,4,10,6,195.0,206.0,200.5
2015-12-22,1610612761,1610612742,2015,103.0,99.0,202.0,100.6,99.2,104.45,102.7,29,17,12,0.586,27,15,12,0.556,8,9,7,8,206.0,213.0,209.5
2015-12-22,1610612743,1610612747,2015,107.0,111.0,218.0,109.2,110.3,107.3,114.65,27,11,16,0.407,27,4,23,0.14800000000000002,5,6,2,2,217.04,219.28,218.16
2015-12-21,1610612764,1610612758,2015,113.0,99.0,212.0,94.7,91.35,97.75,101.5,25,11,14,0.44,27,11,16,0.407,5,6,8,3,193.0,207.08,200.04000000000002
2015-12-21,1610612738,1610612750,2015,113.0,99.0,212.0,99.65,105.5,110.05,111.2,27,14,13,0.519,27,11,16,0.407,7,7,4,7,195.08,209.4,202.24
2015-12-21,1610612752,1610612753,2015,99.0,107.0,206.0,101.2,97.2,96.55,103.5,28,14,14,0.5,27,15,12,0.556,7,7,9,6,200.28,203.64,201.95999999999998
2015-12-21,1610612737,1610612757,2015,106.0,97.0,203.0,96.35,95.7,104.75,105.45,29,17,12,0.586,29,11,18,0.379,9,8,6,5,199.44,209.44,204.44
2015-12-21,1610612741,1610612751,2015,102.0,105.0,207.0,94.0,91.0,96.7,98.4,25,15,10,0.6,27,7,20,0.259,11,4,6,1,185.44,196.96,191.2
2015-12-21,1610612745,1610612766,2015,102.0,95.0,197.0,112.7,109.85,99.45,97.7,28,14,14,0.5,26,15,11,0.5770000000000001,8,6,11,4,216.24,194.96,205.60000000000002
2015-12-21,1610612759,1610612754,2015,106.0,92.0,198.0,107.75,96.55,92.05,92.25,28,23,5,0.821,26,16,10,0.615,15,8,10,6,204.12,187.28,195.7
2015-12-21,1610612762,1610612756,2015,110.0,89.0,199.0,95.55,106.55,106.25,103.85,25,11,14,0.44,29,12,17,0.414,6,5,8,4,200.2,212.88,206.54
2015-12-21,1610612746,1610612760,2015,99.0,100.0,199.0,109.85,106.5,101.8,103.4,28,16,12,0.5710000000000001,27,18,9,0.667,10,6,13,5,214.36,210.36,212.36
2015-12-20,1610612751,1610612750,2015,85.0,100.0,185.0,96.7,98.4,110.05,111.2,26,7,19,0.269,26,10,16,0.385,6,1,4,6,196.96,209.4,203.18
2015-12-20,1610612748,1610612757,2015,116.0,109.0,225.0,97.25,95.5,104.75,105.45,25,15,10,0.6,28,11,17,0.393,11,4,6,5,195.0,209.44,202.22
2015-12-20,1610612739,1610612755,2015,108.0,86.0,194.0,101.9,101.55,97.85,106.0,24,17,7,0.708,28,1,27,0.036000000000000004,11,6,1,0,195.48,207.68,201.57999999999998
2015-12-20,1610612756,1610612749,2015,95.0,101.0,196.0,106.25,103.85,99.8,108.15,28,12,16,0.429,28,10,18,0.35700000000000004,8,4,8,2,212.88,200.48,206.68
2015-12-20,1610612753,1610612737,2015,100.0,103.0,203.0,96.55,103.5,96.35,95.7,26,15,11,0.5770000000000001,28,16,12,0.5710000000000001,9,6,9,7,203.64,199.44,201.54
2015-12-20,1610612761,1610612758,2015,94.0,104.0,198.0,100.6,99.2,97.75,101.5,28,17,11,0.607,26,10,16,0.385,8,9,8,2,206.0,207.08,206.54000000000002
2015-12-20,1610612743,1610612740,2015,125.0,130.0,255.0,109.2,110.3,100.45,104.8,26,11,15,0.423,26,7,19,0.269,5,6,5,2,217.04,200.8,208.92000000000002
2015-12-19,1610612760,1610612747,2015,118.0,78.0,196.0,101.8,103.4,107.3,114.65,26,17,9,0.654,26,4,22,0.154,12,5,2,2,210.36,219.28,214.82
2015-12-19,1610612764,1610612766,2015,109.0,101.0,210.0,94.7,91.35,99.45,97.7,24,10,14,0.417,25,15,10,0.6,4,6,11,4,193.0,194.96,193.98000000000002
2015-12-19,1610612752,1610612741,2015,107.0,91.0,198.0,101.2,97.2,94.0,91.0,27,13,14,0.481,24,15,9,0.625,6,7,11,4,200.28,185.44,192.86
2015-12-19,1610612745,1610612746,2015,107.0,97.0,204.0,112.7,109.85,109.85,106.5,27,13,14,0.481,27,16,11,0.593,7,6,10,6,216.24,214.36,215.3
2015-12-19,1610612763,1610612754,2015,96.0,84.0,180.0,98.25,97.5,92.05,92.25,28,14,14,0.5,25,16,9,0.64,8,6,10,6,193.96,187.28,190.62
2015-12-18,1610612754,1610612751,2015,104.0,97.0,201.0,92.05,92.25,96.7,98.4,24,15,9,0.625,25,7,18,0.28,9,6,6,1,187.28,196.96,192.12
2015-12-18,1610612753,1610612757,2015,102.0,94.0,196.0,96.55,103.5,104.75,105.45,25,14,11,0.56,27,11,16,0.407,8,6,6,5,203.64,209.44,206.54
2015-12-18,1610612755,1610612752,2015,97.0,107.0,204.0,97.85,106.0,101.2,97.2,27,1,26,0.037000000000000005,26,12,14,0.462,1,0,6,6,207.68,200.28,203.98000000000002
2015-12-18,1610612738,1610612737,2015,101.0,109.0,210.0,99.65,105.5,96.35,95.7,26,14,12,0.5379999999999999,27,15,12,0.556,7,7,9,6,195.08,199.44,197.26
2015-12-18,1610612748,1610612761,2015,94.0,108.0,202.0,97.25,95.5,100.6,99.2,24,15,9,0.625,27,16,11,0.593,11,4,8,8,195.0,206.0,200.5
2015-12-18,1610612741,1610612765,2015,144.0,147.0,291.0,94.0,91.0,100.85,105.95,23,15,8,0.652,27,15,12,0.556,11,4,10,5,185.44,206.0,195.72
2015-12-18,1610612750,1610612758,2015,99.0,95.0,194.0,110.05,111.2,97.75,101.5,25,9,16,0.36,25,10,15,0.4,3,6,8,2,209.4,207.08,208.24
2015-12-18,1610612759,1610612746,2015,115.0,107.0,222.0,107.75,96.55,109.85,106.5,27,22,5,0.815,26,16,10,0.615,14,8,10,6,204.12,214.36,209.24
2015-12-18,1610612742,1610612763,2015,97.0,88.0,185.0,104.45,102.7,98.25,97.5,26,14,12,0.5379999999999999,27,14,13,0.519,6,8,8,6,213.0,193.96,203.48000000000002
2015-12-18,1610612762,1610612743,2015,97.0,88.0,185.0,95.55,106.55,109.2,110.3,24,10,14,0.417,25,11,14,0.44,5,5,5,6,200.2,217.04,208.62
2015-12-18,1610612756,1610612740,2015,104.0,88.0,192.0,106.25,103.85,100.45,104.8,27,11,16,0.407,25,7,18,0.28,7,4,5,2,212.88,200.8,206.84
2015-12-18,1610612744,1610612749,2015,121.0,112.0,233.0,107.5,105.85,99.8,108.15,26,25,1,0.962,27,10,17,0.37,11,14,8,2,199.04,200.48,199.76
2015-12-17,1610612766,1610612761,2015,109.0,99.0,208.0,99.45,97.7,100.6,99.2,24,14,10,0.583,26,16,10,0.615,10,4,8,8,194.96,206.0,200.48000000000002
2015-12-17,1610612739,1610612760,2015,104.0,100.0,204.0,101.9,101.55,101.8,103.4,23,16,7,0.696,25,17,8,0.68,10,6,12,5,195.48,210.36,202.92000000000002
2015-12-17,1610612747,1610612745,2015,87.0,107.0,194.0,107.3,114.65,112.7,109.85,25,4,21,0.16,26,12,14,0.462,2,2,7,5,219.28,216.24,217.76
2015-12-16,1610612754,1610612742,2015,107.0,81.0,188.0,92.05,92.25,104.45,102.7,23,14,9,0.609,25,14,11,0.56,8,6,6,8,187.28,213.0,200.14
2015-12-16,1610612753,1610612766,2015,113.0,98.0,211.0,96.55,103.5,99.45,97.7,24,13,11,0.542,23,14,9,0.609,7,6,10,4,203.64,194.96,199.3
2015-12-16,1610612751,1610612748,2015,98.0,104.0,202.0,96.7,98.4,97.25,95.5,24,7,17,0.292,23,14,9,0.609,6,1,11,3,196.96,195.0,195.98000000000002
2015-12-16,1610612765,1610612738,2015,119.0,116.0,235.0,100.85,105.95,99.65,105.5,26,14,12,0.5379999999999999,25,14,11,0.56,9,5,7,7,206.0,195.08,200.54000000000002
2015-12-16,1610612752,1610612750,2015,107.0,102.0,209.0,101.2,97.2,110.05,111.2,25,11,14,0.44,24,9,15,0.375,5,6,3,6,200.28,209.4,204.84
2015-12-16,1610612737,1610612755,2015,127.0,106.0,233.0,96.35,95.7,97.85,106.0,26,14,12,0.5379999999999999,26,1,25,0.038,8,6,1,0,199.44,207.68,203.56
2015-12-16,1610612741,1610612763,2015,98.0,85.0,183.0,94.0,91.0,98.25,97.5,22,14,8,0.636,26,14,12,0.5379999999999999,10,4,8,6,185.44,193.96,189.7
2015-12-16,1610612760,1610612757,2015,106.0,90.0,196.0,101.8,103.4,104.75,105.45,24,16,8,0.667,26,11,15,0.423,11,5,6,5,210.36,209.44,209.9
2015-12-16,1610612759,1610612764,2015,114.0,95.0,209.0,107.75,96.55,94.7,91.35,26,21,5,0.8079999999999999,23,10,13,0.435,13,8,4,6,204.12,193.0,198.56
2015-12-16,1610612762,1610612740,2015,94.0,104.0,198.0,95.55,106.55,100.45,104.8,23,10,13,0.435,24,6,18,0.25,5,5,5,1,200.2,200.8,200.5
2015-12-16,1610612744,1610612756,2015,128.0,103.0,231.0,107.5,105.85,106.25,103.85,25,24,1,0.96,26,11,15,0.423,10,14,7,4,199.04,212.88,205.95999999999998
2015-12-16,1610612746,1610612749,2015,103.0,90.0,193.0,109.85,106.5,99.8,108.15,25,15,10,0.6,26,10,16,0.385,9,6,8,2,214.36,200.48,207.42000000000002
2015-12-15,1610612738,1610612739,2015,77.0,89.0,166.0,99.65,105.5,101.9,101.55,24,14,10,0.583,22,15,7,0.682,7,7,10,5,195.08,195.48,195.28
2015-12-15,1610612750,1610612743,2015,100.0,112.0,212.0,110.05,111.2,109.2,110.3,23,9,14,0.391,24,10,14,0.417,3,6,5,5,209.4,217.04,213.22
2015-12-15,1610612758,1610612745,2015,107.0,97.0,204.0,97.75,101.5,112.7,109.85,24,9,15,0.375,25,12,13,0.48,7,2,7,5,207.08,216.24,211.66000000000003
2015-12-15,1610612747,1610612749,2015,113.0,95.0,208.0,107.3,114.65,99.8,108.15,24,3,21,0.125,25,10,15,0.4,1,2,8,2,219.28,200.48,209.88
2015-12-14,1610612754,1610612761,2015,106.0,90.0,196.0,92.05,92.25,100.6,99.2,22,13,9,0.591,25,16,9,0.64,7,6,8,8,187.28,206.0,196.64
2015-12-14,1610612751,1610612753,2015,82.0,105.0,187.0,96.7,98.4,96.55,103.5,23,7,16,0.304,23,12,11,0.522,6,1,7,5,196.96,203.64,200.3
2015-12-14,1610612765,1610612746,2015,103.0,105.0,208.0,100.85,105.95,109.85,106.5,25,14,11,0.56,24,14,10,0.583,9,5,9,5,206.0,214.36,210.18
2015-12-14,1610612737,1610612748,2015,88.0,100.0,188.0,96.35,95.7,97.25,95.5,25,14,11,0.56,22,13,9,0.591,8,6,11,2,199.44,195.0,197.22
2015-12-14,1610612741,1610612755,2015,115.0,96.0,211.0,94.0,91.0,97.85,106.0,21,13,8,0.619,25,1,24,0.04,9,4,1,0,185.44,207.68,196.56
2015-12-14,1610612763,1610612764,2015,112.0,95.0,207.0,98.25,97.5,94.7,91.35,25,13,12,0.52,22,10,12,0.455,7,6,4,6,193.96,193.0,193.48000000000002
2015-12-14,1610612742,1610612756,2015,104.0,94.0,198.0,104.45,102.7,106.25,103.85,24,13,11,0.542,25,11,14,0.44,5,8,7,4,213.0,212.88,212.94
2015-12-14,1610612759,1610612762,2015,118.0,81.0,199.0,107.75,96.55,95.55,106.55,25,20,5,0.8,22,10,12,0.455,12,8,5,5,204.12,200.2,202.16
2015-12-14,1610612743,1610612745,2015,114.0,108.0,222.0,109.2,110.3,112.7,109.85,23,9,14,0.391,24,12,12,0.5,4,5,7,5,217.04,216.24,216.64
2015-12-14,1610612757,1610612740,2015,105.0,101.0,206.0,104.75,105.45,100.45,104.8,25,10,15,0.4,23,6,17,0.261,5,5,5,1,209.44,200.8,205.12
2015-12-13,1610612756,1610612750,2015,108.0,101.0,209.0,106.25,103.85,110.05,111.2,24,10,14,0.417,22,9,13,0.409,6,4,3,6,212.88,209.4,211.14
2015-12-13,1610612748,1610612763,2015,100.0,97.0,197.0,97.25,95.5,98.25,97.5,21,12,9,0.5710000000000001,24,13,11,0.542,10,2,7,6,195.0,193.96,194.48000000000002
2015-12-13,1610612761,1610612755,2015,96.0,76.0,172.0,100.6,99.2,97.85,106.0,24,15,9,0.625,24,1,23,0.042,7,8,1,0,206.0,207.68,206.84
2015-12-13,1610612760,1610612762,2015,104.0,98.0,202.0,101.8,103.4,95.55,106.55,23,15,8,0.652,21,10,11,0.476,10,5,5,5,210.36,200.2,205.28
2015-12-12,1610612751,1610612746,2015,100.0,105.0,205.0,96.7,98.4,109.85,106.5,22,7,15,0.318,23,13,10,0.565,6,1,9,4,196.96,214.36,205.66000000000003
2015-12-12,1610612766,1610612738,2015,93.0,98.0,191.0,99.45,97.7,99.65,105.5,22,14,8,0.636,23,13,10,0.565,10,4,7,6,194.96,195.08,195.02
2015-12-12,1610612765,1610612754,2015,118.0,96.0,214.0,100.85,105.95,92.05,92.25,24,13,11,0.542,21,13,8,0.619,8,5,7,6,206.0,187.28,196.64
2015-12-12,1610612737,1610612759,2015,78.0,103.0,181.0,96.35,95.7,107.75,96.55,24,14,10,0.583,24,19,5,0.792,8,6,12,7,199.44,204.12,201.78
2015-12-12,1610612741,1610612740,2015,98.0,94.0,192.0,94.0,91.0,100.45,104.8,20,12,8,0.6,22,6,16,0.273,8,4,5,1,185.44,200.8,193.12
2015-12-12,1610612745,1610612747,2015,126.0,97.0,223.0,112.7,109.85,107.3,114.65,23,11,12,0.478,23,3,20,0.13,6,5,1,2,216.24,219.28,217.76
2015-12-12,1610612742,1610612764,2015,111.0,114.0,225.0,104.45,102.7,94.7,91.35,23,13,10,0.565,21,9,12,0.429,5,8,4,5,213.0,193.0,203.0
2015-12-12,1610612749,1610612744,2015,108.0,95.0,203.0,99.8,108.15,107.5,105.85,24,9,15,0.375,24,24,0,1.0,7,2,10,14,200.48,199.04,199.76
2015-12-12,1610612757,1610612752,2015,110.0,112.0,222.0,104.75,105.45,101.2,97.2,24,10,14,0.417,24,10,14,0.417,5,5,5,5,209.44,200.28,204.86
2015-12-11,1610612754,1610612748,2015,96.0,83.0,179.0,92.05,92.25,97.25,95.5,20,12,8,0.6,20,12,8,0.6,6,6,10,2,187.28,195.0,191.14
2015-12-11,1610612753,1610612739,2015,76.0,111.0,187.0,96.55,103.5,101.9,101.55,22,12,10,0.545,21,14,7,0.667,7,5,10,4,203.64,195.48,199.56
2015-12-11,1610612755,1610612765,2015,95.0,107.0,202.0,97.85,106.0,100.85,105.95,23,1,22,0.043,23,12,11,0.522,1,0,8,4,207.68,206.0,206.84
2015-12-11,1610612738,1610612744,2015,119.0,124.0,243.0,99.65,105.5,107.5,105.85,22,13,9,0.591,23,23,0,1.0,7,6,10,13,195.08,199.04,197.06
2015-12-11,1610612761,1610612749,2015,90.0,83.0,173.0,100.6,99.2,99.8,108.15,23,14,9,0.609,23,9,14,0.391,6,8,7,2,206.0,200.48,203.24
2015-12-11,1610612763,1610612766,2015,99.0,123.0,222.0,98.25,97.5,99.45,97.7,23,13,10,0.565,21,13,8,0.619,7,6,10,3,193.96,194.96,194.46
2015-12-11,1610612740,1610612764,2015,107.0,105.0,212.0,100.45,104.8,94.7,91.35,21,5,16,0.238,20,9,11,0.45,4,1,4,5,200.8,193.0,196.9
2015-12-11,1610612743,1610612750,2015,111.0,108.0,219.0,109.2,110.3,110.05,111.2,22,8,14,0.364,21,9,12,0.429,3,5,3,6,217.04,209.4,213.22
2015-12-11,1610612762,1610612760,2015,90.0,94.0,184.0,95.55,106.55,101.8,103.4,20,10,10,0.5,22,14,8,0.636,5,5,10,4,200.2,210.36,205.28
2015-12-11,1610612759,1610612747,2015,109.0,87.0,196.0,107.75,96.55,107.3,114.65,23,18,5,0.7829999999999999,22,3,19,0.136,11,7,1,2,204.12,219.28,211.7
2015-12-11,1610612756,1610612757,2015,96.0,106.0,202.0,106.25,103.85,104.75,105.45,23,10,13,0.435,23,9,14,0.391,6,4,5,4,212.88,209.44,211.16
2015-12-10,1610612751,1610612755,2015,100.0,91.0,191.0,96.7,98.4,97.85,106.0,21,6,15,0.28600000000000003,22,1,21,0.045,5,1,1,0,196.96,207.68,202.32
2015-12-10,1610612741,1610612746,2015,83.0,80.0,163.0,94.0,91.0,109.85,106.5,19,11,8,0.579,22,13,9,0.591,7,4,9,4,185.44,214.36,199.9
2015-12-10,1610612760,1610612737,2015,107.0,94.0,201.0,101.8,103.4,96.35,95.7,21,13,8,0.619,23,14,9,0.609,9,4,8,6,210.36,199.44,204.9
2015-12-10,1610612758,1610612752,2015,99.0,97.0,196.0,97.75,101.5,101.2,97.2,23,8,15,0.348,23,10,13,0.435,6,2,5,5,207.08,200.28,203.68
2015-12-09,1610612738,1610612741,2015,105.0,100.0,205.0,99.65,105.5,94.0,91.0,21,12,9,0.5710000000000001,18,11,7,0.611,6,6,7,4,195.08,185.44,190.26
2015-12-09,1610612766,1610612748,2015,99.0,81.0,180.0,99.45,97.7,97.25,95.5,20,12,8,0.6,19,12,7,0.632,9,3,10,2,194.96,195.0,194.98000000000002
2015-12-09,1610612764,1610612745,2015,103.0,109.0,212.0,94.7,91.35,112.7,109.85,19,9,10,0.474,22,10,12,0.455,4,5,6,4,193.0,216.24,204.62
2015-12-09,1610612765,1610612763,2015,92.0,93.0,185.0,100.85,105.95,98.25,97.5,22,12,10,0.545,22,12,10,0.545,8,4,7,5,206.0,193.96,199.98000000000002
2015-12-09,1610612761,1610612759,2015,97.0,94.0,191.0,100.6,99.2,107.75,96.55,22,13,9,0.591,22,18,4,0.818,5,8,11,7,206.0,204.12,205.06
2015-12-09,1610612749,1610612746,2015,95.0,109.0,204.0,99.8,108.15,109.85,106.5,22,9,13,0.409,21,12,9,0.5710000000000001,7,2,9,3,200.48,214.36,207.42000000000002
2015-12-09,1610612750,1610612747,2015,123.0,122.0,245.0,110.05,111.2,107.3,114.65,20,8,12,0.4,21,3,18,0.14300000000000002,2,6,1,2,209.4,219.28,214.34
2015-12-09,1610612756,1610612753,2015,107.0,104.0,211.0,106.25,103.85,96.55,103.5,22,9,13,0.409,21,12,9,0.5710000000000001,5,4,7,5,212.88,203.64,208.26
2015-12-09,1610612762,1610612752,2015,106.0,85.0,191.0,95.55,106.55,101.2,97.2,19,9,10,0.474,22,10,12,0.455,4,5,5,5,200.2,200.28,200.24
2015-12-09,1610612742,1610612737,2015,95.0,98.0,193.0,104.45,102.7,96.35,95.7,22,13,9,0.591,22,13,9,0.591,5,8,8,5,213.0,199.44,206.22
2015-12-08,1610612739,1610612757,2015,105.0,100.0,205.0,101.9,101.55,104.75,105.45,20,13,7,0.65,22,9,13,0.409,9,4,5,4,195.48,209.44,202.45999999999998
2015-12-08,1610612754,1610612744,2015,123.0,131.0,254.0,92.05,92.25,107.5,105.85,19,12,7,0.632,22,22,0,1.0,6,6,10,12,187.28,199.04,193.16
2015-12-08,1610612751,1610612745,2015,110.0,105.0,215.0,96.7,98.4,112.7,109.85,20,5,15,0.25,21,10,11,0.476,4,1,6,4,196.96,216.24,206.60000000000002
2015-12-08,1610612763,1610612760,2015,88.0,125.0,213.0,98.25,97.5,101.8,103.4,21,12,9,0.5710000000000001,20,12,8,0.6,7,5,9,3,193.96,210.36,202.16000000000003
2015-12-08,1610612743,1610612753,2015,74.0,85.0,159.0,109.2,110.3,96.55,103.5,21,8,13,0.381,20,11,9,0.55,3,5,7,4,217.04,203.64,210.33999999999997
2015-12-08,1610612758,1610612762,2015,114.0,106.0,220.0,97.75,101.5,95.55,106.55,22,7,15,0.318,18,9,9,0.5,5,2,4,5,207.08,200.2,203.64
2015-12-07,1610612766,1610612765,2015,104.0,84.0,188.0,99.45,97.7,100.85,105.95,19,11,8,0.579,21,12,9,0.5710000000000001,8,3,8,4,194.96,206.0,200.48000000000002
2015-12-07,1610612755,1610612759,2015,68.0,119.0,187.0,97.85,106.0,107.75,96.55,21,1,20,0.048,21,17,4,0.81,1,0,11,6,207.68,204.12,205.9
2015-12-07,1610612748,1610612764,2015,103.0,114.0,217.0,97.25,95.5,94.7,91.35,18,12,6,0.667,18,8,10,0.444,10,2,4,4,195.0,193.0,194.0
2015-12-07,1610612752,1610612742,2015,97.0,104.0,201.0,101.2,97.2,104.45,102.7,21,10,11,0.476,21,12,9,0.5710000000000001,5,5,5,7,200.28,213.0,206.64
2015-12-07,1610612761,1610612747,2015,102.0,93.0,195.0,100.6,99.2,107.3,114.65,21,12,9,0.5710000000000001,20,3,17,0.15,4,8,1,2,206.0,219.28,212.64
2015-12-07,1610612741,1610612756,2015,101.0,103.0,204.0,94.0,91.0,106.25,103.85,17,11,6,0.647,21,8,13,0.381,7,4,5,3,185.44,212.88,199.16
2015-12-07,1610612749,1610612757,2015,90.0,88.0,178.0,99.8,108.15,104.75,105.45,21,8,13,0.381,21,9,12,0.429,6,2,5,4,200.48,209.44,204.95999999999998
2015-12-07,1610612750,1610612746,2015,106.0,110.0,216.0,110.05,111.2,109.85,106.5,19,8,11,0.421,20,11,9,0.55,2,6,9,2,209.4,214.36,211.88
2015-12-07,1610612740,1610612738,2015,93.0,111.0,204.0,100.45,104.8,99.65,105.5,20,5,15,0.25,20,11,9,0.55,4,1,6,5,200.8,195.08,197.94
2015-12-06,1610612763,1610612756,2015,95.0,93.0,188.0,98.25,97.5,106.25,103.85,20,11,9,0.55,20,8,12,0.4,6,5,5,3,193.96,212.88,203.42000000000002
2015-12-06,1610612751,1610612744,2015,98.0,114.0,212.0,96.7,98.4,107.5,105.85,19,5,14,0.263,21,21,0,1.0,4,1,10,11,196.96,199.04,198.0
2015-12-06,1610612765,1610612747,2015,111.0,91.0,202.0,100.85,105.95,107.3,114.65,20,11,9,0.55,19,3,16,0.158,7,4,1,2,206.0,219.28,212.64
2015-12-06,1610612764,1610612742,2015,104.0,116.0,220.0,94.7,91.35,104.45,102.7,17,8,9,0.471,20,11,9,0.55,4,4,5,6,193.0,213.0,203.0
2015-12-06,1610612760,1610612758,2015,98.0,95.0,193.0,101.8,103.4,97.75,101.5,19,11,8,0.579,21,7,14,0.333,8,3,5,2,210.36,207.08,208.72000000000003
2015-12-05,1610612755,1610612743,2015,105.0,108.0,213.0,97.85,106.0,109.2,110.3,20,1,19,0.05,20,7,13,0.35,1,0,3,4,207.68,217.04,212.36
2015-12-05,1610612761,1610612744,2015,109.0,112.0,221.0,100.6,99.2,107.5,105.85,20,12,8,0.6,20,20,0,1.0,4,8,10,10,206.0,199.04,202.51999999999998
2015-12-05,1610612748,1610612739,2015,99.0,84.0,183.0,97.25,95.5,101.9,101.55,17,11,6,0.647,19,13,6,0.684,9,2,9,4,195.0,195.48,195.24
2015-12-05,1610612741,1610612766,2015,96.0,102.0,198.0,94.0,91.0,99.45,97.7,16,11,5,0.688,18,10,8,0.556,7,4,8,2,185.44,194.96,190.2
2015-12-05,1610612745,1610612758,2015,120.0,113.0,233.0,112.7,109.85,97.75,101.5,20,9,11,0.45,20,7,13,0.35,5,4,5,2,216.24,207.08,211.66000000000003
2015-12-05,1610612750,1610612757,2015,103.0,109.0,212.0,110.05,111.2,104.75,105.45,18,8,10,0.444,20,8,12,0.4,2,6,5,3,209.4,209.44,209.42000000000002
2015-12-05,1610612749,1610612752,2015,106.0,91.0,197.0,99.8,108.15,101.2,97.2,20,7,13,0.35,20,10,10,0.5,5,2,5,5,200.48,200.28,200.38
2015-12-05,1610612759,1610612738,2015,108.0,105.0,213.0,107.75,96.55,99.65,105.5,20,16,4,0.8,19,11,8,0.579,10,6,6,5,204.12,195.08,199.60000000000002
2015-12-05,1610612762,1610612754,2015,122.0,119.0,241.0,95.55,106.55,92.05,92.25,17,8,9,0.471,18,12,6,0.667,3,5,6,6,200.2,187.28,193.74
2015-12-05,1610612746,1610612753,2015,103.0,101.0,204.0,109.85,106.5,96.55,103.5,19,10,9,0.526,19,11,8,0.579,8,2,7,4,214.36,203.64,209.0
2015-12-04,1610612752,1610612751,2015,108.0,91.0,199.0,101.2,97.2,96.7,98.4,19,9,10,0.474,18,5,13,0.278,4,5,4,1,200.28,196.96,198.62
2015-12-04,1610612764,1610612756,2015,109.0,106.0,215.0,94.7,91.35,106.25,103.85,16,7,9,0.438,19,8,11,0.421,3,4,5,3,193.0,212.88,202.94
2015-12-04,1610612765,1610612749,2015,102.0,95.0,197.0,100.85,105.95,99.8,108.15,19,10,9,0.526,19,7,12,0.368,6,4,5,2,206.0,200.48,203.24
2015-12-04,1610612737,1610612747,2015,100.0,87.0,187.0,96.35,95.7,107.3,114.65,21,12,9,0.5710000000000001,18,3,15,0.16699999999999998,7,5,1,2,199.44,219.28,209.36
2015-12-04,1610612742,1610612745,2015,96.0,100.0,196.0,104.45,102.7,112.7,109.85,19,11,8,0.579,19,8,11,0.421,5,6,5,3,213.0,216.24,214.62
2015-12-04,1610612740,1610612739,2015,114.0,108.0,222.0,100.45,104.8,101.9,101.55,19,4,15,0.211,18,13,5,0.722,3,1,9,4,200.8,195.48,198.14
2015-12-03,1610612748,1610612760,2015,97.0,95.0,192.0,97.25,95.5,101.8,103.4,16,10,6,0.625,18,11,7,0.611,8,2,8,3,195.0,210.36,202.68
2015-12-03,1610612761,1610612743,2015,105.0,106.0,211.0,100.6,99.2,109.2,110.3,19,12,7,0.632,19,6,13,0.316,4,8,3,3,206.0,217.04,211.51999999999998
2015-12-03,1610612762,1610612753,2015,94.0,103.0,197.0,95.55,106.55,96.55,103.5,16,8,8,0.5,18,10,8,0.556,3,5,7,3,200.2,203.64,201.92
2015-12-03,1610612763,1610612759,2015,83.0,103.0,186.0,98.25,97.5,107.75,96.55,19,11,8,0.579,19,15,4,0.789,6,5,10,5,193.96,204.12,199.04000000000002
2015-12-03,1610612757,1610612754,2015,123.0,111.0,234.0,104.75,105.45,92.05,92.25,19,7,12,0.368,17,12,5,0.706,4,3,6,6,209.44,187.28,198.36
2015-12-03,1610612758,1610612738,2015,97.0,114.0,211.0,97.75,101.5,99.65,105.5,19,7,12,0.368,18,10,8,0.556,5,2,6,4,207.08,195.08,201.08
2015-12-02,1610612766,1610612744,2015,99.0,116.0,215.0,99.45,97.7,107.5,105.85,17,10,7,0.588,19,19,0,1.0,8,2,10,9,194.96,199.04,197.0
2015-12-02,1610612764,1610612747,2015,104.0,108.0,212.0,94.7,91.35,107.3,114.65,15,7,8,0.467,17,2,15,0.118,3,4,1,1,193.0,219.28,206.14
2015-12-02,1610612765,1610612756,2015,127.0,122.0,249.0,100.85,105.95,106.25,103.85,18,9,9,0.5,18,8,10,0.444,5,4,5,3,206.0,212.88,209.44
2015-12-02,1610612752,1610612755,2015,99.0,87.0,186.0,101.2,97.2,97.85,106.0,18,8,10,0.444,19,1,18,0.053,3,5,1,0,200.28,207.68,203.98000000000002
2015-12-02,1610612737,1610612761,2015,86.0,96.0,182.0,96.35,95.7,100.6,99.2,20,12,8,0.6,18,11,7,0.611,7,5,4,7,199.44,206.0,202.72
2015-12-02,1610612741,1610612743,2015,99.0,90.0,189.0,94.0,91.0,109.2,110.3,15,10,5,0.667,18,6,12,0.333,6,4,3,3,185.44,217.04,201.24
2015-12-02,1610612745,1610612740,2015,108.0,101.0,209.0,112.7,109.85,100.45,104.8,18,7,11,0.389,18,4,14,0.222,4,3,3,1,216.24,200.8,208.52
2015-12-02,1610612759,1610612749,2015,95.0,70.0,165.0,107.75,96.55,99.8,108.15,18,14,4,0.778,18,7,11,0.389,9,5,5,2,204.12,200.48,202.3
2015-12-02,1610612746,1610612754,2015,91.0,103.0,194.0,109.85,106.5,92.05,92.25,18,10,8,0.556,16,11,5,0.688,8,2,6,5,214.36,187.28,200.82
2015-12-01,1610612739,1610612764,2015,85.0,97.0,182.0,101.9,101.55,94.7,91.35,17,13,4,0.765,14,6,8,0.429,9,4,3,3,195.48,193.0,194.24
2015-12-01,1610612755,1610612747,2015,103.0,91.0,194.0,97.85,106.0,107.3,114.65,18,0,18,0.0,16,2,14,0.125,0,0,1,1,207.68,219.28,213.48000000000002
2015-12-01,1610612751,1610612756,2015,94.0,91.0,185.0,96.7,98.4,106.25,103.85,17,4,13,0.235,17,8,9,0.471,3,1,5,3,196.96,212.88,204.92000000000002
2015-12-01,1610612750,1610612753,2015,93.0,96.0,189.0,110.05,111.2,96.55,103.5,17,8,9,0.471,17,9,8,0.529,2,6,7,2,209.4,203.64,206.51999999999998
2015-12-01,1610612740,1610612763,2015,104.0,113.0,217.0,100.45,104.8,98.25,97.5,17,4,13,0.235,18,10,8,0.556,3,1,6,4,200.8,193.96,197.38
2015-12-01,1610612757,1610612742,2015,112.0,115.0,227.0,104.75,105.45,104.45,102.7,18,7,11,0.389,18,10,8,0.556,4,3,5,5,209.44,213.0,211.22
2015-11-30,1610612765,1610612745,2015,116.0,105.0,221.0,100.85,105.95,112.7,109.85,17,8,9,0.471,17,7,10,0.412,4,4,4,3,206.0,216.24,211.12
2015-11-30,1610612748,1610612738,2015,95.0,105.0,200.0,97.25,95.5,99.65,105.5,15,10,5,0.667,17,9,8,0.529,8,2,6,3,195.0,195.08,195.04000000000002
2015-11-30,1610612737,1610612760,2015,106.0,100.0,206.0,96.35,95.7,101.8,103.4,19,11,8,0.579,17,11,6,0.647,6,5,8,3,199.44,210.36,204.9
2015-11-30,1610612741,1610612759,2015,92.0,89.0,181.0,94.0,91.0,107.75,96.55,14,9,5,0.643,17,14,3,0.8240000000000001,5,4,9,5,185.44,204.12,194.78
2015-11-30,1610612749,1610612743,2015,92.0,74.0,166.0,99.8,108.15,109.2,110.3,17,6,11,0.353,17,6,11,0.353,4,2,3,3,200.48,217.04,208.76
2015-11-30,1610612762,1610612744,2015,103.0,106.0,209.0,95.55,106.55,107.5,105.85,15,8,7,0.5329999999999999,18,18,0,1.0,3,5,10,8,200.2,199.04,199.62
2015-11-30,1610612758,1610612742,2015,112.0,98.0,210.0,97.75,101.5,104.45,102.7,18,6,12,0.333,17,10,7,0.588,4,2,5,5,207.08,213.0,210.04000000000002
2015-11-30,1610612746,1610612757,2015,102.0,87.0,189.0,109.85,106.5,104.75,105.45,17,9,8,0.529,17,7,10,0.412,7,2,4,3,214.36,209.44,211.9
2015-11-29,1610612766,1610612749,2015,87.0,82.0,169.0,99.45,97.7,99.8,108.15,16,9,7,0.563,16,6,10,0.375,7,2,4,2,194.96,200.48,197.72
2015-11-29,1610612746,1610612750,2015,107.0,99.0,206.0,109.85,106.5,110.05,111.2,16,8,8,0.5,16,8,8,0.5,6,2,2,6,214.36,209.4,211.88
2015-11-29,1610612751,1610612765,2015,87.0,83.0,170.0,96.7,98.4,100.85,105.95,16,3,13,0.188,16,8,8,0.5,2,1,4,4,196.96,206.0,201.48000000000002
2015-11-29,1610612753,1610612738,2015,110.0,91.0,201.0,96.55,103.5,99.65,105.5,16,8,8,0.5,16,9,7,0.563,6,2,6,3,203.64,195.08,199.36
2015-11-29,1610612761,1610612756,2015,102.0,107.0,209.0,100.6,99.2,106.25,103.85,17,11,6,0.647,16,7,9,0.438,4,7,5,2,206.0,212.88,209.44
2015-11-29,1610612763,1610612755,2015,92.0,84.0,176.0,98.25,97.5,97.85,106.0,17,9,8,0.529,17,0,17,0.0,5,4,0,0,193.96,207.68,200.82
2015-11-29,1610612752,1610612745,2015,111.0,116.0,227.0,101.2,97.2,112.7,109.85,17,8,9,0.471,16,6,10,0.375,3,5,4,2,200.28,216.24,208.26
2015-11-29,1610612747,1610612754,2015,103.0,107.0,210.0,107.3,114.65,92.05,92.25,15,2,13,0.133,15,10,5,0.667,1,1,6,4,219.28,187.28,203.28
2015-11-28,1610612764,1610612761,2015,82.0,84.0,166.0,94.7,91.35,100.6,99.2,13,6,7,0.462,16,10,6,0.625,3,3,4,6,193.0,206.0,199.5
2015-11-28,1610612739,1610612751,2015,90.0,88.0,178.0,101.9,101.55,96.7,98.4,16,12,4,0.75,15,3,12,0.2,8,4,2,1,195.48,196.96,196.22
2015-11-28,1610612742,1610612743,2015,92.0,81.0,173.0,104.45,102.7,109.2,110.3,16,9,7,0.563,16,6,10,0.375,4,5,3,3,213.0,217.04,215.01999999999998
2015-11-28,1610612759,1610612737,2015,108.0,88.0,196.0,107.75,96.55,96.35,95.7,16,13,3,0.813,18,11,7,0.611,8,5,6,5,204.12,199.44,201.78
2015-11-28,1610612762,1610612740,2015,101.0,87.0,188.0,95.55,106.55,100.45,104.8,14,7,7,0.5,16,4,12,0.25,2,5,3,1,200.2,200.8,200.5
2015-11-28,1610612757,1610612747,2015,108.0,96.0,204.0,104.75,105.45,107.3,114.65,16,6,10,0.375,14,2,12,0.14300000000000002,3,3,1,1,209.44,219.28,214.36
2015-11-28,1610612744,1610612758,2015,120.0,101.0,221.0,107.5,105.85,97.75,101.5,17,17,0,1.0,17,6,11,0.353,9,8,4,2,199.04,207.08,203.06
2015-11-27,1610612766,1610612739,2015,90.0,95.0,185.0,99.45,97.7,101.9,101.55,15,9,6,0.6,15,11,4,0.733,7,2,8,3,194.96,195.48,195.22
2015-11-27,1610612753,1610612749,2015,114.0,90.0,204.0,96.55,103.5,99.8,108.15,15,7,8,0.467,15,6,9,0.4,5,2,4,2,203.64,200.48,202.06
2015-11-27,1610612738,1610612764,2015,111.0,78.0,189.0,99.65,105.5,94.7,91.35,15,8,7,0.5329999999999999,12,6,6,0.5,5,3,3,3,195.08,193.0,194.04000000000002
2015-11-27,1610612752,1610612748,2015,78.0,97.0,175.0,101.2,97.2,97.25,95.5,16,8,8,0.5,14,9,5,0.643,3,5,8,1,200.28,195.0,197.64
2015-11-27,1610612754,1610612741,2015,104.0,92.0,196.0,92.05,92.25,94.0,91.0,14,9,5,0.643,13,9,4,0.6920000000000001,5,4,5,4,187.28,185.44,186.36
2015-11-27,1610612745,1610612755,2015,116.0,114.0,230.0,112.7,109.85,97.85,106.0,15,5,10,0.333,16,0,16,0.0,3,2,0,0,216.24,207.68,211.96
2015-11-27,1610612763,1610612737,2015,101.0,116.0,217.0,98.25,97.5,96.35,95.7,16,9,7,0.563,17,10,7,0.588,5,4,6,4,193.96,199.44,196.7
2015-11-27,1610612760,1610612765,2015,103.0,87.0,190.0,101.8,103.4,100.85,105.95,16,10,6,0.625,15,8,7,0.5329999999999999,7,3,4,4,210.36,206.0,208.18
2015-11-27,1610612743,1610612759,2015,80.0,91.0,171.0,109.2,110.3,107.75,96.55,15,6,9,0.4,15,12,3,0.8,3,3,8,4,217.04,204.12,210.57999999999998
2015-11-27,1610612756,1610612744,2015,116.0,135.0,251.0,106.25,103.85,107.5,105.85,15,7,8,0.467,16,16,0,1.0,5,2,9,7,212.88,199.04,205.95999999999998
2015-11-27,1610612758,1610612750,2015,91.0,101.0,192.0,97.75,101.5,110.05,111.2,16,6,10,0.375,15,7,8,0.467,4,2,2,5,207.08,209.4,208.24
2015-11-27,1610612746,1610612740,2015,111.0,90.0,201.0,109.85,106.5,100.45,104.8,15,7,8,0.467,15,4,11,0.267,5,2,3,1,214.36,200.8,207.58
2015-11-25,1610612766,1610612764,2015,101.0,87.0,188.0,99.45,97.7,94.7,91.35,14,8,6,0.5710000000000001,11,6,5,0.545,6,2,3,3,194.96,193.0,193.98000000000002
2015-11-25,1610612753,1610612752,2015,100.0,91.0,191.0,96.55,103.5,101.2,97.2,14,6,8,0.429,15,8,7,0.5329999999999999,4,2,3,5,203.64,200.28,201.95999999999998
2015-11-25,1610612738,1610612755,2015,84.0,80.0,164.0,99.65,105.5,97.85,106.0,14,7,7,0.5,15,0,15,0.0,4,3,0,0,195.08,207.68,201.38
2015-11-25,1610612765,1610612748,2015,104.0,81.0,185.0,100.85,105.95,97.25,95.5,14,7,7,0.5,13,9,4,0.6920000000000001,3,4,8,1,206.0,195.0,200.5
2015-11-25,1610612761,1610612739,2015,103.0,99.0,202.0,100.6,99.2,101.9,101.55,15,9,6,0.6,14,11,3,0.7859999999999999,3,6,8,3,206.0,195.48,200.74
2015-11-25,1610612745,1610612763,2015,93.0,102.0,195.0,112.7,109.85,98.25,97.5,14,5,9,0.35700000000000004,15,8,7,0.5329999999999999,3,2,5,3,216.24,193.96,205.10000000000002
2015-11-25,1610612749,1610612758,2015,118.0,129.0,247.0,99.8,108.15,97.75,101.5,14,6,8,0.429,15,5,10,0.333,4,2,4,1,200.48,207.08,203.78
2015-11-25,1610612750,1610612737,2015,99.0,95.0,194.0,110.05,111.2,96.35,95.7,14,6,8,0.429,16,10,6,0.625,1,5,6,4,209.4,199.44,204.42000000000002
2015-11-25,1610612760,1610612751,2015,110.0,99.0,209.0,101.8,103.4,96.7,98.4,15,9,6,0.6,14,3,11,0.214,6,3,2,1,210.36,196.96,203.66000000000003
2015-11-25,1610612759,1610612742,2015,88.0,83.0,171.0,107.75,96.55,104.45,102.7,14,11,3,0.7859999999999999,15,9,6,0.6,7,4,4,5,204.12,213.0,208.56
2015-11-25,1610612756,1610612740,2015,114.0,120.0,234.0,106.25,103.85,100.45,104.8,14,7,7,0.5,14,3,11,0.214,5,2,3,0,212.88,200.8,206.84
2015-11-25,1610612746,1610612762,2015,91.0,102.0,193.0,109.85,106.5,95.55,106.55,14,7,7,0.5,13,6,7,0.462,5,2,2,4,214.36,200.2,207.28
2015-11-24,1610612764,1610612754,2015,106.0,123.0,229.0,94.7,91.35,92.05,92.25,10,6,4,0.6,13,8,5,0.615,3,3,5,3,193.0,187.28,190.14
2015-11-24,1610612737,1610612738,2015,121.0,97.0,218.0,96.35,95.7,99.65,105.5,15,9,6,0.6,13,7,6,0.5379999999999999,5,4,4,3,199.44,195.08,197.26
2015-11-24,1610612763,1610612742,2015,110.0,96.0,206.0,98.25,97.5,104.45,102.7,14,7,7,0.5,14,9,5,0.643,4,3,4,5,193.96,213.0,203.48000000000002
2015-11-24,1610612743,1610612746,2015,94.0,111.0,205.0,109.2,110.3,109.85,106.5,14,6,8,0.429,13,6,7,0.462,3,3,5,1,217.04,214.36,215.7
2015-11-24,1610612757,1610612741,2015,88.0,93.0,181.0,104.75,105.45,94.0,91.0,15,6,9,0.4,12,8,4,0.667,3,3,5,3,209.44,185.44,197.44
2015-11-24,1610612744,1610612747,2015,111.0,77.0,188.0,107.5,105.85,107.3,114.65,15,15,0,1.0,13,2,11,0.154,8,7,1,1,199.04,219.28,209.16
2015-11-23,1610612766,1610612758,2015,127.0,122.0,249.0,99.45,97.7,97.75,101.5,13,7,6,0.5379999999999999,14,5,9,0.35700000000000004,5,2,4,1,194.96,207.08,201.02
2015-11-23,1610612739,1610612753,2015,117.0,103.0,220.0,101.9,101.55,96.55,103.5,13,10,3,0.769,13,6,7,0.462,7,3,4,2,195.48,203.64,199.56
2015-11-23,1610612748,1610612752,2015,95.0,78.0,173.0,97.25,95.5,101.2,97.2,12,8,4,0.667,14,8,6,0.5710000000000001,7,1,3,5,195.0,200.28,197.64
2015-11-23,1610612749,1610612765,2015,109.0,88.0,197.0,99.8,108.15,100.85,105.95,13,5,8,0.385,13,7,6,0.5379999999999999,3,2,3,4,200.48,206.0,203.24
2015-11-23,1610612750,1610612755,2015,100.0,95.0,195.0,110.05,111.2,97.85,106.0,13,5,8,0.385,14,0,14,0.0,0,5,0,0,209.4,207.68,208.54000000000002
2015-11-23,1610612759,1610612756,2015,98.0,84.0,182.0,107.75,96.55,106.25,103.85,13,10,3,0.769,13,7,6,0.5379999999999999,6,4,5,2,204.12,212.88,208.5
2015-11-23,1610612762,1610612760,2015,89.0,111.0,200.0,95.55,106.55,101.8,103.4,12,6,6,0.5,14,8,6,0.5710000000000001,2,4,6,2,200.2,210.36,205.28
2015-11-22,1610612746,1610612761,2015,80.0,91.0,171.0,109.85,106.5,100.6,99.2,12,6,6,0.5,14,8,6,0.5710000000000001,5,1,3,5,214.36,206.0,210.18
2015-11-22,1610612751,1610612738,2015,111.0,101.0,212.0,96.7,98.4,99.65,105.5,13,2,11,0.154,12,7,5,0.583,1,1,4,3,196.96,195.08,196.02
2015-11-22,1610612740,1610612756,2015,122.0,116.0,238.0,100.45,104.8,106.25,103.85,13,2,11,0.154,12,7,5,0.583,2,0,5,2,200.8,212.88,206.84
2015-11-22,1610612760,1610612742,2015,117.0,114.0,231.0,101.8,103.4,104.45,102.7,13,7,6,0.5379999999999999,13,9,4,0.6920000000000001,5,2,4,5,210.36,213.0,211.68
2015-11-22,1610612743,1610612744,2015,105.0,118.0,223.0,109.2,110.3,107.5,105.85,13,6,7,0.462,14,14,0,1.0,3,3,8,6,217.04,199.04,208.04
2015-11-22,1610612747,1610612757,2015,93.0,107.0,200.0,107.3,114.65,104.75,105.45,12,2,10,0.16699999999999998,14,5,9,0.35700000000000004,1,1,3,2,219.28,209.44,214.36
2015-11-21,1610612753,1610612758,2015,91.0,97.0,188.0,96.55,103.5,97.75,101.5,12,6,6,0.5,13,4,9,0.308,4,2,4,0,203.64,207.08,205.36
2015-11-21,1610612754,1610612749,2015,123.0,86.0,209.0,92.05,92.25,99.8,108.15,12,7,5,0.583,12,5,7,0.417,4,3,3,2,187.28,200.48,193.88
2015-11-21,1610612739,1610612737,2015,109.0,97.0,206.0,101.9,101.55,96.35,95.7,12,9,3,0.75,14,9,5,0.643,6,3,5,4,195.48,199.44,197.45999999999998
2015-11-21,1610612765,1610612764,2015,95.0,97.0,192.0,100.85,105.95,94.7,91.35,12,7,5,0.583,9,5,4,0.556,3,4,3,2,206.0,193.0,199.5
2015-11-21,1610612748,1610612755,2015,96.0,91.0,187.0,97.25,95.5,97.85,106.0,11,7,4,0.636,13,0,13,0.0,6,1,0,0,195.0,207.68,201.34
2015-11-21,1610612745,1610612752,2015,102.0,107.0,209.0,112.7,109.85,101.2,97.2,13,5,8,0.385,13,7,6,0.5379999999999999,3,2,3,4,216.24,200.28,208.26
2015-11-21,1610612759,1610612763,2015,92.0,82.0,174.0,107.75,96.55,98.25,97.5,12,9,3,0.75,13,7,6,0.5379999999999999,5,4,4,3,204.12,193.96,199.04000000000002
2015-11-20,1610612766,1610612755,2015,113.0,88.0,201.0,99.45,97.7,97.85,106.0,12,6,6,0.5,12,0,12,0.0,4,2,0,0,194.96,207.68,201.32
2015-11-20,1610612738,1610612751,2015,120.0,95.0,215.0,99.65,105.5,96.7,98.4,11,6,5,0.545,12,2,10,0.16699999999999998,3,3,1,1,195.08,196.96,196.02
2015-11-20,1610612763,1610612745,2015,96.0,84.0,180.0,98.25,97.5,112.7,109.85,12,6,6,0.5,12,5,7,0.417,3,3,3,2,193.96,216.24,205.10000000000002
2015-11-20,1610612750,1610612765,2015,86.0,96.0,182.0,110.05,111.2,100.85,105.95,12,5,7,0.417,11,6,5,0.545,0,5,3,3,209.4,206.0,207.7
2015-11-20,1610612740,1610612759,2015,104.0,90.0,194.0,100.45,104.8,107.75,96.55,12,1,11,0.083,11,9,2,0.818,1,0,5,4,200.8,204.12,202.46
2015-11-20,1610612760,1610612752,2015,90.0,93.0,183.0,101.8,103.4,101.2,97.2,12,7,5,0.583,12,6,6,0.5,5,2,3,3,210.36,200.28,205.32
2015-11-20,1610612742,1610612762,2015,102.0,93.0,195.0,104.45,102.7,95.55,106.55,12,8,4,0.667,11,6,5,0.545,3,5,2,4,213.0,200.2,206.6
2015-11-20,1610612743,1610612756,2015,107.0,114.0,221.0,109.2,110.3,106.25,103.85,12,6,6,0.5,11,6,5,0.545,3,3,5,1,217.04,212.88,214.95999999999998
2015-11-20,1610612757,1610612746,2015,102.0,91.0,193.0,104.75,105.45,109.85,106.5,13,4,9,0.308,11,6,5,0.545,2,2,5,1,209.44,214.36,211.9
2015-11-20,1610612744,1610612741,2015,106.0,94.0,200.0,107.5,105.85,94.0,91.0,13,13,0,1.0,11,8,3,0.727,7,6,5,3,199.04,185.44,192.24
2015-11-20,1610612747,1610612761,2015,91.0,102.0,193.0,107.3,114.65,100.6,99.2,11,2,9,0.182,13,7,6,0.5379999999999999,1,1,3,4,219.28,206.0,212.64
2015-11-19,1610612748,1610612758,2015,116.0,109.0,225.0,97.25,95.5,97.75,101.5,10,6,4,0.6,12,4,8,0.333,5,1,4,0,195.0,207.08,201.04000000000002
2015-11-19,1610612739,1610612749,2015,115.0,100.0,215.0,101.9,101.55,99.8,108.15,11,8,3,0.727,11,5,6,0.455,5,3,3,2,195.48,200.48,197.98
2015-11-19,1610612746,1610612744,2015,117.0,124.0,241.0,109.85,106.5,107.5,105.85,10,6,4,0.6,12,12,0,1.0,5,1,7,5,214.36,199.04,206.7
2015-11-18,1610612766,1610612751,2015,116.0,111.0,227.0,99.45,97.7,96.7,98.4,11,5,6,0.455,11,2,9,0.182,3,2,1,1,194.96,196.96,195.96
2015-11-18,1610612753,1610612750,2015,104.0,101.0,205.0,96.55,103.5,110.05,111.2,11,5,6,0.455,11,5,6,0.455,3,2,0,5,203.64,209.4,206.51999999999998
2015-11-18,1610612755,1610612754,2015,85.0,112.0,197.0,97.85,106.0,92.05,92.25,11,0,11,0.0,11,6,5,0.545,0,0,4,2,207.68,187.28,197.48000000000002
2015-11-18,1610612738,1610612742,2015,102.0,106.0,208.0,99.65,105.5,104.45,102.7,10,6,4,0.6,11,7,4,0.636,3,3,3,4,195.08,213.0,204.04000000000002
2015-11-18,1610612737,1610612758,2015,103.0,97.0,200.0,96.35,95.7,97.75,101.5,13,8,5,0.615,11,4,7,0.364,4,4,4,0,199.44,207.08,203.26
2015-11-18,1610612745,1610612757,2015,108.0,103.0,211.0,112.7,109.85,104.75,105.45,11,4,7,0.364,12,4,8,0.333,2,2,2,2,216.24,209.44,212.84
2015-11-18,1610612760,1610612740,2015,110.0,103.0,213.0,101.8,103.4,100.45,104.8,11,6,5,0.545,11,1,10,0.091,4,2,1,0,210.36,200.8,205.58
2015-11-18,1610612759,1610612743,2015,109.0,98.0,207.0,107.75,96.55,109.2,110.3,10,8,2,0.8,11,6,5,0.545,4,4,3,3,204.12,217.04,210.57999999999998
2015-11-18,1610612762,1610612761,2015,93.0,89.0,182.0,95.55,106.55,100.6,99.2,10,5,5,0.5,12,7,5,0.583,1,4,3,4,200.2,206.0,203.1
2015-11-18,1610612756,1610612741,2015,97.0,103.0,200.0,106.25,103.85,94.0,91.0,10,6,4,0.6,10,7,3,0.7,5,1,5,2,212.88,185.44,199.16
2015-11-17,1610612764,1610612749,2015,115.0,86.0,201.0,94.7,91.35,99.8,108.15,8,4,4,0.5,10,5,5,0.5,2,2,3,2,193.0,200.48,196.74
2015-11-17,1610612751,1610612737,2015,90.0,88.0,178.0,96.7,98.4,96.35,95.7,10,1,9,0.1,12,8,4,0.667,0,1,4,4,196.96,199.44,198.2
2015-11-17,1610612765,1610612739,2015,104.0,99.0,203.0,100.85,105.95,101.9,101.55,10,5,5,0.5,10,8,2,0.8,2,3,5,3,206.0,195.48,200.74
2015-11-17,1610612748,1610612750,2015,91.0,103.0,194.0,97.25,95.5,110.05,111.2,9,6,3,0.667,10,4,6,0.4,5,1,0,4,195.0,209.4,202.2
2015-11-17,1610612752,1610612766,2015,102.0,94.0,196.0,101.2,97.2,99.45,97.7,11,5,6,0.455,10,5,5,0.5,2,3,3,2,200.28,194.96,197.62
2015-11-17,1610612740,1610612743,2015,98.0,115.0,213.0,100.45,104.8,109.2,110.3,10,1,9,0.1,10,5,5,0.5,1,0,3,2,200.8,217.04,208.92000000000002
2015-11-17,1610612744,1610612761,2015,115.0,110.0,225.0,107.5,105.85,100.6,99.2,11,11,0,1.0,11,7,4,0.636,6,5,3,4,199.04,206.0,202.51999999999998
2015-11-16,1610612755,1610612742,2015,86.0,92.0,178.0,97.85,106.0,104.45,102.7,10,0,10,0.0,10,6,4,0.6,0,0,3,3,207.68,213.0,210.34
2015-11-16,1610612741,1610612754,2015,96.0,95.0,191.0,94.0,91.0,92.05,92.25,9,6,3,0.667,10,6,4,0.6,4,2,4,2,185.44,187.28,186.36
2015-11-16,1610612745,1610612738,2015,95.0,111.0,206.0,112.7,109.85,99.65,105.5,10,4,6,0.4,9,5,4,0.556,2,2,3,2,216.24,195.08,205.66000000000003
2015-11-16,1610612763,1610612760,2015,122.0,114.0,236.0,98.25,97.5,101.8,103.4,11,5,6,0.455,10,6,4,0.6,2,3,4,2,193.96,210.36,202.16000000000003
2015-11-16,1610612759,1610612757,2015,93.0,80.0,173.0,107.75,96.55,104.75,105.45,9,7,2,0.778,11,4,7,0.364,3,4,2,2,204.12,209.44,206.78
2015-11-16,1610612756,1610612747,2015,120.0,101.0,221.0,106.25,103.85,107.3,114.65,9,5,4,0.556,10,2,8,0.2,4,1,1,1,212.88,219.28,216.07999999999998
2015-11-15,1610612752,1610612740,2015,95.0,87.0,182.0,101.2,97.2,100.45,104.8,10,4,6,0.4,9,1,8,0.111,1,3,1,0,200.28,200.8,200.54000000000002
2015-11-15,1610612750,1610612763,2015,106.0,114.0,220.0,110.05,111.2,98.25,97.5,9,4,5,0.444,10,4,6,0.4,0,4,2,2,209.4,193.96,201.68
2015-11-15,1610612766,1610612757,2015,106.0,94.0,200.0,99.45,97.7,104.75,105.45,9,4,5,0.444,10,4,6,0.4,2,2,2,2,194.96,209.44,202.2
2015-11-15,1610612737,1610612762,2015,96.0,97.0,193.0,96.35,95.7,95.55,106.55,11,8,3,0.727,9,4,5,0.444,4,4,1,3,199.44,200.2,199.82
2015-11-15,1610612760,1610612738,2015,85.0,100.0,185.0,101.8,103.4,99.65,105.5,9,6,3,0.667,8,4,4,0.5,4,2,3,1,210.36,195.08,202.72000000000003
2015-11-15,1610612758,1610612761,2015,107.0,101.0,208.0,97.75,101.5,100.6,99.2,10,3,7,0.3,10,7,3,0.7,3,0,3,4,207.08,206.0,206.54000000000002
2015-11-15,1610612747,1610612765,2015,97.0,85.0,182.0,107.3,114.65,100.85,105.95,9,1,8,0.111,9,5,4,0.556,0,1,2,3,219.28,206.0,212.64
2015-11-14,1610612746,1610612765,2015,101.0,96.0,197.0,109.85,106.5,100.85,105.95,9,5,4,0.556,8,5,3,0.625,4,1,2,3,214.36,206.0,210.18
2015-11-14,1610612764,1610612753,2015,108.0,99.0,207.0,94.7,91.35,96.55,103.5,7,3,4,0.429,10,5,5,0.5,1,2,3,2,193.0,203.64,198.32
2015-11-14,1610612745,1610612742,2015,98.0,110.0,208.0,112.7,109.85,104.45,102.7,9,4,5,0.444,9,5,4,0.556,2,2,3,2,216.24,213.0,214.62
2015-11-14,1610612749,1610612739,2015,108.0,105.0,213.0,99.8,108.15,101.9,101.55,9,4,5,0.444,9,8,1,0.889,2,2,5,3,200.48,195.48,197.98
2015-11-14,1610612759,1610612755,2015,92.0,83.0,175.0,107.75,96.55,97.85,106.0,8,6,2,0.75,9,0,9,0.0,2,4,0,0,204.12,207.68,205.9
2015-11-14,1610612756,1610612743,2015,105.0,81.0,186.0,106.25,103.85,109.2,110.3,8,4,4,0.5,9,5,4,0.556,3,1,3,2,212.88,217.04,214.95999999999998
2015-11-14,1610612744,1610612751,2015,107.0,99.0,206.0,107.5,105.85,96.7,98.4,10,10,0,1.0,9,1,8,0.111,5,5,0,1,199.04,196.96,198.0
2015-11-13,1610612754,1610612750,2015,107.0,103.0,210.0,92.05,92.25,110.05,111.2,9,5,4,0.556,8,4,4,0.5,3,2,0,4,187.28,209.4,198.34
2015-11-13,1610612753,1610612762,2015,102.0,93.0,195.0,96.55,103.5,95.55,106.55,9,4,5,0.444,8,4,4,0.5,2,2,1,3,203.64,200.2,201.92
2015-11-13,1610612738,1610612737,2015,106.0,93.0,199.0,99.65,105.5,96.35,95.7,7,3,4,0.429,10,8,2,0.8,2,1,4,4,195.08,199.44,197.26
2015-11-13,1610612752,1610612739,2015,84.0,90.0,174.0,101.2,97.2,101.9,101.55,9,4,5,0.444,8,7,1,0.875,1,3,5,2,200.28,195.48,197.88
2015-11-13,1610612761,1610612740,2015,100.0,81.0,181.0,100.6,99.2,100.45,104.8,9,6,3,0.667,8,1,7,0.125,2,4,1,0,206.0,200.8,203.4
2015-11-13,1610612741,1610612766,2015,102.0,97.0,199.0,94.0,91.0,99.45,97.7,8,5,3,0.625,8,4,4,0.5,3,2,2,2,185.44,194.96,190.2
2015-11-13,1610612763,1610612757,2015,101.0,100.0,201.0,98.25,97.5,104.75,105.45,9,3,6,0.333,9,4,5,0.444,1,2,2,2,193.96,209.44,201.7
2015-11-13,1610612760,1610612755,2015,102.0,85.0,187.0,101.8,103.4,97.85,106.0,8,5,3,0.625,8,0,8,0.0,3,2,0,0,210.36,207.68,209.02
2015-11-13,1610612742,1610612747,2015,90.0,82.0,172.0,104.45,102.7,107.3,114.65,8,4,4,0.5,8,1,7,0.125,2,2,0,1,213.0,219.28,216.14
2015-11-13,1610612743,1610612745,2015,107.0,98.0,205.0,109.2,110.3,112.7,109.85,8,4,4,0.5,8,4,4,0.5,2,2,2,2,217.04,216.24,216.64
2015-11-13,1610612758,1610612751,2015,111.0,109.0,220.0,97.75,101.5,96.7,98.4,9,2,7,0.222,8,1,7,0.125,2,0,0,1,207.08,196.96,202.02
2015-11-12,1610612748,1610612762,2015,92.0,91.0,183.0,97.25,95.5,95.55,106.55,8,5,3,0.625,7,4,3,0.5710000000000001,4,1,1,3,195.0,200.2,197.6
2015-11-12,1610612750,1610612744,2015,116.0,129.0,245.0,110.05,111.2,107.5,105.85,7,4,3,0.5710000000000001,9,9,0,1.0,0,4,5,4,209.4,199.04,204.22
2015-11-12,1610612756,1610612746,2015,118.0,104.0,222.0,106.25,103.85,109.85,106.5,7,3,4,0.429,8,5,3,0.625,2,1,4,1,212.88,214.36,213.62
2015-11-11,1610612766,1610612752,2015,95.0,93.0,188.0,99.45,97.7,101.2,97.2,7,3,4,0.429,8,4,4,0.5,1,2,1,3,194.96,200.28,197.62
2015-11-11,1610612753,1610612747,2015,101.0,99.0,200.0,96.55,103.5,107.3,114.65,8,3,5,0.375,7,1,6,0.14300000000000002,1,2,0,1,203.64,219.28,211.45999999999998
2015-11-11,1610612755,1610612761,2015,103.0,119.0,222.0,97.85,106.0,100.6,99.2,7,0,7,0.0,8,5,3,0.625,0,0,2,3,207.68,206.0,206.84
2015-11-11,1610612738,1610612754,2015,91.0,102.0,193.0,99.65,105.5,92.05,92.25,6,3,3,0.5,8,4,4,0.5,2,1,3,1,195.08,187.28,191.18
2015-11-11,1610612737,1610612740,2015,106.0,98.0,204.0,96.35,95.7,100.45,104.8,9,7,2,0.778,7,1,6,0.14300000000000002,3,4,1,0,199.44,200.8,200.12
2015-11-11,1610612742,1610612746,2015,118.0,108.0,226.0,104.45,102.7,109.85,106.5,7,3,4,0.429,7,5,2,0.7140000000000001,1,2,4,1,213.0,214.36,213.68
2015-11-11,1610612745,1610612751,2015,98.0,106.0,204.0,112.7,109.85,96.7,98.4,7,4,3,0.5710000000000001,7,0,7,0.0,2,2,0,0,216.24,196.96,206.60000000000002
2015-11-11,1610612763,1610612744,2015,84.0,100.0,184.0,98.25,97.5,107.5,105.85,8,3,5,0.375,8,8,0,1.0,1,2,5,3,193.96,199.04,196.5
2015-11-11,1610612743,1610612749,2015,103.0,102.0,205.0,109.2,110.3,99.8,108.15,7,3,4,0.429,8,4,4,0.5,1,2,2,2,217.04,200.48,208.76
2015-11-11,1610612758,1610612765,2015,101.0,92.0,193.0,97.75,101.5,100.85,105.95,8,1,7,0.125,7,5,2,0.7140000000000001,1,0,2,3,207.08,206.0,206.54000000000002
2015-11-11,1610612757,1610612759,2015,101.0,113.0,214.0,104.75,105.45,107.75,96.55,8,4,4,0.5,7,5,2,0.7140000000000001,2,2,2,3,209.44,204.12,206.78
2015-11-10,1610612739,1610612762,2015,118.0,114.0,232.0,101.9,101.55,95.55,106.55,7,6,1,0.857,6,4,2,0.667,4,2,1,3,195.48,200.2,197.83999999999997
2015-11-10,1610612764,1610612760,2015,101.0,125.0,226.0,94.7,91.35,101.8,103.4,6,3,3,0.5,7,4,3,0.5710000000000001,1,2,3,1,193.0,210.36,201.68
2015-11-10,1610612748,1610612747,2015,101.0,88.0,189.0,97.25,95.5,107.3,114.65,7,4,3,0.5710000000000001,6,1,5,0.16699999999999998,3,1,0,1,195.0,219.28,207.14
2015-11-10,1610612761,1610612752,2015,109.0,111.0,220.0,100.6,99.2,101.2,97.2,7,5,2,0.7140000000000001,7,3,4,0.429,2,3,1,2,206.0,200.28,203.14
2015-11-10,1610612749,1610612738,2015,83.0,99.0,182.0,99.8,108.15,99.65,105.5,7,4,3,0.5710000000000001,5,2,3,0.4,2,2,2,0,200.48,195.08,197.78
2015-11-10,1610612750,1610612766,2015,95.0,104.0,199.0,110.05,111.2,99.45,97.7,6,4,2,0.667,6,2,4,0.333,0,4,1,1,209.4,194.96,202.18
2015-11-10,1610612740,1610612742,2015,120.0,105.0,225.0,100.45,104.8,104.45,102.7,6,0,6,0.0,6,3,3,0.5,0,0,1,2,200.8,213.0,206.9
2015-11-09,1610612754,1610612753,2015,97.0,84.0,181.0,92.05,92.25,96.55,103.5,7,3,4,0.429,7,3,4,0.429,2,1,1,2,187.28,203.64,195.45999999999998
2015-11-09,1610612755,1610612741,2015,88.0,111.0,199.0,97.85,106.0,94.0,91.0,6,0,6,0.0,7,4,3,0.5710000000000001,0,0,3,1,207.68,185.44,196.56
2015-11-09,1610612737,1610612750,2015,107.0,117.0,224.0,96.35,95.7,110.05,111.2,8,7,1,0.875,5,3,2,0.6,3,4,0,3,199.44,209.4,204.42000000000002
2015-11-09,1610612743,1610612757,2015,108.0,104.0,212.0,109.2,110.3,104.75,105.45,6,2,4,0.333,7,4,3,0.5710000000000001,0,2,2,2,217.04,209.44,213.24
2015-11-09,1610612758,1610612759,2015,88.0,106.0,194.0,97.75,101.5,107.75,96.55,7,1,6,0.14300000000000002,6,4,2,0.667,1,0,2,2,207.08,204.12,205.60000000000002
2015-11-09,1610612744,1610612765,2015,109.0,95.0,204.0,107.5,105.85,100.85,105.95,7,7,0,1.0,6,5,1,0.833,4,3,2,3,199.04,206.0,202.51999999999998
2015-11-09,1610612746,1610612763,2015,94.0,92.0,186.0,109.85,106.5,98.25,97.5,6,4,2,0.667,7,3,4,0.429,3,1,1,2,214.36,193.96,204.16000000000003
2015-11-08,1610612739,1610612754,2015,101.0,97.0,198.0,101.9,101.55,92.05,92.25,6,5,1,0.833,6,3,3,0.5,3,2,2,1,195.48,187.28,191.38
2015-11-08,1610612752,1610612747,2015,99.0,95.0,194.0,101.2,97.2,107.3,114.65,6,2,4,0.333,5,1,4,0.2,0,2,0,1,200.28,219.28,209.78
2015-11-08,1610612748,1610612761,2015,96.0,76.0,172.0,97.25,95.5,100.6,99.2,6,3,3,0.5,6,5,1,0.833,2,1,2,3,195.0,206.0,200.5
2015-11-08,1610612760,1610612756,2015,124.0,103.0,227.0,101.8,103.4,106.25,103.85,6,3,3,0.5,6,3,3,0.5,2,1,2,1,210.36,212.88,211.62
2015-11-08,1610612757,1610612765,2015,103.0,120.0,223.0,104.75,105.45,100.85,105.95,6,4,2,0.667,5,4,1,0.8,2,2,2,2,209.44,206.0,207.72
2015-11-07,1610612741,1610612750,2015,93.0,102.0,195.0,94.0,91.0,110.05,111.2,6,4,2,0.667,4,2,2,0.5,3,1,0,2,185.44,209.4,197.42000000000002
2015-11-07,1610612755,1610612753,2015,97.0,105.0,202.0,97.85,106.0,96.55,103.5,5,0,5,0.0,6,2,4,0.333,0,0,1,1,207.68,203.64,205.66
2015-11-07,1610612737,1610612764,2015,114.0,99.0,213.0,96.35,95.7,94.7,91.35,7,6,1,0.857,5,3,2,0.6,2,4,1,2,199.44,193.0,196.22
2015-11-07,1610612742,1610612740,2015,107.0,98.0,205.0,104.45,102.7,100.45,104.8,5,2,3,0.4,5,0,5,0.0,0,2,0,0,213.0,200.8,206.9
2015-11-07,1610612749,1610612751,2015,94.0,86.0,180.0,99.8,108.15,96.7,98.4,6,3,3,0.5,6,0,6,0.0,1,2,0,0,200.48,196.96,198.72
2015-11-07,1610612759,1610612766,2015,114.0,94.0,208.0,107.75,96.55,99.45,97.7,5,3,2,0.6,5,2,3,0.4,1,2,1,1,204.12,194.96,199.54000000000002
2015-11-07,1610612762,1610612763,2015,89.0,79.0,168.0,95.55,106.55,98.25,97.5,5,3,2,0.6,6,3,3,0.5,0,3,1,2,200.2,193.96,197.07999999999998
2015-11-07,1610612758,1610612744,2015,94.0,103.0,197.0,97.75,101.5,107.5,105.85,6,1,5,0.16699999999999998,6,6,0,1.0,1,0,4,2,207.08,199.04,203.06
2015-11-07,1610612746,1610612745,2015,105.0,109.0,214.0,109.85,106.5,112.7,109.85,5,4,1,0.8,6,3,3,0.5,3,1,2,1,214.36,216.24,215.3
2015-11-06,1610612753,1610612761,2015,92.0,87.0,179.0,96.55,103.5,100.6,99.2,5,1,4,0.2,5,5,0,1.0,0,1,2,3,203.64,206.0,204.82
2015-11-06,1610612738,1610612764,2015,118.0,98.0,216.0,99.65,105.5,94.7,91.35,4,1,3,0.25,4,3,1,0.75,1,0,1,2,195.08,193.0,194.04000000000002
2015-11-06,1610612751,1610612747,2015,98.0,104.0,202.0,96.7,98.4,107.3,114.65,5,0,5,0.0,4,0,4,0.0,0,0,0,0,196.96,219.28,208.12
2015-11-06,1610612739,1610612755,2015,108.0,102.0,210.0,101.9,101.55,97.85,106.0,5,4,1,0.8,4,0,4,0.0,2,2,0,0,195.48,207.68,201.57999999999998
2015-11-06,1610612752,1610612749,2015,92.0,99.0,191.0,101.2,97.2,99.8,108.15,5,2,3,0.4,5,2,3,0.4,0,2,1,1,200.28,200.48,200.38
2015-11-06,1610612754,1610612748,2015,90.0,87.0,177.0,92.05,92.25,97.25,95.5,5,2,3,0.4,5,3,2,0.6,1,1,2,1,187.28,195.0,191.14
2015-11-06,1610612740,1610612737,2015,115.0,121.0,236.0,100.45,104.8,96.35,95.7,4,0,4,0.0,6,5,1,0.833,0,0,2,3,200.8,199.44,200.12
2015-11-06,1610612756,1610612765,2015,92.0,100.0,192.0,106.25,103.85,100.85,105.95,5,3,2,0.6,4,3,1,0.75,2,1,2,1,212.88,206.0,209.44
2015-11-06,1610612744,1610612743,2015,119.0,104.0,223.0,107.5,105.85,109.2,110.3,5,5,0,1.0,5,2,3,0.4,3,2,0,2,199.04,217.04,208.04
2015-11-06,1610612758,1610612745,2015,110.0,116.0,226.0,97.75,101.5,112.7,109.85,5,1,4,0.2,5,2,3,0.4,1,0,2,0,207.08,216.24,211.66000000000003
2015-11-05,1610612741,1610612760,2015,104.0,98.0,202.0,94.0,91.0,101.8,103.4,5,3,2,0.6,5,3,2,0.6,2,1,2,1,185.44,210.36,197.9
2015-11-05,1610612750,1610612748,2015,84.0,96.0,180.0,110.05,111.2,97.25,95.5,3,2,1,0.667,4,2,2,0.5,0,2,2,0,209.4,195.0,202.2
2015-11-05,1610612742,1610612766,2015,94.0,108.0,202.0,104.45,102.7,99.45,97.7,4,2,2,0.5,4,1,3,0.25,0,2,1,0,213.0,194.96,203.98000000000002
2015-11-05,1610612743,1610612762,2015,84.0,96.0,180.0,109.2,110.3,95.55,106.55,4,2,2,0.5,4,2,2,0.5,0,2,0,2,217.04,200.2,208.62
2015-11-05,1610612757,1610612763,2015,115.0,96.0,211.0,104.75,105.45,98.25,97.5,5,3,2,0.6,5,3,2,0.6,1,2,1,2,209.44,193.96,201.7
2015-11-04,1610612754,1610612738,2015,100.0,98.0,198.0,92.05,92.25,99.65,105.5,4,1,3,0.25,3,1,2,0.333,0,1,1,0,187.28,195.08,191.18
2015-11-04,1610612764,1610612759,2015,102.0,99.0,201.0,94.7,91.35,107.75,96.55,3,2,1,0.667,4,3,1,0.75,0,2,1,2,193.0,204.12,198.56
2015-11-04,1610612737,1610612751,2015,101.0,87.0,188.0,96.35,95.7,96.7,98.4,5,4,1,0.8,4,0,4,0.0,1,3,0,0,199.44,196.96,198.2
2015-11-04,1610612739,1610612752,2015,96.0,86.0,182.0,101.9,101.55,101.2,97.2,4,3,1,0.75,4,2,2,0.5,1,2,0,2,195.48,200.28,197.88
2015-11-04,1610612745,1610612753,2015,119.0,114.0,233.0,112.7,109.85,96.55,103.5,4,1,3,0.25,4,1,3,0.25,1,0,0,1,216.24,203.64,209.94
2015-11-04,1610612749,1610612755,2015,91.0,87.0,178.0,99.8,108.15,97.85,106.0,4,1,3,0.25,3,0,3,0.0,0,1,0,0,200.48,207.68,204.07999999999998
2015-11-04,1610612760,1610612761,2015,98.0,103.0,201.0,101.8,103.4,100.6,99.2,4,3,1,0.75,4,4,0,1.0,2,1,2,2,210.36,206.0,208.18
2015-11-04,1610612756,1610612758,2015,118.0,97.0,215.0,106.25,103.85,97.75,101.5,4,2,2,0.5,4,1,3,0.25,1,1,1,0,212.88,207.08,209.98000000000002
2015-11-04,1610612762,1610612757,2015,92.0,108.0,200.0,95.55,106.55,104.75,105.45,3,2,1,0.667,4,2,2,0.5,0,2,1,1,200.2,209.44,204.82
2015-11-04,1610612744,1610612746,2015,112.0,108.0,220.0,107.5,105.85,109.85,106.5,4,4,0,1.0,4,4,0,1.0,2,2,3,1,199.04,214.36,206.7
2015-11-03,1610612766,1610612741,2015,130.0,105.0,235.0,99.45,97.7,94.0,91.0,3,0,3,0.0,4,3,1,0.75,0,0,2,1,194.96,185.44,190.2
2015-11-03,1610612765,1610612754,2015,82.0,94.0,176.0,100.85,105.95,92.05,92.25,3,3,0,1.0,3,0,3,0.0,2,1,0,0,206.0,187.28,196.64
2015-11-03,1610612748,1610612737,2015,92.0,98.0,190.0,97.25,95.5,96.35,95.7,3,2,1,0.667,4,3,1,0.75,2,0,1,2,195.0,199.44,197.22
2015-11-03,1610612740,1610612753,2015,94.0,103.0,197.0,100.45,104.8,96.55,103.5,3,0,3,0.0,3,0,3,0.0,0,0,0,0,200.8,203.64,202.22
2015-11-03,1610612742,1610612761,2015,91.0,102.0,193.0,104.45,102.7,100.6,99.2,3,2,1,0.667,3,3,0,1.0,0,2,2,1,213.0,206.0,209.5
2015-11-03,1610612758,1610612763,2015,89.0,103.0,192.0,97.75,101.5,98.25,97.5,3,1,2,0.333,4,2,2,0.5,1,0,1,1,207.08,193.96,200.52
2015-11-03,1610612747,1610612743,2015,109.0,120.0,229.0,107.3,114.65,109.2,110.3,3,0,3,0.0,3,1,2,0.333,0,0,0,1,219.28,217.04,218.16
2015-11-02,1610612755,1610612739,2015,100.0,107.0,207.0,97.85,106.0,101.9,101.55,2,0,2,0.0,3,2,1,0.667,0,0,1,1,207.68,195.48,201.57999999999998
2015-11-02,1610612751,1610612749,2015,96.0,103.0,199.0,96.7,98.4,99.8,108.15,3,0,3,0.0,3,0,3,0.0,0,0,0,0,196.96,200.48,198.72
2015-11-02,1610612752,1610612759,2015,84.0,94.0,178.0,101.2,97.2,107.75,96.55,3,2,1,0.667,3,2,1,0.667,0,2,1,1,200.28,204.12,202.2
2015-11-02,1610612745,1610612760,2015,110.0,105.0,215.0,112.7,109.85,101.8,103.4,3,0,3,0.0,3,3,0,1.0,0,0,2,1,216.24,210.36,213.3
2015-11-02,1610612750,1610612757,2015,101.0,106.0,207.0,110.05,111.2,104.75,105.45,2,2,0,1.0,3,1,2,0.333,0,2,1,0,209.4,209.44,209.42000000000002
2015-11-02,1610612744,1610612763,2015,119.0,69.0,188.0,107.5,105.85,98.25,97.5,3,3,0,1.0,3,2,1,0.667,1,2,1,1,199.04,193.96,196.5
2015-11-02,1610612746,1610612756,2015,102.0,96.0,198.0,109.85,106.5,106.25,103.85,3,3,0,1.0,3,2,1,0.667,2,1,1,1,214.36,212.88,213.62
2015-11-01,1610612766,1610612737,2015,92.0,94.0,186.0,99.45,97.7,96.35,95.7,2,0,2,0.0,3,2,1,0.667,0,0,1,1,194.96,199.44,197.2
2015-11-01,1610612738,1610612759,2015,87.0,95.0,182.0,99.65,105.5,107.75,96.55,2,1,1,0.5,2,1,1,0.5,1,0,1,0,195.08,204.12,199.60000000000002
2015-11-01,1610612748,1610612745,2015,109.0,89.0,198.0,97.25,95.5,112.7,109.85,2,1,1,0.5,2,0,2,0.0,1,0,0,0,195.0,216.24,205.62
2015-11-01,1610612761,1610612749,2015,106.0,87.0,193.0,100.6,99.2,99.8,108.15,2,2,0,1.0,2,0,2,0.0,1,1,0,0,206.0,200.48,203.24
2015-11-01,1610612741,1610612753,2015,92.0,87.0,179.0,94.0,91.0,96.55,103.5,3,2,1,0.667,2,0,2,0.0,1,1,0,0,185.44,203.64,194.54
2015-11-01,1610612760,1610612743,2015,117.0,93.0,210.0,101.8,103.4,109.2,110.3,2,2,0,1.0,2,1,1,0.5,1,1,0,1,210.36,217.04,213.7
2015-11-01,1610612747,1610612742,2015,93.0,103.0,196.0,107.3,114.65,104.45,102.7,2,0,2,0.0,2,1,1,0.5,0,0,0,1,219.28,213.0,216.14
2015-10-31,1610612754,1610612762,2015,76.0,97.0,173.0,92.05,92.25,95.55,106.55,2,0,2,0.0,2,1,1,0.5,0,0,0,1,187.28,200.2,193.74
2015-10-31,1610612764,1610612752,2015,110.0,117.0,227.0,94.7,91.35,101.2,97.2,2,2,0,1.0,2,1,1,0.5,0,2,0,1,193.0,200.28,196.64
2015-10-31,1610612740,1610612744,2015,120.0,134.0,254.0,100.45,104.8,107.5,105.85,2,0,2,0.0,2,2,0,1.0,0,0,1,1,200.8,199.04,199.92000000000002
2015-10-31,1610612763,1610612751,2015,101.0,91.0,192.0,98.25,97.5,96.7,98.4,2,1,1,0.5,2,0,2,0.0,0,1,0,0,193.96,196.96,195.46
2015-10-31,1610612757,1610612756,2015,90.0,101.0,191.0,104.75,105.45,106.25,103.85,2,1,1,0.5,2,1,1,0.5,1,0,1,0,209.44,212.88,211.16
2015-10-31,1610612746,1610612758,2015,114.0,109.0,223.0,109.85,106.5,97.75,101.5,2,2,0,1.0,2,1,1,0.5,1,1,1,0,214.36,207.08,210.72000000000003
2015-10-30,1610612739,1610612748,2015,102.0,92.0,194.0,101.9,101.55,97.25,95.5,2,1,1,0.5,1,1,0,1.0,0,1,1,0,195.48,195.0,195.24
2015-10-30,1610612753,1610612760,2015,136.0,139.0,275.0,96.55,103.5,101.8,103.4,1,0,1,0.0,1,1,0,1.0,0,0,1,0,203.64,210.36,207.0
2015-10-30,1610612755,1610612762,2015,71.0,99.0,170.0,97.85,106.0,95.55,106.55,1,0,1,0.0,1,0,1,0.0,0,0,0,0,207.68,200.2,203.94
2015-10-30,1610612738,1610612761,2015,103.0,113.0,216.0,99.65,105.5,100.6,99.2,1,1,0,1.0,1,1,0,1.0,1,0,1,0,195.08,206.0,200.54000000000002
2015-10-30,1610612765,1610612741,2015,98.0,94.0,192.0,100.85,105.95,94.0,91.0,2,2,0,1.0,2,2,0,1.0,1,1,1,1,206.0,185.44,195.72
2015-10-30,1610612737,1610612766,2015,97.0,94.0,191.0,96.35,95.7,99.45,97.7,2,1,1,0.5,1,0,1,0.0,0,1,0,0,199.44,194.96,197.2
2015-10-30,1610612749,1610612764,2015,113.0,118.0,231.0,99.8,108.15,94.7,91.35,1,0,1,0.0,1,1,0,1.0,0,0,0,1,200.48,193.0,196.74
2015-10-30,1610612759,1610612751,2015,102.0,75.0,177.0,107.75,96.55,96.7,98.4,1,0,1,0.0,1,0,1,0.0,0,0,0,0,204.12,196.96,200.54000000000002
2015-10-30,1610612743,1610612750,2015,78.0,95.0,173.0,109.2,110.3,110.05,111.2,1,1,0,1.0,1,1,0,1.0,0,1,0,1,217.04,209.4,213.22
2015-10-30,1610612745,1610612744,2015,92.0,112.0,204.0,112.7,109.85,107.5,105.85,1,0,1,0.0,1,1,0,1.0,0,0,1,0,216.24,199.04,207.64
2015-10-30,1610612758,1610612747,2015,132.0,114.0,246.0,97.75,101.5,107.3,114.65,1,0,1,0.0,1,0,1,0.0,0,0,0,0,207.08,219.28,213.18
2015-10-30,1610612756,1610612757,2015,110.0,92.0,202.0,106.25,103.85,104.75,105.45,1,0,1,0.0,1,1,0,1.0,0,0,1,0,212.88,209.44,211.16
2015-10-29,1610612754,1610612763,2015,103.0,112.0,215.0,92.05,92.25,98.25,97.5,1,0,1,0.0,1,0,1,0.0,0,0,0,0,187.28,193.96,190.62
2015-10-29,1610612752,1610612737,2015,101.0,112.0,213.0,101.2,97.2,96.35,95.7,1,1,0,1.0,1,0,1,0.0,0,1,0,0,200.28,199.44,199.86
2015-10-29,1610612746,1610612742,2015,104.0,88.0,192.0,109.85,106.5,104.45,102.7,1,1,0,1.0,1,1,0,1.0,0,1,0,1,214.36,213.0,213.68
2015-10-28,1610612753,1610612764,2015,87.0,88.0,175.0,96.55,103.5,94.7,91.35,0,0,0,0.0,0,0,0,0.0,0,0,0,0,203.64,193.0,198.32
2015-10-28,1610612738,1610612755,2015,112.0,95.0,207.0,99.65,105.5,97.85,106.0,0,0,0,0.0,0,0,0,0.0,0,0,0,0,195.08,207.68,201.38
2015-10-28,1610612751,1610612741,2015,100.0,115.0,215.0,96.7,98.4,94.0,91.0,0,0,0,0.0,1,1,0,1.0,0,0,1,0,196.96,185.44,191.2
2015-10-28,1610612765,1610612762,2015,92.0,87.0,179.0,100.85,105.95,95.55,106.55,1,1,0,1.0,0,0,0,0.0,0,1,0,0,206.0,200.2,203.1
2015-10-28,1610612748,1610612766,2015,104.0,94.0,198.0,97.25,95.5,99.45,97.7,0,0,0,0.0,0,0,0,0.0,0,0,0,0,195.0,194.96,194.98000000000002
2015-10-28,1610612761,1610612754,2015,106.0,99.0,205.0,100.6,99.2,92.05,92.25,0,0,0,0.0,0,0,0,0.0,0,0,0,0,206.0,187.28,196.64
2015-10-28,1610612745,1610612743,2015,85.0,105.0,190.0,112.7,109.85,109.2,110.3,0,0,0,0.0,0,0,0,0.0,0,0,0,0,216.24,217.04,216.64
2015-10-28,1610612763,1610612739,2015,76.0,106.0,182.0,98.25,97.5,101.9,101.55,0,0,0,0.0,1,0,1,0.0,0,0,0,0,193.96,195.48,194.72
2015-10-28,1610612749,1610612752,2015,97.0,122.0,219.0,99.8,108.15,101.2,97.2,0,0,0,0.0,0,0,0,0.0,0,0,0,0,200.48,200.28,200.38
2015-10-28,1610612760,1610612759,2015,112.0,106.0,218.0,101.8,103.4,107.75,96.55,0,0,0,0.0,0,0,0,0.0,0,0,0,0,210.36,204.12,207.24
2015-10-28,1610612756,1610612742,2015,95.0,111.0,206.0,106.25,103.85,104.45,102.7,0,0,0,0.0,0,0,0,0.0,0,0,0,0,212.88,213.0,212.94
2015-10-28,1610612757,1610612740,2015,112.0,94.0,206.0,104.75,105.45,100.45,104.8,0,0,0,0.0,1,0,1,0.0,0,0,0,0,209.44,200.8,205.12
2015-10-28,1610612758,1610612746,2015,104.0,111.0,215.0,97.75,101.5,109.85,106.5,0,0,0,0.0,0,0,0,0.0,0,0,0,0,207.08,214.36,210.72000000000003
2015-10-28,1610612747,1610612750,2015,111.0,112.0,223.0,107.3,114.65,110.05,111.2,0,0,0,0.0,0,0,0,0.0,0,0,0,0,219.28,209.4,214.34
2015-10-27,1610612737,1610612765,2015,94.0,106.0,200.0,96.35,95.7,100.85,105.95,7,4,3,0.5710000000000001,8,3,5,0.375,1,3,1,2,199.44,206.0,202.72
2015-10-27,1610612741,1610612739,2015,97.0,95.0,192.0,94.0,91.0,101.9,101.55,8,4,4,0.5,7,1,6,0.14300000000000002,3,1,1,0,185.44,195.48,190.45999999999998
2015-10-27,1610612744,1610612740,2015,111.0,95.0,206.0,107.5,105.85,100.45,104.8,7,3,4,0.429,7,3,4,0.429,2,1,1,2,199.04,200.8,199.92000000000002
2015-10-23,1610612753,1610612763,2015,86.0,76.0,162.0,96.55,103.5,98.25,97.5,7,5,2,0.7140000000000001,6,6,0,1.0,2,3,4,2,203.64,193.96,198.8
2015-10-23,1610612738,1610612755,2015,81.0,65.0,146.0,99.65,105.5,97.85,106.0,6,5,1,0.833,6,2,4,0.333,2,3,2,0,195.08,207.68,201.38
2015-10-23,1610612761,1610612764,2015,92.0,82.0,174.0,100.6,99.2,94.7,91.35,6,4,2,0.667,6,4,2,0.667,3,1,2,2,206.0,193.0,199.5
2015-10-23,1610612765,1610612737,2015,115.0,87.0,202.0,100.85,105.95,96.35,95.7,7,2,5,0.28600000000000003,6,4,2,0.667,0,2,1,3,206.0,199.44,202.72
2015-10-23,1610612741,1610612742,2015,103.0,102.0,205.0,94.0,91.0,104.45,102.7,7,3,4,0.429,6,0,6,0.0,2,1,0,0,185.44,213.0,199.22
2015-10-23,1610612740,1610612748,2015,93.0,90.0,183.0,100.45,104.8,97.25,95.5,6,2,4,0.333,7,4,3,0.5710000000000001,0,2,2,2,200.8,195.0,197.9
2015-10-23,1610612750,1610612749,2015,112.0,108.0,220.0,110.05,111.2,99.8,108.15,6,1,5,0.16699999999999998,5,2,3,0.4,1,0,1,1,209.4,200.48,204.94
2015-10-23,1610612759,1610612745,2015,111.0,86.0,197.0,107.75,96.55,112.7,109.85,5,1,4,0.2,7,3,4,0.429,1,0,2,1,204.12,216.24,210.18
2015-10-22,1610612754,1610612766,2015,98.0,86.0,184.0,92.05,92.25,99.45,97.7,6,4,2,0.667,7,7,0,1.0,2,2,3,4,187.28,194.96,191.12
2015-10-22,1610612738,1610612752,2015,99.0,85.0,184.0,99.65,105.5,101.2,97.2,5,4,1,0.8,5,4,1,0.8,1,3,3,1,195.08,200.28,197.68
2015-10-22,1610612762,1610612743,2015,98.0,78.0,176.0,95.55,106.55,109.2,110.3,6,2,4,0.333,6,4,2,0.667,0,2,2,2,200.2,217.04,208.62
2015-10-22,1610612747,1610612744,2015,97.0,136.0,233.0,107.3,114.65,107.5,105.85,7,3,4,0.429,6,2,4,0.333,3,0,2,0,219.28,199.04,209.16
2015-10-22,1610612746,1610612757,2015,115.0,109.0,224.0,109.85,106.5,104.75,105.45,5,2,3,0.4,6,3,3,0.5,2,0,2,1,214.36,209.44,211.9
2015-10-21,1610612753,1610612740,2015,110.0,107.0,217.0,96.55,103.5,100.45,104.8,6,4,2,0.667,5,2,3,0.4,1,3,0,2,203.64,200.8,202.22
2015-10-21,1610612765,1610612766,2015,94.0,99.0,193.0,100.85,105.95,99.45,97.7,6,2,4,0.333,6,6,0,1.0,0,2,3,3,206.0,194.96,200.48000000000002
2015-10-21,1610612737,1610612763,2015,81.0,82.0,163.0,96.35,95.7,98.25,97.5,5,4,1,0.8,5,5,0,1.0,1,3,4,1,199.44,193.96,196.7
2015-10-21,1610612748,1610612764,2015,110.0,105.0,215.0,97.25,95.5,94.7,91.35,6,3,3,0.5,5,4,1,0.8,1,2,2,2,195.0,193.0,194.0
2015-10-21,1610612742,1610612756,2015,87.0,99.0,186.0,104.45,102.7,106.25,103.85,5,0,5,0.0,5,3,2,0.6,0,0,2,1,213.0,212.88,212.94
2015-10-20,1610612741,1610612754,2015,103.0,94.0,197.0,94.0,91.0,92.05,92.25,6,2,4,0.333,5,4,1,0.8,1,1,2,2,185.44,187.28,186.36
2015-10-20,1610612749,1610612750,2015,106.0,88.0,194.0,99.8,108.15,110.05,111.2,4,1,3,0.25,5,1,4,0.2,0,1,1,0,200.48,209.4,204.94
2015-10-20,1610612759,1610612756,2015,84.0,104.0,188.0,107.75,96.55,106.25,103.85,4,1,3,0.25,4,2,2,0.5,1,0,2,0,204.12,212.88,208.5
2015-10-20,1610612762,1610612760,2015,102.0,113.0,215.0,95.55,106.55,101.8,103.4,5,2,3,0.4,5,4,1,0.8,0,2,3,1,200.2,210.36,205.28
2015-10-20,1610612746,1610612744,2015,130.0,95.0,225.0,109.85,106.5,107.5,105.85,4,1,3,0.25,5,2,3,0.4,1,0,2,0,214.36,199.04,206.7
2015-10-19,1610612766,1610612741,2015,94.0,86.0,180.0,99.45,97.7,94.0,91.0,5,5,0,1.0,5,2,3,0.4,2,3,1,1,194.96,185.44,190.2
2015-10-19,1610612739,1610612742,2015,103.0,97.0,200.0,101.9,101.55,104.45,102.7,6,0,6,0.0,4,0,4,0.0,0,0,0,0,195.48,213.0,204.24
2015-10-19,1610612738,1610612751,2015,111.0,105.0,216.0,99.65,105.5,96.7,98.4,4,3,1,0.75,5,2,3,0.4,0,3,1,1,195.08,196.96,196.02
2015-10-19,1610612745,1610612740,2015,120.0,100.0,220.0,112.7,109.85,100.45,104.8,6,2,4,0.333,4,2,2,0.5,1,1,0,2,216.24,200.8,208.52
2015-10-19,1610612747,1610612757,2015,104.0,102.0,206.0,107.3,114.65,104.75,105.45,6,2,4,0.333,5,3,2,0.6,2,0,2,1,219.28,209.44,214.36
2015-10-18,1610612751,1610612755,2015,92.0,91.0,183.0,96.7,98.4,97.85,106.0,4,1,3,0.25,5,2,3,0.4,0,1,2,0,196.96,207.68,202.32
2015-10-18,1610612759,1610612765,2015,96.0,92.0,188.0,107.75,96.55,100.85,105.95,3,0,3,0.0,5,2,3,0.4,0,0,0,2,204.12,206.0,205.06
2015-10-18,1610612763,1610612750,2015,90.0,68.0,158.0,98.25,97.5,110.05,111.2,4,4,0,1.0,4,1,3,0.25,3,1,1,0,193.96,209.4,201.68
2015-10-18,1610612761,1610612739,2015,87.0,81.0,168.0,100.6,99.2,101.9,101.55,5,3,2,0.6,5,0,5,0.0,2,1,0,0,206.0,195.48,200.74
2015-10-18,1610612760,1610612743,2015,111.0,98.0,209.0,101.8,103.4,109.2,110.3,4,3,1,0.75,5,4,1,0.8,2,1,2,2,210.36,217.04,213.7
2015-10-18,1610612737,1610612748,2015,92.0,101.0,193.0,96.35,95.7,97.25,95.5,4,4,0,1.0,5,2,3,0.4,1,3,1,1,199.44,195.0,197.22
2015-10-18,1610612757,1610612762,2015,116.0,111.0,227.0,104.75,105.45,95.55,106.55,4,2,2,0.5,4,2,2,0.5,1,1,0,2,209.44,200.2,204.82
2015-10-17,1610612766,1610612752,2015,97.0,93.0,190.0,99.45,97.7,101.2,97.2,4,4,0,1.0,4,4,0,1.0,1,3,3,1,194.96,200.28,197.62
2015-10-17,1610612740,1610612758,2015,98.0,107.0,205.0,100.45,104.8,97.75,101.5,3,2,1,0.667,5,4,1,0.8,0,2,2,2,200.8,207.08,203.94
2015-10-17,1610612745,1610612748,2015,100.0,105.0,205.0,112.7,109.85,97.25,95.5,5,2,3,0.4,4,1,3,0.25,1,1,1,0,216.24,195.0,205.62
2015-10-17,1610612749,1610612764,2015,101.0,105.0,206.0,99.8,108.15,94.7,91.35,3,1,2,0.333,4,3,1,0.75,0,1,2,1,200.48,193.0,196.74
2015-10-17,1610612747,1610612744,2015,85.0,70.0,155.0,107.3,114.65,107.5,105.85,5,1,4,0.2,4,2,2,0.5,1,0,2,0,219.28,199.04,209.16
2015-10-16,1610612755,1610612764,2015,118.0,127.0,245.0,97.85,106.0,94.7,91.35,4,2,2,0.5,3,2,1,0.667,2,0,2,0,207.68,193.0,200.34
2015-10-16,1610612752,1610612738,2015,101.0,95.0,196.0,101.2,97.2,99.65,105.5,3,3,0,1.0,3,3,0,1.0,2,1,0,3,200.28,195.08,197.68
2015-10-16,1610612763,1610612760,2015,94.0,78.0,172.0,98.25,97.5,101.8,103.4,3,3,0,1.0,3,3,0,1.0,2,1,2,1,193.96,210.36,202.16000000000003
2015-10-16,1610612742,1610612737,2015,84.0,91.0,175.0,104.45,102.7,96.35,95.7,3,0,3,0.0,3,3,0,1.0,0,0,1,2,213.0,199.44,206.22
2015-10-16,1610612743,1610612756,2015,106.0,81.0,187.0,109.2,110.3,106.25,103.85,4,3,1,0.75,3,2,1,0.667,1,2,2,0,217.04,212.88,214.95999999999998
2015-10-15,1610612739,1610612754,2015,85.0,107.0,192.0,101.9,101.55,92.05,92.25,4,0,4,0.0,4,3,1,0.75,0,0,2,1,195.48,187.28,191.38
2015-10-15,1610612744,1610612745,2015,123.0,101.0,224.0,107.5,105.85,112.7,109.85,3,1,2,0.333,4,2,2,0.5,1,0,1,1,199.04,216.24,207.64
2015-10-14,1610612746,1610612766,2015,71.0,113.0,184.0,109.85,106.5,99.45,97.7,3,1,2,0.333,3,3,0,1.0,1,0,1,2,214.36,194.96,204.66000000000003
2015-10-14,1610612750,1610612761,2015,89.0,87.0,176.0,110.05,111.2,100.6,99.2,3,0,3,0.0,4,3,1,0.75,0,0,2,1,209.4,206.0,207.7
2015-10-14,1610612751,1610612738,2015,105.0,109.0,214.0,96.7,98.4,99.65,105.5,3,1,2,0.333,2,2,0,1.0,0,1,0,2,196.96,195.08,196.02
2015-10-14,1610612741,1610612765,2015,91.0,114.0,205.0,94.0,91.0,100.85,105.95,4,2,2,0.5,4,1,3,0.25,1,1,0,1,185.44,206.0,195.72
2015-10-14,1610612737,1610612759,2015,100.0,86.0,186.0,96.35,95.7,107.75,96.55,2,2,0,1.0,2,0,2,0.0,0,2,0,0,199.44,204.12,201.78
2015-10-13,1610612753,1610612748,2015,95.0,92.0,187.0,96.55,103.5,97.25,95.5,4,2,2,0.5,3,1,2,0.333,0,2,1,0,203.64,195.0,199.32
2015-10-13,1610612739,1610612749,2015,101.0,110.0,211.0,101.9,101.55,99.8,108.15,3,0,3,0.0,2,0,2,0.0,0,0,0,0,195.48,200.48,197.98
2015-10-13,1610612754,1610612765,2015,101.0,97.0,198.0,92.05,92.25,100.85,105.95,3,2,1,0.667,3,1,2,0.333,1,1,0,1,187.28,206.0,196.64
2015-10-13,1610612760,1610612742,2015,100.0,88.0,188.0,101.8,103.4,104.45,102.7,2,2,0,1.0,2,0,2,0.0,1,1,0,0,210.36,213.0,211.68
2015-10-13,1610612756,1610612745,2015,129.0,135.0,264.0,106.25,103.85,112.7,109.85,2,2,0,1.0,3,1,2,0.333,2,0,1,0,212.88,216.24,214.56
2015-10-13,1610612747,1610612758,2015,100.0,107.0,207.0,107.3,114.65,97.75,101.5,4,1,3,0.25,4,3,1,0.75,1,0,2,1,219.28,207.08,213.18
2015-10-13,1610612744,1610612743,2015,103.0,114.0,217.0,107.5,105.85,109.2,110.3,2,1,1,0.5,3,2,1,0.667,1,0,1,1,199.04,217.04,208.04
2015-10-12,1610612739,1610612763,2015,81.0,91.0,172.0,101.9,101.55,98.25,97.5,2,0,2,0.0,2,2,0,1.0,0,0,2,0,195.48,193.96,194.72
2015-10-12,1610612752,1610612755,2015,94.0,88.0,182.0,101.2,97.2,97.85,106.0,2,2,0,1.0,3,2,1,0.667,1,1,2,0,200.28,207.68,203.98000000000002
2015-10-12,1610612761,1610612750,2015,112.0,105.0,217.0,100.6,99.2,110.05,111.2,3,2,1,0.667,2,0,2,0.0,1,1,0,0,206.0,209.4,207.7
2015-10-12,1610612748,1610612759,2015,97.0,94.0,191.0,97.25,95.5,107.75,96.55,2,0,2,0.0,1,0,1,0.0,0,0,0,0,195.0,204.12,199.56
2015-10-12,1610612741,1610612740,2015,115.0,123.0,238.0,94.0,91.0,100.45,104.8,3,2,1,0.667,2,1,1,0.5,1,1,0,1,185.44,200.8,193.12
2015-10-12,1610612762,1610612757,2015,81.0,88.0,169.0,95.55,106.55,104.75,105.45,3,2,1,0.667,3,1,2,0.333,0,2,1,0,200.2,209.44,204.82
2015-10-11,1610612766,1610612746,2015,106.0,94.0,200.0,99.45,97.7,109.85,106.5,2,2,0,1.0,2,1,1,0.5,0,2,1,0,194.96,214.36,204.66000000000003
2015-10-11,1610612745,1610612753,2015,119.0,123.0,242.0,112.7,109.85,96.55,103.5,2,1,1,0.5,3,1,2,0.333,1,0,0,1,216.24,203.64,209.94
2015-10-10,1610612755,1610612751,2015,97.0,95.0,192.0,97.85,106.0,96.7,98.4,2,1,1,0.5,2,1,1,0.5,1,0,0,1,207.68,196.96,202.32
2015-10-10,1610612750,1610612741,2015,105.0,114.0,219.0,110.05,111.2,94.0,91.0,1,0,1,0.0,2,1,1,0.5,0,0,1,0,209.4,185.44,197.42000000000002
2015-10-10,1610612749,1610612765,2015,88.0,117.0,205.0,99.8,108.15,100.85,105.95,1,0,1,0.0,2,0,2,0.0,0,0,0,0,200.48,206.0,203.24
2015-10-10,1610612758,1610612757,2015,94.0,90.0,184.0,97.75,101.5,104.75,105.45,3,2,1,0.667,2,1,1,0.5,1,1,1,0,207.08,209.44,208.26
2015-10-09,1610612764,1610612752,2015,104.0,115.0,219.0,94.7,91.35,101.2,97.2,1,1,0,1.0,1,1,0,1.0,1,0,1,0,193.0,200.28,196.64
2015-10-09,1610612740,1610612737,2015,93.0,103.0,196.0,100.45,104.8,96.35,95.7,1,1,0,1.0,1,1,0,1.0,0,1,0,1,200.8,199.44,200.12
2015-10-09,1610612756,1610612762,2015,101.0,85.0,186.0,106.25,103.85,95.55,106.55,1,1,0,1.0,2,2,0,1.0,1,0,0,2,212.88,200.2,206.54
2015-10-08,1610612755,1610612739,2015,115.0,114.0,229.0,97.85,106.0,101.9,101.55,1,0,1,0.0,1,0,1,0.0,0,0,0,0,207.68,195.48,201.57999999999998
2015-10-08,1610612754,1610612753,2015,97.0,92.0,189.0,92.05,92.25,96.55,103.5,2,1,1,0.5,2,1,1,0.5,0,1,0,1,187.28,203.64,195.45999999999998
2015-10-08,1610612765,1610612751,2015,83.0,93.0,176.0,100.85,105.95,96.7,98.4,1,0,1,0.0,1,0,1,0.0,0,0,0,0,206.0,196.96,201.48000000000002
2015-10-08,1610612743,1610612741,2015,112.0,94.0,206.0,109.2,110.3,94.0,91.0,2,1,1,0.5,1,1,0,1.0,0,1,1,0,217.04,185.44,201.24
2015-10-08,1610612757,1610612744,2015,118.0,101.0,219.0,104.75,105.45,107.5,105.85,1,0,1,0.0,1,1,0,1.0,0,0,1,0,209.44,199.04,204.24
2015-10-08,1610612758,1610612759,2015,95.0,92.0,187.0,97.75,101.5,107.75,96.55,2,1,1,0.5,0,0,0,0.0,0,1,0,0,207.08,204.12,205.60000000000002
2015-10-08,1610612747,1610612761,2015,97.0,105.0,202.0,107.3,114.65,100.6,99.2,2,0,2,0.0,2,1,1,0.5,0,0,1,0,219.28,206.0,212.64
2015-10-07,1610612747,1610612762,2015,114.0,117.0,231.0,107.3,114.65,95.55,106.55,1,0,1,0.0,1,1,0,1.0,0,0,0,1,219.28,200.2,209.74
2015-10-07,1610612739,1610612737,2015,96.0,98.0,194.0,101.9,101.55,96.35,95.7,0,0,0,0.0,0,0,0,0.0,0,0,0,0,195.48,199.44,197.45999999999998
2015-10-07,1610612748,1610612753,2015,97.0,100.0,197.0,97.25,95.5,96.55,103.5,1,0,1,0.0,1,0,1,0.0,0,0,0,0,195.0,203.64,199.32
2015-10-07,1610612750,1610612760,2015,99.0,122.0,221.0,110.05,111.2,101.8,103.4,0,0,0,0.0,0,0,0,0.0,0,0,0,0,209.4,210.36,209.88
2015-10-07,1610612745,1610612742,2015,109.0,82.0,191.0,112.7,109.85,104.45,102.7,1,0,1,0.0,1,0,1,0.0,0,0,0,0,216.24,213.0,214.62
2015-10-07,1610612756,1610612758,2015,102.0,98.0,200.0,106.25,103.85,97.75,101.5,0,0,0,0.0,1,1,0,1.0,0,0,0,1,212.88,207.08,209.98000000000002
2015-10-06,1610612764,1610612755,2015,129.0,95.0,224.0,94.7,91.35,97.85,106.0,0,0,0,0.0,0,0,0,0.0,0,0,0,0,193.0,207.68,200.34
2015-10-06,1610612765,1610612754,2015,112.0,115.0,227.0,100.85,105.95,92.05,92.25,0,0,0,0.0,1,0,1,0.0,0,0,0,0,206.0,187.28,196.64
2015-10-06,1610612741,1610612749,2015,105.0,95.0,200.0,94.0,91.0,99.8,108.15,0,0,0,0.0,0,0,0,0.0,0,0,0,0,185.44,200.48,192.95999999999998
2015-10-06,1610612763,1610612745,2015,92.0,89.0,181.0,98.25,97.5,112.7,109.85,0,0,0,0.0,0,0,0,0.0,0,0,0,0,193.96,216.24,205.10000000000002
2015-10-06,1610612742,1610612743,2015,86.0,96.0,182.0,104.45,102.7,109.2,110.3,0,0,0,0.0,1,0,1,0.0,0,0,0,0,213.0,217.04,215.01999999999998
2015-10-05,1610612757,1610612758,2015,105.0,109.0,214.0,104.75,105.45,97.75,101.5,0,0,0,0.0,0,0,0,0.0,0,0,0,0,209.44,207.08,208.26
2015-10-05,1610612744,1610612761,2015,95.0,87.0,182.0,107.5,105.85,100.6,99.2,0,0,0,0.0,1,1,0,1.0,0,0,1,0,199.04,206.0,202.51999999999998
2015-10-04,1610612748,1610612766,2015,77.0,90.0,167.0,97.25,95.5,99.45,97.7,0,0,0,0.0,1,1,0,1.0,0,0,0,1,195.0,194.96,194.98000000000002
2015-10-04,1610612761,1610612746,2015,93.0,73.0,166.0,100.6,99.2,109.85,106.5,0,0,0,0.0,1,1,0,1.0,0,0,1,0,206.0,214.36,210.18
2015-10-04,1610612747,1610612762,2015,71.0,90.0,161.0,107.3,114.65,95.55,106.55,0,0,0,0.0,0,0,0,0.0,0,0,0,0,219.28,200.2,209.74
2015-10-03,1610612753,1610612766,2015,100.0,106.0,206.0,96.55,103.5,99.45,97.7,0,0,0,0.0,0,0,0,0.0,0,0,0,0,203.64,194.96,199.3
2015-10-03,1610612754,1610612740,2015,105.0,110.0,215.0,92.05,92.25,100.45,104.8,0,0,0,0.0,0,0,0,0.0,0,0,0,0,187.28,200.8,194.04000000000002
2015-10-02,1610612746,1610612743,2015,103.0,96.0,199.0,109.85,106.5,109.2,110.3,0,0,0,0.0,0,0,0,0.0,0,0,0,0,214.36,217.04,215.7
2015-06-16,1610612739,1610612744,2014,97.0,105.0,202.0,101.9,101.55,107.5,105.85,82,53,29,0.6459999999999999,82,67,15,0.8170000000000001,31,22,39,28,195.48,199.04,197.26
2015-06-14,1610612744,1610612739,2014,104.0,91.0,195.0,107.5,105.85,101.9,101.55,82,67,15,0.8170000000000001,82,53,29,0.6459999999999999,39,28,31,22,199.04,195.48,197.26
2015-06-11,1610612739,1610612744,2014,82.0,103.0,185.0,101.9,101.55,107.5,105.85,82,53,29,0.6459999999999999,82,67,15,0.8170000000000001,31,22,39,28,195.48,199.04,197.26
2015-06-09,1610612739,1610612744,2014,96.0,91.0,187.0,101.9,101.55,107.5,105.85,82,53,29,0.6459999999999999,82,67,15,0.8170000000000001,31,22,39,28,195.48,199.04,197.26
2015-06-07,1610612744,1610612739,2014,93.0,95.0,188.0,107.5,105.85,101.9,101.55,82,67,15,0.8170000000000001,82,53,29,0.6459999999999999,39,28,31,22,199.04,195.48,197.26
2015-06-04,1610612744,1610612739,2014,108.0,100.0,208.0,107.5,105.85,101.9,101.55,82,67,15,0.8170000000000001,82,53,29,0.6459999999999999,39,28,31,22,199.04,195.48,197.26
2015-05-27,1610612744,1610612745,2014,104.0,90.0,194.0,107.5,105.85,112.7,109.85,82,67,15,0.8170000000000001,82,56,26,0.6829999999999999,39,28,30,26,199.04,216.24,207.64
2015-05-26,1610612739,1610612737,2014,118.0,88.0,206.0,101.9,101.55,96.35,95.7,82,53,29,0.6459999999999999,82,60,22,0.732,31,22,35,25,195.48,199.44,197.45999999999998
2015-05-25,1610612745,1610612744,2014,128.0,115.0,243.0,112.7,109.85,107.5,105.85,82,56,26,0.6829999999999999,82,67,15,0.8170000000000001,30,26,39,28,216.24,199.04,207.64
2015-05-24,1610612739,1610612737,2014,114.0,111.0,225.0,101.9,101.55,96.35,95.7,82,53,29,0.6459999999999999,82,60,22,0.732,31,22,35,25,195.48,199.44,197.45999999999998
2015-05-23,1610612745,1610612744,2014,80.0,115.0,195.0,112.7,109.85,107.5,105.85,82,56,26,0.6829999999999999,82,67,15,0.8170000000000001,30,26,39,28,216.24,199.04,207.64
2015-05-22,1610612737,1610612739,2014,82.0,94.0,176.0,96.35,95.7,101.9,101.55,82,60,22,0.732,82,53,29,0.6459999999999999,35,25,31,22,199.44,195.48,197.45999999999998
2015-05-21,1610612744,1610612745,2014,99.0,98.0,197.0,107.5,105.85,112.7,109.85,82,67,15,0.8170000000000001,82,56,26,0.6829999999999999,39,28,30,26,199.04,216.24,207.64
2015-05-20,1610612737,1610612739,2014,89.0,97.0,186.0,96.35,95.7,101.9,101.55,82,60,22,0.732,82,53,29,0.6459999999999999,35,25,31,22,199.44,195.48,197.45999999999998
2015-05-19,1610612744,1610612745,2014,110.0,106.0,216.0,107.5,105.85,112.7,109.85,82,67,15,0.8170000000000001,82,56,26,0.6829999999999999,39,28,30,26,199.04,216.24,207.64
2015-05-17,1610612745,1610612746,2014,113.0,100.0,213.0,112.7,109.85,109.85,106.5,82,56,26,0.6829999999999999,82,56,26,0.6829999999999999,30,26,30,26,216.24,214.36,215.3
2015-05-15,1610612764,1610612737,2014,91.0,94.0,185.0,94.7,91.35,96.35,95.7,82,46,36,0.561,82,60,22,0.732,29,17,35,25,193.0,199.44,196.22
2015-05-15,1610612763,1610612744,2014,95.0,108.0,203.0,98.25,97.5,107.5,105.85,82,55,27,0.6709999999999999,82,67,15,0.8170000000000001,31,24,39,28,193.96,199.04,196.5
2015-05-14,1610612741,1610612739,2014,73.0,94.0,167.0,94.0,91.0,101.9,101.55,82,50,32,0.61,82,53,29,0.6459999999999999,27,23,31,22,185.44,195.48,190.45999999999998
2015-05-14,1610612746,1610612745,2014,107.0,119.0,226.0,109.85,106.5,112.7,109.85,82,56,26,0.6829999999999999,82,56,26,0.6829999999999999,30,26,30,26,214.36,216.24,215.3
2015-05-13,1610612737,1610612764,2014,82.0,81.0,163.0,96.35,95.7,94.7,91.35,82,60,22,0.732,82,46,36,0.561,35,25,29,17,199.44,193.0,196.22
2015-05-13,1610612744,1610612763,2014,98.0,78.0,176.0,107.5,105.85,98.25,97.5,82,67,15,0.8170000000000001,82,55,27,0.6709999999999999,39,28,31,24,199.04,193.96,196.5
2015-05-12,1610612739,1610612741,2014,106.0,101.0,207.0,101.9,101.55,94.0,91.0,82,53,29,0.6459999999999999,82,50,32,0.61,31,22,27,23,195.48,185.44,190.45999999999998
2015-05-12,1610612745,1610612746,2014,124.0,103.0,227.0,112.7,109.85,109.85,106.5,82,56,26,0.6829999999999999,82,56,26,0.6829999999999999,30,26,30,26,216.24,214.36,215.3
2015-05-11,1610612764,1610612737,2014,101.0,106.0,207.0,94.7,91.35,96.35,95.7,82,46,36,0.561,82,60,22,0.732,29,17,35,25,193.0,199.44,196.22
2015-05-11,1610612763,1610612744,2014,84.0,101.0,185.0,98.25,97.5,107.5,105.85,82,55,27,0.6709999999999999,82,67,15,0.8170000000000001,31,24,39,28,193.96,199.04,196.5
2015-05-10,1610612741,1610612739,2014,84.0,86.0,170.0,94.0,91.0,101.9,101.55,82,50,32,0.61,82,53,29,0.6459999999999999,27,23,31,22,185.44,195.48,190.45999999999998
2015-05-10,1610612746,1610612745,2014,128.0,95.0,223.0,109.85,106.5,112.7,109.85,82,56,26,0.6829999999999999,82,56,26,0.6829999999999999,30,26,30,26,214.36,216.24,215.3
2015-05-09,1610612764,1610612737,2014,103.0,101.0,204.0,94.7,91.35,96.35,95.7,82,46,36,0.561,82,60,22,0.732,29,17,35,25,193.0,199.44,196.22
2015-05-09,1610612763,1610612744,2014,99.0,89.0,188.0,98.25,97.5,107.5,105.85,82,55,27,0.6709999999999999,82,67,15,0.8170000000000001,31,24,39,28,193.96,199.04,196.5
2015-05-08,1610612741,1610612739,2014,99.0,96.0,195.0,94.0,91.0,101.9,101.55,82,50,32,0.61,82,53,29,0.6459999999999999,27,23,31,22,185.44,195.48,190.45999999999998
2015-05-08,1610612746,1610612745,2014,124.0,99.0,223.0,109.85,106.5,112.7,109.85,82,56,26,0.6829999999999999,82,56,26,0.6829999999999999,30,26,30,26,214.36,216.24,215.3
2015-05-06,1610612739,1610612741,2014,106.0,91.0,197.0,101.9,101.55,94.0,91.0,82,53,29,0.6459999999999999,82,50,32,0.61,31,22,27,23,195.48,185.44,190.45999999999998
2015-05-06,1610612745,1610612746,2014,115.0,109.0,224.0,112.7,109.85,109.85,106.5,82,56,26,0.6829999999999999,82,56,26,0.6829999999999999,30,26,30,26,216.24,214.36,215.3
2015-05-05,1610612737,1610612764,2014,106.0,90.0,196.0,96.35,95.7,94.7,91.35,82,60,22,0.732,82,46,36,0.561,35,25,29,17,199.44,193.0,196.22
2015-05-05,1610612744,1610612763,2014,90.0,97.0,187.0,107.5,105.85,98.25,97.5,82,67,15,0.8170000000000001,82,55,27,0.6709999999999999,39,28,31,24,199.04,193.96,196.5
2015-05-04,1610612739,1610612741,2014,92.0,99.0,191.0,101.9,101.55,94.0,91.0,82,53,29,0.6459999999999999,82,50,32,0.61,31,22,27,23,195.48,185.44,190.45999999999998
2015-05-04,1610612745,1610612746,2014,101.0,117.0,218.0,112.7,109.85,109.85,106.5,82,56,26,0.6829999999999999,82,56,26,0.6829999999999999,30,26,30,26,216.24,214.36,215.3
2015-05-03,1610612737,1610612764,2014,98.0,104.0,202.0,96.35,95.7,94.7,91.35,82,60,22,0.732,82,46,36,0.561,35,25,29,17,199.44,193.0,196.22
2015-05-03,1610612744,1610612763,2014,101.0,86.0,187.0,107.5,105.85,98.25,97.5,82,67,15,0.8170000000000001,82,55,27,0.6709999999999999,39,28,31,24,199.04,193.96,196.5
2015-05-02,1610612746,1610612759,2014,111.0,109.0,220.0,109.85,106.5,107.75,96.55,82,56,26,0.6829999999999999,82,55,27,0.6709999999999999,30,26,33,22,214.36,204.12,209.24
2015-05-01,1610612751,1610612737,2014,87.0,111.0,198.0,96.7,98.4,96.35,95.7,82,38,44,0.463,82,60,22,0.732,19,19,35,25,196.96,199.44,198.2
2015-04-30,1610612749,1610612741,2014,66.0,120.0,186.0,99.8,108.15,94.0,91.0,82,41,41,0.5,82,50,32,0.61,23,18,27,23,200.48,185.44,192.95999999999998
2015-04-30,1610612759,1610612746,2014,96.0,102.0,198.0,107.75,96.55,109.85,106.5,82,55,27,0.6709999999999999,82,56,26,0.6829999999999999,33,22,30,26,204.12,214.36,209.24
2015-04-29,1610612737,1610612751,2014,107.0,97.0,204.0,96.35,95.7,96.7,98.4,82,60,22,0.732,82,38,44,0.463,35,25,19,19,199.44,196.96,198.2
2015-04-29,1610612763,1610612757,2014,99.0,93.0,192.0,98.25,97.5,104.75,105.45,82,55,27,0.6709999999999999,82,51,31,0.622,31,24,32,19,193.96,209.44,201.7
2015-04-28,1610612745,1610612742,2014,103.0,94.0,197.0,112.7,109.85,104.45,102.7,82,56,26,0.6829999999999999,82,50,32,0.61,30,26,27,23,216.24,213.0,214.62
2015-04-28,1610612746,1610612759,2014,107.0,111.0,218.0,109.85,106.5,107.75,96.55,82,56,26,0.6829999999999999,82,55,27,0.6709999999999999,30,26,33,22,214.36,204.12,209.24
2015-04-27,1610612751,1610612737,2014,120.0,115.0,235.0,96.7,98.4,96.35,95.7,82,38,44,0.463,82,60,22,0.732,19,19,35,25,196.96,199.44,198.2
2015-04-27,1610612741,1610612749,2014,88.0,94.0,182.0,94.0,91.0,99.8,108.15,82,50,32,0.61,82,41,41,0.5,27,23,23,18,185.44,200.48,192.95999999999998
2015-04-27,1610612757,1610612763,2014,99.0,92.0,191.0,104.75,105.45,98.25,97.5,82,51,31,0.622,82,55,27,0.6709999999999999,32,19,31,24,209.44,193.96,201.7
2015-04-26,1610612738,1610612739,2014,93.0,101.0,194.0,99.65,105.5,101.9,101.55,82,40,42,0.488,82,53,29,0.6459999999999999,21,19,31,22,195.08,195.48,195.28
2015-04-26,1610612759,1610612746,2014,105.0,114.0,219.0,107.75,96.55,109.85,106.5,82,55,27,0.6709999999999999,82,56,26,0.6829999999999999,33,22,30,26,204.12,214.36,209.24
2015-04-26,1610612764,1610612761,2014,125.0,94.0,219.0,94.7,91.35,100.6,99.2,82,46,36,0.561,82,49,33,0.598,29,17,27,22,193.0,206.0,199.5
2015-04-26,1610612742,1610612745,2014,121.0,109.0,230.0,104.45,102.7,112.7,109.85,82,50,32,0.61,82,56,26,0.6829999999999999,27,23,30,26,213.0,216.24,214.62
2015-04-25,1610612751,1610612737,2014,91.0,83.0,174.0,96.7,98.4,96.35,95.7,82,38,44,0.463,82,60,22,0.732,19,19,35,25,196.96,199.44,198.2
2015-04-25,1610612749,1610612741,2014,92.0,90.0,182.0,99.8,108.15,94.0,91.0,82,41,41,0.5,82,50,32,0.61,23,18,27,23,200.48,185.44,192.95999999999998
2015-04-25,1610612740,1610612744,2014,98.0,109.0,207.0,100.45,104.8,107.5,105.85,82,45,37,0.5489999999999999,82,67,15,0.8170000000000001,28,17,39,28,200.8,199.04,199.92000000000002
2015-04-25,1610612757,1610612763,2014,109.0,115.0,224.0,104.75,105.45,98.25,97.5,82,51,31,0.622,82,55,27,0.6709999999999999,32,19,31,24,209.44,193.96,201.7
2015-04-24,1610612742,1610612745,2014,128.0,130.0,258.0,104.45,102.7,112.7,109.85,82,50,32,0.61,82,56,26,0.6829999999999999,27,23,30,26,213.0,216.24,214.62
2015-04-24,1610612764,1610612761,2014,106.0,99.0,205.0,94.7,91.35,100.6,99.2,82,46,36,0.561,82,49,33,0.598,29,17,27,22,193.0,206.0,199.5
2015-04-24,1610612759,1610612746,2014,100.0,73.0,173.0,107.75,96.55,109.85,106.5,82,55,27,0.6709999999999999,82,56,26,0.6829999999999999,33,22,30,26,204.12,214.36,209.24
2015-04-23,1610612738,1610612739,2014,95.0,103.0,198.0,99.65,105.5,101.9,101.55,82,40,42,0.488,82,53,29,0.6459999999999999,21,19,31,22,195.08,195.48,195.28
2015-04-23,1610612749,1610612741,2014,106.0,113.0,219.0,99.8,108.15,94.0,91.0,82,41,41,0.5,82,50,32,0.61,23,18,27,23,200.48,185.44,192.95999999999998
2015-04-23,1610612740,1610612744,2014,119.0,123.0,242.0,100.45,104.8,107.5,105.85,82,45,37,0.5489999999999999,82,67,15,0.8170000000000001,28,17,39,28,200.8,199.04,199.92000000000002
2015-04-22,1610612737,1610612751,2014,96.0,91.0,187.0,96.35,95.7,96.7,98.4,82,60,22,0.732,82,38,44,0.463,35,25,19,19,199.44,196.96,198.2
2015-04-22,1610612763,1610612757,2014,97.0,82.0,179.0,98.25,97.5,104.75,105.45,82,55,27,0.6709999999999999,82,51,31,0.622,31,24,32,19,193.96,209.44,201.7
2015-04-22,1610612746,1610612759,2014,107.0,111.0,218.0,109.85,106.5,107.75,96.55,82,56,26,0.6829999999999999,82,55,27,0.6709999999999999,30,26,33,22,214.36,204.12,209.24
2015-04-21,1610612739,1610612738,2014,99.0,91.0,190.0,101.9,101.55,99.65,105.5,82,53,29,0.6459999999999999,82,40,42,0.488,31,22,21,19,195.48,195.08,195.28
2015-04-21,1610612761,1610612764,2014,106.0,117.0,223.0,100.6,99.2,94.7,91.35,82,49,33,0.598,82,46,36,0.561,27,22,29,17,206.0,193.0,199.5
2015-04-21,1610612745,1610612742,2014,111.0,99.0,210.0,112.7,109.85,104.45,102.7,82,56,26,0.6829999999999999,82,50,32,0.61,30,26,27,23,216.24,213.0,214.62
2015-04-20,1610612741,1610612749,2014,91.0,82.0,173.0,94.0,91.0,99.8,108.15,82,50,32,0.61,82,41,41,0.5,27,23,23,18,185.44,200.48,192.95999999999998
2015-04-20,1610612744,1610612740,2014,97.0,87.0,184.0,107.5,105.85,100.45,104.8,82,67,15,0.8170000000000001,82,45,37,0.5489999999999999,39,28,28,17,199.04,200.8,199.92000000000002
2015-04-19,1610612739,1610612738,2014,113.0,100.0,213.0,101.9,101.55,99.65,105.5,82,53,29,0.6459999999999999,82,40,42,0.488,31,22,21,19,195.48,195.08,195.28
2015-04-19,1610612737,1610612751,2014,99.0,92.0,191.0,96.35,95.7,96.7,98.4,82,60,22,0.732,82,38,44,0.463,35,25,19,19,199.44,196.96,198.2
2015-04-19,1610612763,1610612757,2014,100.0,86.0,186.0,98.25,97.5,104.75,105.45,82,55,27,0.6709999999999999,82,51,31,0.622,31,24,32,19,193.96,209.44,201.7
2015-04-19,1610612746,1610612759,2014,107.0,92.0,199.0,109.85,106.5,107.75,96.55,82,56,26,0.6829999999999999,82,55,27,0.6709999999999999,30,26,33,22,214.36,204.12,209.24
2015-04-18,1610612761,1610612764,2014,86.0,93.0,179.0,100.6,99.2,94.7,91.35,82,49,33,0.598,82,46,36,0.561,27,22,29,17,206.0,193.0,199.5
2015-04-18,1610612744,1610612740,2014,106.0,99.0,205.0,107.5,105.85,100.45,104.8,82,67,15,0.8170000000000001,82,45,37,0.5489999999999999,39,28,28,17,199.04,200.8,199.92000000000002
2015-04-18,1610612741,1610612749,2014,103.0,91.0,194.0,94.0,91.0,99.8,108.15,82,50,32,0.61,82,41,41,0.5,27,23,23,18,185.44,200.48,192.95999999999998
2015-04-18,1610612745,1610612742,2014,118.0,108.0,226.0,112.7,109.85,104.45,102.7,82,56,26,0.6829999999999999,82,50,32,0.61,30,26,27,23,216.24,213.0,214.62
2015-04-15,1610612761,1610612766,2014,92.0,87.0,179.0,100.6,99.2,99.45,97.7,81,48,33,0.593,81,33,48,0.407,26,22,19,14,206.0,194.96,200.48000000000002
2015-04-15,1610612741,1610612737,2014,91.0,85.0,176.0,94.0,91.0,96.35,95.7,81,49,32,0.605,81,60,21,0.741,26,23,35,25,185.44,199.44,192.44
2015-04-15,1610612742,1610612757,2014,114.0,98.0,212.0,104.45,102.7,104.75,105.45,81,49,32,0.605,81,51,30,0.63,26,23,32,19,213.0,209.44,211.22
2015-04-15,1610612745,1610612762,2014,117.0,91.0,208.0,112.7,109.85,95.55,106.55,81,55,26,0.679,81,38,43,0.469,29,26,21,17,216.24,200.2,208.22
2015-04-15,1610612749,1610612738,2014,100.0,105.0,205.0,99.8,108.15,99.65,105.5,81,41,40,0.506,81,39,42,0.481,23,18,21,18,200.48,195.08,197.78
2015-04-15,1610612750,1610612760,2014,113.0,138.0,251.0,110.05,111.2,101.8,103.4,81,16,65,0.198,81,44,37,0.5429999999999999,9,7,29,15,209.4,210.36,209.88
2015-04-15,1610612740,1610612759,2014,108.0,103.0,211.0,100.45,104.8,107.75,96.55,81,44,37,0.5429999999999999,81,55,26,0.679,27,17,33,22,200.8,204.12,202.46
2015-04-15,1610612751,1610612753,2014,101.0,88.0,189.0,96.7,98.4,96.55,103.5,81,37,44,0.457,81,25,56,0.309,18,19,13,12,196.96,203.64,200.3
2015-04-15,1610612739,1610612764,2014,113.0,108.0,221.0,101.9,101.55,94.7,91.35,81,52,29,0.642,81,46,35,0.568,30,22,29,17,195.48,193.0,194.24
2015-04-15,1610612752,1610612765,2014,90.0,112.0,202.0,101.2,97.2,100.85,105.95,81,17,64,0.21,81,31,50,0.383,10,7,18,13,200.28,206.0,203.14
2015-04-15,1610612755,1610612748,2014,101.0,105.0,206.0,97.85,106.0,97.25,95.5,81,18,63,0.222,81,36,45,0.444,12,6,20,16,207.68,195.0,201.34
2015-04-15,1610612763,1610612754,2014,95.0,83.0,178.0,98.25,97.5,92.05,92.25,81,54,27,0.667,81,38,43,0.469,30,24,23,15,193.96,187.28,190.62
2015-04-15,1610612744,1610612743,2014,133.0,126.0,259.0,107.5,105.85,109.2,110.3,81,66,15,0.815,81,30,51,0.37,38,28,19,11,199.04,217.04,208.04
2015-04-15,1610612747,1610612758,2014,99.0,122.0,221.0,107.3,114.65,97.75,101.5,81,21,60,0.259,81,28,53,0.34600000000000003,12,9,18,10,219.28,207.08,213.18
2015-04-14,1610612738,1610612761,2014,95.0,93.0,188.0,99.65,105.5,100.6,99.2,80,38,42,0.475,80,48,32,0.6,20,18,26,22,195.08,206.0,200.54000000000002
2015-04-14,1610612754,1610612764,2014,99.0,95.0,194.0,92.05,92.25,94.7,91.35,80,37,43,0.463,80,46,34,0.575,22,15,29,17,187.28,193.0,190.14
2015-04-14,1610612756,1610612746,2014,101.0,112.0,213.0,106.25,103.85,109.85,106.5,81,39,42,0.481,81,55,26,0.679,22,17,30,25,212.88,214.36,213.62
2015-04-13,1610612766,1610612745,2014,90.0,100.0,190.0,99.45,97.7,112.7,109.85,80,33,47,0.413,80,54,26,0.675,19,14,29,25,194.96,216.24,205.60000000000002
2015-04-13,1610612739,1610612765,2014,109.0,97.0,206.0,101.9,101.55,100.85,105.95,80,51,29,0.638,80,31,49,0.388,29,22,18,13,195.48,206.0,200.74
2015-04-13,1610612755,1610612749,2014,97.0,107.0,204.0,97.85,106.0,99.8,108.15,80,18,62,0.225,80,40,40,0.5,12,6,23,17,207.68,200.48,204.07999999999998
2015-04-13,1610612737,1610612752,2014,108.0,112.0,220.0,96.35,95.7,101.2,97.2,80,60,20,0.75,80,16,64,0.2,35,25,10,6,199.44,200.28,199.86
2015-04-13,1610612751,1610612741,2014,86.0,113.0,199.0,96.7,98.4,94.0,91.0,80,37,43,0.463,80,48,32,0.6,18,19,26,22,196.96,185.44,191.2
2015-04-13,1610612748,1610612753,2014,100.0,93.0,193.0,97.25,95.5,96.55,103.5,80,35,45,0.438,80,25,55,0.313,19,16,13,12,195.0,203.64,199.32
2015-04-13,1610612750,1610612740,2014,88.0,100.0,188.0,110.05,111.2,100.45,104.8,80,16,64,0.2,80,43,37,0.5379999999999999,9,7,27,16,209.4,200.8,205.10000000000002
2015-04-13,1610612760,1610612757,2014,101.0,90.0,191.0,101.8,103.4,104.75,105.45,80,43,37,0.5379999999999999,80,51,29,0.638,28,15,32,19,210.36,209.44,209.9
2015-04-13,1610612762,1610612742,2014,109.0,92.0,201.0,95.55,106.55,104.45,102.7,80,37,43,0.463,80,49,31,0.613,20,17,26,23,200.2,213.0,206.6
2015-04-13,1610612758,1610612747,2014,102.0,92.0,194.0,97.75,101.5,107.3,114.65,80,27,53,0.338,80,21,59,0.263,17,10,12,9,207.08,219.28,213.18
2015-04-13,1610612744,1610612763,2014,111.0,107.0,218.0,107.5,105.85,98.25,97.5,80,65,15,0.813,80,54,26,0.675,37,28,30,24,199.04,193.96,196.5
2015-04-13,1610612746,1610612743,2014,110.0,103.0,213.0,109.85,106.5,109.2,110.3,80,54,26,0.675,80,30,50,0.375,29,25,19,11,214.36,217.04,215.7
2015-04-12,1610612749,1610612751,2014,96.0,73.0,169.0,99.8,108.15,96.7,98.4,79,39,40,0.494,79,37,42,0.468,22,17,18,19,200.48,196.96,198.72
2015-04-12,1610612738,1610612739,2014,117.0,78.0,195.0,99.65,105.5,101.9,101.55,79,37,42,0.468,79,51,28,0.6459999999999999,19,18,29,22,195.08,195.48,195.28
2015-04-12,1610612765,1610612766,2014,116.0,77.0,193.0,100.85,105.95,99.45,97.7,79,30,49,0.38,79,33,46,0.418,17,13,19,14,206.0,194.96,200.48000000000002
2015-04-12,1610612743,1610612758,2014,122.0,111.0,233.0,109.2,110.3,97.75,101.5,79,29,50,0.3670000000000001,79,27,52,0.342,18,11,17,10,217.04,207.08,212.06
2015-04-12,1610612754,1610612760,2014,116.0,104.0,220.0,92.05,92.25,101.8,103.4,79,36,43,0.456,79,43,36,0.544,21,15,28,15,187.28,210.36,198.82
2015-04-12,1610612764,1610612737,2014,108.0,99.0,207.0,94.7,91.35,96.35,95.7,79,45,34,0.57,79,60,19,0.759,28,17,35,25,193.0,199.44,196.22
2015-04-12,1610612745,1610612740,2014,121.0,114.0,235.0,112.7,109.85,100.45,104.8,79,53,26,0.6709999999999999,79,43,36,0.544,28,25,27,16,216.24,200.8,208.52
2015-04-12,1610612759,1610612756,2014,107.0,91.0,198.0,107.75,96.55,106.25,103.85,80,54,26,0.675,80,39,41,0.488,32,22,22,17,204.12,212.88,208.5
2015-04-12,1610612747,1610612742,2014,106.0,120.0,226.0,107.3,114.65,104.45,102.7,79,21,58,0.266,79,48,31,0.608,12,9,26,22,219.28,213.0,216.14
2015-04-11,1610612753,1610612752,2014,79.0,80.0,159.0,96.55,103.5,101.2,97.2,79,25,54,0.316,79,15,64,0.19,13,12,10,5,203.64,200.28,201.95999999999998
2015-04-11,1610612748,1610612761,2014,104.0,107.0,211.0,97.25,95.5,100.6,99.2,79,35,44,0.443,79,47,32,0.595,19,16,26,21,195.0,206.0,200.5
2015-04-11,1610612741,1610612755,2014,114.0,107.0,221.0,94.0,91.0,97.85,106.0,79,47,32,0.595,79,18,61,0.228,25,22,12,6,185.44,207.68,196.56
2015-04-11,1610612746,1610612763,2014,94.0,86.0,180.0,109.85,106.5,98.25,97.5,79,53,26,0.6709999999999999,79,54,25,0.684,28,25,30,24,214.36,193.96,204.16000000000003
2015-04-11,1610612757,1610612762,2014,105.0,111.0,216.0,104.75,105.45,95.55,106.55,79,51,28,0.6459999999999999,79,36,43,0.456,32,19,20,16,209.44,200.2,204.82
2015-04-11,1610612744,1610612750,2014,110.0,101.0,211.0,107.5,105.85,110.05,111.2,79,64,15,0.81,79,16,63,0.203,36,28,9,7,199.04,209.4,204.22
2015-04-10,1610612753,1610612761,2014,99.0,101.0,200.0,96.55,103.5,100.6,99.2,78,25,53,0.321,78,46,32,0.59,13,12,26,20,203.64,206.0,204.82
2015-04-10,1610612737,1610612766,2014,104.0,80.0,184.0,96.35,95.7,99.45,97.7,78,59,19,0.7559999999999999,78,33,45,0.423,34,25,19,14,199.44,194.96,197.2
2015-04-10,1610612751,1610612764,2014,117.0,80.0,197.0,96.7,98.4,94.7,91.35,78,36,42,0.462,78,45,33,0.5770000000000001,17,19,28,17,196.96,193.0,194.98000000000002
2015-04-10,1610612739,1610612738,2014,90.0,99.0,189.0,101.9,101.55,99.65,105.5,78,51,27,0.654,78,36,42,0.462,29,22,19,17,195.48,195.08,195.28
2015-04-10,1610612765,1610612754,2014,103.0,107.0,210.0,100.85,105.95,92.05,92.25,78,30,48,0.385,78,35,43,0.449,17,13,21,14,206.0,187.28,196.64
2015-04-10,1610612752,1610612749,2014,91.0,99.0,190.0,101.2,97.2,99.8,108.15,78,15,63,0.192,78,38,40,0.487,10,5,22,16,200.28,200.48,200.38
2015-04-10,1610612745,1610612759,2014,103.0,104.0,207.0,112.7,109.85,107.75,96.55,78,53,25,0.679,79,53,26,0.6709999999999999,28,25,32,21,216.24,204.12,210.18
2015-04-10,1610612740,1610612756,2014,90.0,75.0,165.0,100.45,104.8,106.25,103.85,78,42,36,0.5379999999999999,79,39,40,0.494,26,16,22,17,200.8,212.88,206.84
2015-04-10,1610612760,1610612758,2014,116.0,103.0,219.0,101.8,103.4,97.75,101.5,78,42,36,0.5379999999999999,78,27,51,0.34600000000000003,27,15,17,10,210.36,207.08,208.72000000000003
2015-04-10,1610612743,1610612742,2014,143.0,144.0,287.0,109.2,110.3,104.45,102.7,78,29,49,0.3720000000000001,78,47,31,0.603,18,11,26,21,217.04,213.0,215.01999999999998
2015-04-10,1610612762,1610612763,2014,88.0,89.0,177.0,95.55,106.55,98.25,97.5,78,36,42,0.462,78,53,25,0.679,20,16,30,23,200.2,193.96,197.07999999999998
2015-04-10,1610612747,1610612750,2014,106.0,98.0,204.0,107.3,114.65,110.05,111.2,78,20,58,0.256,78,16,62,0.205,11,9,9,7,219.28,209.4,214.34
2015-04-09,1610612748,1610612741,2014,78.0,89.0,167.0,97.25,95.5,94.0,91.0,78,35,43,0.449,78,46,32,0.59,19,16,25,21,195.0,185.44,190.22
2015-04-09,1610612744,1610612757,2014,116.0,105.0,221.0,107.5,105.85,104.75,105.45,78,63,15,0.8079999999999999,78,51,27,0.654,35,28,32,19,199.04,209.44,204.24
2015-04-08,1610612766,1610612761,2014,74.0,92.0,166.0,99.45,97.7,100.6,99.2,77,33,44,0.429,77,45,32,0.584,19,14,26,19,194.96,206.0,200.48000000000002
2015-04-08,1610612753,1610612741,2014,105.0,103.0,208.0,96.55,103.5,94.0,91.0,77,24,53,0.312,77,46,31,0.597,12,12,25,21,203.64,185.44,194.54
2015-04-08,1610612755,1610612764,2014,90.0,119.0,209.0,97.85,106.0,94.7,91.35,78,18,60,0.231,77,44,33,0.5710000000000001,12,6,28,16,207.68,193.0,200.34
2015-04-08,1610612765,1610612738,2014,103.0,113.0,216.0,100.85,105.95,99.65,105.5,77,30,47,0.39,77,35,42,0.455,17,13,19,16,206.0,195.08,200.54000000000002
2015-04-08,1610612751,1610612737,2014,111.0,114.0,225.0,96.7,98.4,96.35,95.7,77,36,41,0.468,77,58,19,0.753,17,19,34,24,196.96,199.44,198.2
2015-04-08,1610612752,1610612754,2014,86.0,102.0,188.0,101.2,97.2,92.05,92.25,77,15,62,0.195,77,34,43,0.442,10,5,21,13,200.28,187.28,193.78
2015-04-08,1610612763,1610612740,2014,110.0,74.0,184.0,98.25,97.5,100.45,104.8,77,52,25,0.675,77,42,35,0.545,29,23,26,16,193.96,200.8,197.38
2015-04-08,1610612749,1610612739,2014,99.0,104.0,203.0,99.8,108.15,101.9,101.55,77,38,39,0.494,77,50,27,0.649,22,16,29,21,200.48,195.48,197.98
2015-04-08,1610612759,1610612745,2014,110.0,98.0,208.0,107.75,96.55,112.7,109.85,78,52,26,0.667,77,53,24,0.688,31,21,28,25,204.12,216.24,210.18
2015-04-08,1610612743,1610612747,2014,119.0,101.0,220.0,109.2,110.3,107.3,114.65,77,28,49,0.364,77,20,57,0.26,17,11,11,9,217.04,219.28,218.16
2015-04-08,1610612762,1610612758,2014,103.0,91.0,194.0,95.55,106.55,97.75,101.5,77,35,42,0.455,77,27,50,0.35100000000000003,19,16,17,10,200.2,207.08,203.64
2015-04-08,1610612742,1610612756,2014,107.0,104.0,211.0,104.45,102.7,106.25,103.85,77,46,31,0.597,78,39,39,0.5,25,21,22,17,213.0,212.88,212.94
2015-04-08,1610612757,1610612750,2014,116.0,91.0,207.0,104.75,105.45,110.05,111.2,77,50,27,0.649,77,16,61,0.208,31,19,9,7,209.44,209.4,209.42000000000002
2015-04-07,1610612737,1610612756,2014,96.0,69.0,165.0,96.35,95.7,106.25,103.85,76,57,19,0.75,77,39,38,0.506,33,24,22,17,199.44,212.88,206.16
2015-04-07,1610612748,1610612766,2014,105.0,100.0,205.0,97.25,95.5,99.45,97.7,77,34,43,0.442,76,33,43,0.434,18,16,19,14,195.0,194.96,194.98000000000002
2015-04-07,1610612740,1610612744,2014,103.0,100.0,203.0,100.45,104.8,107.5,105.85,76,41,35,0.539,77,63,14,0.818,25,16,35,28,200.8,199.04,199.92000000000002
2015-04-07,1610612760,1610612759,2014,88.0,113.0,201.0,101.8,103.4,107.75,96.55,77,42,35,0.545,77,51,26,0.662,27,15,31,20,210.36,204.12,207.24
2015-04-07,1610612758,1610612750,2014,116.0,111.0,227.0,97.75,101.5,110.05,111.2,76,26,50,0.342,76,16,60,0.211,16,10,9,7,207.08,209.4,208.24
2015-04-07,1610612746,1610612747,2014,105.0,100.0,205.0,109.85,106.5,107.3,114.65,78,52,26,0.667,76,20,56,0.263,27,25,11,9,214.36,219.28,216.82
2015-04-06,1610612751,1610612757,2014,106.0,96.0,202.0,96.7,98.4,104.75,105.45,76,35,41,0.461,76,50,26,0.6579999999999999,16,19,31,19,196.96,209.44,203.2
2015-04-05,1610612760,1610612745,2014,112.0,115.0,227.0,101.8,103.4,112.7,109.85,76,42,34,0.5529999999999999,76,52,24,0.684,27,15,28,24,210.36,216.24,213.3
2015-04-05,1610612739,1610612741,2014,99.0,94.0,193.0,101.9,101.55,94.0,91.0,76,49,27,0.645,76,46,30,0.605,28,21,25,21,195.48,185.44,190.45999999999998
2015-04-05,1610612754,1610612748,2014,112.0,89.0,201.0,92.05,92.25,97.25,95.5,76,33,43,0.434,76,34,42,0.447,20,13,18,16,187.28,195.0,191.14
2015-04-05,1610612759,1610612744,2014,107.0,92.0,199.0,107.75,96.55,107.5,105.85,76,50,26,0.6579999999999999,76,63,13,0.8290000000000001,30,20,35,28,204.12,199.04,201.57999999999998
2015-04-05,1610612752,1610612755,2014,101.0,91.0,192.0,101.2,97.2,97.85,106.0,76,14,62,0.184,77,18,59,0.234,9,5,12,6,200.28,207.68,203.98000000000002
2015-04-05,1610612758,1610612762,2014,95.0,101.0,196.0,97.75,101.5,95.55,106.55,75,26,49,0.34700000000000003,76,34,42,0.447,16,10,19,15,207.08,200.2,203.64
2015-04-05,1610612747,1610612746,2014,78.0,106.0,184.0,107.3,114.65,109.85,106.5,75,20,55,0.267,77,51,26,0.662,11,9,27,24,219.28,214.36,216.82
2015-04-04,1610612766,1610612755,2014,92.0,91.0,183.0,99.45,97.7,97.85,106.0,75,32,43,0.4270000000000001,76,18,58,0.237,18,14,12,6,194.96,207.68,201.32
2015-04-04,1610612737,1610612751,2014,131.0,99.0,230.0,96.35,95.7,96.7,98.4,75,56,19,0.747,75,35,40,0.467,32,24,16,19,199.44,196.96,198.2
2015-04-04,1610612765,1610612748,2014,99.0,98.0,197.0,100.85,105.95,97.25,95.5,76,29,47,0.382,75,34,41,0.453,16,13,18,16,206.0,195.0,200.5
2015-04-04,1610612761,1610612738,2014,116.0,117.0,233.0,100.6,99.2,99.65,105.5,76,45,31,0.5920000000000001,76,34,42,0.447,26,19,19,15,206.0,195.08,200.54000000000002
2015-04-04,1610612763,1610612764,2014,83.0,92.0,175.0,98.25,97.5,94.7,91.35,76,52,24,0.684,76,43,33,0.5660000000000001,29,23,28,15,193.96,193.0,193.48000000000002
2015-04-04,1610612742,1610612744,2014,110.0,123.0,233.0,104.45,102.7,107.5,105.85,76,46,30,0.605,75,62,13,0.8270000000000001,25,21,35,27,213.0,199.04,206.01999999999998
2015-04-04,1610612749,1610612753,2014,90.0,97.0,187.0,99.8,108.15,96.55,103.5,76,38,38,0.5,76,23,53,0.303,22,16,12,11,200.48,203.64,202.06
2015-04-04,1610612743,1610612746,2014,92.0,107.0,199.0,109.2,110.3,109.85,106.5,76,28,48,0.368,76,50,26,0.6579999999999999,17,11,27,23,217.04,214.36,215.7
2015-04-04,1610612756,1610612762,2014,87.0,85.0,172.0,106.25,103.85,95.55,106.55,76,38,38,0.5,75,34,41,0.453,21,17,19,15,212.88,200.2,206.54
2015-04-04,1610612757,1610612740,2014,99.0,90.0,189.0,104.75,105.45,100.45,104.8,75,49,26,0.653,75,41,34,0.547,30,19,25,16,209.44,200.8,205.12
2015-04-03,1610612754,1610612766,2014,93.0,74.0,167.0,92.05,92.25,99.45,97.7,75,32,43,0.4270000000000001,74,32,42,0.4320000000000001,19,13,18,14,187.28,194.96,191.12
2015-04-03,1610612764,1610612752,2014,101.0,87.0,188.0,94.7,91.35,101.2,97.2,75,42,33,0.56,75,14,61,0.187,27,15,9,5,193.0,200.28,196.64
2015-04-03,1610612738,1610612749,2014,101.0,110.0,211.0,99.65,105.5,99.8,108.15,75,34,41,0.453,75,37,38,0.493,19,15,22,15,195.08,200.48,197.78
2015-04-03,1610612751,1610612761,2014,114.0,109.0,223.0,96.7,98.4,100.6,99.2,74,34,40,0.459,75,45,30,0.6,15,19,26,19,196.96,206.0,201.48000000000002
2015-04-03,1610612741,1610612765,2014,88.0,82.0,170.0,94.0,91.0,100.85,105.95,75,45,30,0.6,75,29,46,0.387,24,21,16,13,185.44,206.0,195.72
2015-04-03,1610612763,1610612760,2014,100.0,92.0,192.0,98.25,97.5,101.8,103.4,75,51,24,0.68,75,42,33,0.56,28,23,27,15,193.96,210.36,202.16000000000003
2015-04-03,1610612750,1610612753,2014,84.0,97.0,181.0,110.05,111.2,96.55,103.5,75,16,59,0.213,75,22,53,0.293,9,7,12,10,209.4,203.64,206.51999999999998
2015-04-03,1610612759,1610612743,2014,123.0,93.0,216.0,107.75,96.55,109.2,110.3,75,49,26,0.653,75,28,47,0.373,29,20,17,11,204.12,217.04,210.57999999999998
2015-04-03,1610612758,1610612740,2014,95.0,101.0,196.0,97.75,101.5,100.45,104.8,74,26,48,0.35100000000000003,74,40,34,0.541,16,10,25,15,207.08,200.8,203.94
2015-04-03,1610612747,1610612757,2014,77.0,107.0,184.0,107.3,114.65,104.75,105.45,74,20,54,0.27,74,48,26,0.649,11,9,30,18,219.28,209.44,214.36
2015-04-02,1610612739,1610612748,2014,114.0,88.0,202.0,101.9,101.55,97.25,95.5,75,48,27,0.64,74,34,40,0.459,27,21,18,16,195.48,195.0,195.24
2015-04-02,1610612742,1610612745,2014,101.0,108.0,209.0,104.45,102.7,112.7,109.85,75,46,29,0.613,75,51,24,0.68,25,21,28,23,213.0,216.24,214.62
2015-04-02,1610612744,1610612756,2014,107.0,106.0,213.0,107.5,105.85,106.25,103.85,74,61,13,0.8240000000000001,75,38,37,0.507,34,27,21,17,199.04,212.88,205.95999999999998
2015-04-01,1610612766,1610612765,2014,102.0,78.0,180.0,99.45,97.7,100.85,105.95,73,31,42,0.425,74,29,45,0.392,17,14,16,13,194.96,206.0,200.48000000000002
2015-04-01,1610612753,1610612759,2014,91.0,103.0,194.0,96.55,103.5,107.75,96.55,74,22,52,0.297,74,48,26,0.649,12,10,29,19,203.64,204.12,203.88
2015-04-01,1610612764,1610612755,2014,106.0,93.0,199.0,94.7,91.35,97.85,106.0,74,41,33,0.5539999999999999,75,18,57,0.24,26,15,12,6,193.0,207.68,200.34
2015-04-01,1610612738,1610612754,2014,100.0,87.0,187.0,99.65,105.5,92.05,92.25,74,33,41,0.446,74,32,42,0.4320000000000001,18,15,19,13,195.08,187.28,191.18
2015-04-01,1610612752,1610612751,2014,98.0,100.0,198.0,101.2,97.2,96.7,98.4,74,14,60,0.189,73,33,40,0.452,9,5,15,18,200.28,196.96,198.62
2015-04-01,1610612745,1610612758,2014,115.0,111.0,226.0,112.7,109.85,97.75,101.5,74,50,24,0.6759999999999999,73,26,47,0.35600000000000004,27,23,16,10,216.24,207.08,211.66000000000003
2015-04-01,1610612749,1610612741,2014,95.0,91.0,186.0,99.8,108.15,94.0,91.0,74,36,38,0.486,74,45,29,0.608,21,15,24,21,200.48,185.44,192.95999999999998
2015-04-01,1610612750,1610612761,2014,99.0,113.0,212.0,110.05,111.2,100.6,99.2,74,16,58,0.21600000000000005,74,44,30,0.595,9,7,26,18,209.4,206.0,207.7
2015-04-01,1610612760,1610612742,2014,131.0,135.0,266.0,101.8,103.4,104.45,102.7,74,42,32,0.568,74,45,29,0.608,27,15,25,20,210.36,213.0,211.68
2015-04-01,1610612762,1610612743,2014,98.0,84.0,182.0,95.55,106.55,109.2,110.3,74,33,41,0.446,74,28,46,0.378,18,15,17,11,200.2,217.04,208.62
2015-04-01,1610612757,1610612746,2014,122.0,126.0,248.0,104.75,105.45,109.85,106.5,73,48,25,0.6579999999999999,75,49,26,0.653,30,18,27,22,209.44,214.36,211.9
2015-04-01,1610612747,1610612740,2014,92.0,113.0,205.0,107.3,114.65,100.45,104.8,73,20,53,0.274,73,39,34,0.534,11,9,25,14,219.28,200.8,210.04000000000002
2015-03-31,1610612751,1610612754,2014,111.0,106.0,217.0,96.7,98.4,92.05,92.25,72,32,40,0.444,73,32,41,0.438,14,18,19,13,196.96,187.28,192.12
2015-03-31,1610612765,1610612737,2014,105.0,95.0,200.0,100.85,105.95,96.35,95.7,73,28,45,0.384,74,56,18,0.757,15,13,32,24,206.0,199.44,202.72
2015-03-31,1610612748,1610612759,2014,81.0,95.0,176.0,97.25,95.5,107.75,96.55,73,34,39,0.466,73,47,26,0.644,18,16,29,18,195.0,204.12,199.56
2015-03-31,1610612746,1610612744,2014,106.0,110.0,216.0,109.85,106.5,107.5,105.85,74,49,25,0.662,73,60,13,0.8220000000000001,27,22,34,26,214.36,199.04,206.7
2015-03-30,1610612766,1610612738,2014,104.0,116.0,220.0,99.45,97.7,99.65,105.5,72,31,41,0.431,73,32,41,0.438,17,14,18,14,194.96,195.08,195.02
2015-03-30,1610612755,1610612747,2014,111.0,113.0,224.0,97.85,106.0,107.3,114.65,74,18,56,0.243,72,19,53,0.264,12,6,11,8,207.68,219.28,213.48000000000002
2015-03-30,1610612737,1610612749,2014,101.0,88.0,189.0,96.35,95.7,99.8,108.15,73,55,18,0.753,73,36,37,0.493,31,24,21,15,199.44,200.48,199.95999999999998
2015-03-30,1610612761,1610612745,2014,99.0,96.0,195.0,100.6,99.2,112.7,109.85,73,43,30,0.589,73,50,23,0.685,25,18,27,23,206.0,216.24,211.12
2015-03-30,1610612763,1610612758,2014,97.0,83.0,180.0,98.25,97.5,97.75,101.5,74,50,24,0.6759999999999999,72,26,46,0.361,27,23,16,10,193.96,207.08,200.52
2015-03-30,1610612750,1610612762,2014,84.0,104.0,188.0,110.05,111.2,95.55,106.55,73,16,57,0.219,73,32,41,0.438,9,7,18,14,209.4,200.2,204.8
2015-03-30,1610612757,1610612756,2014,109.0,86.0,195.0,104.75,105.45,106.25,103.85,72,47,25,0.653,74,38,36,0.514,29,18,21,17,209.44,212.88,211.16
2015-03-29,1610612764,1610612745,2014,91.0,99.0,190.0,94.7,91.35,112.7,109.85,73,41,32,0.562,72,49,23,0.6809999999999999,26,15,27,22,193.0,216.24,204.62
2015-03-29,1610612751,1610612747,2014,107.0,99.0,206.0,96.7,98.4,107.3,114.65,71,31,40,0.4370000000000001,71,19,52,0.268,13,18,11,8,196.96,219.28,208.12
2015-03-29,1610612740,1610612750,2014,110.0,88.0,198.0,100.45,104.8,110.05,111.2,72,38,34,0.528,72,16,56,0.222,24,14,9,7,200.8,209.4,205.10000000000002
2015-03-29,1610612739,1610612755,2014,87.0,86.0,173.0,101.9,101.55,97.85,106.0,74,47,27,0.635,73,18,55,0.247,26,21,12,6,195.48,207.68,201.57999999999998
2015-03-29,1610612738,1610612746,2014,106.0,119.0,225.0,99.65,105.5,109.85,106.5,72,32,40,0.444,73,48,25,0.6579999999999999,18,14,27,21,195.08,214.36,204.72000000000003
2015-03-29,1610612748,1610612765,2014,109.0,102.0,211.0,97.25,95.5,100.85,105.95,72,33,39,0.458,72,28,44,0.389,17,16,15,13,195.0,206.0,200.5
2015-03-29,1610612759,1610612763,2014,103.0,89.0,192.0,107.75,96.55,98.25,97.5,72,46,26,0.639,73,50,23,0.685,28,18,27,23,204.12,193.96,199.04000000000002
2015-03-29,1610612754,1610612742,2014,104.0,99.0,203.0,92.05,92.25,104.45,102.7,72,31,41,0.431,73,45,28,0.616,18,13,25,20,187.28,213.0,200.14
2015-03-29,1610612756,1610612760,2014,97.0,109.0,206.0,106.25,103.85,101.8,103.4,73,38,35,0.521,73,41,32,0.562,21,17,27,14,212.88,210.36,211.62
2015-03-28,1610612766,1610612737,2014,115.0,100.0,215.0,99.45,97.7,96.35,95.7,71,30,41,0.423,72,55,17,0.764,16,14,31,24,194.96,199.44,197.2
2015-03-28,1610612741,1610612752,2014,111.0,80.0,191.0,94.0,91.0,101.2,97.2,73,44,29,0.603,73,14,59,0.192,23,21,9,5,185.44,200.28,192.86
2015-03-28,1610612749,1610612744,2014,95.0,108.0,203.0,99.8,108.15,107.5,105.85,72,36,36,0.5,72,59,13,0.8190000000000001,21,15,34,25,200.48,199.04,199.76
2015-03-28,1610612762,1610612760,2014,94.0,89.0,183.0,95.55,106.55,101.8,103.4,72,31,41,0.431,72,41,31,0.569,17,14,27,14,200.2,210.36,205.28
2015-03-28,1610612757,1610612743,2014,120.0,114.0,234.0,104.75,105.45,109.2,110.3,71,46,25,0.648,73,28,45,0.384,28,18,17,11,209.44,217.04,213.24
2015-03-27,1610612753,1610612765,2014,97.0,111.0,208.0,96.55,103.5,100.85,105.95,73,22,51,0.301,71,27,44,0.38,12,10,15,12,203.64,206.0,204.82
2015-03-27,1610612755,1610612746,2014,98.0,119.0,217.0,97.85,106.0,109.85,106.5,72,18,54,0.25,72,47,25,0.653,12,6,27,20,207.68,214.36,211.02
2015-03-27,1610612764,1610612766,2014,110.0,107.0,217.0,94.7,91.35,99.45,97.7,72,40,32,0.556,70,30,40,0.429,25,15,16,14,193.0,194.96,193.98000000000002
2015-03-27,1610612737,1610612748,2014,99.0,86.0,185.0,96.35,95.7,97.25,95.5,71,54,17,0.7609999999999999,71,33,38,0.465,30,24,17,16,199.44,195.0,197.22
2015-03-27,1610612751,1610612739,2014,106.0,98.0,204.0,96.7,98.4,101.9,101.55,70,30,40,0.429,73,47,26,0.644,12,18,26,21,196.96,195.48,196.22
2015-03-27,1610612752,1610612738,2014,92.0,96.0,188.0,101.2,97.2,99.65,105.5,72,14,58,0.194,71,31,40,0.4370000000000001,9,5,18,13,200.28,195.08,197.68
2015-03-27,1610612761,1610612747,2014,94.0,83.0,177.0,100.6,99.2,107.3,114.65,72,42,30,0.583,70,19,51,0.271,24,18,11,8,206.0,219.28,212.64
2015-03-27,1610612745,1610612750,2014,120.0,110.0,230.0,112.7,109.85,110.05,111.2,71,48,23,0.6759999999999999,71,16,55,0.225,26,22,9,7,216.24,209.4,212.82
2015-03-27,1610612763,1610612744,2014,84.0,107.0,191.0,98.25,97.5,107.5,105.85,72,50,22,0.6940000000000001,71,58,13,0.8170000000000001,27,23,34,24,193.96,199.04,196.5
2015-03-27,1610612740,1610612758,2014,102.0,88.0,190.0,100.45,104.8,97.75,101.5,71,37,34,0.521,71,26,45,0.366,23,14,16,10,200.8,207.08,203.94
2015-03-27,1610612759,1610612742,2014,94.0,76.0,170.0,107.75,96.55,104.45,102.7,71,45,26,0.634,72,45,27,0.625,27,18,25,20,204.12,213.0,208.56
2015-03-27,1610612743,1610612762,2014,107.0,91.0,198.0,109.2,110.3,95.55,106.55,72,27,45,0.375,71,31,40,0.4370000000000001,16,11,17,14,217.04,200.2,208.62
2015-03-27,1610612756,1610612757,2014,81.0,87.0,168.0,106.25,103.85,104.75,105.45,72,38,34,0.528,70,45,25,0.643,21,17,28,17,212.88,209.44,211.16
2015-03-26,1610612749,1610612754,2014,111.0,107.0,218.0,99.8,108.15,92.05,92.25,71,35,36,0.493,71,31,40,0.4370000000000001,20,15,18,13,200.48,187.28,193.88
2015-03-25,1610612766,1610612751,2014,88.0,91.0,179.0,99.45,97.7,96.7,98.4,69,30,39,0.435,69,29,40,0.42,16,14,12,17,194.96,196.96,195.96
2015-03-25,1610612752,1610612746,2014,80.0,111.0,191.0,101.2,97.2,109.85,106.5,71,14,57,0.197,71,46,25,0.648,9,5,27,19,200.28,214.36,207.32
2015-03-25,1610612753,1610612737,2014,83.0,95.0,178.0,96.55,103.5,96.35,95.7,72,22,50,0.306,70,53,17,0.757,12,10,30,23,203.64,199.44,201.54
2015-03-25,1610612764,1610612754,2014,101.0,103.0,204.0,94.7,91.35,92.05,92.25,71,40,31,0.563,70,30,40,0.429,25,15,18,12,193.0,187.28,190.14
2015-03-25,1610612761,1610612741,2014,103.0,116.0,219.0,100.6,99.2,94.0,91.0,71,42,29,0.5920000000000001,72,43,29,0.597,24,18,23,20,206.0,185.44,195.72
2015-03-25,1610612738,1610612748,2014,86.0,93.0,179.0,99.65,105.5,97.25,95.5,70,31,39,0.443,70,32,38,0.457,18,13,17,15,195.08,195.0,195.04000000000002
2015-03-25,1610612763,1610612739,2014,89.0,111.0,200.0,98.25,97.5,101.9,101.55,71,50,21,0.7040000000000001,72,46,26,0.639,27,23,26,20,193.96,195.48,194.72
2015-03-25,1610612750,1610612747,2014,99.0,101.0,200.0,110.05,111.2,107.3,114.65,70,16,54,0.229,69,18,51,0.261,9,7,11,7,209.4,219.28,214.34
2015-03-25,1610612740,1610612745,2014,93.0,95.0,188.0,100.45,104.8,112.7,109.85,70,37,33,0.529,70,47,23,0.6709999999999999,23,14,26,21,200.8,216.24,208.52
2015-03-25,1610612743,1610612755,2014,85.0,99.0,184.0,109.2,110.3,97.85,106.0,71,27,44,0.38,71,17,54,0.239,16,11,12,5,217.04,207.68,212.36
2015-03-25,1610612762,1610612757,2014,89.0,92.0,181.0,95.55,106.55,104.75,105.45,70,31,39,0.443,69,44,25,0.638,17,14,28,16,200.2,209.44,204.82
2015-03-25,1610612759,1610612760,2014,130.0,91.0,221.0,107.75,96.55,101.8,103.4,70,44,26,0.629,71,41,30,0.5770000000000001,26,18,27,14,204.12,210.36,207.24
2015-03-25,1610612756,1610612758,2014,99.0,108.0,207.0,106.25,103.85,97.75,101.5,71,38,33,0.535,70,25,45,0.35700000000000004,21,17,16,9,212.88,207.08,209.98000000000002
2015-03-24,1610612765,1610612761,2014,108.0,104.0,212.0,100.85,105.95,100.6,99.2,70,26,44,0.371,70,42,28,0.6,14,12,24,18,206.0,206.0,206.0
2015-03-24,1610612749,1610612748,2014,89.0,88.0,177.0,99.8,108.15,97.25,95.5,70,34,36,0.486,69,32,37,0.464,19,15,17,15,200.48,195.0,197.74
2015-03-24,1610612760,1610612747,2014,127.0,117.0,244.0,101.8,103.4,107.3,114.65,70,40,30,0.5710000000000001,68,18,50,0.265,26,14,11,7,210.36,219.28,214.82
2015-03-24,1610612742,1610612759,2014,101.0,94.0,195.0,104.45,102.7,107.75,96.55,71,44,27,0.62,69,44,25,0.638,24,20,26,18,213.0,204.12,208.56
2015-03-24,1610612758,1610612755,2014,107.0,106.0,213.0,97.75,101.5,97.85,106.0,69,24,45,0.348,70,17,53,0.243,15,9,12,5,207.08,207.68,207.38
2015-03-24,1610612757,1610612744,2014,108.0,122.0,230.0,104.75,105.45,107.5,105.85,68,44,24,0.647,70,57,13,0.8140000000000001,28,16,34,23,209.44,199.04,204.24
2015-03-23,1610612754,1610612745,2014,100.0,110.0,210.0,92.05,92.25,112.7,109.85,69,30,39,0.435,69,46,23,0.667,18,12,26,20,187.28,216.24,201.76
2015-03-23,1610612751,1610612738,2014,91.0,110.0,201.0,96.7,98.4,99.65,105.5,68,29,39,0.426,69,30,39,0.435,12,17,18,12,196.96,195.08,196.02
2015-03-23,1610612752,1610612763,2014,82.0,103.0,185.0,101.2,97.2,98.25,97.5,70,14,56,0.2,70,49,21,0.7,9,5,27,22,200.28,193.96,197.12
2015-03-23,1610612741,1610612766,2014,98.0,86.0,184.0,94.0,91.0,99.45,97.7,71,42,29,0.5920000000000001,68,30,38,0.441,22,20,16,14,185.44,194.96,190.2
2015-03-23,1610612762,1610612750,2014,104.0,106.0,210.0,95.55,106.55,110.05,111.2,69,31,38,0.449,69,15,54,0.217,17,14,9,6,200.2,209.4,204.8
2015-03-23,1610612744,1610612764,2014,107.0,76.0,183.0,107.5,105.85,94.7,91.35,69,56,13,0.812,70,40,30,0.5710000000000001,33,23,25,15,199.04,193.0,196.01999999999998
2015-03-22,1610612749,1610612739,2014,90.0,108.0,198.0,99.8,108.15,101.9,101.55,69,34,35,0.493,71,45,26,0.634,19,15,26,19,200.48,195.48,197.98
2015-03-22,1610612760,1610612748,2014,93.0,75.0,168.0,101.8,103.4,97.25,95.5,69,39,30,0.565,68,32,36,0.471,25,14,17,15,210.36,195.0,202.68
2015-03-22,1610612737,1610612759,2014,95.0,114.0,209.0,96.35,95.7,107.75,96.55,69,53,16,0.768,68,43,25,0.632,30,23,26,17,199.44,204.12,201.78
2015-03-22,1610612746,1610612740,2014,107.0,100.0,207.0,109.85,106.5,100.45,104.8,70,45,25,0.643,69,37,32,0.536,26,19,23,14,214.36,200.8,207.58
2015-03-22,1610612761,1610612752,2014,106.0,89.0,195.0,100.6,99.2,101.2,97.2,69,41,28,0.594,69,14,55,0.203,23,18,9,5,206.0,200.28,203.14
2015-03-22,1610612758,1610612764,2014,109.0,86.0,195.0,97.75,101.5,94.7,91.35,68,23,45,0.338,69,40,29,0.58,14,9,25,15,207.08,193.0,200.04000000000002
2015-03-22,1610612738,1610612765,2014,97.0,105.0,202.0,99.65,105.5,100.85,105.95,68,30,38,0.441,69,25,44,0.362,18,12,14,11,195.08,206.0,200.54000000000002
2015-03-22,1610612753,1610612743,2014,100.0,119.0,219.0,96.55,103.5,109.2,110.3,71,22,49,0.31,70,26,44,0.371,12,10,16,10,203.64,217.04,210.33999999999997
2015-03-22,1610612750,1610612766,2014,98.0,109.0,207.0,110.05,111.2,99.45,97.7,68,15,53,0.221,67,29,38,0.433,9,6,16,13,209.4,194.96,202.18
2015-03-22,1610612756,1610612742,2014,98.0,92.0,190.0,106.25,103.85,104.45,102.7,70,37,33,0.529,70,44,26,0.629,20,17,24,20,212.88,213.0,212.94
2015-03-22,1610612747,1610612755,2014,101.0,87.0,188.0,107.3,114.65,97.85,106.0,67,17,50,0.254,69,17,52,0.246,10,7,12,5,219.28,207.68,213.48000000000002
2015-03-21,1610612754,1610612751,2014,111.0,123.0,234.0,92.05,92.25,96.7,98.4,68,30,38,0.441,67,28,39,0.418,18,12,12,16,187.28,196.96,192.12
2015-03-21,1610612765,1610612741,2014,107.0,91.0,198.0,100.85,105.95,94.0,91.0,68,24,44,0.353,70,42,28,0.6,13,11,22,20,206.0,185.44,195.72
2015-03-21,1610612745,1610612756,2014,102.0,117.0,219.0,112.7,109.85,106.25,103.85,68,46,22,0.6759999999999999,69,36,33,0.522,26,20,20,16,216.24,212.88,214.56
2015-03-21,1610612763,1610612757,2014,97.0,86.0,183.0,98.25,97.5,104.75,105.45,69,48,21,0.696,67,44,23,0.657,26,22,28,16,193.96,209.44,201.7
2015-03-21,1610612744,1610612762,2014,106.0,91.0,197.0,107.5,105.85,95.55,106.55,68,55,13,0.809,68,31,37,0.456,32,23,17,14,199.04,200.2,199.62
2015-03-20,1610612753,1610612757,2014,111.0,104.0,215.0,96.55,103.5,104.75,105.45,70,21,49,0.3,66,44,22,0.667,11,10,28,16,203.64,209.44,206.54
2015-03-20,1610612755,1610612752,2014,97.0,81.0,178.0,97.85,106.0,101.2,97.2,68,16,52,0.235,68,14,54,0.206,11,5,9,5,207.68,200.28,203.98000000000002
2015-03-20,1610612751,1610612749,2014,129.0,127.0,256.0,96.7,98.4,99.8,108.15,66,27,39,0.409,68,34,34,0.5,11,16,19,15,196.96,200.48,198.72
2015-03-20,1610612739,1610612754,2014,95.0,92.0,187.0,101.9,101.55,92.05,92.25,70,44,26,0.629,67,30,37,0.448,25,19,18,12,195.48,187.28,191.38
2015-03-20,1610612748,1610612743,2014,108.0,91.0,199.0,97.25,95.5,109.2,110.3,67,31,36,0.463,69,26,43,0.377,16,15,16,10,195.0,217.04,206.01999999999998
2015-03-20,1610612741,1610612761,2014,108.0,92.0,200.0,94.0,91.0,100.6,99.2,69,41,28,0.594,68,41,27,0.603,21,20,23,18,185.44,206.0,195.72
2015-03-20,1610612760,1610612737,2014,123.0,115.0,238.0,101.8,103.4,96.35,95.7,68,38,30,0.5589999999999999,68,53,15,0.779,24,14,30,23,210.36,199.44,204.9
2015-03-20,1610612742,1610612763,2014,101.0,112.0,213.0,104.45,102.7,98.25,97.5,69,44,25,0.638,68,47,21,0.691,24,20,26,21,213.0,193.96,203.48000000000002
2015-03-20,1610612759,1610612738,2014,101.0,89.0,190.0,107.75,96.55,99.65,105.5,67,42,25,0.627,67,30,37,0.448,25,17,18,12,204.12,195.08,199.60000000000002
2015-03-20,1610612758,1610612766,2014,101.0,91.0,192.0,97.75,101.5,99.45,97.7,67,22,45,0.328,66,29,37,0.439,13,9,16,13,207.08,194.96,201.02
2015-03-20,1610612744,1610612740,2014,112.0,96.0,208.0,107.5,105.85,100.45,104.8,67,54,13,0.8059999999999999,68,37,31,0.544,31,23,23,14,199.04,200.8,199.92000000000002
2015-03-20,1610612746,1610612764,2014,113.0,99.0,212.0,109.85,106.5,94.7,91.35,69,44,25,0.638,68,40,28,0.588,25,19,25,15,214.36,193.0,203.68
2015-03-19,1610612752,1610612750,2014,92.0,95.0,187.0,101.2,97.2,110.05,111.2,67,14,53,0.209,67,14,53,0.209,9,5,9,5,200.28,209.4,204.84
2015-03-19,1610612745,1610612743,2014,118.0,108.0,226.0,112.7,109.85,109.2,110.3,67,45,22,0.672,68,26,42,0.382,25,20,16,10,216.24,217.04,216.64
2015-03-19,1610612756,1610612740,2014,74.0,72.0,146.0,106.25,103.85,100.45,104.8,68,35,33,0.515,67,37,30,0.552,19,16,23,14,212.88,200.8,206.84
2015-03-19,1610612747,1610612762,2014,73.0,80.0,153.0,107.3,114.65,95.55,106.55,66,17,49,0.258,67,30,37,0.448,10,7,17,13,219.28,200.2,209.74
2015-03-18,1610612739,1610612751,2014,117.0,92.0,209.0,101.9,101.55,96.7,98.4,69,43,26,0.623,65,27,38,0.415,24,19,11,16,195.48,196.96,196.22
2015-03-18,1610612755,1610612765,2014,94.0,83.0,177.0,97.85,106.0,100.85,105.95,67,15,52,0.224,67,24,43,0.358,10,5,13,11,207.68,206.0,206.84
2015-03-18,1610612748,1610612757,2014,108.0,104.0,212.0,97.25,95.5,104.75,105.45,66,30,36,0.455,65,44,21,0.677,15,15,28,16,195.0,209.44,202.22
2015-03-18,1610612761,1610612750,2014,105.0,100.0,205.0,100.6,99.2,110.05,111.2,67,40,27,0.597,66,14,52,0.212,22,18,9,5,206.0,209.4,207.7
2015-03-18,1610612741,1610612754,2014,103.0,86.0,189.0,94.0,91.0,92.05,92.25,68,40,28,0.588,66,30,36,0.455,20,20,18,12,185.44,187.28,186.36
2015-03-18,1610612749,1610612759,2014,103.0,114.0,217.0,99.8,108.15,107.75,96.55,67,34,33,0.507,66,41,25,0.621,19,15,25,16,200.48,204.12,202.3
2015-03-18,1610612760,1610612738,2014,122.0,118.0,240.0,101.8,103.4,99.65,105.5,67,37,30,0.552,66,30,36,0.455,23,14,18,12,210.36,195.08,202.72000000000003
2015-03-18,1610612742,1610612753,2014,107.0,102.0,209.0,104.45,102.7,96.55,103.5,68,43,25,0.632,69,21,48,0.304,23,20,11,10,213.0,203.64,208.32
2015-03-18,1610612758,1610612746,2014,105.0,116.0,221.0,97.75,101.5,109.85,106.5,66,22,44,0.333,68,43,25,0.632,13,9,25,18,207.08,214.36,210.72000000000003
2015-03-18,1610612744,1610612737,2014,114.0,95.0,209.0,107.5,105.85,96.35,95.7,66,53,13,0.8029999999999999,67,53,14,0.7909999999999999,30,23,30,23,199.04,199.44,199.24
2015-03-18,1610612762,1610612764,2014,84.0,88.0,172.0,95.55,106.55,94.7,91.35,66,30,36,0.455,67,39,28,0.5820000000000001,17,13,25,14,200.2,193.0,196.6
2015-03-17,1610612765,1610612763,2014,105.0,95.0,200.0,100.85,105.95,98.25,97.5,66,23,43,0.348,67,47,20,0.701,12,11,26,21,206.0,193.96,199.98000000000002
2015-03-17,1610612752,1610612759,2014,104.0,100.0,204.0,101.2,97.2,107.75,96.55,66,13,53,0.197,65,41,24,0.631,8,5,25,16,200.28,204.12,202.2
2015-03-17,1610612745,1610612753,2014,107.0,94.0,201.0,112.7,109.85,96.55,103.5,66,44,22,0.667,68,21,47,0.309,24,20,11,10,216.24,203.64,209.94
2015-03-17,1610612740,1610612749,2014,85.0,84.0,169.0,100.45,104.8,99.8,108.15,66,36,30,0.545,66,34,32,0.515,22,14,19,15,200.8,200.48,200.64
2015-03-17,1610612746,1610612766,2014,99.0,92.0,191.0,109.85,106.5,99.45,97.7,67,42,25,0.627,65,29,36,0.446,24,18,16,13,214.36,194.96,204.66000000000003
2015-03-16,1610612754,1610612761,2014,98.0,117.0,215.0,92.05,92.25,100.6,99.2,65,30,35,0.462,66,39,27,0.591,18,12,22,17,187.28,206.0,196.64
2015-03-16,1610612764,1610612757,2014,105.0,97.0,202.0,94.7,91.35,104.75,105.45,66,38,28,0.5760000000000001,64,44,20,0.688,24,14,28,16,193.0,209.44,201.22
2015-03-16,1610612738,1610612755,2014,108.0,89.0,197.0,99.65,105.5,97.85,106.0,65,29,36,0.446,66,15,51,0.227,17,12,10,5,195.08,207.68,201.38
2015-03-16,1610612763,1610612743,2014,92.0,81.0,173.0,98.25,97.5,109.2,110.3,66,46,20,0.6970000000000001,67,26,41,0.388,25,21,16,10,193.96,217.04,205.5
2015-03-16,1610612750,1610612751,2014,106.0,122.0,228.0,110.05,111.2,96.7,98.4,65,14,51,0.215,64,26,38,0.406,9,5,11,15,209.4,196.96,203.18
2015-03-16,1610612748,1610612739,2014,106.0,92.0,198.0,97.25,95.5,101.9,101.55,65,29,36,0.446,68,43,25,0.632,14,15,24,19,195.0,195.48,195.24
2015-03-16,1610612742,1610612760,2014,119.0,115.0,234.0,104.45,102.7,101.8,103.4,67,42,25,0.627,66,37,29,0.561,22,20,23,14,213.0,210.36,211.68
2015-03-16,1610612762,1610612766,2014,94.0,66.0,160.0,95.55,106.55,99.45,97.7,65,29,36,0.446,64,29,35,0.453,16,13,16,13,200.2,194.96,197.57999999999998
2015-03-16,1610612758,1610612737,2014,103.0,110.0,213.0,97.75,101.5,96.35,95.7,65,22,43,0.338,66,52,14,0.7879999999999999,13,9,30,22,207.08,199.44,203.26
2015-03-16,1610612744,1610612747,2014,108.0,105.0,213.0,107.5,105.85,107.3,114.65,65,52,13,0.8,65,17,48,0.262,29,23,10,7,199.04,219.28,209.16
2015-03-15,1610612760,1610612741,2014,109.0,100.0,209.0,101.8,103.4,94.0,91.0,65,36,29,0.5539999999999999,67,40,27,0.597,22,14,20,20,210.36,185.44,197.9
2015-03-15,1610612746,1610612745,2014,98.0,100.0,198.0,109.85,106.5,112.7,109.85,66,42,24,0.636,65,43,22,0.662,24,18,24,19,214.36,216.24,215.3
2015-03-15,1610612740,1610612743,2014,111.0,118.0,229.0,100.45,104.8,109.2,110.3,65,36,29,0.5539999999999999,66,25,41,0.379,22,14,16,9,200.8,217.04,208.92000000000002
2015-03-15,1610612753,1610612739,2014,108.0,123.0,231.0,96.55,103.5,101.9,101.55,67,21,46,0.313,67,42,25,0.627,11,10,24,18,203.64,195.48,199.56
2015-03-15,1610612759,1610612750,2014,123.0,97.0,220.0,107.75,96.55,110.05,111.2,64,40,24,0.625,64,14,50,0.219,24,16,9,5,204.12,209.4,206.76
2015-03-15,1610612761,1610612757,2014,97.0,113.0,210.0,100.6,99.2,104.75,105.45,65,39,26,0.6,63,43,20,0.6829999999999999,22,17,28,15,206.0,209.44,207.72
2015-03-15,1610612756,1610612752,2014,102.0,89.0,191.0,106.25,103.85,101.2,97.2,67,34,33,0.507,65,13,52,0.2,18,16,8,5,212.88,200.28,206.57999999999998
2015-03-15,1610612747,1610612737,2014,86.0,91.0,177.0,107.3,114.65,96.35,95.7,64,17,47,0.266,65,51,14,0.785,10,7,30,21,219.28,199.44,209.36
2015-03-14,1610612754,1610612738,2014,89.0,93.0,182.0,92.05,92.25,99.65,105.5,64,30,34,0.469,64,28,36,0.438,18,12,17,11,187.28,195.08,191.18
2015-03-14,1610612764,1610612758,2014,113.0,97.0,210.0,94.7,91.35,97.75,101.5,65,37,28,0.569,64,22,42,0.344,23,14,13,9,193.0,207.08,200.04000000000002
2015-03-14,1610612755,1610612751,2014,87.0,94.0,181.0,97.85,106.0,96.7,98.4,65,15,50,0.231,63,25,38,0.397,10,5,11,14,207.68,196.96,202.32
2015-03-14,1610612763,1610612749,2014,96.0,83.0,179.0,98.25,97.5,99.8,108.15,65,45,20,0.6920000000000001,65,34,31,0.523,24,21,19,15,193.96,200.48,197.22
2015-03-14,1610612762,1610612765,2014,88.0,85.0,173.0,95.55,106.55,100.85,105.95,64,28,36,0.438,65,23,42,0.354,15,13,12,11,200.2,206.0,203.1
2015-03-14,1610612744,1610612752,2014,125.0,94.0,219.0,107.5,105.85,101.2,97.2,64,51,13,0.797,64,13,51,0.203,28,23,8,5,199.04,200.28,199.66
2015-03-13,1610612766,1610612741,2014,101.0,91.0,192.0,99.45,97.7,94.0,91.0,63,28,35,0.444,66,40,26,0.606,15,13,20,20,194.96,185.44,190.2
2015-03-13,1610612755,1610612758,2014,114.0,107.0,221.0,97.85,106.0,97.75,101.5,64,14,50,0.219,63,22,41,0.349,9,5,13,9,207.68,207.08,207.38
2015-03-13,1610612738,1610612753,2014,95.0,88.0,183.0,99.65,105.5,96.55,103.5,63,27,36,0.429,66,21,45,0.318,16,11,11,10,195.08,203.64,199.36
2015-03-13,1610612761,1610612748,2014,102.0,92.0,194.0,100.6,99.2,97.25,95.5,64,38,26,0.594,64,29,35,0.453,21,17,14,15,206.0,195.0,200.5
2015-03-13,1610612760,1610612750,2014,113.0,99.0,212.0,101.8,103.4,110.05,111.2,64,35,29,0.547,63,14,49,0.222,21,14,9,5,210.36,209.4,209.88
2015-03-13,1610612742,1610612746,2014,129.0,99.0,228.0,104.45,102.7,109.85,106.5,66,41,25,0.621,65,42,23,0.6459999999999999,21,20,24,18,213.0,214.36,213.68
2015-03-13,1610612743,1610612744,2014,114.0,103.0,217.0,109.2,110.3,107.5,105.85,65,24,41,0.369,63,51,12,0.81,15,9,28,23,217.04,199.04,208.04
2015-03-13,1610612756,1610612737,2014,87.0,96.0,183.0,106.25,103.85,96.35,95.7,66,34,32,0.515,64,50,14,0.7809999999999999,18,16,30,20,212.88,199.44,206.16
2015-03-13,1610612757,1610612765,2014,118.0,99.0,217.0,104.75,105.45,100.85,105.95,62,42,20,0.677,64,23,41,0.359,27,15,12,11,209.44,206.0,207.72
2015-03-12,1610612754,1610612749,2014,109.0,103.0,212.0,92.05,92.25,99.8,108.15,63,29,34,0.46,64,34,30,0.531,17,12,19,15,187.28,200.48,193.88
2015-03-12,1610612764,1610612763,2014,107.0,87.0,194.0,94.7,91.35,98.25,97.5,64,36,28,0.563,64,45,19,0.703,22,14,24,21,193.0,193.96,193.48000000000002
2015-03-12,1610612762,1610612745,2014,109.0,91.0,200.0,95.55,106.55,112.7,109.85,63,27,36,0.429,64,43,21,0.672,14,13,24,19,200.2,216.24,208.22
2015-03-12,1610612759,1610612739,2014,125.0,128.0,253.0,107.75,96.55,101.9,101.55,63,40,23,0.635,66,41,25,0.621,24,16,24,17,204.12,195.48,199.8
2015-03-12,1610612747,1610612752,2014,94.0,101.0,195.0,107.3,114.65,101.2,97.2,63,17,46,0.27,63,12,51,0.19,10,7,8,4,219.28,200.28,209.78
2015-03-11,1610612766,1610612758,2014,106.0,113.0,219.0,99.45,97.7,97.75,101.5,62,28,34,0.452,62,21,41,0.339,15,13,13,8,194.96,207.08,201.02
2015-03-11,1610612755,1610612741,2014,95.0,104.0,199.0,97.85,106.0,94.0,91.0,63,14,49,0.222,65,39,26,0.6,9,5,20,19,207.68,185.44,196.56
2015-03-11,1610612738,1610612763,2014,95.0,92.0,187.0,99.65,105.5,98.25,97.5,62,26,36,0.419,63,45,18,0.7140000000000001,15,11,24,21,195.08,193.96,194.52
2015-03-11,1610612748,1610612751,2014,104.0,98.0,202.0,97.25,95.5,96.7,98.4,63,28,35,0.444,62,25,37,0.403,13,15,11,14,195.0,196.96,195.98000000000002
2015-03-11,1610612749,1610612753,2014,97.0,91.0,188.0,99.8,108.15,96.55,103.5,63,33,30,0.524,65,21,44,0.32299999999999995,18,15,11,10,200.48,203.64,202.06
2015-03-11,1610612760,1610612746,2014,108.0,120.0,228.0,101.8,103.4,109.85,106.5,63,35,28,0.556,64,41,23,0.6409999999999999,21,14,24,17,210.36,214.36,212.36
2015-03-11,1610612743,1610612737,2014,115.0,102.0,217.0,109.2,110.3,96.35,95.7,64,23,41,0.359,63,50,13,0.794,14,9,30,20,217.04,199.44,208.24
2015-03-11,1610612756,1610612750,2014,106.0,97.0,203.0,106.25,103.85,110.05,111.2,65,33,32,0.508,62,14,48,0.226,17,16,9,5,212.88,209.4,211.14
2015-03-11,1610612744,1610612765,2014,105.0,98.0,203.0,107.5,105.85,100.85,105.95,62,50,12,0.8059999999999999,63,23,40,0.365,27,23,12,11,199.04,206.0,202.51999999999998
2015-03-11,1610612757,1610612745,2014,105.0,100.0,205.0,104.75,105.45,112.7,109.85,61,41,20,0.672,63,43,20,0.6829999999999999,26,15,24,19,209.44,216.24,212.84
2015-03-10,1610612754,1610612753,2014,118.0,86.0,204.0,92.05,92.25,96.55,103.5,62,28,34,0.452,64,21,43,0.328,16,12,11,10,187.28,203.64,195.45999999999998
2015-03-10,1610612751,1610612740,2014,91.0,111.0,202.0,96.7,98.4,100.45,104.8,61,25,36,0.41,64,35,29,0.547,11,14,22,13,196.96,200.8,198.88
2015-03-10,1610612742,1610612739,2014,94.0,127.0,221.0,104.45,102.7,101.9,101.55,65,41,24,0.631,65,40,25,0.615,21,20,24,16,213.0,195.48,204.24
2015-03-10,1610612759,1610612761,2014,117.0,107.0,224.0,107.75,96.55,100.6,99.2,62,39,23,0.629,63,38,25,0.603,23,16,21,17,204.12,206.0,205.06
2015-03-10,1610612762,1610612752,2014,87.0,82.0,169.0,95.55,106.55,101.2,97.2,62,26,36,0.419,62,12,50,0.194,13,13,8,4,200.2,200.28,200.24
2015-03-10,1610612747,1610612765,2014,93.0,85.0,178.0,107.3,114.65,100.85,105.95,62,16,46,0.258,62,23,39,0.371,9,7,12,11,219.28,206.0,212.64
2015-03-09,1610612766,1610612764,2014,69.0,95.0,164.0,99.45,97.7,94.7,91.35,61,28,33,0.459,63,35,28,0.556,15,13,22,13,194.96,193.0,193.98000000000002
2015-03-09,1610612737,1610612758,2014,130.0,105.0,235.0,96.35,95.7,97.75,101.5,62,49,13,0.79,61,21,40,0.344,29,20,13,8,199.44,207.08,203.26
2015-03-09,1610612748,1610612738,2014,90.0,100.0,190.0,97.25,95.5,99.65,105.5,62,28,34,0.452,61,25,36,0.41,13,15,15,10,195.0,195.08,195.04000000000002
2015-03-09,1610612741,1610612763,2014,91.0,101.0,192.0,94.0,91.0,98.25,97.5,64,39,25,0.609,62,44,18,0.71,20,19,24,20,185.44,193.96,189.7
2015-03-09,1610612749,1610612740,2014,103.0,114.0,217.0,99.8,108.15,100.45,104.8,62,33,29,0.532,63,34,29,0.54,18,15,22,12,200.48,200.8,200.64
2015-03-09,1610612743,1610612752,2014,106.0,78.0,184.0,109.2,110.3,101.2,97.2,63,22,41,0.349,61,12,49,0.197,13,9,8,4,217.04,200.28,208.66
2015-03-09,1610612756,1610612744,2014,80.0,98.0,178.0,106.25,103.85,107.5,105.85,64,33,31,0.516,61,49,12,0.8029999999999999,17,16,27,22,212.88,199.04,205.95999999999998
2015-03-09,1610612746,1610612750,2014,89.0,76.0,165.0,109.85,106.5,110.05,111.2,63,40,23,0.635,61,14,47,0.23,23,17,9,5,214.36,209.4,211.88
2015-03-08,1610612759,1610612741,2014,116.0,105.0,221.0,107.75,96.55,94.0,91.0,61,38,23,0.623,63,39,24,0.619,22,16,20,19,204.12,185.44,194.78
2015-03-08,1610612744,1610612746,2014,106.0,98.0,204.0,107.5,105.85,109.85,106.5,60,48,12,0.8,62,40,22,0.645,26,22,23,17,199.04,214.36,206.7
2015-03-08,1610612751,1610612762,2014,88.0,95.0,183.0,96.7,98.4,95.55,106.55,60,25,35,0.417,61,25,36,0.41,11,14,13,12,196.96,200.2,198.57999999999998
2015-03-08,1610612765,1610612766,2014,101.0,108.0,209.0,100.85,105.95,99.45,97.7,61,23,38,0.377,60,27,33,0.45,12,11,15,12,206.0,194.96,200.48000000000002
2015-03-08,1610612753,1610612738,2014,103.0,98.0,201.0,96.55,103.5,99.65,105.5,63,20,43,0.317,60,25,35,0.417,10,10,15,10,203.64,195.08,199.36
2015-03-08,1610612760,1610612761,2014,108.0,104.0,212.0,101.8,103.4,100.6,99.2,62,34,28,0.5479999999999999,62,38,24,0.613,20,14,21,17,210.36,206.0,208.18
2015-03-08,1610612747,1610612742,2014,93.0,100.0,193.0,107.3,114.65,104.45,102.7,61,16,45,0.262,64,40,24,0.625,9,7,21,19,219.28,213.0,216.14
2015-03-07,1610612740,1610612763,2014,95.0,89.0,184.0,100.45,104.8,98.25,97.5,62,33,29,0.532,61,44,17,0.721,21,12,24,20,200.8,193.96,197.38
2015-03-07,1610612739,1610612756,2014,89.0,79.0,168.0,101.9,101.55,106.25,103.85,64,39,25,0.609,63,33,30,0.524,23,16,17,16,195.48,212.88,204.18
2015-03-07,1610612748,1610612758,2014,114.0,109.0,223.0,97.25,95.5,97.75,101.5,61,27,34,0.443,60,21,39,0.35,12,15,13,8,195.0,207.08,201.04000000000002
2015-03-07,1610612752,1610612754,2014,86.0,92.0,178.0,101.2,97.2,92.05,92.25,60,12,48,0.2,61,27,34,0.443,8,4,16,11,200.28,187.28,193.78
2015-03-07,1610612755,1610612737,2014,92.0,84.0,176.0,97.85,106.0,96.35,95.7,62,13,49,0.21,61,49,12,0.8029999999999999,8,5,29,20,207.68,199.44,203.56
2015-03-07,1610612750,1610612757,2014,121.0,113.0,234.0,110.05,111.2,104.75,105.45,60,13,47,0.217,60,41,19,0.6829999999999999,8,5,26,15,209.4,209.44,209.42000000000002
2015-03-07,1610612749,1610612764,2014,91.0,85.0,176.0,99.8,108.15,94.7,91.35,61,32,29,0.525,62,35,27,0.565,17,15,22,13,200.48,193.0,196.74
2015-03-07,1610612743,1610612745,2014,100.0,114.0,214.0,109.2,110.3,112.7,109.85,62,22,40,0.355,62,42,20,0.677,13,9,24,18,217.04,216.24,216.64
2015-03-06,1610612766,1610612761,2014,103.0,94.0,197.0,99.45,97.7,100.6,99.2,59,26,33,0.441,61,38,23,0.623,14,12,21,17,194.96,206.0,200.48000000000002
2015-03-06,1610612754,1610612741,2014,98.0,84.0,182.0,92.05,92.25,94.0,91.0,60,26,34,0.433,62,39,23,0.629,15,11,20,19,187.28,185.44,186.36
2015-03-06,1610612753,1610612758,2014,119.0,114.0,233.0,96.55,103.5,97.75,101.5,62,19,43,0.306,59,21,38,0.35600000000000004,9,10,13,8,203.64,207.08,205.36
2015-03-06,1610612755,1610612762,2014,83.0,89.0,172.0,97.85,106.0,95.55,106.55,61,13,48,0.213,60,24,36,0.4,8,5,13,11,207.68,200.2,203.94
2015-03-06,1610612764,1610612748,2014,99.0,97.0,196.0,94.7,91.35,97.25,95.5,61,34,27,0.557,60,27,33,0.45,21,13,12,15,193.0,195.0,194.0
2015-03-06,1610612737,1610612739,2014,106.0,97.0,203.0,96.35,95.7,101.9,101.55,60,48,12,0.8,63,39,24,0.619,28,20,23,16,199.44,195.48,197.45999999999998
2015-03-06,1610612751,1610612756,2014,100.0,108.0,208.0,96.7,98.4,106.25,103.85,59,25,34,0.424,62,32,30,0.516,11,14,17,15,196.96,212.88,204.92000000000002
2015-03-06,1610612745,1610612765,2014,103.0,93.0,196.0,112.7,109.85,100.85,105.95,61,41,20,0.672,60,23,37,0.383,23,18,12,11,216.24,206.0,211.12
2015-03-06,1610612763,1610612747,2014,97.0,90.0,187.0,98.25,97.5,107.3,114.65,60,43,17,0.7170000000000001,60,16,44,0.267,23,20,9,7,193.96,219.28,206.62
2015-03-06,1610612740,1610612738,2014,98.0,104.0,202.0,100.45,104.8,99.65,105.5,61,33,28,0.541,59,24,35,0.407,21,12,15,9,200.8,195.08,197.94
2015-03-06,1610612759,1610612743,2014,120.0,111.0,231.0,107.75,96.55,109.2,110.3,60,37,23,0.617,61,22,39,0.361,21,16,13,9,204.12,217.04,210.57999999999998
2015-03-06,1610612744,1610612742,2014,104.0,89.0,193.0,107.5,105.85,104.45,102.7,59,47,12,0.797,63,40,23,0.635,25,22,21,19,199.04,213.0,206.01999999999998
2015-03-05,1610612741,1610612760,2014,108.0,105.0,213.0,94.0,91.0,101.8,103.4,61,38,23,0.623,61,34,27,0.557,19,19,20,14,185.44,210.36,197.9
2015-03-05,1610612757,1610612742,2014,94.0,75.0,169.0,104.75,105.45,104.45,102.7,59,40,19,0.6779999999999999,62,40,22,0.645,25,15,21,19,209.44,213.0,211.22
2015-03-04,1610612754,1610612752,2014,105.0,82.0,187.0,92.05,92.25,101.2,97.2,59,25,34,0.424,59,12,47,0.203,14,11,8,4,187.28,200.28,193.78
2015-03-04,1610612753,1610612756,2014,100.0,105.0,205.0,96.55,103.5,106.25,103.85,61,19,42,0.311,61,31,30,0.508,9,10,17,14,203.64,212.88,208.26
2015-03-04,1610612738,1610612762,2014,85.0,84.0,169.0,99.65,105.5,95.55,106.55,58,23,35,0.397,59,24,35,0.407,14,9,13,11,195.08,200.2,197.64
2015-03-04,1610612751,1610612766,2014,91.0,115.0,206.0,96.7,98.4,99.45,97.7,58,25,33,0.431,58,25,33,0.431,11,14,14,11,196.96,194.96,195.96
2015-03-04,1610612761,1610612739,2014,112.0,120.0,232.0,100.6,99.2,101.9,101.55,60,38,22,0.633,62,38,24,0.613,21,17,23,15,206.0,195.48,200.74
2015-03-04,1610612745,1610612763,2014,100.0,102.0,202.0,112.7,109.85,98.25,97.5,60,41,19,0.6829999999999999,59,42,17,0.7120000000000001,23,18,23,19,216.24,193.96,205.10000000000002
2015-03-04,1610612750,1610612743,2014,85.0,100.0,185.0,110.05,111.2,109.2,110.3,59,13,46,0.22,60,21,39,0.35,8,5,13,8,209.4,217.04,213.22
2015-03-04,1610612740,1610612765,2014,88.0,85.0,173.0,100.45,104.8,100.85,105.95,60,32,28,0.5329999999999999,59,23,36,0.39,20,12,12,11,200.8,206.0,203.4
2015-03-04,1610612760,1610612755,2014,123.0,118.0,241.0,101.8,103.4,97.85,106.0,60,33,27,0.55,60,13,47,0.217,19,14,8,5,210.36,207.68,209.02
2015-03-04,1610612748,1610612747,2014,100.0,94.0,194.0,97.25,95.5,107.3,114.65,59,26,33,0.441,59,16,43,0.271,11,15,9,7,195.0,219.28,207.14
2015-03-04,1610612759,1610612758,2014,112.0,85.0,197.0,107.75,96.55,97.75,101.5,59,36,23,0.61,58,21,37,0.362,20,16,13,8,204.12,207.08,205.60000000000002
2015-03-04,1610612744,1610612749,2014,102.0,93.0,195.0,107.5,105.85,99.8,108.15,58,46,12,0.7929999999999999,60,32,28,0.5329999999999999,24,22,17,15,199.04,200.48,199.76
2015-03-04,1610612746,1610612757,2014,93.0,98.0,191.0,109.85,106.5,104.75,105.45,61,40,21,0.6559999999999999,58,39,19,0.672,23,17,25,14,214.36,209.44,211.9
2015-03-03,1610612752,1610612758,2014,86.0,124.0,210.0,101.2,97.2,97.75,101.5,58,12,46,0.207,57,20,37,0.35100000000000003,8,4,13,7,200.28,207.08,203.68
2015-03-03,1610612766,1610612747,2014,104.0,103.0,207.0,99.45,97.7,107.3,114.65,57,24,33,0.421,58,16,42,0.276,13,11,9,7,194.96,219.28,207.12
2015-03-03,1610612739,1610612738,2014,110.0,79.0,189.0,101.9,101.55,99.65,105.5,61,37,24,0.607,57,23,34,0.404,22,15,14,9,195.48,195.08,195.28
2015-03-03,1610612737,1610612745,2014,104.0,96.0,200.0,96.35,95.7,112.7,109.85,59,47,12,0.797,59,41,18,0.695,27,20,23,18,199.44,216.24,207.84
2015-03-03,1610612741,1610612764,2014,97.0,92.0,189.0,94.0,91.0,94.7,91.35,60,37,23,0.617,60,34,26,0.5670000000000001,18,19,21,13,185.44,193.0,189.22
2015-03-03,1610612763,1610612762,2014,82.0,93.0,175.0,98.25,97.5,95.55,106.55,58,42,16,0.7240000000000001,58,23,35,0.397,23,19,13,10,193.96,200.2,197.07999999999998
2015-03-03,1610612743,1610612749,2014,106.0,95.0,201.0,109.2,110.3,99.8,108.15,59,20,39,0.339,59,32,27,0.542,12,8,17,15,217.04,200.48,208.76
2015-03-02,1610612755,1610612761,2014,103.0,114.0,217.0,97.85,106.0,100.6,99.2,59,13,46,0.22,59,37,22,0.627,8,5,21,16,207.68,206.0,206.84
2015-03-02,1610612751,1610612744,2014,110.0,108.0,218.0,96.7,98.4,107.5,105.85,57,24,33,0.421,57,46,11,0.807,10,14,24,22,196.96,199.04,198.0
2015-03-02,1610612748,1610612756,2014,115.0,98.0,213.0,97.25,95.5,106.25,103.85,58,25,33,0.431,60,31,29,0.517,10,15,17,14,195.0,212.88,203.94
2015-03-02,1610612750,1610612746,2014,105.0,110.0,215.0,110.05,111.2,109.85,106.5,58,13,45,0.224,60,39,21,0.65,8,5,23,16,209.4,214.36,211.88
2015-03-02,1610612742,1610612740,2014,102.0,93.0,195.0,104.45,102.7,100.45,104.8,61,39,22,0.639,59,32,27,0.542,20,19,20,12,213.0,200.8,206.9
2015-03-01,1610612741,1610612746,2014,86.0,96.0,182.0,94.0,91.0,109.85,106.5,59,37,22,0.627,59,38,21,0.644,18,19,23,15,185.44,214.36,199.9
2015-03-01,1610612745,1610612739,2014,105.0,103.0,208.0,112.7,109.85,101.9,101.55,58,40,18,0.69,60,37,23,0.617,22,18,22,15,216.24,195.48,205.86
2015-03-01,1610612758,1610612757,2014,99.0,110.0,209.0,97.75,101.5,104.75,105.45,56,20,36,0.35700000000000004,57,38,19,0.667,13,7,25,13,207.08,209.44,208.26
2015-03-01,1610612738,1610612744,2014,101.0,106.0,207.0,99.65,105.5,107.5,105.85,56,23,33,0.411,56,45,11,0.804,14,9,24,21,195.08,199.04,197.06
2015-03-01,1610612754,1610612755,2014,94.0,74.0,168.0,92.05,92.25,97.85,106.0,58,24,34,0.414,58,13,45,0.224,13,11,8,5,187.28,207.68,197.48000000000002
2015-03-01,1610612753,1610612766,2014,83.0,98.0,181.0,96.55,103.5,99.45,97.7,60,19,41,0.317,56,23,33,0.411,9,10,13,10,203.64,194.96,199.3
2015-03-01,1610612747,1610612760,2014,101.0,108.0,209.0,107.3,114.65,101.8,103.4,57,16,41,0.281,59,32,27,0.542,9,7,19,13,219.28,210.36,214.82
2015-03-01,1610612743,1610612740,2014,92.0,99.0,191.0,109.2,110.3,100.45,104.8,58,20,38,0.345,58,31,27,0.534,12,8,20,11,217.04,200.8,208.92000000000002
2015-02-28,1610612764,1610612765,2014,99.0,95.0,194.0,94.7,91.35,100.85,105.95,59,33,26,0.5589999999999999,58,23,35,0.397,20,13,12,11,193.0,206.0,199.5
2015-02-28,1610612748,1610612737,2014,91.0,93.0,184.0,97.25,95.5,96.35,95.7,57,25,32,0.439,58,46,12,0.7929999999999999,10,15,27,19,195.0,199.44,197.22
2015-02-28,1610612752,1610612761,2014,103.0,98.0,201.0,101.2,97.2,100.6,99.2,57,11,46,0.193,58,37,21,0.638,7,4,21,16,200.28,206.0,203.14
2015-02-28,1610612750,1610612763,2014,97.0,101.0,198.0,110.05,111.2,98.25,97.5,57,13,44,0.228,57,41,16,0.7190000000000001,8,5,23,18,209.4,193.96,201.68
2015-02-28,1610612742,1610612751,2014,94.0,104.0,198.0,104.45,102.7,96.7,98.4,60,39,21,0.65,56,23,33,0.411,20,19,10,13,213.0,196.96,204.98000000000002
2015-02-28,1610612756,1610612759,2014,74.0,101.0,175.0,106.25,103.85,107.75,96.55,59,31,28,0.525,58,35,23,0.603,17,14,20,15,212.88,204.12,208.5
2015-02-28,1610612762,1610612749,2014,82.0,75.0,157.0,95.55,106.55,99.8,108.15,57,22,35,0.386,58,32,26,0.552,12,10,17,15,200.2,200.48,200.33999999999997
2015-02-27,1610612754,1610612739,2014,93.0,86.0,179.0,92.05,92.25,101.9,101.55,57,23,34,0.404,59,37,22,0.627,12,11,22,15,187.28,195.48,191.38
2015-02-27,1610612755,1610612764,2014,89.0,81.0,170.0,97.85,106.0,94.7,91.35,57,12,45,0.211,58,33,25,0.569,7,5,20,13,207.68,193.0,200.34
2015-02-27,1610612737,1610612753,2014,95.0,88.0,183.0,96.35,95.7,96.55,103.5,57,45,12,0.789,59,19,40,0.322,26,19,9,10,199.44,203.64,201.54
2015-02-27,1610612738,1610612766,2014,106.0,98.0,204.0,99.65,105.5,99.45,97.7,55,22,33,0.4,55,23,32,0.418,13,9,13,10,195.08,194.96,195.02
2015-02-27,1610612765,1610612752,2014,115.0,121.0,236.0,100.85,105.95,101.2,97.2,57,23,34,0.404,56,10,46,0.179,12,11,7,3,206.0,200.28,203.14
2015-02-27,1610612761,1610612744,2014,89.0,113.0,202.0,100.6,99.2,107.5,105.85,57,37,20,0.649,55,44,11,0.8,21,16,24,20,206.0,199.04,202.51999999999998
2015-02-27,1610612741,1610612750,2014,96.0,89.0,185.0,94.0,91.0,110.05,111.2,58,36,22,0.621,56,13,43,0.232,17,19,8,5,185.44,209.4,197.42000000000002
2015-02-27,1610612745,1610612751,2014,102.0,98.0,200.0,112.7,109.85,96.7,98.4,57,39,18,0.684,55,23,32,0.418,21,18,10,13,216.24,196.96,206.60000000000002
2015-02-27,1610612763,1610612746,2014,79.0,97.0,176.0,98.25,97.5,109.85,106.5,56,41,15,0.732,58,37,21,0.638,23,18,23,14,193.96,214.36,204.16000000000003
2015-02-27,1610612740,1610612748,2014,104.0,102.0,206.0,100.45,104.8,97.25,95.5,57,30,27,0.526,56,25,31,0.446,19,11,10,15,200.8,195.0,197.9
2015-02-27,1610612743,1610612762,2014,82.0,104.0,186.0,109.2,110.3,95.55,106.55,57,20,37,0.35100000000000003,56,21,35,0.375,12,8,12,9,217.04,200.2,208.62
2015-02-27,1610612758,1610612759,2014,96.0,107.0,203.0,97.75,101.5,107.75,96.55,55,20,35,0.364,57,34,23,0.596,13,7,20,14,207.08,204.12,205.60000000000002
2015-02-27,1610612747,1610612749,2014,101.0,93.0,194.0,107.3,114.65,99.8,108.15,56,15,41,0.268,57,32,25,0.561,8,7,17,15,219.28,200.48,209.88
2015-02-27,1610612757,1610612760,2014,115.0,112.0,227.0,104.75,105.45,101.8,103.4,56,37,19,0.6609999999999999,58,32,26,0.552,24,13,19,13,209.44,210.36,209.9
2015-02-26,1610612739,1610612744,2014,110.0,99.0,209.0,101.9,101.55,107.5,105.85,58,36,22,0.621,54,44,10,0.815,21,15,24,20,195.48,199.04,197.26
2015-02-26,1610612756,1610612760,2014,117.0,113.0,230.0,106.25,103.85,101.8,103.4,58,30,28,0.517,57,32,25,0.561,16,14,19,13,212.88,210.36,211.62
2015-02-25,1610612753,1610612748,2014,90.0,93.0,183.0,96.55,103.5,97.25,95.5,58,19,39,0.328,55,24,31,0.436,9,10,10,14,203.64,195.0,199.32
2015-02-25,1610612737,1610612742,2014,104.0,87.0,191.0,96.35,95.7,104.45,102.7,56,44,12,0.7859999999999999,59,39,20,0.6609999999999999,25,19,20,19,199.44,213.0,206.22
2015-02-25,1610612738,1610612752,2014,115.0,94.0,209.0,99.65,105.5,101.2,97.2,54,21,33,0.389,55,10,45,0.182,12,9,7,3,195.08,200.28,197.68
2015-02-25,1610612741,1610612766,2014,86.0,98.0,184.0,94.0,91.0,99.45,97.7,57,36,21,0.632,54,22,32,0.407,17,19,13,9,185.44,194.96,190.2
2015-02-25,1610612745,1610612746,2014,110.0,105.0,215.0,112.7,109.85,109.85,106.5,56,38,18,0.679,57,37,20,0.649,20,18,23,14,216.24,214.36,215.3
2015-02-25,1610612749,1610612755,2014,104.0,88.0,192.0,99.8,108.15,97.85,106.0,56,31,25,0.5539999999999999,56,12,44,0.214,16,15,7,5,200.48,207.68,204.07999999999998
2015-02-25,1610612750,1610612764,2014,97.0,77.0,174.0,110.05,111.2,94.7,91.35,55,12,43,0.218,57,33,24,0.579,7,5,20,13,209.4,193.0,201.2
2015-02-25,1610612740,1610612751,2014,102.0,96.0,198.0,100.45,104.8,96.7,98.4,56,29,27,0.518,54,23,31,0.426,18,11,10,13,200.8,196.96,198.88
2015-02-25,1610612743,1610612756,2014,96.0,110.0,206.0,109.2,110.3,106.25,103.85,56,20,36,0.35700000000000004,57,29,28,0.509,12,8,16,13,217.04,212.88,214.95999999999998
2015-02-25,1610612762,1610612747,2014,97.0,100.0,197.0,95.55,106.55,107.3,114.65,55,21,34,0.382,55,14,41,0.255,12,9,8,6,200.2,219.28,209.74
2015-02-25,1610612758,1610612763,2014,102.0,90.0,192.0,97.75,101.5,98.25,97.5,54,19,35,0.35200000000000004,55,41,14,0.745,12,7,23,18,207.08,193.96,200.52
2015-02-25,1610612757,1610612759,2014,111.0,95.0,206.0,104.75,105.45,107.75,96.55,55,36,19,0.655,56,34,22,0.607,23,13,20,14,209.44,204.12,206.78
2015-02-24,1610612764,1610612744,2014,107.0,114.0,221.0,94.7,91.35,107.5,105.85,56,33,23,0.589,53,43,10,0.8109999999999999,20,13,24,19,193.0,199.04,196.01999999999998
2015-02-24,1610612765,1610612739,2014,93.0,102.0,195.0,100.85,105.95,101.9,101.55,56,23,33,0.411,57,35,22,0.614,12,11,21,14,206.0,195.48,200.74
2015-02-24,1610612760,1610612754,2014,105.0,92.0,197.0,101.8,103.4,92.05,92.25,56,31,25,0.5539999999999999,56,23,33,0.411,18,13,12,11,210.36,187.28,198.82
2015-02-24,1610612742,1610612761,2014,99.0,92.0,191.0,104.45,102.7,100.6,99.2,58,38,20,0.655,56,37,19,0.6609999999999999,19,19,21,16,213.0,206.0,209.5
2015-02-23,1610612748,1610612755,2014,119.0,108.0,227.0,97.25,95.5,97.85,106.0,54,23,31,0.426,55,12,43,0.218,9,14,7,5,195.0,207.68,201.34
2015-02-23,1610612741,1610612749,2014,87.0,71.0,158.0,94.0,91.0,99.8,108.15,56,35,21,0.625,55,31,24,0.564,16,19,16,15,185.44,200.48,192.95999999999998
2015-02-23,1610612745,1610612750,2014,113.0,102.0,215.0,112.7,109.85,110.05,111.2,55,37,18,0.6729999999999999,54,12,42,0.222,19,18,7,5,216.24,209.4,212.82
2015-02-23,1610612740,1610612761,2014,100.0,97.0,197.0,100.45,104.8,100.6,99.2,55,28,27,0.509,55,37,18,0.6729999999999999,17,11,21,16,200.8,206.0,203.4
2015-02-23,1610612743,1610612751,2014,82.0,110.0,192.0,109.2,110.3,96.7,98.4,55,20,35,0.364,53,22,31,0.415,12,8,10,12,217.04,196.96,207.0
2015-02-23,1610612756,1610612738,2014,110.0,115.0,225.0,106.25,103.85,99.65,105.5,56,29,27,0.518,53,20,33,0.377,16,13,12,8,212.88,195.08,203.98000000000002
2015-02-23,1610612762,1610612759,2014,90.0,81.0,171.0,95.55,106.55,107.75,96.55,54,20,34,0.37,55,34,21,0.618,11,9,20,14,200.2,204.12,202.16
2015-02-23,1610612746,1610612763,2014,87.0,90.0,177.0,109.85,106.5,98.25,97.5,56,37,19,0.6609999999999999,54,40,14,0.741,23,14,23,17,214.36,193.96,204.16000000000003
2015-02-22,1610612752,1610612739,2014,83.0,101.0,184.0,101.2,97.2,101.9,101.55,54,10,44,0.185,56,34,22,0.607,7,3,21,13,200.28,195.48,197.88
2015-02-22,1610612749,1610612737,2014,86.0,97.0,183.0,99.8,108.15,96.35,95.7,54,31,23,0.574,55,43,12,0.782,16,15,25,18,200.48,199.44,199.95999999999998
2015-02-22,1610612765,1610612764,2014,106.0,89.0,195.0,100.85,105.95,94.7,91.35,55,22,33,0.4,55,33,22,0.6,11,11,20,13,206.0,193.0,199.5
2015-02-22,1610612754,1610612744,2014,104.0,98.0,202.0,92.05,92.25,107.5,105.85,55,22,33,0.4,52,43,9,0.8270000000000001,11,11,24,19,187.28,199.04,193.16
2015-02-22,1610612753,1610612755,2014,103.0,98.0,201.0,96.55,103.5,97.85,106.0,57,18,39,0.316,54,12,42,0.222,8,10,7,5,203.64,207.68,205.66
2015-02-22,1610612760,1610612743,2014,119.0,94.0,213.0,101.8,103.4,109.2,110.3,55,30,25,0.545,54,20,34,0.37,17,13,12,8,210.36,217.04,213.7
2015-02-22,1610612742,1610612766,2014,92.0,81.0,173.0,104.45,102.7,99.45,97.7,57,37,20,0.649,53,22,31,0.415,18,19,13,9,213.0,194.96,203.98000000000002
2015-02-22,1610612757,1610612763,2014,92.0,98.0,190.0,104.75,105.45,98.25,97.5,54,36,18,0.667,53,39,14,0.736,23,13,23,16,209.44,193.96,201.7
2015-02-22,1610612747,1610612738,2014,118.0,111.0,229.0,107.3,114.65,99.65,105.5,54,13,41,0.241,52,20,32,0.385,7,6,12,8,219.28,195.08,207.18
2015-02-21,1610612766,1610612760,2014,103.0,110.0,213.0,99.45,97.7,101.8,103.4,52,22,30,0.423,54,29,25,0.537,13,9,17,12,194.96,210.36,202.66000000000003
2015-02-21,1610612748,1610612740,2014,91.0,105.0,196.0,97.25,95.5,100.45,104.8,53,23,30,0.434,54,27,27,0.5,9,14,17,10,195.0,200.8,197.9
2015-02-21,1610612741,1610612756,2014,112.0,107.0,219.0,94.0,91.0,106.25,103.85,55,34,21,0.618,55,29,26,0.527,15,19,16,13,185.44,212.88,199.16
2015-02-21,1610612745,1610612761,2014,98.0,76.0,174.0,112.7,109.85,100.6,99.2,54,36,18,0.667,54,37,17,0.685,18,18,21,16,216.24,206.0,211.12
2015-02-21,1610612746,1610612758,2014,126.0,99.0,225.0,109.85,106.5,97.75,101.5,55,36,19,0.655,53,19,34,0.358,22,14,12,7,214.36,207.08,210.72000000000003
2015-02-20,1610612753,1610612740,2014,95.0,84.0,179.0,96.55,103.5,100.45,104.8,56,17,39,0.304,53,27,26,0.509,7,10,17,10,203.64,200.8,202.22
2015-02-20,1610612755,1610612754,2014,95.0,106.0,201.0,97.85,106.0,92.05,92.25,53,12,41,0.226,54,21,33,0.389,7,5,11,10,207.68,187.28,197.48000000000002
2015-02-20,1610612737,1610612761,2014,80.0,105.0,185.0,96.35,95.7,100.6,99.2,54,43,11,0.7959999999999999,53,36,17,0.679,25,18,21,15,199.44,206.0,202.72
2015-02-20,1610612765,1610612741,2014,100.0,91.0,191.0,100.85,105.95,94.0,91.0,54,21,33,0.389,54,34,20,0.63,10,11,15,19,206.0,185.44,195.72
2015-02-20,1610612752,1610612748,2014,87.0,111.0,198.0,101.2,97.2,97.25,95.5,53,10,43,0.189,52,22,30,0.423,7,3,9,13,200.28,195.0,197.64
2015-02-20,1610612750,1610612756,2014,111.0,109.0,220.0,110.05,111.2,106.25,103.85,53,11,42,0.208,54,29,25,0.537,6,5,16,13,209.4,212.88,211.14
2015-02-20,1610612764,1610612739,2014,89.0,127.0,216.0,94.7,91.35,101.9,101.55,54,33,21,0.611,55,33,22,0.6,20,13,21,12,193.0,195.48,194.24
2015-02-20,1610612742,1610612745,2014,111.0,100.0,211.0,104.45,102.7,112.7,109.85,56,36,20,0.643,53,36,17,0.679,17,19,18,18,213.0,216.24,214.62
2015-02-20,1610612749,1610612743,2014,89.0,81.0,170.0,99.8,108.15,109.2,110.3,53,30,23,0.5660000000000001,53,20,33,0.377,15,15,12,8,200.48,217.04,208.76
2015-02-20,1610612762,1610612757,2014,92.0,76.0,168.0,95.55,106.55,104.75,105.45,53,19,34,0.358,53,36,17,0.679,10,9,23,13,200.2,209.44,204.82
2015-02-20,1610612758,1610612738,2014,109.0,101.0,210.0,97.75,101.5,99.65,105.5,52,18,34,0.34600000000000003,51,20,31,0.392,11,7,12,8,207.08,195.08,201.08
2015-02-20,1610612744,1610612759,2014,110.0,99.0,209.0,107.5,105.85,107.75,96.55,51,42,9,0.8240000000000001,54,34,20,0.63,23,19,20,14,199.04,204.12,201.57999999999998
2015-02-20,1610612747,1610612751,2014,105.0,114.0,219.0,107.3,114.65,96.7,98.4,53,13,40,0.245,52,21,31,0.404,7,6,10,11,219.28,196.96,208.12
2015-02-19,1610612760,1610612742,2014,104.0,89.0,193.0,101.8,103.4,104.45,102.7,53,28,25,0.528,55,36,19,0.655,16,12,17,19,210.36,213.0,211.68
2015-02-19,1610612746,1610612759,2014,119.0,115.0,234.0,109.85,106.5,107.75,96.55,54,35,19,0.648,53,34,19,0.642,21,14,20,14,214.36,204.12,209.24
2015-02-12,1610612741,1610612739,2014,113.0,98.0,211.0,94.0,91.0,101.9,101.55,53,33,20,0.623,54,33,21,0.611,14,19,21,12,185.44,195.48,190.45999999999998
2015-02-11,1610612753,1610612752,2014,89.0,83.0,172.0,96.55,103.5,101.2,97.2,55,16,39,0.29100000000000004,52,10,42,0.192,6,10,7,3,203.64,200.28,201.95999999999998
2015-02-11,1610612738,1610612737,2014,89.0,88.0,177.0,99.65,105.5,96.35,95.7,50,19,31,0.38,53,43,10,0.8109999999999999,11,8,25,18,195.08,199.44,197.26
2015-02-11,1610612765,1610612759,2014,87.0,104.0,191.0,100.85,105.95,107.75,96.55,53,21,32,0.396,52,33,19,0.635,10,11,20,13,206.0,204.12,205.06
2015-02-11,1610612761,1610612764,2014,95.0,93.0,188.0,100.6,99.2,94.7,91.35,52,35,17,0.6729999999999999,53,33,20,0.623,20,15,20,13,206.0,193.0,199.5
2015-02-11,1610612749,1610612758,2014,111.0,103.0,214.0,99.8,108.15,97.75,101.5,52,29,23,0.5579999999999999,51,18,33,0.353,14,15,11,7,200.48,207.08,203.78
2015-02-11,1610612750,1610612744,2014,91.0,94.0,185.0,110.05,111.2,107.5,105.85,52,11,41,0.212,50,41,9,0.82,6,5,23,18,209.4,199.04,204.22
2015-02-11,1610612740,1610612754,2014,93.0,106.0,199.0,100.45,104.8,92.05,92.25,52,27,25,0.519,53,20,33,0.377,17,10,11,9,200.8,187.28,194.04000000000002
2015-02-11,1610612760,1610612763,2014,105.0,89.0,194.0,101.8,103.4,98.25,97.5,52,27,25,0.519,52,39,13,0.75,15,12,23,16,210.36,193.96,202.16000000000003
2015-02-11,1610612739,1610612748,2014,113.0,93.0,206.0,101.9,101.55,97.25,95.5,53,32,21,0.604,51,22,29,0.431,20,12,9,13,195.48,195.0,195.24
2015-02-11,1610612742,1610612762,2014,87.0,82.0,169.0,104.45,102.7,95.55,106.55,54,35,19,0.648,52,19,33,0.365,16,19,10,9,213.0,200.2,206.6
2015-02-11,1610612757,1610612747,2014,102.0,86.0,188.0,104.75,105.45,107.3,114.65,52,35,17,0.6729999999999999,52,13,39,0.25,22,13,7,6,209.44,219.28,214.36
2015-02-11,1610612746,1610612745,2014,110.0,95.0,205.0,109.85,106.5,112.7,109.85,53,34,19,0.642,52,36,16,0.6920000000000001,20,14,18,18,214.36,216.24,215.3
2015-02-10,1610612766,1610612765,2014,78.0,106.0,184.0,99.45,97.7,100.85,105.95,51,22,29,0.431,52,20,32,0.385,13,9,10,10,194.96,206.0,200.48000000000002
2015-02-10,1610612756,1610612745,2014,118.0,127.0,245.0,106.25,103.85,112.7,109.85,53,29,24,0.547,51,35,16,0.6859999999999999,16,13,18,17,212.88,216.24,214.56
2015-02-10,1610612741,1610612758,2014,104.0,86.0,190.0,94.0,91.0,97.75,101.5,52,32,20,0.615,50,18,32,0.36,13,19,11,7,185.44,207.08,196.26
2015-02-10,1610612763,1610612751,2014,95.0,86.0,181.0,98.25,97.5,96.7,98.4,51,38,13,0.745,51,21,30,0.412,22,16,10,11,193.96,196.96,195.46
2015-02-10,1610612747,1610612743,2014,96.0,106.0,202.0,107.3,114.65,109.2,110.3,51,13,38,0.255,52,19,33,0.365,7,6,12,7,219.28,217.04,218.16
2015-02-09,1610612754,1610612759,2014,93.0,95.0,188.0,92.05,92.25,107.75,96.55,52,20,32,0.385,51,32,19,0.627,11,9,20,12,187.28,204.12,195.7
2015-02-09,1610612755,1610612744,2014,84.0,89.0,173.0,97.85,106.0,107.5,105.85,52,12,40,0.231,49,40,9,0.816,7,5,23,17,207.68,199.04,203.36
2015-02-09,1610612764,1610612753,2014,96.0,80.0,176.0,94.7,91.35,96.55,103.5,52,32,20,0.615,54,16,38,0.29600000000000004,19,13,6,10,193.0,203.64,198.32
2015-02-09,1610612748,1610612752,2014,109.0,95.0,204.0,97.25,95.5,101.2,97.2,50,21,29,0.42,51,10,41,0.196,8,13,7,3,195.0,200.28,197.64
2015-02-09,1610612749,1610612751,2014,103.0,97.0,200.0,99.8,108.15,96.7,98.4,51,28,23,0.5489999999999999,50,21,29,0.42,13,15,10,11,200.48,196.96,198.72
2015-02-09,1610612750,1610612737,2014,105.0,117.0,222.0,110.05,111.2,96.35,95.7,51,11,40,0.21600000000000005,52,42,10,0.8079999999999999,6,5,25,17,209.4,199.44,204.42000000000002
2015-02-09,1610612740,1610612762,2014,96.0,100.0,196.0,100.45,104.8,95.55,106.55,51,27,24,0.529,51,18,33,0.353,17,10,10,8,200.8,200.2,200.5
2015-02-09,1610612742,1610612746,2014,98.0,115.0,213.0,104.45,102.7,109.85,106.5,53,35,18,0.66,52,33,19,0.635,16,19,20,13,213.0,214.36,213.68
2015-02-09,1610612743,1610612760,2014,114.0,124.0,238.0,109.2,110.3,101.8,103.4,51,19,32,0.373,51,26,25,0.51,12,7,15,11,217.04,210.36,213.7
2015-02-08,1610612760,1610612746,2014,131.0,108.0,239.0,101.8,103.4,109.85,106.5,50,25,25,0.5,51,33,18,0.647,14,11,20,13,210.36,214.36,212.36
2015-02-08,1610612739,1610612747,2014,120.0,105.0,225.0,101.9,101.55,107.3,114.65,52,31,21,0.596,50,13,37,0.26,19,12,7,6,195.48,219.28,207.38
2015-02-08,1610612763,1610612737,2014,94.0,88.0,182.0,98.25,97.5,96.35,95.7,50,37,13,0.74,51,42,9,0.8240000000000001,21,16,25,17,193.96,199.44,196.7
2015-02-08,1610612766,1610612754,2014,102.0,103.0,205.0,99.45,97.7,92.05,92.25,50,22,28,0.44,51,19,32,0.373,13,9,11,8,194.96,187.28,191.12
2015-02-08,1610612765,1610612750,2014,101.0,112.0,213.0,100.85,105.95,110.05,111.2,51,20,31,0.392,50,10,40,0.2,10,10,6,4,206.0,209.4,207.7
2015-02-08,1610612753,1610612741,2014,97.0,98.0,195.0,96.55,103.5,94.0,91.0,53,16,37,0.302,51,31,20,0.608,6,10,13,18,203.64,185.44,194.54
2015-02-08,1610612745,1610612757,2014,98.0,109.0,207.0,112.7,109.85,104.75,105.45,50,35,15,0.7,51,34,17,0.667,18,17,22,12,216.24,209.44,212.84
2015-02-08,1610612761,1610612759,2014,87.0,82.0,169.0,100.6,99.2,107.75,96.55,51,34,17,0.667,50,32,18,0.64,19,15,20,12,206.0,204.12,205.06
2015-02-08,1610612758,1610612756,2014,85.0,83.0,168.0,97.75,101.5,106.25,103.85,49,17,32,0.34700000000000003,52,29,23,0.5579999999999999,10,7,16,13,207.08,212.88,209.98000000000002
2015-02-07,1610612740,1610612741,2014,72.0,107.0,179.0,100.45,104.8,94.0,91.0,50,27,23,0.54,50,30,20,0.6,17,10,13,17,200.8,185.44,193.12
2015-02-07,1610612764,1610612751,2014,114.0,77.0,191.0,94.7,91.35,96.7,98.4,51,31,20,0.608,49,21,28,0.429,18,13,10,11,193.0,196.96,194.98000000000002
2015-02-07,1610612752,1610612744,2014,92.0,106.0,198.0,101.2,97.2,107.5,105.85,50,10,40,0.2,48,39,9,0.813,7,3,23,16,200.28,199.04,199.66
2015-02-07,1610612755,1610612766,2014,89.0,81.0,170.0,97.85,106.0,99.45,97.7,51,11,40,0.21600000000000005,49,22,27,0.449,6,5,13,9,207.68,194.96,201.32
2015-02-07,1610612742,1610612757,2014,111.0,101.0,212.0,104.45,102.7,104.75,105.45,52,34,18,0.654,50,34,16,0.68,15,19,22,12,213.0,209.44,211.22
2015-02-07,1610612749,1610612738,2014,96.0,93.0,189.0,99.8,108.15,99.65,105.5,50,27,23,0.54,49,19,30,0.388,12,15,11,8,200.48,195.08,197.78
2015-02-07,1610612762,1610612758,2014,102.0,90.0,192.0,95.55,106.55,97.75,101.5,50,17,33,0.34,48,17,31,0.354,9,8,10,7,200.2,207.08,203.64
2015-02-06,1610612751,1610612752,2014,92.0,88.0,180.0,96.7,98.4,101.2,97.2,48,20,28,0.417,49,10,39,0.204,9,11,7,3,196.96,200.28,198.62
2015-02-06,1610612754,1610612739,2014,103.0,99.0,202.0,92.05,92.25,101.9,101.55,50,18,32,0.36,51,31,20,0.608,10,8,19,12,187.28,195.48,191.38
2015-02-06,1610612753,1610612747,2014,103.0,97.0,200.0,96.55,103.5,107.3,114.65,52,15,37,0.28800000000000003,49,13,36,0.265,5,10,7,6,203.64,219.28,211.45999999999998
2015-02-06,1610612761,1610612746,2014,123.0,107.0,230.0,100.6,99.2,109.85,106.5,50,33,17,0.66,50,33,17,0.66,18,15,20,13,206.0,214.36,210.18
2015-02-06,1610612737,1610612744,2014,124.0,116.0,240.0,96.35,95.7,107.5,105.85,50,41,9,0.82,47,39,8,0.83,24,17,23,16,199.44,199.04,199.24
2015-02-06,1610612738,1610612755,2014,107.0,96.0,203.0,99.65,105.5,97.85,106.0,48,18,30,0.375,50,11,39,0.22,10,8,6,5,195.08,207.68,201.38
2015-02-06,1610612765,1610612743,2014,98.0,88.0,186.0,100.85,105.95,109.2,110.3,50,19,31,0.38,50,19,31,0.38,9,10,12,7,206.0,217.04,211.51999999999998
2015-02-06,1610612745,1610612749,2014,117.0,111.0,228.0,112.7,109.85,99.8,108.15,49,34,15,0.6940000000000001,49,27,22,0.551,17,17,12,15,216.24,200.48,208.36
2015-02-06,1610612750,1610612763,2014,90.0,89.0,179.0,110.05,111.2,98.25,97.5,49,9,40,0.184,49,37,12,0.755,5,4,21,16,209.4,193.96,201.68
2015-02-06,1610612760,1610612740,2014,113.0,116.0,229.0,101.8,103.4,100.45,104.8,49,25,24,0.51,49,26,23,0.531,14,11,17,9,210.36,200.8,205.58
2015-02-06,1610612756,1610612762,2014,100.0,93.0,193.0,106.25,103.85,95.55,106.55,51,28,23,0.5489999999999999,49,17,32,0.34700000000000003,15,13,9,8,212.88,200.2,206.54
2015-02-06,1610612759,1610612748,2014,98.0,85.0,183.0,107.75,96.55,97.25,95.5,49,31,18,0.633,49,21,28,0.429,19,12,8,13,204.12,195.0,199.56
2015-02-05,1610612766,1610612764,2014,94.0,87.0,181.0,99.45,97.7,94.7,91.35,48,21,27,0.438,50,31,19,0.62,12,9,18,13,194.96,193.0,193.98000000000002
2015-02-05,1610612739,1610612746,2014,105.0,94.0,199.0,101.9,101.55,109.85,106.5,50,30,20,0.6,49,33,16,0.6729999999999999,18,12,20,13,195.48,214.36,204.92000000000002
2015-02-05,1610612758,1610612742,2014,78.0,101.0,179.0,97.75,101.5,104.45,102.7,47,17,30,0.362,51,33,18,0.647,10,7,15,18,207.08,213.0,210.04000000000002
2015-02-05,1610612757,1610612756,2014,108.0,87.0,195.0,104.75,105.45,106.25,103.85,49,33,16,0.6729999999999999,50,28,22,0.56,21,12,15,13,209.44,212.88,211.16
2015-02-04,1610612754,1610612765,2014,114.0,109.0,223.0,92.05,92.25,100.85,105.95,49,17,32,0.34700000000000003,49,19,30,0.388,9,8,9,10,187.28,206.0,196.64
2015-02-04,1610612737,1610612764,2014,105.0,96.0,201.0,96.35,95.7,94.7,91.35,49,40,9,0.816,49,31,18,0.633,23,17,18,13,199.44,193.0,196.22
2015-02-04,1610612738,1610612743,2014,104.0,100.0,204.0,99.65,105.5,109.2,110.3,47,17,30,0.362,49,19,30,0.388,9,8,12,7,195.08,217.04,206.06
2015-02-04,1610612761,1610612751,2014,93.0,109.0,202.0,100.6,99.2,96.7,98.4,49,33,16,0.6729999999999999,47,19,28,0.404,18,15,9,10,206.0,196.96,201.48000000000002
2015-02-04,1610612745,1610612741,2014,101.0,90.0,191.0,112.7,109.85,94.0,91.0,48,33,15,0.688,49,30,19,0.612,16,17,13,17,216.24,185.44,200.84
2015-02-04,1610612749,1610612747,2014,113.0,105.0,218.0,99.8,108.15,107.3,114.65,48,26,22,0.542,48,13,35,0.271,11,15,7,6,200.48,219.28,209.88
2015-02-04,1610612750,1610612748,2014,102.0,101.0,203.0,110.05,111.2,97.25,95.5,48,8,40,0.16699999999999998,48,21,27,0.438,4,4,8,13,209.4,195.0,202.2
2015-02-04,1610612740,1610612760,2014,91.0,102.0,193.0,100.45,104.8,101.8,103.4,48,26,22,0.542,48,24,24,0.5,17,9,14,10,200.8,210.36,205.58
2015-02-04,1610612759,1610612753,2014,110.0,103.0,213.0,107.75,96.55,96.55,103.5,48,30,18,0.625,51,15,36,0.294,18,12,5,10,204.12,203.64,203.88
2015-02-04,1610612762,1610612763,2014,90.0,100.0,190.0,95.55,106.55,98.25,97.5,48,17,31,0.354,48,36,12,0.75,9,8,21,15,200.2,193.96,197.07999999999998
2015-02-04,1610612744,1610612742,2014,128.0,114.0,242.0,107.5,105.85,104.45,102.7,46,38,8,0.826,50,33,17,0.66,22,16,15,18,199.04,213.0,206.01999999999998
2015-02-03,1610612755,1610612743,2014,105.0,98.0,203.0,97.85,106.0,109.2,110.3,49,10,39,0.204,48,19,29,0.396,5,5,12,7,207.68,217.04,212.36
2015-02-03,1610612765,1610612748,2014,108.0,91.0,199.0,100.85,105.95,97.25,95.5,48,18,30,0.375,47,21,26,0.447,8,10,8,13,206.0,195.0,200.5
2015-02-03,1610612752,1610612738,2014,97.0,108.0,205.0,101.2,97.2,99.65,105.5,48,10,38,0.208,46,16,30,0.348,7,3,9,7,200.28,195.08,197.68
2015-02-03,1610612757,1610612762,2014,103.0,102.0,205.0,104.75,105.45,95.55,106.55,48,32,16,0.667,47,17,30,0.362,20,12,9,8,209.44,200.2,204.82
2015-02-03,1610612758,1610612744,2014,96.0,121.0,217.0,97.75,101.5,107.5,105.85,46,17,29,0.37,45,37,8,0.8220000000000001,10,7,22,15,207.08,199.04,203.06
2015-02-02,1610612739,1610612755,2014,97.0,84.0,181.0,101.9,101.55,97.85,106.0,49,29,20,0.5920000000000001,48,10,38,0.208,17,12,5,5,195.48,207.68,201.57999999999998
2015-02-02,1610612764,1610612766,2014,88.0,92.0,180.0,94.7,91.35,99.45,97.7,48,31,17,0.6459999999999999,47,20,27,0.426,18,13,12,8,193.0,194.96,193.98000000000002
2015-02-02,1610612751,1610612746,2014,102.0,100.0,202.0,96.7,98.4,109.85,106.5,46,18,28,0.391,48,33,15,0.688,8,10,20,13,196.96,214.36,205.66000000000003
2015-02-02,1610612761,1610612749,2014,75.0,82.0,157.0,100.6,99.2,99.8,108.15,48,33,15,0.688,47,25,22,0.532,18,15,11,14,206.0,200.48,203.24
2015-02-02,1610612740,1610612737,2014,115.0,100.0,215.0,100.45,104.8,96.35,95.7,47,25,22,0.532,48,40,8,0.833,16,9,23,17,200.8,199.44,200.12
2015-02-02,1610612760,1610612753,2014,104.0,97.0,201.0,101.8,103.4,96.55,103.5,47,23,24,0.489,50,15,35,0.3,13,10,5,10,210.36,203.64,207.0
2015-02-02,1610612742,1610612750,2014,100.0,94.0,194.0,104.45,102.7,110.05,111.2,49,32,17,0.653,47,8,39,0.17,14,18,4,4,213.0,209.4,211.2
2015-02-02,1610612756,1610612763,2014,101.0,102.0,203.0,106.25,103.85,98.25,97.5,49,28,21,0.5710000000000001,47,35,12,0.745,15,13,21,14,212.88,193.96,203.42000000000002
2015-02-01,1610612738,1610612748,2014,75.0,83.0,158.0,99.65,105.5,97.25,95.5,45,16,29,0.35600000000000004,46,20,26,0.435,9,7,8,12,195.08,195.0,195.04000000000002
2015-02-01,1610612752,1610612747,2014,92.0,80.0,172.0,101.2,97.2,107.3,114.65,47,9,38,0.191,47,13,34,0.277,6,3,7,6,200.28,219.28,209.78
2015-01-31,1610612754,1610612758,2014,94.0,99.0,193.0,92.05,92.25,97.75,101.5,48,17,31,0.354,45,16,29,0.35600000000000004,9,8,10,6,187.28,207.08,197.18
2015-01-31,1610612753,1610612742,2014,93.0,108.0,201.0,96.55,103.5,104.45,102.7,49,15,34,0.306,48,31,17,0.6459999999999999,5,10,14,17,203.64,213.0,208.32
2015-01-31,1610612764,1610612761,2014,116.0,120.0,236.0,94.7,91.35,100.6,99.2,47,31,16,0.66,47,32,15,0.6809999999999999,18,13,18,14,193.0,206.0,199.5
2015-01-31,1610612737,1610612755,2014,91.0,85.0,176.0,96.35,95.7,97.85,106.0,47,39,8,0.83,47,10,37,0.213,22,17,5,5,199.44,207.68,203.56
2015-01-31,1610612765,1610612745,2014,114.0,101.0,215.0,100.85,105.95,112.7,109.85,47,17,30,0.362,47,33,14,0.7020000000000001,7,10,16,17,206.0,216.24,211.12
2015-01-31,1610612763,1610612760,2014,85.0,74.0,159.0,98.25,97.5,101.8,103.4,46,34,12,0.7390000000000001,46,23,23,0.5,20,14,13,10,193.96,210.36,202.16000000000003
2015-01-31,1610612750,1610612739,2014,90.0,106.0,196.0,110.05,111.2,101.9,101.55,46,8,38,0.174,48,28,20,0.583,4,4,17,11,209.4,195.48,202.44
2015-01-31,1610612749,1610612757,2014,95.0,88.0,183.0,99.8,108.15,104.75,105.45,46,24,22,0.522,47,32,15,0.6809999999999999,10,14,20,12,200.48,209.44,204.95999999999998
2015-01-31,1610612743,1610612766,2014,86.0,104.0,190.0,109.2,110.3,99.45,97.7,47,19,28,0.404,46,19,27,0.413,12,7,12,7,217.04,194.96,206.0
2015-01-31,1610612759,1610612746,2014,85.0,105.0,190.0,107.75,96.55,109.85,106.5,47,30,17,0.638,47,32,15,0.6809999999999999,18,12,20,12,204.12,214.36,209.24
2015-01-31,1610612744,1610612756,2014,106.0,87.0,193.0,107.5,105.85,106.25,103.85,44,36,8,0.818,48,28,20,0.583,21,15,15,13,199.04,212.88,205.95999999999998
2015-01-30,1610612755,1610612750,2014,103.0,94.0,197.0,97.85,106.0,110.05,111.2,46,9,37,0.196,45,8,37,0.17800000000000002,4,5,4,4,207.68,209.4,208.54000000000002
2015-01-30,1610612737,1610612757,2014,105.0,99.0,204.0,96.35,95.7,104.75,105.45,46,38,8,0.826,46,32,14,0.696,21,17,20,12,199.44,209.44,204.44
2015-01-30,1610612738,1610612745,2014,87.0,93.0,180.0,99.65,105.5,112.7,109.85,44,16,28,0.364,46,32,14,0.696,9,7,16,16,195.08,216.24,205.66000000000003
2015-01-30,1610612751,1610612761,2014,122.0,127.0,249.0,96.7,98.4,100.6,99.2,45,18,27,0.4,46,31,15,0.674,8,10,18,13,196.96,206.0,201.48000000000002
2015-01-30,1610612739,1610612758,2014,101.0,90.0,191.0,101.9,101.55,97.75,101.5,47,27,20,0.574,44,16,28,0.364,16,11,10,6,195.48,207.08,201.28
2015-01-30,1610612740,1610612746,2014,108.0,103.0,211.0,100.45,104.8,109.85,106.5,46,24,22,0.522,46,32,14,0.696,15,9,20,12,200.8,214.36,207.58
2015-01-30,1610612748,1610612742,2014,72.0,93.0,165.0,97.25,95.5,104.45,102.7,45,20,25,0.444,47,30,17,0.638,8,12,14,16,195.0,213.0,204.0
2015-01-30,1610612762,1610612744,2014,110.0,100.0,210.0,95.55,106.55,107.5,105.85,46,16,30,0.348,43,36,7,0.8370000000000001,8,8,21,15,200.2,199.04,199.62
2015-01-30,1610612756,1610612741,2014,99.0,93.0,192.0,106.25,103.85,94.0,91.0,47,27,20,0.574,48,30,18,0.625,14,13,13,17,212.88,185.44,199.16
2015-01-29,1610612753,1610612749,2014,100.0,115.0,215.0,96.55,103.5,99.8,108.15,48,15,33,0.313,45,23,22,0.511,5,10,10,13,203.64,200.48,202.06
2015-01-29,1610612754,1610612752,2014,103.0,82.0,185.0,92.05,92.25,101.2,97.2,47,16,31,0.34,46,9,37,0.196,8,8,6,3,187.28,200.28,193.78
2015-01-29,1610612763,1610612743,2014,99.0,69.0,168.0,98.25,97.5,109.2,110.3,45,33,12,0.733,46,19,27,0.413,19,14,12,7,193.96,217.04,205.5
2015-01-29,1610612747,1610612741,2014,123.0,118.0,241.0,107.3,114.65,94.0,91.0,46,12,34,0.261,47,30,17,0.638,6,6,13,17,219.28,185.44,202.36
2015-01-28,1610612739,1610612757,2014,99.0,94.0,193.0,101.9,101.55,104.75,105.45,46,26,20,0.565,45,32,13,0.711,15,11,20,12,195.48,209.44,202.45999999999998
2015-01-28,1610612755,1610612765,2014,89.0,69.0,158.0,97.85,106.0,100.85,105.95,45,8,37,0.17800000000000002,46,17,29,0.37,3,5,7,10,207.68,206.0,206.84
2015-01-28,1610612761,1610612758,2014,119.0,102.0,221.0,100.6,99.2,97.75,101.5,45,30,15,0.667,43,16,27,0.3720000000000001,17,13,10,6,206.0,207.08,206.54000000000002
2015-01-28,1610612737,1610612751,2014,113.0,102.0,215.0,96.35,95.7,96.7,98.4,45,37,8,0.8220000000000001,44,18,26,0.409,20,17,8,10,199.44,196.96,198.2
2015-01-28,1610612745,1610612742,2014,99.0,94.0,193.0,112.7,109.85,104.45,102.7,45,31,14,0.6890000000000001,46,30,16,0.652,15,16,14,16,216.24,213.0,214.62
2015-01-28,1610612750,1610612738,2014,110.0,98.0,208.0,110.05,111.2,99.65,105.5,44,7,37,0.159,43,16,27,0.3720000000000001,3,4,9,7,209.4,195.08,202.24
2015-01-28,1610612740,1610612743,2014,85.0,93.0,178.0,100.45,104.8,109.2,110.3,45,24,21,0.5329999999999999,45,18,27,0.4,15,9,12,6,200.8,217.04,208.92000000000002
2015-01-28,1610612752,1610612760,2014,100.0,92.0,192.0,101.2,97.2,101.8,103.4,45,8,37,0.17800000000000002,45,23,22,0.511,5,3,13,10,200.28,210.36,205.32
2015-01-28,1610612759,1610612766,2014,95.0,86.0,181.0,107.75,96.55,99.45,97.7,46,29,17,0.63,45,19,26,0.422,17,12,12,7,204.12,194.96,199.54000000000002
2015-01-28,1610612762,1610612746,2014,89.0,94.0,183.0,95.55,106.55,109.85,106.5,45,16,29,0.35600000000000004,45,31,14,0.6890000000000001,8,8,20,11,200.2,214.36,207.28
2015-01-28,1610612756,1610612764,2014,106.0,98.0,204.0,106.25,103.85,94.7,91.35,46,26,20,0.565,46,31,15,0.674,13,13,18,13,212.88,193.0,202.94
2015-01-27,1610612754,1610612761,2014,91.0,104.0,195.0,92.05,92.25,100.6,99.2,46,16,30,0.348,44,29,15,0.659,8,8,17,12,187.28,206.0,196.64
2015-01-27,1610612765,1610612739,2014,95.0,103.0,198.0,100.85,105.95,101.9,101.55,45,17,28,0.378,45,25,20,0.556,7,10,15,10,206.0,195.48,200.74
2015-01-27,1610612748,1610612749,2014,102.0,109.0,211.0,97.25,95.5,99.8,108.15,44,20,24,0.455,44,22,22,0.5,8,12,10,12,195.0,200.48,197.74
2015-01-27,1610612742,1610612763,2014,90.0,109.0,199.0,104.45,102.7,98.25,97.5,45,30,15,0.667,44,32,12,0.727,14,16,19,13,213.0,193.96,203.48000000000002
2015-01-27,1610612744,1610612741,2014,111.0,113.0,224.0,107.5,105.85,94.0,91.0,42,36,6,0.857,46,29,17,0.63,21,15,13,16,199.04,185.44,192.24
2015-01-27,1610612747,1610612764,2014,92.0,98.0,190.0,107.3,114.65,94.7,91.35,45,12,33,0.267,45,30,15,0.667,6,6,18,12,219.28,193.0,206.14
2015-01-26,1610612763,1610612753,2014,103.0,94.0,197.0,98.25,97.5,96.55,103.5,43,31,12,0.721,47,15,32,0.319,18,13,5,10,193.96,203.64,198.8
2015-01-26,1610612740,1610612755,2014,99.0,74.0,173.0,100.45,104.8,97.85,106.0,44,23,21,0.523,44,8,36,0.182,14,9,3,5,200.8,207.68,204.24
2015-01-26,1610612760,1610612750,2014,92.0,84.0,176.0,101.8,103.4,110.05,111.2,44,22,22,0.5,43,7,36,0.163,12,10,3,4,210.36,209.4,209.88
2015-01-26,1610612762,1610612738,2014,90.0,99.0,189.0,95.55,106.55,99.65,105.5,44,16,28,0.364,42,15,27,0.35700000000000004,8,8,9,6,200.2,195.08,197.64
2015-01-26,1610612746,1610612743,2014,102.0,98.0,200.0,109.85,106.5,109.2,110.3,44,30,14,0.682,44,18,26,0.409,19,11,12,6,214.36,217.04,215.7
2015-01-25,1610612741,1610612748,2014,84.0,96.0,180.0,94.0,91.0,97.25,95.5,45,29,16,0.644,43,19,24,0.442,13,16,8,11,185.44,195.0,190.22
2015-01-25,1610612739,1610612760,2014,108.0,98.0,206.0,101.9,101.55,101.8,103.4,44,24,20,0.545,43,22,21,0.512,14,10,12,10,195.48,210.36,202.92000000000002
2015-01-25,1610612756,1610612746,2014,100.0,120.0,220.0,106.25,103.85,109.85,106.5,45,26,19,0.578,43,29,14,0.674,13,13,19,10,212.88,214.36,213.62
2015-01-25,1610612740,1610612742,2014,109.0,106.0,215.0,100.45,104.8,104.45,102.7,43,22,21,0.512,44,30,14,0.682,13,9,14,16,200.8,213.0,206.9
2015-01-25,1610612737,1610612750,2014,112.0,100.0,212.0,96.35,95.7,110.05,111.2,44,36,8,0.818,42,7,35,0.16699999999999998,19,17,3,4,199.44,209.4,204.42000000000002
2015-01-25,1610612753,1610612754,2014,99.0,106.0,205.0,96.55,103.5,92.05,92.25,46,15,31,0.326,45,15,30,0.333,5,10,8,7,203.64,187.28,195.45999999999998
2015-01-25,1610612759,1610612749,2014,101.0,95.0,196.0,107.75,96.55,99.8,108.15,45,28,17,0.622,43,22,21,0.512,16,12,10,12,204.12,200.48,202.3
2015-01-25,1610612761,1610612765,2014,114.0,110.0,224.0,100.6,99.2,100.85,105.95,43,28,15,0.6509999999999999,44,17,27,0.386,16,12,7,10,206.0,206.0,206.0
2015-01-25,1610612744,1610612738,2014,114.0,111.0,225.0,107.5,105.85,99.65,105.5,41,35,6,0.8540000000000001,41,15,26,0.366,20,15,9,6,199.04,195.08,197.06
2015-01-25,1610612743,1610612764,2014,115.0,117.0,232.0,109.2,110.3,94.7,91.35,43,18,25,0.419,44,29,15,0.659,12,6,18,11,217.04,193.0,205.01999999999998
2015-01-25,1610612747,1610612745,2014,87.0,99.0,186.0,107.3,114.65,112.7,109.85,44,12,32,0.273,44,30,14,0.682,6,6,15,15,219.28,216.24,217.76
2015-01-24,1610612766,1610612752,2014,76.0,71.0,147.0,99.45,97.7,101.2,97.2,44,18,26,0.409,44,8,36,0.182,11,7,5,3,194.96,200.28,197.62
2015-01-24,1610612749,1610612765,2014,101.0,86.0,187.0,99.8,108.15,100.85,105.95,42,21,21,0.5,43,17,26,0.395,9,12,7,10,200.48,206.0,203.24
2015-01-24,1610612763,1610612755,2014,101.0,83.0,184.0,98.25,97.5,97.85,106.0,42,30,12,0.7140000000000001,43,8,35,0.18600000000000005,17,13,3,5,193.96,207.68,200.82
2015-01-24,1610612762,1610612751,2014,108.0,73.0,181.0,95.55,106.55,96.7,98.4,43,15,28,0.349,43,18,25,0.419,7,8,8,10,200.2,196.96,198.57999999999998
2015-01-24,1610612757,1610612764,2014,103.0,96.0,199.0,104.75,105.45,94.7,91.35,44,31,13,0.705,43,29,14,0.674,19,12,18,11,209.44,193.0,201.22
2015-01-23,1610612755,1610612761,2014,86.0,91.0,177.0,97.85,106.0,100.6,99.2,42,8,34,0.19,42,27,15,0.643,3,5,16,11,207.68,206.0,206.84
2015-01-23,1610612737,1610612760,2014,103.0,93.0,196.0,96.35,95.7,101.8,103.4,43,35,8,0.8140000000000001,42,22,20,0.524,18,17,12,10,199.44,210.36,204.9
2015-01-23,1610612739,1610612766,2014,129.0,90.0,219.0,101.9,101.55,99.45,97.7,43,23,20,0.535,43,18,25,0.419,13,10,11,7,195.48,194.96,195.22
2015-01-23,1610612748,1610612754,2014,89.0,87.0,176.0,97.25,95.5,92.05,92.25,42,18,24,0.429,44,15,29,0.341,7,11,8,7,195.0,187.28,191.14
2015-01-23,1610612752,1610612753,2014,113.0,106.0,219.0,101.2,97.2,96.55,103.5,43,7,36,0.163,45,15,30,0.333,4,3,5,10,200.28,203.64,201.95999999999998
2015-01-23,1610612742,1610612741,2014,98.0,102.0,200.0,104.45,102.7,94.0,91.0,43,30,13,0.698,44,28,16,0.636,14,16,13,15,213.0,185.44,199.22
2015-01-23,1610612750,1610612740,2014,84.0,92.0,176.0,110.05,111.2,100.45,104.8,41,7,34,0.171,42,21,21,0.5,3,4,13,8,209.4,200.8,205.10000000000002
2015-01-23,1610612759,1610612747,2014,99.0,85.0,184.0,107.75,96.55,107.3,114.65,44,27,17,0.614,43,12,31,0.279,15,12,6,6,204.12,219.28,211.7
2015-01-23,1610612743,1610612738,2014,99.0,100.0,199.0,109.2,110.3,99.65,105.5,42,18,24,0.429,40,14,26,0.35,12,6,9,5,217.04,195.08,206.06
2015-01-23,1610612756,1610612745,2014,111.0,113.0,224.0,106.25,103.85,112.7,109.85,44,26,18,0.591,43,29,14,0.674,13,13,15,14,212.88,216.24,214.56
2015-01-23,1610612744,1610612758,2014,126.0,101.0,227.0,107.5,105.85,97.75,101.5,40,34,6,0.85,42,16,26,0.381,19,15,10,6,199.04,207.08,203.06
2015-01-22,1610612741,1610612759,2014,104.0,81.0,185.0,94.0,91.0,107.75,96.55,43,27,16,0.628,43,27,16,0.628,12,15,15,12,185.44,204.12,194.78
2015-01-22,1610612749,1610612762,2014,99.0,101.0,200.0,99.8,108.15,95.55,106.55,41,21,20,0.512,42,14,28,0.333,9,12,7,7,200.48,200.2,200.33999999999997
2015-01-22,1610612757,1610612738,2014,89.0,90.0,179.0,104.75,105.45,99.65,105.5,43,31,12,0.721,39,13,26,0.333,19,12,9,4,209.44,195.08,202.26
2015-01-22,1610612746,1610612751,2014,123.0,84.0,207.0,109.85,106.5,96.7,98.4,42,28,14,0.667,42,18,24,0.429,18,10,8,10,214.36,196.96,205.66000000000003
2015-01-21,1610612766,1610612748,2014,78.0,76.0,154.0,99.45,97.7,97.25,95.5,42,17,25,0.405,41,18,23,0.439,10,7,7,11,194.96,195.0,194.98000000000002
2015-01-21,1610612739,1610612762,2014,106.0,92.0,198.0,101.9,101.55,95.55,106.55,42,22,20,0.524,41,14,27,0.341,12,10,7,7,195.48,200.2,197.83999999999997
2015-01-21,1610612755,1610612752,2014,91.0,98.0,189.0,97.85,106.0,101.2,97.2,41,8,33,0.195,42,6,36,0.14300000000000002,3,5,4,2,207.68,200.28,203.98000000000002
2015-01-21,1610612737,1610612754,2014,110.0,91.0,201.0,96.35,95.7,92.05,92.25,42,34,8,0.81,43,15,28,0.349,17,17,8,7,199.44,187.28,193.36
2015-01-21,1610612765,1610612753,2014,128.0,118.0,246.0,100.85,105.95,96.55,103.5,42,16,26,0.381,44,15,29,0.341,6,10,5,10,206.0,203.64,204.82
2015-01-21,1610612763,1610612761,2014,92.0,86.0,178.0,98.25,97.5,100.6,99.2,41,29,12,0.7070000000000001,41,27,14,0.659,16,13,16,11,193.96,206.0,199.98000000000002
2015-01-21,1610612750,1610612742,2014,75.0,98.0,173.0,110.05,111.2,104.45,102.7,40,7,33,0.175,42,29,13,0.69,3,4,14,15,209.4,213.0,211.2
2015-01-21,1610612740,1610612747,2014,96.0,80.0,176.0,100.45,104.8,107.3,114.65,41,20,21,0.488,42,12,30,0.28600000000000003,12,8,6,6,200.8,219.28,210.04000000000002
2015-01-21,1610612764,1610612760,2014,103.0,105.0,208.0,94.7,91.35,101.8,103.4,42,29,13,0.69,41,21,20,0.512,18,11,12,9,193.0,210.36,201.68
2015-01-21,1610612756,1610612757,2014,118.0,113.0,231.0,106.25,103.85,104.75,105.45,43,25,18,0.581,42,31,11,0.738,12,13,19,12,212.88,209.44,211.16
2015-01-21,1610612758,1610612751,2014,100.0,103.0,203.0,97.75,101.5,96.7,98.4,41,16,25,0.39,41,17,24,0.415,10,6,8,9,207.08,196.96,202.02
2015-01-21,1610612744,1610612745,2014,126.0,113.0,239.0,107.5,105.85,112.7,109.85,39,33,6,0.846,42,29,13,0.69,18,15,15,14,199.04,216.24,207.64
2015-01-20,1610612748,1610612760,2014,86.0,94.0,180.0,97.25,95.5,101.8,103.4,40,18,22,0.45,40,20,20,0.5,7,11,12,8,195.0,210.36,202.68
2015-01-20,1610612743,1610612759,2014,99.0,109.0,208.0,109.2,110.3,107.75,96.55,41,18,23,0.439,42,26,16,0.619,12,6,15,11,217.04,204.12,210.57999999999998
2015-01-19,1610612766,1610612750,2014,105.0,80.0,185.0,99.45,97.7,110.05,111.2,41,16,25,0.39,39,7,32,0.179,9,7,3,4,194.96,209.4,202.18
2015-01-19,1610612764,1610612755,2014,111.0,76.0,187.0,94.7,91.35,97.85,106.0,41,28,13,0.6829999999999999,40,8,32,0.2,17,11,3,5,193.0,207.68,200.34
2015-01-19,1610612737,1610612765,2014,93.0,82.0,175.0,96.35,95.7,100.85,105.95,41,33,8,0.805,41,16,25,0.39,16,17,6,10,199.44,206.0,202.72
2015-01-19,1610612746,1610612738,2014,102.0,93.0,195.0,109.85,106.5,99.65,105.5,41,27,14,0.659,38,13,25,0.342,17,10,9,4,214.36,195.08,204.72000000000003
2015-01-19,1610612744,1610612743,2014,122.0,79.0,201.0,107.5,105.85,109.2,110.3,38,32,6,0.8420000000000001,40,18,22,0.45,17,15,12,6,199.04,217.04,208.04
2015-01-19,1610612763,1610612742,2014,95.0,103.0,198.0,98.25,97.5,104.45,102.7,40,29,11,0.725,41,28,13,0.6829999999999999,16,13,14,14,193.96,213.0,203.48000000000002
2015-01-19,1610612745,1610612754,2014,110.0,98.0,208.0,112.7,109.85,92.05,92.25,41,28,13,0.6829999999999999,42,15,27,0.35700000000000004,14,14,8,7,216.24,187.28,201.76
2015-01-19,1610612752,1610612740,2014,99.0,92.0,191.0,101.2,97.2,100.45,104.8,41,5,36,0.122,40,20,20,0.5,3,2,12,8,200.28,200.8,200.54000000000002
2015-01-19,1610612739,1610612741,2014,108.0,94.0,202.0,101.9,101.55,94.0,91.0,41,21,20,0.512,42,27,15,0.643,11,10,12,15,195.48,185.44,190.45999999999998
2015-01-19,1610612749,1610612761,2014,89.0,92.0,181.0,99.8,108.15,100.6,99.2,40,21,19,0.525,40,26,14,0.65,9,12,16,10,200.48,206.0,203.24
2015-01-19,1610612757,1610612758,2014,98.0,94.0,192.0,104.75,105.45,97.75,101.5,41,30,11,0.732,40,16,24,0.4,18,12,10,6,209.44,207.08,208.26
2015-01-19,1610612756,1610612747,2014,115.0,100.0,215.0,106.25,103.85,107.3,114.65,42,24,18,0.5710000000000001,41,12,29,0.293,11,13,6,6,212.88,219.28,216.07999999999998
2015-01-18,1610612761,1610612740,2014,93.0,95.0,188.0,100.6,99.2,100.45,104.8,39,26,13,0.667,39,19,20,0.487,16,10,12,7,206.0,200.8,203.4
2015-01-18,1610612753,1610612760,2014,99.0,127.0,226.0,96.55,103.5,101.8,103.4,43,15,28,0.349,39,19,20,0.487,5,10,12,7,203.64,210.36,207.0
2015-01-18,1610612759,1610612762,2014,89.0,69.0,158.0,107.75,96.55,95.55,106.55,41,25,16,0.61,40,14,26,0.35,14,11,7,7,204.12,200.2,202.16
2015-01-17,1610612766,1610612754,2014,80.0,71.0,151.0,99.45,97.7,92.05,92.25,40,15,25,0.375,41,15,26,0.366,8,7,8,7,194.96,187.28,191.12
2015-01-17,1610612765,1610612755,2014,107.0,89.0,196.0,100.85,105.95,97.85,106.0,40,15,25,0.375,39,8,31,0.205,5,10,3,5,206.0,207.68,206.84
2015-01-17,1610612741,1610612737,2014,99.0,107.0,206.0,94.0,91.0,96.35,95.7,41,27,14,0.659,40,32,8,0.8,12,15,16,16,185.44,199.44,192.44
2015-01-17,1610612745,1610612744,2014,106.0,131.0,237.0,112.7,109.85,107.5,105.85,40,28,12,0.7,37,31,6,0.838,14,14,17,14,216.24,199.04,207.64
2015-01-17,1610612751,1610612764,2014,90.0,99.0,189.0,96.7,98.4,94.7,91.35,40,17,23,0.425,40,27,13,0.675,8,9,17,10,196.96,193.0,194.98000000000002
2015-01-17,1610612763,1610612757,2014,102.0,98.0,200.0,98.25,97.5,104.75,105.45,39,28,11,0.718,40,30,10,0.75,15,13,18,12,193.96,209.44,201.7
2015-01-17,1610612743,1610612750,2014,105.0,113.0,218.0,109.2,110.3,110.05,111.2,39,18,21,0.462,38,6,32,0.158,12,6,3,3,217.04,209.4,213.22
2015-01-17,1610612758,1610612746,2014,108.0,117.0,225.0,97.75,101.5,109.85,106.5,39,16,23,0.41,40,26,14,0.65,10,6,17,9,207.08,214.36,210.72000000000003
2015-01-16,1610612754,1610612765,2014,96.0,98.0,194.0,92.05,92.25,100.85,105.95,40,15,25,0.375,39,14,25,0.359,8,7,5,9,187.28,206.0,196.64
2015-01-16,1610612753,1610612763,2014,96.0,106.0,202.0,96.55,103.5,98.25,97.5,42,15,27,0.35700000000000004,38,27,11,0.711,5,10,15,12,203.64,193.96,198.8
2015-01-16,1610612755,1610612740,2014,96.0,81.0,177.0,97.85,106.0,100.45,104.8,38,7,31,0.184,38,19,19,0.5,2,5,12,7,207.68,200.8,204.24
2015-01-16,1610612764,1610612751,2014,80.0,102.0,182.0,94.7,91.35,96.7,98.4,39,27,12,0.6920000000000001,39,16,23,0.41,17,10,8,8,193.0,196.96,194.98000000000002
2015-01-16,1610612738,1610612741,2014,103.0,119.0,222.0,99.65,105.5,94.0,91.0,37,13,24,0.35100000000000003,40,26,14,0.65,9,4,12,14,195.08,185.44,190.26
2015-01-16,1610612761,1610612737,2014,89.0,110.0,199.0,100.6,99.2,96.35,95.7,38,26,12,0.684,39,31,8,0.795,16,10,16,15,206.0,199.44,202.72
2015-01-16,1610612760,1610612744,2014,127.0,115.0,242.0,101.8,103.4,107.5,105.85,38,18,20,0.474,36,31,5,0.861,11,7,17,14,210.36,199.04,204.7
2015-01-16,1610612742,1610612743,2014,97.0,89.0,186.0,104.45,102.7,109.2,110.3,40,27,13,0.675,38,18,20,0.474,13,14,12,6,213.0,217.04,215.01999999999998
2015-01-16,1610612759,1610612757,2014,110.0,96.0,206.0,107.75,96.55,104.75,105.45,40,24,16,0.6,39,30,9,0.769,13,11,18,12,204.12,209.44,206.78
2015-01-16,1610612756,1610612750,2014,110.0,99.0,209.0,106.25,103.85,110.05,111.2,41,23,18,0.561,37,6,31,0.162,10,13,3,3,212.88,209.4,211.14
2015-01-16,1610612762,1610612747,2014,94.0,85.0,179.0,95.55,106.55,107.3,114.65,39,13,26,0.333,40,12,28,0.3,6,7,6,6,200.2,219.28,209.74
2015-01-16,1610612758,1610612748,2014,83.0,95.0,178.0,97.75,101.5,97.25,95.5,38,16,22,0.421,39,17,22,0.436,10,6,7,10,207.08,195.0,201.04000000000002
2015-01-16,1610612746,1610612739,2014,121.0,126.0,247.0,109.85,106.5,101.9,101.55,39,26,13,0.667,40,20,20,0.5,17,9,11,9,214.36,195.48,204.92000000000002
2015-01-15,1610612749,1610612752,2014,95.0,79.0,174.0,99.8,108.15,101.2,97.2,39,20,19,0.513,40,5,35,0.125,8,12,3,2,200.48,200.28,200.38
2015-01-15,1610612745,1610612760,2014,112.0,101.0,213.0,112.7,109.85,101.8,103.4,39,27,12,0.6920000000000001,37,18,19,0.486,13,14,11,7,216.24,210.36,213.3
2015-01-15,1610612747,1610612739,2014,102.0,109.0,211.0,107.3,114.65,101.9,101.55,39,12,27,0.308,39,19,20,0.487,6,6,11,8,219.28,195.48,207.38
2015-01-14,1610612766,1610612759,2014,93.0,98.0,191.0,99.45,97.7,107.75,96.55,39,15,24,0.385,39,23,16,0.59,8,7,13,10,194.96,204.12,199.54000000000002
2015-01-14,1610612753,1610612745,2014,120.0,113.0,233.0,96.55,103.5,112.7,109.85,41,14,27,0.341,38,27,11,0.711,4,10,13,14,203.64,216.24,209.94
2015-01-14,1610612751,1610612763,2014,92.0,103.0,195.0,96.7,98.4,98.25,97.5,38,16,22,0.421,37,26,11,0.703,8,8,15,11,196.96,193.96,195.46
2015-01-14,1610612765,1610612740,2014,94.0,105.0,199.0,100.85,105.95,100.45,104.8,38,14,24,0.368,37,18,19,0.486,5,9,12,6,206.0,200.8,203.4
2015-01-14,1610612761,1610612755,2014,100.0,84.0,184.0,100.6,99.2,97.85,106.0,37,25,12,0.6759999999999999,37,7,30,0.189,15,10,2,5,206.0,207.68,206.84
2015-01-14,1610612741,1610612764,2014,99.0,105.0,204.0,94.0,91.0,94.7,91.35,39,26,13,0.667,38,26,12,0.684,12,14,17,9,185.44,193.0,189.22
2015-01-14,1610612738,1610612737,2014,91.0,105.0,196.0,99.65,105.5,96.35,95.7,36,13,23,0.361,38,30,8,0.789,9,4,16,14,195.08,199.44,197.26
2015-01-14,1610612743,1610612742,2014,114.0,107.0,221.0,109.2,110.3,104.45,102.7,37,17,20,0.459,39,27,12,0.6920000000000001,11,6,13,14,217.04,213.0,215.01999999999998
2015-01-14,1610612744,1610612748,2014,104.0,89.0,193.0,107.5,105.85,97.25,95.5,35,30,5,0.857,38,17,21,0.447,16,14,7,10,199.04,195.0,197.01999999999998
2015-01-14,1610612757,1610612746,2014,94.0,100.0,194.0,104.75,105.45,109.85,106.5,38,30,8,0.789,38,25,13,0.6579999999999999,18,12,17,8,209.44,214.36,211.9
2015-01-13,1610612754,1610612750,2014,101.0,110.0,211.0,92.05,92.25,110.05,111.2,39,15,24,0.385,36,5,31,0.139,8,7,3,2,187.28,209.4,198.34
2015-01-13,1610612755,1610612737,2014,87.0,105.0,192.0,97.85,106.0,96.35,95.7,36,7,29,0.194,37,29,8,0.784,2,5,16,13,207.68,199.44,203.56
2015-01-13,1610612764,1610612759,2014,101.0,93.0,194.0,94.7,91.35,107.75,96.55,37,25,12,0.6759999999999999,38,23,15,0.605,16,9,13,10,193.0,204.12,198.56
2015-01-13,1610612756,1610612739,2014,107.0,100.0,207.0,106.25,103.85,101.9,101.55,40,22,18,0.55,38,19,19,0.5,9,13,11,8,212.88,195.48,204.18
2015-01-13,1610612762,1610612744,2014,105.0,116.0,221.0,95.55,106.55,107.5,105.85,38,13,25,0.342,34,29,5,0.853,6,7,16,13,200.2,199.04,199.62
2015-01-13,1610612758,1610612742,2014,104.0,108.0,212.0,97.75,101.5,104.45,102.7,37,16,21,0.4320000000000001,38,26,12,0.684,10,6,13,13,207.08,213.0,210.04000000000002
2015-01-13,1610612747,1610612748,2014,75.0,78.0,153.0,107.3,114.65,97.25,95.5,38,12,26,0.316,37,16,21,0.4320000000000001,6,6,7,9,219.28,195.0,207.14
2015-01-12,1610612738,1610612740,2014,108.0,100.0,208.0,99.65,105.5,100.45,104.8,35,12,23,0.343,36,18,18,0.5,8,4,12,6,195.08,200.8,197.94
2015-01-12,1610612751,1610612745,2014,99.0,113.0,212.0,96.7,98.4,112.7,109.85,37,16,21,0.4320000000000001,37,26,11,0.703,8,8,13,13,196.96,216.24,206.60000000000002
2015-01-12,1610612761,1610612765,2014,111.0,114.0,225.0,100.6,99.2,100.85,105.95,36,25,11,0.6940000000000001,37,13,24,0.35100000000000003,15,10,5,8,206.0,206.0,206.0
2015-01-12,1610612741,1610612753,2014,114.0,121.0,235.0,94.0,91.0,96.55,103.5,38,26,12,0.684,40,13,27,0.325,12,14,4,9,185.44,203.64,194.54
2015-01-11,1610612737,1610612764,2014,120.0,89.0,209.0,96.35,95.7,94.7,91.35,36,28,8,0.778,36,25,11,0.6940000000000001,15,13,16,9,199.44,193.0,196.22
2015-01-11,1610612746,1610612748,2014,90.0,104.0,194.0,109.85,106.5,97.25,95.5,37,25,12,0.6759999999999999,36,15,21,0.417,17,8,7,8,214.36,195.0,204.68
2015-01-11,1610612763,1610612756,2014,122.0,110.0,232.0,98.25,97.5,106.25,103.85,36,25,11,0.6940000000000001,39,22,17,0.564,14,11,9,13,193.96,212.88,203.42000000000002
2015-01-11,1610612758,1610612739,2014,103.0,84.0,187.0,97.75,101.5,101.9,101.55,36,15,21,0.417,37,19,18,0.514,9,6,11,8,207.08,195.48,201.28
2015-01-11,1610612747,1610612757,2014,94.0,106.0,200.0,107.3,114.65,104.75,105.45,37,12,25,0.324,37,29,8,0.784,6,6,18,11,219.28,209.44,214.36
2015-01-10,1610612752,1610612766,2014,82.0,110.0,192.0,101.2,97.2,99.45,97.7,39,5,34,0.128,38,14,24,0.368,3,2,8,6,200.28,194.96,197.62
2015-01-10,1610612746,1610612742,2014,120.0,100.0,220.0,109.85,106.5,104.45,102.7,36,24,12,0.667,37,26,11,0.703,16,8,13,13,214.36,213.0,213.68
2015-01-10,1610612765,1610612751,2014,98.0,93.0,191.0,100.85,105.95,96.7,98.4,36,12,24,0.333,36,16,20,0.444,4,8,8,8,206.0,196.96,201.48000000000002
2015-01-10,1610612755,1610612754,2014,93.0,92.0,185.0,97.85,106.0,92.05,92.25,35,6,29,0.171,38,15,23,0.395,1,5,8,7,207.68,187.28,197.48000000000002
2015-01-10,1610612761,1610612738,2014,109.0,96.0,205.0,100.6,99.2,99.65,105.5,35,24,11,0.6859999999999999,34,12,22,0.353,14,10,8,4,206.0,195.08,200.54000000000002
2015-01-10,1610612741,1610612749,2014,95.0,87.0,182.0,94.0,91.0,99.8,108.15,37,25,12,0.6759999999999999,38,20,18,0.526,11,14,8,12,185.44,200.48,192.95999999999998
2015-01-10,1610612745,1610612762,2014,97.0,82.0,179.0,112.7,109.85,95.55,106.55,36,25,11,0.6940000000000001,37,13,24,0.35100000000000003,12,13,6,7,216.24,200.2,208.22
2015-01-10,1610612750,1610612759,2014,93.0,108.0,201.0,110.05,111.2,107.75,96.55,35,5,30,0.14300000000000002,37,22,15,0.595,3,2,13,9,209.4,204.12,206.76
2015-01-10,1610612757,1610612753,2014,103.0,92.0,195.0,104.75,105.45,96.55,103.5,36,28,8,0.778,39,13,26,0.333,17,11,4,9,209.44,203.64,206.54
2015-01-09,1610612754,1610612738,2014,107.0,103.0,210.0,92.05,92.25,99.65,105.5,37,14,23,0.378,33,12,21,0.364,7,7,8,4,187.28,195.08,191.18
2015-01-09,1610612751,1610612755,2014,88.0,90.0,178.0,96.7,98.4,97.85,106.0,35,16,19,0.457,34,5,29,0.147,8,8,1,4,196.96,207.68,202.32
2015-01-09,1610612765,1610612737,2014,103.0,106.0,209.0,100.85,105.95,96.35,95.7,35,12,23,0.343,35,27,8,0.7709999999999999,4,8,15,12,206.0,199.44,202.72
2015-01-09,1610612740,1610612763,2014,106.0,95.0,201.0,100.45,104.8,98.25,97.5,35,17,18,0.486,35,25,10,0.7140000000000001,11,6,14,11,200.8,193.96,197.38
2015-01-09,1610612760,1610612762,2014,99.0,94.0,193.0,101.8,103.4,95.55,106.55,36,17,19,0.472,36,13,23,0.361,10,7,6,7,210.36,200.2,205.28
2015-01-09,1610612764,1610612741,2014,102.0,86.0,188.0,94.7,91.35,94.0,91.0,35,24,11,0.6859999999999999,36,25,11,0.6940000000000001,15,9,11,14,193.0,185.44,189.22
2015-01-09,1610612749,1610612750,2014,98.0,84.0,182.0,99.8,108.15,110.05,111.2,37,19,18,0.514,34,5,29,0.147,7,12,3,2,200.48,209.4,204.94
2015-01-09,1610612759,1610612756,2014,100.0,95.0,195.0,107.75,96.55,106.25,103.85,36,21,15,0.583,38,22,16,0.579,12,9,9,13,204.12,212.88,208.5
2015-01-09,1610612758,1610612743,2014,108.0,118.0,226.0,97.75,101.5,109.2,110.3,35,15,20,0.429,36,16,20,0.444,9,6,11,5,207.08,217.04,212.06
2015-01-09,1610612744,1610612739,2014,112.0,94.0,206.0,107.5,105.85,101.9,101.55,33,28,5,0.848,36,19,17,0.528,15,13,11,8,199.04,195.48,197.26
2015-01-09,1610612747,1610612753,2014,101.0,84.0,185.0,107.3,114.65,96.55,103.5,36,11,25,0.306,38,13,25,0.342,5,6,4,9,219.28,203.64,211.45999999999998
2015-01-08,1610612761,1610612766,2014,95.0,103.0,198.0,100.6,99.2,99.45,97.7,34,24,10,0.706,37,13,24,0.35100000000000003,14,10,8,5,206.0,194.96,200.48000000000002
2015-01-08,1610612752,1610612745,2014,96.0,120.0,216.0,101.2,97.2,112.7,109.85,38,5,33,0.132,35,24,11,0.6859999999999999,3,2,12,12,200.28,216.24,208.26
2015-01-08,1610612757,1610612748,2014,99.0,83.0,182.0,104.75,105.45,97.25,95.5,35,27,8,0.7709999999999999,35,15,20,0.429,16,11,7,8,209.44,195.0,202.22
2015-01-07,1610612766,1610612740,2014,98.0,94.0,192.0,99.45,97.7,100.45,104.8,36,12,24,0.333,34,17,17,0.5,7,5,11,6,194.96,200.8,197.88
2015-01-07,1610612739,1610612745,2014,93.0,105.0,198.0,101.9,101.55,112.7,109.85,35,19,16,0.5429999999999999,34,23,11,0.6759999999999999,11,8,12,11,195.48,216.24,205.86
2015-01-07,1610612755,1610612749,2014,77.0,97.0,174.0,97.85,106.0,99.8,108.15,33,5,28,0.152,36,18,18,0.5,1,4,7,11,207.68,200.48,204.07999999999998
2015-01-07,1610612764,1610612752,2014,101.0,91.0,192.0,94.7,91.35,101.2,97.2,34,23,11,0.6759999999999999,37,5,32,0.135,14,9,3,2,193.0,200.28,196.64
2015-01-07,1610612737,1610612763,2014,96.0,86.0,182.0,96.35,95.7,98.25,97.5,34,26,8,0.765,34,25,9,0.735,14,12,14,11,199.44,193.96,196.7
2015-01-07,1610612751,1610612738,2014,81.0,89.0,170.0,96.7,98.4,99.65,105.5,34,16,18,0.471,32,11,21,0.344,8,8,8,3,196.96,195.08,196.02
2015-01-07,1610612741,1610612762,2014,77.0,97.0,174.0,94.0,91.0,95.55,106.55,35,25,10,0.7140000000000001,35,12,23,0.343,11,14,6,6,185.44,200.2,192.82
2015-01-07,1610612742,1610612765,2014,95.0,108.0,203.0,104.45,102.7,100.85,105.95,36,26,10,0.722,34,11,23,0.324,13,13,4,7,213.0,206.0,209.5
2015-01-07,1610612743,1610612753,2014,93.0,90.0,183.0,109.2,110.3,96.55,103.5,35,15,20,0.429,37,13,24,0.35100000000000003,10,5,4,9,217.04,203.64,210.33999999999997
2015-01-07,1610612750,1610612756,2014,111.0,113.0,224.0,110.05,111.2,106.25,103.85,33,5,28,0.152,37,21,16,0.568,3,2,9,12,209.4,212.88,211.14
2015-01-07,1610612758,1610612760,2014,104.0,83.0,187.0,97.75,101.5,101.8,103.4,34,14,20,0.412,35,17,18,0.486,8,6,10,7,207.08,210.36,208.72000000000003
2015-01-07,1610612744,1610612754,2014,117.0,102.0,219.0,107.5,105.85,92.05,92.25,32,27,5,0.8440000000000001,36,14,22,0.389,14,13,7,7,199.04,187.28,193.16
2015-01-07,1610612746,1610612747,2014,114.0,89.0,203.0,109.85,106.5,107.3,114.65,35,23,12,0.657,35,11,24,0.314,15,8,5,6,214.36,219.28,216.82
2015-01-06,1610612749,1610612756,2014,96.0,102.0,198.0,99.8,108.15,106.25,103.85,35,18,17,0.514,36,20,16,0.556,7,11,9,11,200.48,212.88,206.68
2015-01-06,1610612759,1610612765,2014,104.0,105.0,209.0,107.75,96.55,100.85,105.95,35,21,14,0.6,33,10,23,0.303,12,9,4,6,204.12,206.0,205.06
2015-01-05,1610612755,1610612739,2014,95.0,92.0,187.0,97.85,106.0,101.9,101.55,32,4,28,0.125,34,19,15,0.5589999999999999,0,4,11,8,207.68,195.48,201.57999999999998
2015-01-05,1610612738,1610612766,2014,95.0,104.0,199.0,99.65,105.5,99.45,97.7,31,11,20,0.355,35,11,24,0.314,8,3,7,4,195.08,194.96,195.02
2015-01-05,1610612751,1610612742,2014,88.0,96.0,184.0,96.7,98.4,104.45,102.7,33,16,17,0.485,35,25,10,0.7140000000000001,8,8,13,12,196.96,213.0,204.98000000000002
2015-01-05,1610612741,1610612745,2014,114.0,105.0,219.0,94.0,91.0,112.7,109.85,34,24,10,0.706,33,23,10,0.6970000000000001,10,14,12,11,185.44,216.24,200.84
2015-01-05,1610612763,1610612752,2014,105.0,83.0,188.0,98.25,97.5,101.2,97.2,33,24,9,0.727,36,5,31,0.139,13,11,3,2,193.96,200.28,197.12
2015-01-05,1610612750,1610612743,2014,101.0,110.0,211.0,110.05,111.2,109.2,110.3,32,5,27,0.156,34,14,20,0.412,3,2,10,4,209.4,217.04,213.22
2015-01-05,1610612740,1610612764,2014,85.0,92.0,177.0,100.45,104.8,94.7,91.35,33,17,16,0.515,33,22,11,0.667,11,6,14,8,200.8,193.0,196.9
2015-01-05,1610612762,1610612754,2014,101.0,105.0,206.0,95.55,106.55,92.05,92.25,34,12,22,0.353,35,13,22,0.371,6,6,7,6,200.2,187.28,193.74
2015-01-05,1610612757,1610612747,2014,98.0,94.0,192.0,104.75,105.45,107.3,114.65,34,26,8,0.765,34,11,23,0.324,15,11,5,6,209.44,219.28,214.36
2015-01-05,1610612744,1610612760,2014,117.0,91.0,208.0,107.5,105.85,101.8,103.4,31,26,5,0.8390000000000001,34,17,17,0.5,13,13,10,7,199.04,210.36,204.7
2015-01-05,1610612746,1610612737,2014,98.0,107.0,205.0,109.85,106.5,96.35,95.7,34,23,11,0.6759999999999999,33,25,8,0.758,15,8,14,11,214.36,199.44,206.9
2015-01-04,1610612739,1610612742,2014,90.0,109.0,199.0,101.9,101.55,104.45,102.7,33,19,14,0.5760000000000001,34,24,10,0.706,11,8,13,11,195.48,213.0,204.24
2015-01-04,1610612765,1610612758,2014,114.0,95.0,209.0,100.85,105.95,97.75,101.5,32,9,23,0.281,33,14,19,0.424,3,6,8,6,206.0,207.08,206.54000000000002
2015-01-04,1610612748,1610612751,2014,88.0,84.0,172.0,97.25,95.5,96.7,98.4,34,14,20,0.412,32,16,16,0.5,6,8,8,8,195.0,196.96,195.98000000000002
2015-01-04,1610612752,1610612749,2014,82.0,95.0,177.0,101.2,97.2,99.8,108.15,35,5,30,0.14300000000000002,34,17,17,0.5,3,2,7,10,200.28,200.48,200.38
2015-01-04,1610612756,1610612761,2014,125.0,109.0,234.0,106.25,103.85,100.6,99.2,35,19,16,0.5429999999999999,33,24,9,0.727,8,11,14,10,212.88,206.0,209.44
2015-01-04,1610612747,1610612754,2014,88.0,87.0,175.0,107.3,114.65,92.05,92.25,33,10,23,0.303,34,13,21,0.382,4,6,7,6,219.28,187.28,203.28
2015-01-03,1610612753,1610612766,2014,90.0,98.0,188.0,96.55,103.5,99.45,97.7,36,13,23,0.361,34,10,24,0.294,4,9,7,3,203.64,194.96,199.3
2015-01-03,1610612741,1610612738,2014,109.0,104.0,213.0,94.0,91.0,99.65,105.5,33,23,10,0.6970000000000001,30,11,19,0.3670000000000001,9,14,8,3,185.44,195.08,190.26
2015-01-03,1610612745,1610612748,2014,115.0,79.0,194.0,112.7,109.85,97.25,95.5,32,22,10,0.688,33,14,19,0.424,11,11,6,8,216.24,195.0,205.62
2015-01-03,1610612750,1610612762,2014,89.0,101.0,190.0,110.05,111.2,95.55,106.55,31,5,26,0.161,33,11,22,0.333,3,2,6,5,209.4,200.2,204.8
2015-01-03,1610612759,1610612764,2014,101.0,92.0,193.0,107.75,96.55,94.7,91.35,34,20,14,0.588,32,22,10,0.688,11,9,14,8,204.12,193.0,198.56
2015-01-03,1610612743,1610612763,2014,114.0,85.0,199.0,109.2,110.3,98.25,97.5,33,13,20,0.394,32,24,8,0.75,9,4,13,11,217.04,193.96,205.5
2015-01-03,1610612757,1610612737,2014,107.0,115.0,222.0,104.75,105.45,96.35,95.7,33,26,7,0.7879999999999999,32,24,8,0.75,15,11,14,10,209.44,199.44,204.44
2015-01-03,1610612746,1610612755,2014,127.0,91.0,218.0,109.85,106.5,97.85,106.0,33,22,11,0.667,31,4,27,0.129,14,8,0,4,214.36,207.68,211.02
2015-01-02,1610612766,1610612739,2014,87.0,91.0,178.0,99.45,97.7,101.9,101.55,33,10,23,0.303,32,18,14,0.563,7,3,11,7,194.96,195.48,195.22
2015-01-02,1610612753,1610612751,2014,98.0,100.0,198.0,96.55,103.5,96.7,98.4,35,13,22,0.371,31,15,16,0.484,4,9,8,7,203.64,196.96,200.3
2015-01-02,1610612738,1610612742,2014,101.0,119.0,220.0,99.65,105.5,104.45,102.7,29,11,18,0.379,33,23,10,0.6970000000000001,8,3,13,10,195.08,213.0,204.04000000000002
2015-01-02,1610612752,1610612765,2014,81.0,97.0,178.0,101.2,97.2,100.85,105.95,34,5,29,0.147,31,8,23,0.258,3,2,3,5,200.28,206.0,203.14
2015-01-02,1610612740,1610612745,2014,111.0,83.0,194.0,100.45,104.8,112.7,109.85,32,16,16,0.5,31,22,9,0.71,10,6,11,11,200.8,216.24,208.52
2015-01-02,1610612760,1610612764,2014,109.0,102.0,211.0,101.8,103.4,94.7,91.35,33,16,17,0.485,31,22,9,0.71,9,7,14,8,210.36,193.0,201.68
2015-01-02,1610612749,1610612754,2014,91.0,94.0,185.0,99.8,108.15,92.05,92.25,33,17,16,0.515,33,12,21,0.364,7,10,7,5,200.48,187.28,193.88
2015-01-02,1610612756,1610612755,2014,112.0,96.0,208.0,106.25,103.85,97.85,106.0,34,18,16,0.529,30,4,26,0.133,7,11,0,4,212.88,207.68,210.28
2015-01-02,1610612762,1610612737,2014,92.0,98.0,190.0,95.55,106.55,96.35,95.7,32,11,21,0.344,31,23,8,0.742,6,5,14,9,200.2,199.44,199.82
2015-01-02,1610612744,1610612761,2014,126.0,105.0,231.0,107.5,105.85,100.6,99.2,30,25,5,0.833,32,24,8,0.75,12,13,14,10,199.04,206.0,202.51999999999998
2015-01-02,1610612747,1610612763,2014,106.0,109.0,215.0,107.3,114.65,98.25,97.5,32,10,22,0.313,31,23,8,0.742,4,6,13,10,219.28,193.96,206.62
2015-01-01,1610612741,1610612743,2014,106.0,101.0,207.0,94.0,91.0,109.2,110.3,32,22,10,0.688,32,13,19,0.406,8,14,9,4,185.44,217.04,201.24
2015-01-01,1610612750,1610612758,2014,107.0,110.0,217.0,110.05,111.2,97.75,101.5,30,5,25,0.16699999999999998,32,13,19,0.406,3,2,8,5,209.4,207.08,208.24
2014-12-31,1610612738,1610612758,2014,106.0,84.0,190.0,99.65,105.5,97.75,101.5,28,10,18,0.35700000000000004,31,13,18,0.419,7,3,8,5,195.08,207.08,201.08
2014-12-31,1610612754,1610612748,2014,106.0,95.0,201.0,92.05,92.25,97.25,95.5,32,11,21,0.344,32,14,18,0.438,6,5,6,8,187.28,195.0,191.14
2014-12-31,1610612746,1610612752,2014,99.0,78.0,177.0,109.85,106.5,101.2,97.2,32,21,11,0.6559999999999999,33,5,28,0.152,13,8,3,2,214.36,200.28,207.32
2014-12-31,1610612745,1610612766,2014,102.0,83.0,185.0,112.7,109.85,99.45,97.7,30,21,9,0.7,32,10,22,0.313,10,11,7,3,216.24,194.96,205.60000000000002
2014-12-31,1610612739,1610612749,2014,80.0,96.0,176.0,101.9,101.55,99.8,108.15,31,18,13,0.581,32,16,16,0.5,11,7,7,9,195.48,200.48,197.98
2014-12-31,1610612759,1610612740,2014,95.0,93.0,188.0,107.75,96.55,100.45,104.8,33,19,14,0.5760000000000001,31,16,15,0.516,10,9,10,6,204.12,200.8,202.46
2014-12-31,1610612760,1610612756,2014,137.0,134.0,271.0,101.8,103.4,106.25,103.85,32,15,17,0.469,33,18,15,0.545,8,7,7,11,210.36,212.88,211.62
2014-12-30,1610612753,1610612765,2014,86.0,109.0,195.0,96.55,103.5,100.85,105.95,34,13,21,0.382,30,7,23,0.233,4,9,3,4,203.64,206.0,204.82
2014-12-30,1610612737,1610612739,2014,109.0,101.0,210.0,96.35,95.7,101.9,101.55,30,22,8,0.733,30,18,12,0.6,13,9,11,7,199.44,195.48,197.45999999999998
2014-12-30,1610612741,1610612751,2014,82.0,96.0,178.0,94.0,91.0,96.7,98.4,31,22,9,0.71,30,14,16,0.467,8,14,8,6,185.44,196.96,191.2
2014-12-30,1610612763,1610612759,2014,95.0,87.0,182.0,98.25,97.5,107.75,96.55,30,22,8,0.733,32,19,13,0.594,12,10,10,9,193.96,204.12,199.04000000000002
2014-12-30,1610612740,1610612756,2014,110.0,106.0,216.0,100.45,104.8,106.25,103.85,30,15,15,0.5,32,18,14,0.563,9,6,7,11,200.8,212.88,206.84
2014-12-30,1610612742,1610612764,2014,114.0,87.0,201.0,104.45,102.7,94.7,91.35,32,22,10,0.688,30,22,8,0.733,12,10,14,8,213.0,193.0,203.0
2014-12-30,1610612743,1610612747,2014,103.0,111.0,214.0,109.2,110.3,107.3,114.65,31,13,18,0.419,31,9,22,0.29,9,4,4,5,217.04,219.28,218.16
2014-12-30,1610612762,1610612750,2014,100.0,94.0,194.0,95.55,106.55,110.05,111.2,31,10,21,0.32299999999999995,29,5,24,0.172,5,5,3,2,200.2,209.4,204.8
2014-12-30,1610612757,1610612761,2014,102.0,97.0,199.0,104.75,105.45,100.6,99.2,32,25,7,0.7809999999999999,31,24,7,0.774,14,11,14,10,209.44,206.0,207.72
2014-12-30,1610612744,1610612755,2014,126.0,86.0,212.0,107.5,105.85,97.85,106.0,29,24,5,0.828,29,4,25,0.138,11,13,0,4,199.04,207.68,203.36
2014-12-29,1610612766,1610612749,2014,94.0,104.0,198.0,99.45,97.7,99.8,108.15,31,10,21,0.32299999999999995,31,15,16,0.484,7,3,7,8,194.96,200.48,197.72
2014-12-29,1610612754,1610612741,2014,90.0,92.0,182.0,92.05,92.25,94.0,91.0,31,11,20,0.355,30,21,9,0.7,6,5,8,13,187.28,185.44,186.36
2014-12-29,1610612751,1610612758,2014,107.0,99.0,206.0,96.7,98.4,97.75,101.5,29,13,16,0.448,30,13,17,0.433,7,6,8,5,196.96,207.08,202.02
2014-12-29,1610612748,1610612753,2014,101.0,102.0,203.0,97.25,95.5,96.55,103.5,31,14,17,0.452,33,12,21,0.364,6,8,4,8,195.0,203.64,199.32
2014-12-29,1610612745,1610612764,2014,103.0,104.0,207.0,112.7,109.85,94.7,91.35,29,21,8,0.7240000000000001,29,21,8,0.7240000000000001,10,11,14,7,216.24,193.0,204.62
2014-12-29,1610612746,1610612762,2014,101.0,97.0,198.0,109.85,106.5,95.55,106.55,31,20,11,0.645,30,10,20,0.333,12,8,5,5,214.36,200.2,207.28
2014-12-28,1610612739,1610612765,2014,80.0,103.0,183.0,101.9,101.55,100.85,105.95,29,18,11,0.621,29,6,23,0.207,11,7,3,3,195.48,206.0,200.74
2014-12-28,1610612759,1610612745,2014,110.0,106.0,216.0,107.75,96.55,112.7,109.85,31,18,13,0.581,28,21,7,0.75,9,9,10,11,204.12,216.24,210.18
2014-12-28,1610612742,1610612760,2014,112.0,107.0,219.0,104.45,102.7,101.8,103.4,31,21,10,0.677,31,15,16,0.484,11,10,8,7,213.0,210.36,211.68
2014-12-28,1610612757,1610612752,2014,101.0,79.0,180.0,104.75,105.45,101.2,97.2,31,24,7,0.774,32,5,27,0.156,13,11,3,2,209.44,200.28,204.86
2014-12-28,1610612743,1610612761,2014,102.0,116.0,218.0,109.2,110.3,100.6,99.2,30,13,17,0.433,30,23,7,0.767,9,4,14,9,217.04,206.0,211.51999999999998
2014-12-28,1610612747,1610612756,2014,107.0,116.0,223.0,107.3,114.65,106.25,103.85,30,9,21,0.3,31,17,14,0.5479999999999999,4,5,7,10,219.28,212.88,216.07999999999998
2014-12-27,1610612746,1610612761,2014,98.0,110.0,208.0,109.85,106.5,100.6,99.2,30,20,10,0.667,29,22,7,0.759,12,8,14,8,214.36,206.0,210.18
2014-12-27,1610612766,1610612753,2014,94.0,102.0,196.0,99.45,97.7,96.55,103.5,30,10,20,0.333,32,11,21,0.344,7,3,4,7,194.96,203.64,199.3
2014-12-27,1610612764,1610612738,2014,101.0,88.0,189.0,94.7,91.35,99.65,105.5,28,20,8,0.7140000000000001,27,10,17,0.37,13,7,7,3,193.0,195.08,194.04000000000002
2014-12-27,1610612748,1610612763,2014,95.0,103.0,198.0,97.25,95.5,98.25,97.5,30,14,16,0.467,29,21,8,0.7240000000000001,6,8,12,9,195.0,193.96,194.48000000000002
2014-12-27,1610612741,1610612740,2014,107.0,100.0,207.0,94.0,91.0,100.45,104.8,29,20,9,0.69,29,15,14,0.517,7,13,9,6,185.44,200.8,193.12
2014-12-27,1610612751,1610612754,2014,85.0,110.0,195.0,96.7,98.4,92.05,92.25,28,13,15,0.464,30,10,20,0.333,7,6,6,4,196.96,187.28,192.12
2014-12-27,1610612749,1610612737,2014,85.0,90.0,175.0,99.8,108.15,96.35,95.7,30,15,15,0.5,29,21,8,0.7240000000000001,7,8,13,8,200.48,199.44,199.95999999999998
2014-12-27,1610612762,1610612755,2014,88.0,71.0,159.0,95.55,106.55,97.85,106.0,29,9,20,0.31,28,4,24,0.14300000000000002,4,5,0,4,200.2,207.68,203.94
2014-12-27,1610612758,1610612752,2014,135.0,129.0,264.0,97.75,101.5,101.2,97.2,29,12,17,0.414,31,5,26,0.161,7,5,3,2,207.08,200.28,203.68
2014-12-27,1610612744,1610612750,2014,110.0,97.0,207.0,107.5,105.85,110.05,111.2,28,23,5,0.821,28,5,23,0.179,10,13,3,2,199.04,209.4,204.22
2014-12-26,1610612738,1610612751,2014,107.0,109.0,216.0,99.65,105.5,96.7,98.4,26,10,16,0.385,27,12,15,0.444,7,3,7,5,195.08,196.96,196.02
2014-12-26,1610612753,1610612739,2014,89.0,98.0,187.0,96.55,103.5,101.9,101.55,31,11,20,0.355,28,17,11,0.607,4,7,11,6,203.64,195.48,199.56
2014-12-26,1610612737,1610612749,2014,77.0,107.0,184.0,96.35,95.7,99.8,108.15,28,21,7,0.75,29,14,15,0.483,13,8,7,7,199.44,200.48,199.95999999999998
2014-12-26,1610612765,1610612754,2014,119.0,109.0,228.0,100.85,105.95,92.05,92.25,28,5,23,0.179,29,10,19,0.345,2,3,6,4,206.0,187.28,196.64
2014-12-26,1610612763,1610612745,2014,111.0,117.0,228.0,98.25,97.5,112.7,109.85,28,21,7,0.75,27,20,7,0.741,12,9,10,10,193.96,216.24,205.10000000000002
2014-12-26,1610612740,1610612759,2014,97.0,90.0,187.0,100.45,104.8,107.75,96.55,28,14,14,0.5,30,18,12,0.6,8,6,9,9,200.8,204.12,202.46
2014-12-26,1610612760,1610612766,2014,98.0,75.0,173.0,101.8,103.4,99.45,97.7,30,14,16,0.467,29,10,19,0.345,7,7,7,3,210.36,194.96,202.66000000000003
2014-12-26,1610612742,1610612747,2014,102.0,98.0,200.0,104.45,102.7,107.3,114.65,30,20,10,0.667,29,9,20,0.31,10,10,4,5,213.0,219.28,216.14
2014-12-26,1610612743,1610612750,2014,106.0,102.0,208.0,109.2,110.3,110.05,111.2,29,12,17,0.414,27,5,22,0.185,8,4,3,2,217.04,209.4,213.22
2014-12-26,1610612757,1610612755,2014,114.0,93.0,207.0,104.75,105.45,97.85,106.0,30,23,7,0.767,27,4,23,0.14800000000000002,12,11,0,4,209.44,207.68,208.56
2014-12-26,1610612758,1610612756,2014,106.0,115.0,221.0,97.75,101.5,106.25,103.85,28,12,16,0.429,30,16,14,0.5329999999999999,7,5,7,9,207.08,212.88,209.98000000000002
2014-12-25,1610612752,1610612764,2014,91.0,102.0,193.0,101.2,97.2,94.7,91.35,30,5,25,0.16699999999999998,27,19,8,0.7040000000000001,3,2,13,6,200.28,193.0,196.64
2014-12-25,1610612759,1610612760,2014,106.0,114.0,220.0,107.75,96.55,101.8,103.4,29,18,11,0.621,29,13,16,0.448,9,9,7,6,204.12,210.36,207.24
2014-12-25,1610612748,1610612739,2014,101.0,91.0,192.0,97.25,95.5,101.9,101.55,29,13,16,0.448,27,17,10,0.63,5,8,11,6,195.0,195.48,195.24
2014-12-25,1610612741,1610612747,2014,113.0,93.0,206.0,94.0,91.0,107.3,114.65,28,19,9,0.679,28,9,19,0.321,6,13,4,5,185.44,219.28,202.36
2014-12-25,1610612746,1610612744,2014,100.0,86.0,186.0,109.85,106.5,107.5,105.85,29,19,10,0.655,27,23,4,0.852,11,8,10,13,214.36,199.04,206.7
2014-12-23,1610612739,1610612750,2014,125.0,104.0,229.0,101.9,101.55,110.05,111.2,26,16,10,0.615,26,5,21,0.192,10,6,3,2,195.48,209.4,202.44
2014-12-23,1610612754,1610612740,2014,96.0,84.0,180.0,92.05,92.25,100.45,104.8,28,9,19,0.321,27,14,13,0.519,5,4,8,6,187.28,200.8,194.04000000000002
2014-12-23,1610612753,1610612738,2014,100.0,95.0,195.0,96.55,103.5,99.65,105.5,30,10,20,0.333,25,10,15,0.4,3,7,7,3,203.64,195.08,199.36
2014-12-23,1610612764,1610612741,2014,91.0,99.0,190.0,94.7,91.35,94.0,91.0,26,19,7,0.731,27,18,9,0.667,13,6,6,12,193.0,185.44,189.22
2014-12-23,1610612737,1610612746,2014,107.0,104.0,211.0,96.35,95.7,109.85,106.5,27,20,7,0.741,28,19,9,0.679,12,8,11,8,199.44,214.36,206.9
2014-12-23,1610612751,1610612743,2014,102.0,96.0,198.0,96.7,98.4,109.2,110.3,26,11,15,0.423,28,12,16,0.429,6,5,8,4,196.96,217.04,207.0
2014-12-23,1610612748,1610612755,2014,87.0,91.0,178.0,97.25,95.5,97.85,106.0,28,13,15,0.464,26,3,23,0.115,5,8,0,3,195.0,207.68,201.34
2014-12-23,1610612749,1610612766,2014,101.0,108.0,209.0,99.8,108.15,99.45,97.7,28,14,14,0.5,28,9,19,0.321,7,7,7,2,200.48,194.96,197.72
2014-12-23,1610612760,1610612757,2014,111.0,115.0,226.0,101.8,103.4,104.75,105.45,28,13,15,0.464,29,22,7,0.759,7,6,12,10,210.36,209.44,209.9
2014-12-23,1610612756,1610612742,2014,124.0,115.0,239.0,106.25,103.85,104.45,102.7,29,15,14,0.517,29,20,9,0.69,6,9,10,10,212.88,213.0,212.94
2014-12-23,1610612747,1610612744,2014,115.0,105.0,220.0,107.3,114.65,107.5,105.85,27,8,19,0.29600000000000004,26,23,3,0.885,3,5,10,13,219.28,199.04,209.16
2014-12-22,1610612766,1610612743,2014,110.0,82.0,192.0,99.45,97.7,109.2,110.3,27,8,19,0.29600000000000004,27,12,15,0.444,6,2,8,4,194.96,217.04,206.0
2014-12-22,1610612741,1610612761,2014,129.0,120.0,249.0,94.0,91.0,100.6,99.2,26,17,9,0.654,28,22,6,0.7859999999999999,5,12,14,8,185.44,206.0,195.72
2014-12-22,1610612745,1610612757,2014,110.0,95.0,205.0,112.7,109.85,104.75,105.45,26,19,7,0.731,28,22,6,0.7859999999999999,9,10,12,10,216.24,209.44,212.84
2014-12-22,1610612763,1610612762,2014,91.0,97.0,188.0,98.25,97.5,95.55,106.55,27,21,6,0.778,28,8,20,0.28600000000000003,12,9,4,4,193.96,200.2,197.07999999999998
2014-12-22,1610612742,1610612737,2014,102.0,105.0,207.0,104.45,102.7,96.35,95.7,28,20,8,0.7140000000000001,26,19,7,0.731,10,10,12,7,213.0,199.44,206.22
2014-12-22,1610612759,1610612746,2014,125.0,118.0,243.0,107.75,96.55,109.85,106.5,28,17,11,0.607,27,19,8,0.7040000000000001,8,9,11,8,204.12,214.36,209.24
2014-12-22,1610612744,1610612758,2014,128.0,108.0,236.0,107.5,105.85,97.75,101.5,25,22,3,0.88,27,12,15,0.444,9,13,7,5,199.04,207.08,203.06
2014-12-21,1610612761,1610612752,2014,118.0,108.0,226.0,100.6,99.2,101.2,97.2,27,21,6,0.778,29,5,24,0.172,13,8,3,2,206.0,200.28,203.14
2014-12-21,1610612739,1610612763,2014,105.0,91.0,196.0,101.9,101.55,98.25,97.5,25,15,10,0.6,26,21,5,0.8079999999999999,9,6,12,9,195.48,193.96,194.72
2014-12-21,1610612758,1610612747,2014,108.0,101.0,209.0,97.75,101.5,107.3,114.65,26,11,15,0.423,26,8,18,0.308,6,5,3,5,207.08,219.28,213.18
2014-12-21,1610612751,1610612765,2014,110.0,105.0,215.0,96.7,98.4,100.85,105.95,25,10,15,0.4,27,5,22,0.185,5,5,2,3,196.96,206.0,201.48000000000002
2014-12-21,1610612748,1610612738,2014,100.0,84.0,184.0,97.25,95.5,99.65,105.5,27,12,15,0.444,24,10,14,0.417,4,8,7,3,195.0,195.08,195.04000000000002
2014-12-21,1610612753,1610612755,2014,88.0,96.0,184.0,96.55,103.5,97.85,106.0,29,10,19,0.345,25,2,23,0.08,3,7,0,2,203.64,207.68,205.66
2014-12-21,1610612764,1610612756,2014,92.0,104.0,196.0,94.7,91.35,106.25,103.85,25,19,6,0.76,28,14,14,0.5,13,6,6,8,193.0,212.88,202.94
2014-12-21,1610612750,1610612754,2014,96.0,100.0,196.0,110.05,111.2,92.05,92.25,25,5,20,0.2,27,8,19,0.29600000000000004,3,2,5,3,209.4,187.28,198.34
2014-12-21,1610612760,1610612740,2014,99.0,101.0,200.0,101.8,103.4,100.45,104.8,27,13,14,0.481,26,13,13,0.5,7,6,8,5,210.36,200.8,205.58
2014-12-20,1610612752,1610612756,2014,90.0,99.0,189.0,101.2,97.2,106.25,103.85,28,5,23,0.179,27,13,14,0.481,3,2,6,7,200.28,212.88,206.57999999999998
2014-12-20,1610612740,1610612757,2014,88.0,114.0,202.0,100.45,104.8,104.75,105.45,25,13,12,0.52,27,21,6,0.778,8,5,12,9,200.8,209.44,205.12
2014-12-20,1610612766,1610612762,2014,104.0,86.0,190.0,99.45,97.7,95.55,106.55,26,7,19,0.269,27,8,19,0.29600000000000004,5,2,4,4,194.96,200.2,197.57999999999998
2014-12-20,1610612745,1610612737,2014,97.0,104.0,201.0,112.7,109.85,96.35,95.7,25,19,6,0.76,25,18,7,0.72,9,10,12,6,216.24,199.44,207.84
2014-12-20,1610612742,1610612759,2014,99.0,93.0,192.0,104.45,102.7,107.75,96.55,27,19,8,0.7040000000000001,27,17,10,0.63,9,10,8,9,213.0,204.12,208.56
2014-12-20,1610612743,1610612754,2014,76.0,73.0,149.0,109.2,110.3,92.05,92.25,26,11,15,0.423,26,8,18,0.308,7,4,5,3,217.04,187.28,202.16
2014-12-20,1610612746,1610612749,2014,106.0,102.0,208.0,109.85,106.5,99.8,108.15,26,18,8,0.6920000000000001,27,14,13,0.519,10,8,7,7,214.36,200.48,207.42000000000002
2014-12-19,1610612753,1610612762,2014,94.0,101.0,195.0,96.55,103.5,95.55,106.55,28,10,18,0.35700000000000004,26,7,19,0.269,3,7,4,3,203.64,200.2,201.92
2014-12-19,1610612755,1610612766,2014,91.0,109.0,200.0,97.85,106.0,99.45,97.7,24,2,22,0.083,25,6,19,0.24,0,2,5,1,207.68,194.96,201.32
2014-12-19,1610612738,1610612750,2014,114.0,98.0,212.0,99.65,105.5,110.05,111.2,23,9,14,0.391,24,5,19,0.208,6,3,3,2,195.08,209.4,202.24
2014-12-19,1610612739,1610612751,2014,95.0,91.0,186.0,101.9,101.55,96.7,98.4,24,14,10,0.583,24,10,14,0.417,8,6,5,5,195.48,196.96,196.22
2014-12-19,1610612765,1610612761,2014,100.0,110.0,210.0,100.85,105.95,100.6,99.2,26,5,21,0.192,26,20,6,0.769,2,3,13,7,206.0,206.0,206.0
2014-12-19,1610612748,1610612764,2014,103.0,105.0,208.0,97.25,95.5,94.7,91.35,26,12,14,0.462,24,18,6,0.75,4,8,13,5,195.0,193.0,194.0
2014-12-19,1610612763,1610612741,2014,97.0,103.0,200.0,98.25,97.5,94.0,91.0,25,21,4,0.84,25,16,9,0.64,12,9,5,11,193.96,185.44,189.7
2014-12-19,1610612759,1610612757,2014,119.0,129.0,248.0,107.75,96.55,104.75,105.45,26,17,9,0.654,26,20,6,0.769,8,9,12,8,204.12,209.44,206.78
2014-12-19,1610612743,1610612746,2014,109.0,106.0,215.0,109.2,110.3,109.85,106.5,25,10,15,0.4,25,18,7,0.72,6,4,10,8,217.04,214.36,215.7
2014-12-19,1610612747,1610612760,2014,103.0,104.0,207.0,107.3,114.65,101.8,103.4,25,8,17,0.32,26,12,14,0.462,3,5,7,5,219.28,210.36,214.82
2014-12-18,1610612741,1610612752,2014,103.0,97.0,200.0,94.0,91.0,101.2,97.2,24,15,9,0.625,27,5,22,0.185,4,11,3,2,185.44,200.28,192.86
2014-12-18,1610612745,1610612740,2014,90.0,99.0,189.0,112.7,109.85,100.45,104.8,24,19,5,0.792,24,12,12,0.5,9,10,8,4,216.24,200.8,208.52
2014-12-18,1610612758,1610612749,2014,107.0,108.0,215.0,97.75,101.5,99.8,108.15,25,11,14,0.44,26,13,13,0.5,6,5,7,6,207.08,200.48,203.78
2014-12-18,1610612744,1610612760,2014,114.0,109.0,223.0,107.5,105.85,101.8,103.4,24,21,3,0.875,25,12,13,0.48,8,13,7,5,199.04,210.36,204.7
2014-12-17,1610612766,1610612756,2014,106.0,111.0,217.0,99.45,97.7,106.25,103.85,24,6,18,0.25,26,12,14,0.462,5,1,6,6,194.96,212.88,203.92000000000002
2014-12-17,1610612739,1610612737,2014,98.0,127.0,225.0,101.9,101.55,96.35,95.7,23,14,9,0.609,24,17,7,0.708,8,6,12,5,195.48,199.44,197.45999999999998
2014-12-17,1610612738,1610612753,2014,109.0,92.0,201.0,99.65,105.5,96.55,103.5,22,8,14,0.364,27,10,17,0.37,5,3,3,7,195.08,203.64,199.36
2014-12-17,1610612765,1610612742,2014,106.0,117.0,223.0,100.85,105.95,104.45,102.7,25,5,20,0.2,26,18,8,0.6920000000000001,2,3,9,9,206.0,213.0,209.5
2014-12-17,1610612748,1610612762,2014,87.0,105.0,192.0,97.25,95.5,95.55,106.55,25,12,13,0.48,25,6,19,0.24,4,8,4,2,195.0,200.2,197.6
2014-12-17,1610612761,1610612751,2014,105.0,89.0,194.0,100.6,99.2,96.7,98.4,25,19,6,0.76,23,10,13,0.435,12,7,5,5,206.0,196.96,201.48000000000002
2014-12-17,1610612759,1610612763,2014,116.0,117.0,233.0,107.75,96.55,98.25,97.5,25,17,8,0.68,24,20,4,0.833,8,9,12,8,204.12,193.96,199.04000000000002
2014-12-17,1610612757,1610612749,2014,104.0,97.0,201.0,104.75,105.45,99.8,108.15,25,19,6,0.76,25,13,12,0.52,11,8,7,6,209.44,200.48,204.95999999999998
2014-12-17,1610612746,1610612754,2014,102.0,100.0,202.0,109.85,106.5,92.05,92.25,24,17,7,0.708,25,8,17,0.32,9,8,5,3,214.36,187.28,200.82
2014-12-17,1610612743,1610612745,2014,111.0,115.0,226.0,109.2,110.3,112.7,109.85,24,10,14,0.417,23,18,5,0.7829999999999999,6,4,9,9,217.04,216.24,216.64
2014-12-16,1610612764,1610612750,2014,109.0,95.0,204.0,94.7,91.35,110.05,111.2,23,17,6,0.7390000000000001,23,5,18,0.217,12,5,3,2,193.0,209.4,201.2
2014-12-16,1610612751,1610612748,2014,91.0,95.0,186.0,96.7,98.4,97.25,95.5,22,10,12,0.455,24,11,13,0.458,5,5,4,7,196.96,195.0,195.98000000000002
2014-12-16,1610612763,1610612744,2014,105.0,98.0,203.0,98.25,97.5,107.5,105.85,23,19,4,0.826,23,21,2,0.913,11,8,8,13,193.96,199.04,196.5
2014-12-16,1610612740,1610612762,2014,119.0,111.0,230.0,100.45,104.8,95.55,106.55,23,11,12,0.478,24,6,18,0.25,7,4,4,2,200.8,200.2,200.5
2014-12-16,1610612752,1610612742,2014,87.0,107.0,194.0,101.2,97.2,104.45,102.7,26,5,21,0.192,25,17,8,0.68,3,2,9,8,200.28,213.0,206.64
2014-12-16,1610612758,1610612760,2014,92.0,104.0,196.0,97.75,101.5,101.8,103.4,24,11,13,0.458,24,11,13,0.458,6,5,7,4,207.08,210.36,208.72000000000003
2014-12-15,1610612739,1610612766,2014,97.0,88.0,185.0,101.9,101.55,99.45,97.7,22,13,9,0.591,23,6,17,0.261,7,6,5,1,195.48,194.96,195.22
2014-12-15,1610612754,1610612747,2014,110.0,91.0,201.0,92.05,92.25,107.3,114.65,24,7,17,0.292,24,8,16,0.333,4,3,3,5,187.28,219.28,203.28
2014-12-15,1610612755,1610612738,2014,87.0,105.0,192.0,97.85,106.0,99.65,105.5,23,2,21,0.087,21,7,14,0.333,0,2,5,2,207.68,195.08,201.38
2014-12-15,1610612737,1610612741,2014,93.0,86.0,179.0,96.35,95.7,94.0,91.0,23,16,7,0.696,23,15,8,0.652,11,5,4,11,199.44,185.44,192.44
2014-12-15,1610612761,1610612753,2014,95.0,82.0,177.0,100.6,99.2,96.55,103.5,24,18,6,0.75,26,10,16,0.385,11,7,3,7,206.0,203.64,204.82
2014-12-15,1610612756,1610612749,2014,94.0,96.0,190.0,106.25,103.85,99.8,108.15,25,12,13,0.48,24,12,12,0.5,6,6,7,5,212.88,200.48,206.68
2014-12-15,1610612757,1610612759,2014,108.0,95.0,203.0,104.75,105.45,107.75,96.55,24,18,6,0.75,24,17,7,0.708,10,8,8,9,209.44,204.12,206.78
2014-12-15,1610612746,1610612765,2014,113.0,91.0,204.0,109.85,106.5,100.85,105.95,23,16,7,0.696,24,5,19,0.208,8,8,2,3,214.36,206.0,210.18
2014-12-14,1610612740,1610612744,2014,122.0,128.0,250.0,100.45,104.8,107.5,105.85,22,11,11,0.5,22,20,2,0.909,7,4,8,12,200.8,199.04,199.92000000000002
2014-12-14,1610612748,1610612741,2014,75.0,93.0,168.0,97.25,95.5,94.0,91.0,23,11,12,0.478,22,14,8,0.636,4,7,4,10,195.0,185.44,190.22
2014-12-14,1610612764,1610612762,2014,93.0,84.0,177.0,94.7,91.35,95.55,106.55,22,16,6,0.727,23,6,17,0.261,11,5,4,2,193.0,200.2,196.6
2014-12-14,1610612750,1610612747,2014,94.0,100.0,194.0,110.05,111.2,107.3,114.65,22,5,17,0.227,23,7,16,0.304,3,2,3,4,209.4,219.28,214.34
2014-12-14,1610612760,1610612756,2014,112.0,88.0,200.0,101.8,103.4,106.25,103.85,23,10,13,0.435,24,12,12,0.5,6,4,6,6,210.36,212.88,211.62
2014-12-14,1610612752,1610612761,2014,90.0,95.0,185.0,101.2,97.2,100.6,99.2,25,5,20,0.2,23,17,6,0.7390000000000001,3,2,11,6,200.28,206.0,203.14
2014-12-14,1610612743,1610612759,2014,91.0,99.0,190.0,109.2,110.3,107.75,96.55,23,10,13,0.435,23,16,7,0.696,6,4,8,8,217.04,204.12,210.57999999999998
2014-12-13,1610612742,1610612744,2014,98.0,105.0,203.0,104.45,102.7,107.5,105.85,24,17,7,0.708,21,19,2,0.905,9,8,8,11,213.0,199.04,206.01999999999998
2014-12-13,1610612766,1610612751,2014,87.0,114.0,201.0,99.45,97.7,96.7,98.4,22,6,16,0.273,21,9,12,0.429,5,1,5,4,194.96,196.96,195.96
2014-12-13,1610612754,1610612757,2014,85.0,95.0,180.0,92.05,92.25,104.75,105.45,23,7,16,0.304,23,17,6,0.7390000000000001,4,3,10,7,187.28,209.44,198.36
2014-12-13,1610612753,1610612737,2014,100.0,99.0,199.0,96.55,103.5,96.35,95.7,25,9,16,0.36,22,16,6,0.727,2,7,11,5,203.64,199.44,201.54
2014-12-13,1610612749,1610612746,2014,111.0,106.0,217.0,99.8,108.15,109.85,106.5,23,11,12,0.478,22,16,6,0.727,6,5,8,8,200.48,214.36,207.42000000000002
2014-12-13,1610612755,1610612763,2014,115.0,120.0,235.0,97.85,106.0,98.25,97.5,22,2,20,0.091,22,18,4,0.818,0,2,11,7,207.68,193.96,200.82
2014-12-13,1610612745,1610612743,2014,108.0,96.0,204.0,112.7,109.85,109.2,110.3,22,17,5,0.773,22,10,12,0.455,8,9,6,4,216.24,217.04,216.64
2014-12-13,1610612758,1610612765,2014,90.0,95.0,185.0,97.75,101.5,100.85,105.95,23,11,12,0.478,23,4,19,0.174,6,5,2,2,207.08,206.0,206.54000000000002
2014-12-12,1610612741,1610612757,2014,115.0,106.0,221.0,94.0,91.0,104.75,105.45,21,13,8,0.619,22,17,5,0.773,3,10,10,7,185.44,209.44,197.44
2014-12-12,1610612764,1610612746,2014,104.0,96.0,200.0,94.7,91.35,109.85,106.5,21,15,6,0.7140000000000001,21,16,5,0.762,10,5,8,8,193.0,214.36,203.68
2014-12-12,1610612737,1610612753,2014,87.0,81.0,168.0,96.35,95.7,96.55,103.5,21,15,6,0.7140000000000001,24,9,15,0.375,10,5,2,7,199.44,203.64,201.54
2014-12-12,1610612738,1610612752,2014,95.0,101.0,196.0,99.65,105.5,101.2,97.2,20,7,13,0.35,24,4,20,0.16699999999999998,5,2,3,1,195.08,200.28,197.68
2014-12-12,1610612751,1610612755,2014,88.0,70.0,158.0,96.7,98.4,97.85,106.0,20,8,12,0.4,21,2,19,0.095,4,4,0,2,196.96,207.68,202.32
2014-12-12,1610612761,1610612754,2014,106.0,94.0,200.0,100.6,99.2,92.05,92.25,22,16,6,0.727,22,7,15,0.318,10,6,4,3,206.0,187.28,196.64
2014-12-12,1610612763,1610612766,2014,113.0,107.0,220.0,98.25,97.5,99.45,97.7,21,17,4,0.81,21,6,15,0.28600000000000003,10,7,5,1,193.96,194.96,194.46
2014-12-12,1610612750,1610612760,2014,92.0,111.0,203.0,110.05,111.2,101.8,103.4,21,5,16,0.238,22,9,13,0.409,3,2,6,3,209.4,210.36,209.88
2014-12-12,1610612740,1610612739,2014,119.0,114.0,233.0,100.45,104.8,101.9,101.55,21,10,11,0.476,21,13,8,0.619,6,4,7,6,200.8,195.48,198.14
2014-12-12,1610612756,1610612765,2014,103.0,105.0,208.0,106.25,103.85,100.85,105.95,23,12,11,0.522,22,3,19,0.136,6,6,2,1,212.88,206.0,209.44
2014-12-12,1610612762,1610612748,2014,95.0,100.0,195.0,95.55,106.55,97.25,95.5,22,6,16,0.273,22,10,12,0.455,4,2,4,6,200.2,195.0,197.6
2014-12-12,1610612759,1610612747,2014,110.0,112.0,222.0,107.75,96.55,107.3,114.65,22,16,6,0.727,22,6,16,0.273,8,8,3,3,204.12,219.28,211.7
2014-12-11,1610612760,1610612739,2014,103.0,94.0,197.0,101.8,103.4,101.9,101.55,21,8,13,0.381,20,13,7,0.65,5,3,7,6,210.36,195.48,202.92000000000002
2014-12-11,1610612758,1610612745,2014,109.0,113.0,222.0,97.75,101.5,112.7,109.85,22,11,11,0.5,21,16,5,0.762,6,5,8,8,207.08,216.24,211.66000000000003
2014-12-10,1610612766,1610612738,2014,96.0,87.0,183.0,99.45,97.7,99.65,105.5,20,5,15,0.25,19,7,12,0.368,4,1,5,2,194.96,195.08,195.02
2014-12-10,1610612754,1610612746,2014,96.0,103.0,199.0,92.05,92.25,109.85,106.5,21,7,14,0.333,20,15,5,0.75,4,3,8,7,187.28,214.36,200.82
2014-12-10,1610612753,1610612764,2014,89.0,91.0,180.0,96.55,103.5,94.7,91.35,23,9,14,0.391,20,14,6,0.7,2,7,10,4,203.64,193.0,198.32
2014-12-10,1610612737,1610612755,2014,95.0,79.0,174.0,96.35,95.7,97.85,106.0,20,14,6,0.7,20,2,18,0.1,9,5,0,2,199.44,207.68,203.56
2014-12-10,1610612741,1610612751,2014,105.0,80.0,185.0,94.0,91.0,96.7,98.4,20,12,8,0.6,19,8,11,0.421,2,10,4,4,185.44,196.96,191.2
2014-12-10,1610612750,1610612757,2014,90.0,82.0,172.0,110.05,111.2,104.75,105.45,20,4,16,0.2,21,17,4,0.81,2,2,10,7,209.4,209.44,209.42000000000002
2014-12-10,1610612742,1610612740,2014,112.0,107.0,219.0,104.45,102.7,100.45,104.8,23,16,7,0.696,20,10,10,0.5,8,8,6,4,213.0,200.8,206.9
2014-12-10,1610612759,1610612752,2014,109.0,95.0,204.0,107.75,96.55,101.2,97.2,21,15,6,0.7140000000000001,23,4,19,0.174,7,8,3,1,204.12,200.28,202.2
2014-12-10,1610612744,1610612745,2014,105.0,93.0,198.0,107.5,105.85,112.7,109.85,20,18,2,0.9,20,16,4,0.8,7,11,8,8,199.04,216.24,207.64
2014-12-10,1610612743,1610612748,2014,102.0,82.0,184.0,109.2,110.3,97.25,95.5,21,9,12,0.429,21,10,11,0.476,5,4,4,6,217.04,195.0,206.01999999999998
2014-12-09,1610612739,1610612761,2014,105.0,101.0,206.0,101.9,101.55,100.6,99.2,19,12,7,0.632,21,16,5,0.762,6,6,10,6,195.48,206.0,200.74
2014-12-09,1610612765,1610612757,2014,86.0,98.0,184.0,100.85,105.95,104.75,105.45,21,3,18,0.14300000000000002,20,16,4,0.8,2,1,10,6,206.0,209.44,207.72
2014-12-09,1610612763,1610612742,2014,114.0,105.0,219.0,98.25,97.5,104.45,102.7,20,16,4,0.8,22,16,6,0.727,9,7,8,8,193.96,213.0,203.48000000000002
2014-12-09,1610612740,1610612752,2014,104.0,93.0,197.0,100.45,104.8,101.2,97.2,19,9,10,0.474,22,4,18,0.182,5,4,3,1,200.8,200.28,200.54000000000002
2014-12-09,1610612760,1610612749,2014,114.0,101.0,215.0,101.8,103.4,99.8,108.15,20,7,13,0.35,22,11,11,0.5,4,3,6,5,210.36,200.48,205.42000000000002
2014-12-09,1610612756,1610612748,2014,97.0,103.0,200.0,106.25,103.85,97.25,95.5,22,12,10,0.545,20,9,11,0.45,6,6,4,5,212.88,195.0,203.94
2014-12-09,1610612762,1610612759,2014,100.0,96.0,196.0,95.55,106.55,107.75,96.55,21,5,16,0.238,20,15,5,0.75,3,2,7,8,200.2,204.12,202.16
2014-12-09,1610612747,1610612758,2014,98.0,95.0,193.0,107.3,114.65,97.75,101.5,21,5,16,0.238,21,11,10,0.524,2,3,6,5,219.28,207.08,213.18
2014-12-08,1610612754,1610612737,2014,92.0,108.0,200.0,92.05,92.25,96.35,95.7,20,7,13,0.35,19,13,6,0.684,4,3,9,4,187.28,199.44,193.36
2014-12-08,1610612764,1610612738,2014,133.0,132.0,265.0,94.7,91.35,99.65,105.5,19,13,6,0.684,18,7,11,0.389,9,4,5,2,193.0,195.08,194.04000000000002
2014-12-08,1610612751,1610612739,2014,88.0,110.0,198.0,96.7,98.4,101.9,101.55,18,8,10,0.444,18,11,7,0.611,4,4,6,5,196.96,195.48,196.22
2014-12-08,1610612761,1610612743,2014,112.0,107.0,219.0,100.6,99.2,109.2,110.3,20,15,5,0.75,20,9,11,0.45,9,6,5,4,206.0,217.04,211.51999999999998
2014-12-08,1610612750,1610612744,2014,86.0,102.0,188.0,110.05,111.2,107.5,105.85,19,4,15,0.211,19,17,2,0.895,2,2,7,10,209.4,199.04,204.22
2014-12-08,1610612758,1610612762,2014,101.0,92.0,193.0,97.75,101.5,95.55,106.55,20,10,10,0.5,20,5,15,0.25,5,5,3,2,207.08,200.2,203.64
2014-12-08,1610612746,1610612756,2014,121.0,120.0,241.0,109.85,106.5,106.25,103.85,19,14,5,0.737,21,12,9,0.5710000000000001,7,7,6,6,214.36,212.88,213.62
2014-12-07,1610612738,1610612764,2014,101.0,93.0,194.0,99.65,105.5,94.7,91.35,17,6,11,0.353,18,13,5,0.722,4,2,9,4,195.08,193.0,194.04000000000002
2014-12-07,1610612737,1610612743,2014,96.0,84.0,180.0,96.35,95.7,109.2,110.3,18,12,6,0.667,19,9,10,0.474,8,4,5,4,199.44,217.04,208.24
2014-12-07,1610612763,1610612748,2014,103.0,87.0,190.0,98.25,97.5,97.25,95.5,19,15,4,0.789,19,9,10,0.474,8,7,4,5,193.96,195.0,194.48000000000002
2014-12-07,1610612765,1610612760,2014,94.0,96.0,190.0,100.85,105.95,101.8,103.4,20,3,17,0.15,19,6,13,0.316,2,1,4,2,206.0,210.36,208.18
2014-12-07,1610612742,1610612749,2014,125.0,102.0,227.0,104.45,102.7,99.8,108.15,21,15,6,0.7140000000000001,21,11,10,0.524,7,8,6,5,213.0,200.48,206.74
2014-12-07,1610612752,1610612757,2014,99.0,103.0,202.0,101.2,97.2,104.75,105.45,21,4,17,0.19,19,15,4,0.789,3,1,10,5,200.28,209.44,204.86
2014-12-07,1610612747,1610612740,2014,87.0,104.0,191.0,107.3,114.65,100.45,104.8,20,5,15,0.25,18,8,10,0.444,2,3,5,3,219.28,200.8,210.04000000000002
2014-12-06,1610612765,1610612755,2014,101.0,108.0,209.0,100.85,105.95,97.85,106.0,19,3,16,0.158,19,1,18,0.053,2,1,0,1,206.0,207.68,206.84
2014-12-06,1610612741,1610612744,2014,102.0,112.0,214.0,94.0,91.0,107.5,105.85,19,12,7,0.632,18,16,2,0.889,2,10,7,9,185.44,199.04,192.24
2014-12-06,1610612745,1610612756,2014,100.0,95.0,195.0,112.7,109.85,106.25,103.85,19,15,4,0.789,20,12,8,0.6,7,8,6,6,216.24,212.88,214.56
2014-12-06,1610612759,1610612750,2014,123.0,101.0,224.0,107.75,96.55,110.05,111.2,19,14,5,0.737,18,4,14,0.222,6,8,2,2,204.12,209.4,206.76
2014-12-06,1610612758,1610612753,2014,96.0,105.0,201.0,97.75,101.5,96.55,103.5,19,10,9,0.526,22,8,14,0.364,5,5,2,6,207.08,203.64,205.36
2014-12-06,1610612746,1610612740,2014,120.0,100.0,220.0,109.85,106.5,100.45,104.8,18,13,5,0.722,17,8,9,0.471,6,7,5,3,214.36,200.8,207.58
2014-12-05,1610612766,1610612752,2014,103.0,102.0,205.0,99.45,97.7,101.2,97.2,19,4,15,0.211,20,4,16,0.2,3,1,3,1,194.96,200.28,197.62
2014-12-05,1610612755,1610612760,2014,91.0,103.0,194.0,97.85,106.0,101.8,103.4,18,1,17,0.056,18,5,13,0.278,0,1,4,1,207.68,210.36,209.02
2014-12-05,1610612764,1610612743,2014,119.0,89.0,208.0,94.7,91.35,109.2,110.3,17,12,5,0.706,18,9,9,0.5,8,4,5,4,193.0,217.04,205.01999999999998
2014-12-05,1610612738,1610612747,2014,113.0,96.0,209.0,99.65,105.5,107.3,114.65,16,5,11,0.313,19,5,14,0.263,3,2,2,3,195.08,219.28,207.18
2014-12-05,1610612751,1610612737,2014,75.0,98.0,173.0,96.7,98.4,96.35,95.7,17,8,9,0.471,17,11,6,0.647,4,4,8,3,196.96,199.44,198.2
2014-12-05,1610612761,1610612739,2014,91.0,105.0,196.0,100.6,99.2,101.9,101.55,19,15,4,0.789,17,10,7,0.588,9,6,6,4,206.0,195.48,200.74
2014-12-05,1610612763,1610612759,2014,101.0,107.0,208.0,98.25,97.5,107.75,96.55,18,15,3,0.833,18,13,5,0.722,8,7,6,7,193.96,204.12,199.04000000000002
2014-12-05,1610612750,1610612745,2014,112.0,114.0,226.0,110.05,111.2,112.7,109.85,17,4,13,0.235,18,14,4,0.778,2,2,7,7,209.4,216.24,212.82
2014-12-05,1610612742,1610612756,2014,106.0,118.0,224.0,104.45,102.7,106.25,103.85,20,15,5,0.75,19,11,8,0.579,7,8,6,5,213.0,212.88,212.94
2014-12-05,1610612749,1610612748,2014,109.0,85.0,194.0,99.8,108.15,97.25,95.5,20,10,10,0.5,18,9,9,0.5,5,5,4,5,200.48,195.0,197.74
2014-12-05,1610612762,1610612753,2014,93.0,98.0,191.0,95.55,106.55,96.55,103.5,19,5,14,0.263,21,7,14,0.333,3,2,2,5,200.2,203.64,201.92
2014-12-05,1610612758,1610612754,2014,102.0,101.0,203.0,97.75,101.5,92.05,92.25,18,9,9,0.5,19,7,12,0.368,4,5,4,3,207.08,187.28,197.18
2014-12-04,1610612752,1610612739,2014,87.0,90.0,177.0,101.2,97.2,101.9,101.55,19,4,15,0.211,16,9,7,0.563,3,1,6,3,200.28,195.48,197.88
2014-12-04,1610612757,1610612754,2014,88.0,82.0,170.0,104.75,105.45,92.05,92.25,18,14,4,0.778,18,7,11,0.389,9,5,4,3,209.44,187.28,198.36
2014-12-04,1610612744,1610612740,2014,112.0,85.0,197.0,107.5,105.85,100.45,104.8,17,15,2,0.882,16,8,8,0.5,6,9,5,3,199.04,200.8,199.92000000000002
2014-12-03,1610612766,1610612741,2014,95.0,102.0,197.0,99.45,97.7,94.0,91.0,18,4,14,0.222,18,11,7,0.611,3,1,2,9,194.96,185.44,190.2
2014-12-03,1610612764,1610612747,2014,111.0,95.0,206.0,94.7,91.35,107.3,114.65,16,11,5,0.688,18,5,13,0.278,7,4,2,3,193.0,219.28,206.14
2014-12-03,1610612738,1610612765,2014,109.0,102.0,211.0,99.65,105.5,100.85,105.95,15,4,11,0.267,18,3,15,0.16699999999999998,2,2,2,1,195.08,206.0,200.54000000000002
2014-12-03,1610612751,1610612759,2014,95.0,93.0,188.0,96.7,98.4,107.75,96.55,16,7,9,0.438,17,13,4,0.765,3,4,6,7,196.96,204.12,200.54000000000002
2014-12-03,1610612748,1610612737,2014,102.0,112.0,214.0,97.25,95.5,96.35,95.7,17,9,8,0.529,16,10,6,0.625,4,5,8,2,195.0,199.44,197.22
2014-12-03,1610612745,1610612763,2014,105.0,96.0,201.0,112.7,109.85,98.25,97.5,17,13,4,0.765,17,15,2,0.882,6,7,8,7,216.24,193.96,205.10000000000002
2014-12-03,1610612749,1610612742,2014,105.0,107.0,212.0,99.8,108.15,104.45,102.7,19,10,9,0.526,19,14,5,0.737,5,5,7,7,200.48,213.0,206.74
2014-12-03,1610612750,1610612755,2014,77.0,85.0,162.0,110.05,111.2,97.85,106.0,16,4,12,0.25,17,0,17,0.0,2,2,0,0,209.4,207.68,208.54000000000002
2014-12-03,1610612762,1610612761,2014,104.0,123.0,227.0,95.55,106.55,100.6,99.2,18,5,13,0.278,18,14,4,0.778,3,2,9,5,200.2,206.0,203.1
2014-12-03,1610612746,1610612753,2014,114.0,86.0,200.0,109.85,106.5,96.55,103.5,17,12,5,0.706,20,7,13,0.35,5,7,2,5,214.36,203.64,209.0
2014-12-02,1610612739,1610612749,2014,111.0,108.0,219.0,101.9,101.55,99.8,108.15,15,8,7,0.5329999999999999,18,10,8,0.556,5,3,5,5,195.48,200.48,197.98
2014-12-02,1610612737,1610612738,2014,109.0,105.0,214.0,96.35,95.7,99.65,105.5,15,9,6,0.6,14,4,10,0.28600000000000003,7,2,2,2,199.44,195.08,197.26
2014-12-02,1610612765,1610612747,2014,96.0,106.0,202.0,100.85,105.95,107.3,114.65,17,3,14,0.17600000000000002,17,4,13,0.235,2,1,2,2,206.0,219.28,212.64
2014-12-02,1610612752,1610612751,2014,93.0,98.0,191.0,101.2,97.2,96.7,98.4,18,4,14,0.222,15,6,9,0.4,3,1,3,3,200.28,196.96,198.62
2014-12-02,1610612741,1610612742,2014,129.0,132.0,261.0,94.0,91.0,104.45,102.7,17,11,6,0.647,18,13,5,0.722,2,9,7,6,185.44,213.0,199.22
2014-12-02,1610612740,1610612760,2014,112.0,104.0,216.0,100.45,104.8,101.8,103.4,15,7,8,0.467,17,5,12,0.294,4,3,4,1,200.8,210.36,205.58
2014-12-02,1610612743,1610612757,2014,103.0,105.0,208.0,109.2,110.3,104.75,105.45,17,9,8,0.529,17,13,4,0.765,5,4,9,4,217.04,209.44,213.24
2014-12-02,1610612756,1610612754,2014,116.0,99.0,215.0,106.25,103.85,92.05,92.25,18,10,8,0.556,17,7,10,0.412,5,5,4,3,212.88,187.28,200.07999999999998
2014-12-02,1610612758,1610612761,2014,109.0,117.0,226.0,97.75,101.5,100.6,99.2,17,9,8,0.529,17,13,4,0.765,4,5,9,4,207.08,206.0,206.54000000000002
2014-12-02,1610612744,1610612753,2014,98.0,97.0,195.0,107.5,105.85,96.55,103.5,16,14,2,0.875,19,7,12,0.368,5,9,2,5,199.04,203.64,201.33999999999997
2014-12-01,1610612755,1610612759,2014,103.0,109.0,212.0,97.85,106.0,107.75,96.55,16,0,16,0.0,16,12,4,0.75,0,0,6,6,207.68,204.12,205.9
2014-12-01,1610612764,1610612748,2014,107.0,86.0,193.0,94.7,91.35,97.25,95.5,15,10,5,0.667,16,9,7,0.563,6,4,4,5,193.0,195.0,194.0
2014-12-01,1610612762,1610612743,2014,101.0,103.0,204.0,95.55,106.55,109.2,110.3,17,5,12,0.294,16,8,8,0.5,3,2,5,3,200.2,217.04,208.62
2014-12-01,1610612746,1610612750,2014,127.0,101.0,228.0,109.85,106.5,110.05,111.2,16,11,5,0.688,15,4,11,0.267,4,7,2,2,214.36,209.4,211.88
2014-11-30,1610612738,1610612759,2014,89.0,111.0,200.0,99.65,105.5,107.75,96.55,13,4,9,0.308,15,11,4,0.733,2,2,6,5,195.08,204.12,199.60000000000002
2014-11-30,1610612751,1610612741,2014,84.0,102.0,186.0,96.7,98.4,94.0,91.0,14,6,8,0.429,16,10,6,0.625,3,3,2,8,196.96,185.44,191.2
2014-11-30,1610612765,1610612744,2014,93.0,104.0,197.0,100.85,105.95,107.5,105.85,16,3,13,0.188,15,13,2,0.867,2,1,5,8,206.0,199.04,202.51999999999998
2014-11-30,1610612758,1610612763,2014,85.0,97.0,182.0,97.75,101.5,98.25,97.5,16,9,7,0.563,16,14,2,0.875,4,5,8,6,207.08,193.96,200.52
2014-11-30,1610612752,1610612748,2014,79.0,86.0,165.0,101.2,97.2,97.25,95.5,17,4,13,0.235,15,8,7,0.5329999999999999,3,1,4,4,200.28,195.0,197.64
2014-11-30,1610612756,1610612753,2014,90.0,93.0,183.0,106.25,103.85,96.55,103.5,17,10,7,0.588,18,6,12,0.333,5,5,2,4,212.88,203.64,208.26
2014-11-30,1610612757,1610612750,2014,107.0,93.0,200.0,104.75,105.45,110.05,111.2,16,12,4,0.75,14,4,10,0.28600000000000003,8,4,2,2,209.44,209.4,209.42000000000002
2014-11-30,1610612747,1610612761,2014,129.0,122.0,251.0,107.3,114.65,100.6,99.2,16,3,13,0.188,16,13,3,0.813,1,2,9,4,219.28,206.0,212.64
2014-11-29,1610612755,1610612742,2014,103.0,110.0,213.0,97.85,106.0,104.45,102.7,15,0,15,0.0,17,12,5,0.706,0,0,7,5,207.68,213.0,210.34
2014-11-29,1610612764,1610612740,2014,83.0,80.0,163.0,94.7,91.35,100.45,104.8,14,9,5,0.643,14,7,7,0.5,5,4,4,3,193.0,200.8,196.9
2014-11-29,1610612737,1610612766,2014,105.0,75.0,180.0,96.35,95.7,99.45,97.7,14,8,6,0.5710000000000001,17,4,13,0.235,6,2,3,1,199.44,194.96,197.2
2014-11-29,1610612739,1610612754,2014,109.0,97.0,206.0,101.9,101.55,92.05,92.25,14,7,7,0.5,16,7,9,0.438,4,3,4,3,195.48,187.28,191.38
2014-11-29,1610612762,1610612746,2014,96.0,112.0,208.0,95.55,106.55,109.85,106.5,16,5,11,0.313,15,10,5,0.667,3,2,4,6,200.2,214.36,207.28
2014-11-29,1610612749,1610612745,2014,103.0,117.0,220.0,99.8,108.15,112.7,109.85,17,10,7,0.588,16,12,4,0.75,5,5,6,6,200.48,216.24,208.36
2014-11-28,1610612738,1610612741,2014,102.0,109.0,211.0,99.65,105.5,94.0,91.0,12,4,8,0.333,15,9,6,0.6,2,2,2,7,195.08,185.44,190.26
2014-11-28,1610612766,1610612744,2014,101.0,106.0,207.0,99.45,97.7,107.5,105.85,16,4,12,0.25,14,12,2,0.857,3,1,5,7,194.96,199.04,197.0
2014-11-28,1610612737,1610612740,2014,100.0,91.0,191.0,96.35,95.7,100.45,104.8,13,7,6,0.5379999999999999,13,7,6,0.5379999999999999,5,2,4,3,199.44,200.8,200.12
2014-11-28,1610612765,1610612749,2014,88.0,104.0,192.0,100.85,105.95,99.8,108.15,15,3,12,0.2,16,9,7,0.563,2,1,5,4,206.0,200.48,203.24
2014-11-28,1610612761,1610612742,2014,102.0,106.0,208.0,100.6,99.2,104.45,102.7,15,13,2,0.867,16,11,5,0.688,9,4,7,4,206.0,213.0,209.5
2014-11-28,1610612745,1610612746,2014,85.0,102.0,187.0,112.7,109.85,109.85,106.5,15,12,3,0.8,14,9,5,0.643,6,6,4,5,216.24,214.36,215.3
2014-11-28,1610612760,1610612752,2014,105.0,78.0,183.0,101.8,103.4,101.2,97.2,16,4,12,0.25,16,4,12,0.25,3,1,3,1,210.36,200.28,205.32
2014-11-28,1610612754,1610612753,2014,98.0,83.0,181.0,92.05,92.25,96.55,103.5,15,6,9,0.4,17,6,11,0.353,3,3,2,4,187.28,203.64,195.45999999999998
2014-11-28,1610612759,1610612758,2014,112.0,104.0,216.0,107.75,96.55,97.75,101.5,14,10,4,0.7140000000000001,15,9,6,0.6,5,5,4,5,204.12,207.08,205.60000000000002
2014-11-28,1610612743,1610612756,2014,122.0,97.0,219.0,109.2,110.3,106.25,103.85,15,7,8,0.467,16,10,6,0.625,4,3,5,5,217.04,212.88,214.95999999999998
2014-11-28,1610612757,1610612763,2014,99.0,112.0,211.0,104.75,105.45,98.25,97.5,15,12,3,0.8,15,13,2,0.867,8,4,8,5,209.44,193.96,201.7
2014-11-28,1610612747,1610612750,2014,119.0,120.0,239.0,107.3,114.65,110.05,111.2,15,3,12,0.2,13,3,10,0.231,1,2,2,1,219.28,209.4,214.34
2014-11-26,1610612766,1610612757,2014,97.0,105.0,202.0,99.45,97.7,104.75,105.45,15,4,11,0.267,14,11,3,0.7859999999999999,3,1,8,3,194.96,209.44,202.2
2014-11-26,1610612739,1610612764,2014,113.0,87.0,200.0,101.9,101.55,94.7,91.35,13,6,7,0.462,13,9,4,0.6920000000000001,3,3,5,4,195.48,193.0,194.24
2014-11-26,1610612753,1610612744,2014,96.0,111.0,207.0,96.55,103.5,107.5,105.85,16,6,10,0.375,13,11,2,0.846,2,4,5,6,203.64,199.04,201.33999999999997
2014-11-26,1610612755,1610612751,2014,91.0,99.0,190.0,97.85,106.0,96.7,98.4,14,0,14,0.0,13,5,8,0.385,0,0,3,2,207.68,196.96,202.32
2014-11-26,1610612742,1610612752,2014,109.0,102.0,211.0,104.45,102.7,101.2,97.2,15,10,5,0.667,15,4,11,0.267,6,4,3,1,213.0,200.28,206.64
2014-11-26,1610612737,1610612761,2014,115.0,126.0,241.0,96.35,95.7,100.6,99.2,12,7,5,0.583,14,12,2,0.857,5,2,9,3,199.44,206.0,202.72
2014-11-26,1610612765,1610612746,2014,98.0,104.0,202.0,100.85,105.95,109.85,106.5,14,3,11,0.214,13,8,5,0.615,2,1,4,4,206.0,214.36,210.18
2014-11-26,1610612745,1610612758,2014,102.0,89.0,191.0,112.7,109.85,97.75,101.5,14,11,3,0.7859999999999999,14,9,5,0.643,5,6,4,5,216.24,207.08,211.66000000000003
2014-11-26,1610612750,1610612749,2014,86.0,103.0,189.0,110.05,111.2,99.8,108.15,12,3,9,0.25,15,8,7,0.5329999999999999,2,1,5,3,209.4,200.48,204.94
2014-11-26,1610612760,1610612762,2014,97.0,82.0,179.0,101.8,103.4,95.55,106.55,15,3,12,0.2,15,5,10,0.333,2,1,3,2,210.36,200.2,205.28
2014-11-26,1610612759,1610612754,2014,106.0,100.0,206.0,107.75,96.55,92.05,92.25,13,9,4,0.6920000000000001,14,6,8,0.429,4,5,3,3,204.12,187.28,195.7
2014-11-26,1610612756,1610612743,2014,120.0,112.0,232.0,106.25,103.85,109.2,110.3,15,9,6,0.6,14,7,7,0.5,4,5,4,3,212.88,217.04,214.95999999999998
2014-11-26,1610612747,1610612763,2014,93.0,99.0,192.0,107.3,114.65,98.25,97.5,14,3,11,0.214,14,12,2,0.857,1,2,8,4,219.28,193.96,206.62
2014-11-25,1610612764,1610612737,2014,102.0,106.0,208.0,94.7,91.35,96.35,95.7,12,9,3,0.75,11,6,5,0.545,5,4,5,1,193.0,199.44,196.22
2014-11-25,1610612748,1610612744,2014,97.0,114.0,211.0,97.25,95.5,107.5,105.85,14,8,6,0.5710000000000001,12,10,2,0.833,4,4,5,5,195.0,199.04,197.01999999999998
2014-11-25,1610612749,1610612765,2014,98.0,86.0,184.0,99.8,108.15,100.85,105.95,14,7,7,0.5,13,3,10,0.231,4,3,2,1,200.48,206.0,203.24
2014-11-25,1610612740,1610612758,2014,89.0,99.0,188.0,100.45,104.8,97.75,101.5,12,7,5,0.583,13,8,5,0.615,4,3,4,4,200.8,207.08,203.94
2014-11-25,1610612743,1610612741,2014,114.0,109.0,223.0,109.2,110.3,94.0,91.0,13,6,7,0.462,14,9,5,0.643,3,3,2,7,217.04,185.44,201.24
2014-11-24,1610612766,1610612746,2014,92.0,113.0,205.0,99.45,97.7,109.85,106.5,14,4,10,0.28600000000000003,12,7,5,0.583,3,1,4,3,194.96,214.36,204.66000000000003
2014-11-24,1610612739,1610612753,2014,106.0,74.0,180.0,101.9,101.55,96.55,103.5,12,5,7,0.417,15,6,9,0.4,2,3,2,4,195.48,203.64,199.56
2014-11-24,1610612755,1610612757,2014,104.0,114.0,218.0,97.85,106.0,104.75,105.45,13,0,13,0.0,13,10,3,0.769,0,0,8,2,207.68,209.44,208.56
2014-11-24,1610612761,1610612756,2014,104.0,100.0,204.0,100.6,99.2,106.25,103.85,13,11,2,0.846,14,9,5,0.643,8,3,4,5,206.0,212.88,209.44
2014-11-24,1610612745,1610612752,2014,91.0,86.0,177.0,112.7,109.85,101.2,97.2,13,10,3,0.769,14,4,10,0.28600000000000003,4,6,3,1,216.24,200.28,208.26
2014-11-24,1610612742,1610612754,2014,100.0,111.0,211.0,104.45,102.7,92.05,92.25,14,10,4,0.7140000000000001,13,5,8,0.385,6,4,3,2,213.0,187.28,200.14
2014-11-24,1610612762,1610612741,2014,95.0,97.0,192.0,95.55,106.55,94.0,91.0,14,5,9,0.35700000000000004,13,8,5,0.615,3,2,2,6,200.2,185.44,192.82
2014-11-23,1610612763,1610612746,2014,107.0,91.0,198.0,98.25,97.5,109.85,106.5,13,11,2,0.846,11,7,4,0.636,7,4,4,3,193.96,214.36,204.16000000000003
2014-11-23,1610612738,1610612757,2014,88.0,94.0,182.0,99.65,105.5,104.75,105.45,11,4,7,0.364,12,9,3,0.75,2,2,8,1,195.08,209.44,202.26
2014-11-23,1610612748,1610612766,2014,94.0,93.0,187.0,97.25,95.5,99.45,97.7,13,7,6,0.5379999999999999,13,4,9,0.308,3,4,3,1,195.0,194.96,194.98000000000002
2014-11-23,1610612760,1610612744,2014,86.0,91.0,177.0,101.8,103.4,107.5,105.85,14,3,11,0.214,11,9,2,0.818,2,1,5,4,210.36,199.04,204.7
2014-11-23,1610612747,1610612743,2014,94.0,101.0,195.0,107.3,114.65,109.2,110.3,13,3,10,0.231,12,5,7,0.417,1,2,3,2,219.28,217.04,218.16
2014-11-22,1610612754,1610612756,2014,83.0,106.0,189.0,92.05,92.25,106.25,103.85,12,5,7,0.417,13,8,5,0.615,3,2,4,4,187.28,212.88,200.07999999999998
2014-11-22,1610612753,1610612748,2014,92.0,99.0,191.0,96.55,103.5,97.25,95.5,14,6,8,0.429,12,6,6,0.5,2,4,3,3,203.64,195.0,199.32
2014-11-22,1610612739,1610612761,2014,93.0,110.0,203.0,101.9,101.55,100.6,99.2,11,5,6,0.455,12,10,2,0.833,2,3,8,2,195.48,206.0,200.74
2014-11-22,1610612752,1610612755,2014,91.0,83.0,174.0,101.2,97.2,97.85,106.0,13,3,10,0.231,12,0,12,0.0,2,1,0,0,200.28,207.68,203.98000000000002
2014-11-22,1610612745,1610612742,2014,95.0,92.0,187.0,112.7,109.85,104.45,102.7,12,9,3,0.75,13,10,3,0.769,3,6,6,4,216.24,213.0,214.62
2014-11-22,1610612750,1610612758,2014,101.0,113.0,214.0,110.05,111.2,97.75,101.5,11,3,8,0.273,12,7,5,0.583,2,1,4,3,209.4,207.08,208.24
2014-11-22,1610612749,1610612764,2014,100.0,111.0,211.0,99.8,108.15,94.7,91.35,13,7,6,0.5379999999999999,11,8,3,0.727,4,3,5,3,200.48,193.0,196.74
2014-11-22,1610612759,1610612751,2014,99.0,87.0,186.0,107.75,96.55,96.7,98.4,12,8,4,0.667,12,5,7,0.417,3,5,3,2,204.12,196.96,200.54000000000002
2014-11-22,1610612762,1610612740,2014,94.0,106.0,200.0,95.55,106.55,100.45,104.8,13,5,8,0.385,11,6,5,0.545,3,2,4,2,200.2,200.8,200.5
2014-11-21,1610612766,1610612753,2014,100.0,105.0,205.0,99.45,97.7,96.55,103.5,12,4,8,0.333,13,5,8,0.385,3,1,2,3,194.96,203.64,199.3
2014-11-21,1610612755,1610612756,2014,96.0,122.0,218.0,97.85,106.0,106.25,103.85,11,0,11,0.0,12,7,5,0.583,0,0,4,3,207.68,212.88,210.28
2014-11-21,1610612737,1610612765,2014,99.0,89.0,188.0,96.35,95.7,100.85,105.95,10,5,5,0.5,12,3,9,0.25,4,1,2,1,199.44,206.0,202.72
2014-11-21,1610612761,1610612749,2014,124.0,82.0,206.0,100.6,99.2,99.8,108.15,11,9,2,0.818,12,7,5,0.583,7,2,4,3,206.0,200.48,203.24
2014-11-21,1610612763,1610612738,2014,117.0,100.0,217.0,98.25,97.5,99.65,105.5,12,10,2,0.833,10,4,6,0.4,6,4,2,2,193.96,195.08,194.52
2014-11-21,1610612750,1610612759,2014,92.0,121.0,213.0,110.05,111.2,107.75,96.55,10,3,7,0.3,11,7,4,0.636,2,1,3,4,209.4,204.12,206.76
2014-11-21,1610612760,1610612751,2014,92.0,94.0,186.0,101.8,103.4,96.7,98.4,13,3,10,0.231,11,4,7,0.364,2,1,3,1,210.36,196.96,203.66000000000003
2014-11-21,1610612764,1610612739,2014,91.0,78.0,169.0,94.7,91.35,101.9,101.55,10,7,3,0.7,10,5,5,0.5,4,3,2,3,193.0,195.48,194.24
2014-11-21,1610612742,1610612747,2014,140.0,106.0,246.0,104.45,102.7,107.3,114.65,12,9,3,0.75,12,3,9,0.25,5,4,1,2,213.0,219.28,216.14
2014-11-21,1610612743,1610612740,2014,117.0,97.0,214.0,109.2,110.3,100.45,104.8,11,4,7,0.364,10,6,4,0.6,2,2,4,2,217.04,200.8,208.92000000000002
2014-11-21,1610612744,1610612762,2014,101.0,88.0,189.0,107.5,105.85,95.55,106.55,10,8,2,0.8,12,5,7,0.417,4,4,3,2,199.04,200.2,199.62
2014-11-21,1610612757,1610612741,2014,105.0,87.0,192.0,104.75,105.45,94.0,91.0,11,8,3,0.727,12,8,4,0.667,7,1,2,6,209.44,185.44,197.44
2014-11-20,1610612748,1610612746,2014,93.0,110.0,203.0,97.25,95.5,109.85,106.5,11,6,5,0.545,10,6,4,0.6,3,3,4,2,195.0,214.36,204.68
2014-11-20,1610612758,1610612741,2014,103.0,88.0,191.0,97.75,101.5,94.0,91.0,11,6,5,0.545,11,8,3,0.727,3,3,2,6,207.08,185.44,196.26
2014-11-19,1610612739,1610612759,2014,90.0,92.0,182.0,101.9,101.55,107.75,96.55,9,5,4,0.556,10,6,4,0.6,2,3,3,3,195.48,204.12,199.8
2014-11-19,1610612754,1610612766,2014,88.0,86.0,174.0,92.05,92.25,99.45,97.7,11,4,7,0.364,11,4,7,0.364,2,2,3,1,187.28,194.96,191.12
2014-11-19,1610612753,1610612746,2014,90.0,114.0,204.0,96.55,103.5,109.85,106.5,12,5,7,0.417,9,5,4,0.556,2,3,4,1,203.64,214.36,209.0
2014-11-19,1610612755,1610612738,2014,90.0,101.0,191.0,97.85,106.0,99.65,105.5,10,0,10,0.0,9,3,6,0.333,0,0,2,1,207.68,195.08,201.38
2014-11-19,1610612764,1610612742,2014,102.0,105.0,207.0,94.7,91.35,104.45,102.7,9,7,2,0.778,11,8,3,0.727,4,3,5,3,193.0,213.0,203.0
2014-11-19,1610612751,1610612749,2014,118.0,122.0,240.0,96.7,98.4,99.8,108.15,10,4,6,0.4,11,6,5,0.545,3,1,4,2,196.96,200.48,198.72
2014-11-19,1610612765,1610612756,2014,86.0,88.0,174.0,100.85,105.95,106.25,103.85,11,3,8,0.273,11,6,5,0.545,2,1,4,2,206.0,212.88,209.44
2014-11-19,1610612761,1610612763,2014,96.0,92.0,188.0,100.6,99.2,98.25,97.5,10,8,2,0.8,11,10,1,0.909,6,2,6,4,206.0,193.96,199.98000000000002
2014-11-19,1610612750,1610612752,2014,115.0,99.0,214.0,110.05,111.2,101.2,97.2,9,2,7,0.222,12,3,9,0.25,1,1,2,1,209.4,200.28,204.84
2014-11-19,1610612743,1610612760,2014,107.0,100.0,207.0,109.2,110.3,101.8,103.4,10,3,7,0.3,12,3,9,0.25,1,2,2,1,217.04,210.36,213.7
2014-11-19,1610612745,1610612747,2014,92.0,98.0,190.0,112.7,109.85,107.3,114.65,11,9,2,0.818,11,2,9,0.182,3,6,1,1,216.24,219.28,217.76
2014-11-18,1610612737,1610612747,2014,109.0,114.0,223.0,96.35,95.7,107.3,114.65,9,5,4,0.556,10,1,9,0.1,4,1,1,0,199.44,219.28,209.36
2014-11-18,1610612749,1610612752,2014,117.0,113.0,230.0,99.8,108.15,101.2,97.2,10,5,5,0.5,11,3,8,0.273,3,2,2,1,200.48,200.28,200.38
2014-11-18,1610612762,1610612760,2014,98.0,81.0,179.0,95.55,106.55,101.8,103.4,11,4,7,0.364,11,3,8,0.273,2,2,2,1,200.2,210.36,205.28
2014-11-18,1610612758,1610612740,2014,100.0,106.0,206.0,97.75,101.5,100.45,104.8,10,6,4,0.6,9,5,4,0.556,3,3,4,1,207.08,200.8,203.94
2014-11-17,1610612766,1610612742,2014,80.0,107.0,187.0,99.45,97.7,104.45,102.7,10,4,6,0.4,10,7,3,0.7,3,1,5,2,194.96,213.0,203.98000000000002
2014-11-17,1610612739,1610612743,2014,97.0,106.0,203.0,101.9,101.55,109.2,110.3,8,5,3,0.625,9,2,7,0.222,2,3,1,1,195.48,217.04,206.26
2014-11-17,1610612738,1610612756,2014,114.0,118.0,232.0,99.65,105.5,106.25,103.85,8,3,5,0.375,10,5,5,0.5,2,1,4,1,195.08,212.88,203.98000000000002
2014-11-17,1610612751,1610612748,2014,83.0,95.0,178.0,96.7,98.4,97.25,95.5,9,4,5,0.444,10,5,5,0.5,3,1,3,2,196.96,195.0,195.98000000000002
2014-11-17,1610612765,1610612753,2014,93.0,107.0,200.0,100.85,105.95,96.55,103.5,10,3,7,0.3,11,4,7,0.364,2,1,2,2,206.0,203.64,204.82
2014-11-17,1610612763,1610612745,2014,119.0,93.0,212.0,98.25,97.5,112.7,109.85,10,9,1,0.9,10,9,1,0.9,5,4,3,6,193.96,216.24,205.10000000000002
2014-11-17,1610612759,1610612755,2014,100.0,75.0,175.0,107.75,96.55,97.85,106.0,9,5,4,0.556,9,0,9,0.0,2,3,0,0,204.12,207.68,205.9
2014-11-17,1610612757,1610612740,2014,102.0,93.0,195.0,104.75,105.45,100.45,104.8,10,7,3,0.7,8,5,3,0.625,6,1,4,1,209.44,200.8,205.12
2014-11-17,1610612746,1610612741,2014,89.0,105.0,194.0,109.85,106.5,94.0,91.0,8,5,3,0.625,10,7,3,0.7,4,1,2,5,214.36,185.44,199.9
2014-11-16,1610612752,1610612743,2014,109.0,93.0,202.0,101.2,97.2,109.2,110.3,10,2,8,0.2,8,2,6,0.25,1,1,1,1,200.28,217.04,208.66
2014-11-16,1610612748,1610612749,2014,84.0,91.0,175.0,97.25,95.5,99.8,108.15,9,5,4,0.556,9,4,5,0.444,3,2,3,1,195.0,200.48,197.74
2014-11-16,1610612760,1610612745,2014,65.0,69.0,134.0,101.8,103.4,112.7,109.85,10,3,7,0.3,9,8,1,0.889,2,1,3,5,210.36,216.24,213.3
2014-11-16,1610612747,1610612744,2014,115.0,136.0,251.0,107.3,114.65,107.5,105.85,9,1,8,0.111,9,7,2,0.778,1,0,4,3,219.28,199.04,209.16
2014-11-15,1610612764,1610612753,2014,98.0,93.0,191.0,94.7,91.35,96.55,103.5,8,6,2,0.75,10,4,6,0.4,3,3,2,2,193.0,203.64,198.32
2014-11-15,1610612739,1610612737,2014,127.0,94.0,221.0,101.9,101.55,96.35,95.7,7,4,3,0.5710000000000001,8,5,3,0.625,1,3,4,1,195.48,199.44,197.45999999999998
2014-11-15,1610612761,1610612762,2014,111.0,93.0,204.0,100.6,99.2,95.55,106.55,9,7,2,0.778,10,4,6,0.4,5,2,2,2,206.0,200.2,203.1
2014-11-15,1610612741,1610612754,2014,90.0,99.0,189.0,94.0,91.0,92.05,92.25,9,7,2,0.778,10,3,7,0.3,2,5,2,1,185.44,187.28,186.36
2014-11-15,1610612763,1610612765,2014,95.0,88.0,183.0,98.25,97.5,100.85,105.95,9,8,1,0.889,9,3,6,0.333,4,4,2,1,193.96,206.0,199.98000000000002
2014-11-15,1610612742,1610612750,2014,131.0,117.0,248.0,104.45,102.7,110.05,111.2,9,6,3,0.667,8,2,6,0.25,4,2,1,1,213.0,209.4,211.2
2014-11-15,1610612757,1610612751,2014,97.0,87.0,184.0,104.75,105.45,96.7,98.4,9,6,3,0.667,8,4,4,0.5,5,1,3,1,209.44,196.96,203.2
2014-11-15,1610612758,1610612759,2014,94.0,91.0,185.0,97.75,101.5,107.75,96.55,9,5,4,0.556,8,5,3,0.625,2,3,2,3,207.08,204.12,205.60000000000002
2014-11-15,1610612744,1610612766,2014,112.0,87.0,199.0,107.5,105.85,99.45,97.7,8,6,2,0.75,9,4,5,0.444,3,3,3,1,199.04,194.96,197.0
2014-11-15,1610612746,1610612756,2014,120.0,107.0,227.0,109.85,106.5,106.25,103.85,7,4,3,0.5710000000000001,9,5,4,0.556,3,1,4,1,214.36,212.88,213.62
2014-11-14,1610612754,1610612743,2014,87.0,108.0,195.0,92.05,92.25,109.2,110.3,9,3,6,0.333,7,1,6,0.14300000000000002,2,1,1,0,187.28,217.04,202.16
2014-11-14,1610612753,1610612749,2014,101.0,85.0,186.0,96.55,103.5,99.8,108.15,9,3,6,0.333,8,4,4,0.5,1,2,3,1,203.64,200.48,202.06
2014-11-14,1610612737,1610612748,2014,114.0,103.0,217.0,96.35,95.7,97.25,95.5,7,4,3,0.5710000000000001,8,5,3,0.625,3,1,3,2,199.44,195.0,197.22
2014-11-14,1610612738,1610612739,2014,121.0,122.0,243.0,99.65,105.5,101.9,101.55,7,3,4,0.429,6,3,3,0.5,2,1,1,2,195.08,195.48,195.28
2014-11-14,1610612752,1610612762,2014,100.0,102.0,202.0,101.2,97.2,95.55,106.55,9,2,7,0.222,9,3,6,0.333,1,1,2,1,200.28,200.2,200.24
2014-11-14,1610612745,1610612755,2014,88.0,87.0,175.0,112.7,109.85,97.85,106.0,8,7,1,0.875,8,0,8,0.0,2,5,0,0,216.24,207.68,211.96
2014-11-14,1610612740,1610612750,2014,139.0,91.0,230.0,100.45,104.8,110.05,111.2,7,4,3,0.5710000000000001,7,2,5,0.28600000000000003,3,1,1,1,200.8,209.4,205.10000000000002
2014-11-14,1610612760,1610612765,2014,89.0,96.0,185.0,101.8,103.4,100.85,105.95,9,3,6,0.333,8,2,6,0.25,2,1,2,0,210.36,206.0,208.18
2014-11-14,1610612756,1610612766,2014,95.0,103.0,198.0,106.25,103.85,99.45,97.7,8,5,3,0.625,8,3,5,0.375,4,1,3,0,212.88,194.96,203.92000000000002
2014-11-14,1610612747,1610612759,2014,80.0,93.0,173.0,107.3,114.65,107.75,96.55,8,1,7,0.125,7,4,3,0.5710000000000001,1,0,2,2,219.28,204.12,211.7
2014-11-13,1610612763,1610612758,2014,111.0,110.0,221.0,98.25,97.5,97.75,101.5,8,7,1,0.875,8,5,3,0.625,3,4,2,3,193.96,207.08,200.52
2014-11-13,1610612761,1610612741,2014,93.0,100.0,193.0,100.6,99.2,94.0,91.0,8,7,1,0.875,8,6,2,0.75,5,2,2,4,206.0,185.44,195.72
2014-11-13,1610612742,1610612755,2014,123.0,70.0,193.0,104.45,102.7,97.85,106.0,8,5,3,0.625,7,0,7,0.0,3,2,0,0,213.0,207.68,210.34
2014-11-13,1610612744,1610612751,2014,107.0,99.0,206.0,107.5,105.85,96.7,98.4,7,5,2,0.7140000000000001,7,4,3,0.5710000000000001,2,3,3,1,199.04,196.96,198.0
2014-11-12,1610612764,1610612765,2014,107.0,103.0,210.0,94.7,91.35,100.85,105.95,7,5,2,0.7140000000000001,7,2,5,0.28600000000000003,2,3,2,0,193.0,206.0,199.5
2014-11-12,1610612737,1610612762,2014,100.0,97.0,197.0,96.35,95.7,95.55,106.55,6,3,3,0.5,8,3,5,0.375,2,1,2,1,199.44,200.2,199.82
2014-11-12,1610612738,1610612760,2014,94.0,109.0,203.0,99.65,105.5,101.8,103.4,6,3,3,0.5,8,2,6,0.25,2,1,2,0,195.08,210.36,202.72000000000003
2014-11-12,1610612748,1610612754,2014,75.0,81.0,156.0,97.25,95.5,92.05,92.25,7,5,2,0.7140000000000001,8,2,6,0.25,3,2,2,0,195.0,187.28,191.14
2014-11-12,1610612752,1610612753,2014,95.0,97.0,192.0,101.2,97.2,96.55,103.5,8,2,6,0.25,8,2,6,0.25,1,1,1,1,200.28,203.64,201.95999999999998
2014-11-12,1610612740,1610612747,2014,109.0,102.0,211.0,100.45,104.8,107.3,114.65,6,3,3,0.5,7,1,6,0.14300000000000002,2,1,1,0,200.8,219.28,210.04000000000002
2014-11-12,1610612743,1610612757,2014,113.0,130.0,243.0,109.2,110.3,104.75,105.45,6,1,5,0.16699999999999998,8,5,3,0.625,1,0,5,0,217.04,209.44,213.24
2014-11-12,1610612756,1610612751,2014,112.0,104.0,216.0,106.25,103.85,96.7,98.4,7,4,3,0.5710000000000001,6,4,2,0.667,3,1,3,1,212.88,196.96,204.92000000000002
2014-11-12,1610612750,1610612745,2014,101.0,113.0,214.0,110.05,111.2,112.7,109.85,6,2,4,0.333,7,6,1,0.857,1,1,2,4,209.4,216.24,212.82
2014-11-11,1610612761,1610612753,2014,104.0,100.0,204.0,100.6,99.2,96.55,103.5,7,6,1,0.857,7,2,5,0.28600000000000003,4,2,1,1,206.0,203.64,204.82
2014-11-11,1610612763,1610612747,2014,107.0,102.0,209.0,98.25,97.5,107.3,114.65,7,6,1,0.857,6,1,5,0.16699999999999998,2,4,1,0,193.96,219.28,206.62
2014-11-11,1610612749,1610612760,2014,85.0,78.0,163.0,99.8,108.15,101.8,103.4,7,3,4,0.429,7,2,5,0.28600000000000003,2,1,2,0,200.48,210.36,205.42000000000002
2014-11-11,1610612742,1610612758,2014,106.0,98.0,204.0,104.45,102.7,97.75,101.5,7,4,3,0.5710000000000001,7,5,2,0.7140000000000001,2,2,2,3,213.0,207.08,210.04000000000002
2014-11-11,1610612757,1610612766,2014,102.0,100.0,202.0,104.75,105.45,99.45,97.7,7,4,3,0.5710000000000001,7,3,4,0.429,4,0,3,0,209.44,194.96,202.2
2014-11-11,1610612744,1610612759,2014,100.0,113.0,213.0,107.5,105.85,107.75,96.55,6,5,1,0.833,6,3,3,0.5,2,3,2,1,199.04,204.12,201.57999999999998
2014-11-10,1610612739,1610612740,2014,118.0,111.0,229.0,101.9,101.55,100.45,104.8,5,2,3,0.4,5,3,2,0.6,0,2,2,1,195.48,200.8,198.14
2014-11-10,1610612754,1610612762,2014,97.0,86.0,183.0,92.05,92.25,95.55,106.55,7,1,6,0.14300000000000002,7,3,4,0.429,1,0,2,1,187.28,200.2,193.74
2014-11-10,1610612752,1610612737,2014,85.0,91.0,176.0,101.2,97.2,96.35,95.7,7,2,5,0.28600000000000003,5,2,3,0.4,1,1,2,0,200.28,199.44,199.86
2014-11-10,1610612741,1610612765,2014,102.0,91.0,193.0,94.0,91.0,100.85,105.95,7,5,2,0.7140000000000001,6,2,4,0.333,1,4,2,0,185.44,206.0,195.72
2014-11-10,1610612746,1610612759,2014,85.0,89.0,174.0,109.85,106.5,107.75,96.55,6,4,2,0.667,5,2,3,0.4,3,1,2,0,214.36,204.12,209.24
2014-11-09,1610612751,1610612753,2014,104.0,96.0,200.0,96.7,98.4,96.55,103.5,5,3,2,0.6,6,2,4,0.333,2,1,1,1,196.96,203.64,200.3
2014-11-09,1610612765,1610612762,2014,96.0,97.0,193.0,100.85,105.95,95.55,106.55,5,2,3,0.4,6,2,4,0.333,2,0,2,0,206.0,200.2,203.1
2014-11-09,1610612760,1610612758,2014,101.0,93.0,194.0,101.8,103.4,97.75,101.5,6,1,5,0.16699999999999998,6,5,1,0.833,1,0,2,3,210.36,207.08,208.72000000000003
2014-11-09,1610612761,1610612755,2014,120.0,88.0,208.0,100.6,99.2,97.85,106.0,6,5,1,0.833,6,0,6,0.0,3,2,0,0,206.0,207.68,206.84
2014-11-09,1610612742,1610612748,2014,96.0,105.0,201.0,104.45,102.7,97.25,95.5,6,4,2,0.667,6,4,2,0.667,2,2,3,1,213.0,195.0,204.0
2014-11-09,1610612756,1610612744,2014,107.0,95.0,202.0,106.25,103.85,107.5,105.85,6,3,3,0.5,5,5,0,1.0,2,1,2,3,212.88,199.04,205.95999999999998
2014-11-09,1610612757,1610612743,2014,116.0,100.0,216.0,104.75,105.45,109.2,110.3,6,3,3,0.5,5,1,4,0.2,3,0,1,0,209.44,217.04,213.24
2014-11-09,1610612747,1610612766,2014,107.0,92.0,199.0,107.3,114.65,99.45,97.7,5,0,5,0.0,6,3,3,0.5,0,0,3,0,219.28,194.96,207.12
2014-11-08,1610612746,1610612757,2014,106.0,102.0,208.0,109.85,106.5,104.75,105.45,5,3,2,0.6,5,3,2,0.6,2,1,3,0,214.36,209.44,211.9
2014-11-08,1610612754,1610612764,2014,90.0,97.0,187.0,92.05,92.25,94.7,91.35,6,1,5,0.16699999999999998,6,4,2,0.667,1,0,2,2,187.28,193.0,190.14
2014-11-08,1610612737,1610612752,2014,103.0,96.0,199.0,96.35,95.7,101.2,97.2,4,1,3,0.25,6,2,4,0.333,1,0,1,1,199.44,200.28,199.86
2014-11-08,1610612748,1610612750,2014,102.0,92.0,194.0,97.25,95.5,110.05,111.2,5,3,2,0.6,5,2,3,0.4,2,1,1,1,195.0,209.4,202.2
2014-11-08,1610612741,1610612738,2014,101.0,106.0,207.0,94.0,91.0,99.65,105.5,6,5,1,0.833,5,2,3,0.4,1,4,2,0,185.44,195.08,190.26
2014-11-08,1610612745,1610612744,2014,87.0,98.0,185.0,112.7,109.85,107.5,105.85,6,6,0,1.0,4,4,0,1.0,2,4,2,2,216.24,199.04,207.64
2014-11-08,1610612749,1610612763,2014,93.0,92.0,185.0,99.8,108.15,98.25,97.5,6,2,4,0.333,6,6,0,1.0,1,1,2,4,200.48,193.96,197.22
2014-11-08,1610612759,1610612740,2014,99.0,100.0,199.0,107.75,96.55,100.45,104.8,4,2,2,0.5,4,2,2,0.5,2,0,2,0,204.12,200.8,202.46
2014-11-07,1610612766,1610612737,2014,122.0,119.0,241.0,99.45,97.7,96.35,95.7,5,2,3,0.4,3,1,2,0.333,2,0,1,0,194.96,199.44,197.2
2014-11-07,1610612753,1610612750,2014,112.0,103.0,215.0,96.55,103.5,110.05,111.2,5,1,4,0.2,4,2,2,0.5,0,1,1,1,203.64,209.4,206.51999999999998
2014-11-07,1610612755,1610612741,2014,115.0,118.0,233.0,97.85,106.0,94.0,91.0,5,0,5,0.0,5,4,1,0.8,0,0,1,3,207.68,185.44,196.56
2014-11-07,1610612738,1610612754,2014,101.0,98.0,199.0,99.65,105.5,92.05,92.25,4,1,3,0.25,5,1,4,0.2,1,0,1,0,195.08,187.28,191.18
2014-11-07,1610612751,1610612752,2014,110.0,99.0,209.0,96.7,98.4,101.2,97.2,4,2,2,0.5,5,2,3,0.4,1,1,1,1,196.96,200.28,198.62
2014-11-07,1610612765,1610612749,2014,98.0,95.0,193.0,100.85,105.95,99.8,108.15,4,1,3,0.25,5,2,3,0.4,1,0,1,1,206.0,200.48,203.24
2014-11-07,1610612761,1610612764,2014,103.0,84.0,187.0,100.6,99.2,94.7,91.35,5,4,1,0.8,5,4,1,0.8,2,2,2,2,206.0,193.0,199.5
2014-11-07,1610612760,1610612763,2014,89.0,91.0,180.0,101.8,103.4,98.25,97.5,5,1,4,0.2,5,5,0,1.0,1,0,2,3,210.36,193.96,202.16000000000003
2014-11-07,1610612756,1610612758,2014,112.0,114.0,226.0,106.25,103.85,97.75,101.5,5,3,2,0.6,5,4,1,0.8,2,1,2,2,212.88,207.08,209.98000000000002
2014-11-07,1610612762,1610612742,2014,82.0,105.0,187.0,95.55,106.55,104.45,102.7,5,2,3,0.4,5,3,2,0.6,2,0,2,1,200.2,213.0,206.6
2014-11-07,1610612743,1610612739,2014,101.0,110.0,211.0,109.2,110.3,101.9,101.55,4,1,3,0.25,4,1,3,0.25,1,0,0,1,217.04,195.48,206.26
2014-11-06,1610612745,1610612759,2014,98.0,81.0,179.0,112.7,109.85,107.75,96.55,5,5,0,1.0,3,2,1,0.667,1,4,2,0,216.24,204.12,210.18
2014-11-06,1610612757,1610612742,2014,108.0,87.0,195.0,104.75,105.45,104.45,102.7,4,2,2,0.5,4,3,1,0.75,2,0,2,1,209.44,213.0,211.22
2014-11-05,1610612766,1610612748,2014,96.0,89.0,185.0,99.45,97.7,97.25,95.5,4,1,3,0.25,4,3,1,0.75,1,0,2,1,194.96,195.0,194.98000000000002
2014-11-05,1610612755,1610612753,2014,89.0,91.0,180.0,97.85,106.0,96.55,103.5,4,0,4,0.0,4,0,4,0.0,0,0,0,0,207.68,203.64,205.66
2014-11-05,1610612738,1610612761,2014,107.0,110.0,217.0,99.65,105.5,100.6,99.2,3,1,2,0.333,4,3,1,0.75,1,0,2,1,195.08,206.0,200.54000000000002
2014-11-05,1610612751,1610612750,2014,91.0,98.0,189.0,96.7,98.4,110.05,111.2,3,2,1,0.667,3,1,2,0.333,1,1,1,0,196.96,209.4,203.18
2014-11-05,1610612765,1610612752,2014,98.0,95.0,193.0,100.85,105.95,101.2,97.2,3,0,3,0.0,4,2,2,0.5,0,0,1,1,206.0,200.28,203.14
2014-11-05,1610612749,1610612741,2014,86.0,95.0,181.0,99.8,108.15,94.0,91.0,4,2,2,0.5,4,3,1,0.75,1,1,1,2,200.48,185.44,192.95999999999998
2014-11-05,1610612764,1610612754,2014,96.0,94.0,190.0,94.7,91.35,92.05,92.25,4,3,1,0.75,4,1,3,0.25,1,2,1,0,193.0,187.28,190.14
2014-11-05,1610612759,1610612737,2014,94.0,92.0,186.0,107.75,96.55,96.35,95.7,2,1,1,0.5,2,1,1,0.5,1,0,1,0,204.12,199.44,201.78
2014-11-05,1610612756,1610612763,2014,91.0,102.0,193.0,106.25,103.85,98.25,97.5,4,3,1,0.75,4,4,0,1.0,2,1,2,2,212.88,193.96,203.42000000000002
2014-11-05,1610612762,1610612739,2014,102.0,100.0,202.0,95.55,106.55,101.9,101.55,4,1,3,0.25,3,1,2,0.333,1,0,0,1,200.2,195.48,197.83999999999997
2014-11-05,1610612758,1610612743,2014,131.0,109.0,240.0,97.75,101.5,109.2,110.3,4,3,1,0.75,3,1,2,0.333,1,2,1,0,207.08,217.04,212.06
2014-11-05,1610612744,1610612746,2014,121.0,104.0,225.0,107.5,105.85,109.85,106.5,3,3,0,1.0,4,3,1,0.75,1,2,2,1,199.04,214.36,206.7
2014-11-04,1610612754,1610612749,2014,81.0,87.0,168.0,92.05,92.25,99.8,108.15,3,1,2,0.333,3,1,2,0.333,1,0,1,0,187.28,200.48,193.88
2014-11-04,1610612748,1610612745,2014,91.0,108.0,199.0,97.25,95.5,112.7,109.85,3,3,0,1.0,4,4,0,1.0,2,1,1,3,195.0,216.24,205.62
2014-11-04,1610612752,1610612764,2014,83.0,98.0,181.0,101.2,97.2,94.7,91.35,3,2,1,0.667,3,2,1,0.667,1,1,1,1,200.28,193.0,196.64
2014-11-04,1610612761,1610612760,2014,100.0,88.0,188.0,100.6,99.2,101.8,103.4,3,2,1,0.667,4,1,3,0.25,1,1,1,0,206.0,210.36,208.18
2014-11-04,1610612741,1610612753,2014,98.0,90.0,188.0,94.0,91.0,96.55,103.5,3,2,1,0.667,3,0,3,0.0,0,2,0,0,185.44,203.64,194.54
2014-11-04,1610612740,1610612766,2014,100.0,91.0,191.0,100.45,104.8,99.45,97.7,3,1,2,0.333,3,1,2,0.333,1,0,1,0,200.8,194.96,197.88
2014-11-04,1610612757,1610612739,2014,101.0,82.0,183.0,104.75,105.45,101.9,101.55,3,1,2,0.333,2,1,1,0.5,1,0,0,1,209.44,195.48,202.45999999999998
2014-11-04,1610612747,1610612756,2014,106.0,112.0,218.0,107.3,114.65,106.25,103.85,4,0,4,0.0,3,2,1,0.667,0,0,2,0,219.28,212.88,216.07999999999998
2014-11-03,1610612755,1610612745,2014,93.0,104.0,197.0,97.85,106.0,112.7,109.85,3,0,3,0.0,3,3,0,1.0,0,0,1,2,207.68,216.24,211.96
2014-11-03,1610612751,1610612760,2014,116.0,85.0,201.0,96.7,98.4,101.8,103.4,2,1,1,0.5,3,1,2,0.333,0,1,1,0,196.96,210.36,203.66000000000003
2014-11-03,1610612763,1610612740,2014,93.0,81.0,174.0,98.25,97.5,100.45,104.8,3,3,0,1.0,2,1,1,0.5,1,2,1,0,193.96,200.8,197.38
2014-11-03,1610612742,1610612738,2014,118.0,113.0,231.0,104.45,102.7,99.65,105.5,3,2,1,0.667,2,1,1,0.5,1,1,1,0,213.0,195.08,204.04000000000002
2014-11-03,1610612743,1610612758,2014,105.0,110.0,215.0,109.2,110.3,97.75,101.5,2,1,1,0.5,3,2,1,0.667,1,0,1,1,217.04,207.08,212.06
2014-11-03,1610612746,1610612762,2014,107.0,101.0,208.0,109.85,106.5,95.55,106.55,3,2,1,0.667,3,1,2,0.333,1,1,1,0,214.36,200.2,207.28
2014-11-02,1610612746,1610612758,2014,92.0,98.0,190.0,109.85,106.5,97.75,101.5,2,2,0,1.0,2,1,1,0.5,1,1,1,0,214.36,207.08,210.72000000000003
2014-11-02,1610612748,1610612761,2014,107.0,102.0,209.0,97.25,95.5,100.6,99.2,2,2,0,1.0,2,2,0,1.0,1,1,1,1,195.0,206.0,200.5
2014-11-02,1610612752,1610612766,2014,96.0,93.0,189.0,101.2,97.2,99.45,97.7,2,1,1,0.5,2,1,1,0.5,0,1,1,0,200.28,194.96,197.62
2014-11-02,1610612757,1610612744,2014,90.0,95.0,185.0,104.75,105.45,107.5,105.85,2,1,1,0.5,2,2,0,1.0,1,0,1,1,209.44,199.04,204.24
2014-11-01,1610612740,1610612742,2014,104.0,109.0,213.0,100.45,104.8,104.45,102.7,1,1,0,1.0,2,1,1,0.5,1,0,1,0,200.8,213.0,206.9
2014-11-01,1610612766,1610612763,2014,69.0,71.0,140.0,99.45,97.7,98.25,97.5,1,1,0,1.0,2,2,0,1.0,1,0,1,1,194.96,193.96,194.46
2014-11-01,1610612753,1610612761,2014,95.0,108.0,203.0,96.55,103.5,100.6,99.2,2,0,2,0.0,1,1,0,1.0,0,0,1,0,203.64,206.0,204.82
2014-11-01,1610612755,1610612748,2014,96.0,114.0,210.0,97.85,106.0,97.25,95.5,2,0,2,0.0,1,1,0,1.0,0,0,1,0,207.68,195.0,201.34
2014-11-01,1610612764,1610612749,2014,108.0,97.0,205.0,94.7,91.35,99.8,108.15,2,1,1,0.5,2,1,1,0.5,0,1,1,0,193.0,200.48,196.74
2014-11-01,1610612737,1610612754,2014,102.0,92.0,194.0,96.35,95.7,92.05,92.25,1,0,1,0.0,2,1,1,0.5,0,0,1,0,199.44,187.28,193.36
2014-11-01,1610612765,1610612751,2014,90.0,102.0,192.0,100.85,105.95,96.7,98.4,2,0,2,0.0,1,0,1,0.0,0,0,0,0,206.0,196.96,201.48000000000002
2014-11-01,1610612745,1610612738,2014,104.0,90.0,194.0,112.7,109.85,99.65,105.5,2,2,0,1.0,1,1,0,1.0,0,2,1,0,216.24,195.08,205.66000000000003
2014-11-01,1610612750,1610612741,2014,105.0,106.0,211.0,110.05,111.2,94.0,91.0,2,1,1,0.5,2,1,1,0.5,1,0,0,1,209.4,185.44,197.42000000000002
2014-11-01,1610612760,1610612743,2014,102.0,91.0,193.0,101.8,103.4,109.2,110.3,2,0,2,0.0,1,1,0,1.0,0,0,1,0,210.36,217.04,213.7
2014-11-01,1610612762,1610612756,2014,118.0,91.0,209.0,95.55,106.55,106.25,103.85,2,0,2,0.0,2,2,0,1.0,0,0,2,0,200.2,212.88,206.54
2014-11-01,1610612744,1610612747,2014,127.0,104.0,231.0,107.5,105.85,107.3,114.65,1,1,0,1.0,3,0,3,0.0,0,1,0,0,199.04,219.28,209.16
2014-10-31,1610612754,1610612763,2014,89.0,97.0,186.0,92.05,92.25,98.25,97.5,1,1,0,1.0,1,1,0,1.0,1,0,1,0,187.28,193.96,190.62
2014-10-31,1610612741,1610612739,2014,108.0,114.0,222.0,94.0,91.0,101.9,101.55,1,1,0,1.0,1,0,1,0.0,0,1,0,0,185.44,195.48,190.45999999999998
2014-10-31,1610612749,1610612755,2014,93.0,81.0,174.0,99.8,108.15,97.85,106.0,1,0,1,0.0,1,0,1,0.0,0,0,0,0,200.48,207.68,204.07999999999998
2014-10-31,1610612756,1610612759,2014,94.0,89.0,183.0,106.25,103.85,107.75,96.55,1,1,0,1.0,1,1,0,1.0,1,0,1,0,212.88,204.12,208.5
2014-10-31,1610612758,1610612757,2014,103.0,94.0,197.0,97.75,101.5,104.75,105.45,1,0,1,0.0,1,1,0,1.0,0,0,1,0,207.08,209.44,208.26
2014-10-31,1610612747,1610612746,2014,111.0,118.0,229.0,107.3,114.65,109.85,106.5,2,0,2,0.0,1,1,0,1.0,0,0,1,0,219.28,214.36,216.82
2014-10-30,1610612753,1610612764,2014,98.0,105.0,203.0,96.55,103.5,94.7,91.35,1,0,1,0.0,1,0,1,0.0,0,0,0,0,203.64,193.0,198.32
2014-10-30,1610612750,1610612765,2014,97.0,91.0,188.0,110.05,111.2,100.85,105.95,1,0,1,0.0,1,0,1,0.0,0,0,0,0,209.4,206.0,207.7
2014-10-30,1610612739,1610612752,2014,90.0,95.0,185.0,101.9,101.55,101.2,97.2,0,0,0,0.0,1,0,1,0.0,0,0,0,0,195.48,200.28,197.88
2014-10-30,1610612742,1610612762,2014,120.0,102.0,222.0,104.45,102.7,95.55,106.55,1,0,1,0.0,1,0,1,0.0,0,0,0,0,213.0,200.2,206.6
2014-10-30,1610612746,1610612760,2014,93.0,90.0,183.0,109.85,106.5,101.8,103.4,0,0,0,0.0,1,0,1,0.0,0,0,0,0,214.36,210.36,212.36
2014-10-29,1610612766,1610612749,2014,108.0,106.0,214.0,99.45,97.7,99.8,108.15,0,0,0,0.0,0,0,0,0.0,0,0,0,0,194.96,200.48,197.72
2014-10-29,1610612754,1610612755,2014,103.0,91.0,194.0,92.05,92.25,97.85,106.0,0,0,0,0.0,0,0,0,0.0,0,0,0,0,187.28,207.68,197.48000000000002
2014-10-29,1610612738,1610612751,2014,121.0,105.0,226.0,99.65,105.5,96.7,98.4,0,0,0,0.0,0,0,0,0.0,0,0,0,0,195.08,196.96,196.02
2014-10-29,1610612748,1610612764,2014,107.0,95.0,202.0,97.25,95.5,94.7,91.35,0,0,0,0.0,0,0,0,0.0,0,0,0,0,195.0,193.0,194.0
2014-10-29,1610612761,1610612737,2014,109.0,102.0,211.0,100.6,99.2,96.35,95.7,0,0,0,0.0,0,0,0,0.0,0,0,0,0,206.0,199.44,202.72
2014-10-29,1610612763,1610612750,2014,105.0,101.0,206.0,98.25,97.5,110.05,111.2,0,0,0,0.0,0,0,0,0.0,0,0,0,0,193.96,209.4,201.68
2014-10-29,1610612752,1610612741,2014,80.0,104.0,184.0,101.2,97.2,94.0,91.0,0,0,0,0.0,0,0,0,0.0,0,0,0,0,200.28,185.44,192.86
2014-10-29,1610612743,1610612765,2014,89.0,79.0,168.0,109.2,110.3,100.85,105.95,0,0,0,0.0,0,0,0,0.0,0,0,0,0,217.04,206.0,211.51999999999998
2014-10-29,1610612762,1610612745,2014,93.0,104.0,197.0,95.55,106.55,112.7,109.85,0,0,0,0.0,1,1,0,1.0,0,0,0,1,200.2,216.24,208.22
2014-10-29,1610612756,1610612747,2014,119.0,99.0,218.0,106.25,103.85,107.3,114.65,0,0,0,0.0,1,0,1,0.0,0,0,0,0,212.88,219.28,216.07999999999998
2014-10-29,1610612758,1610612744,2014,77.0,95.0,172.0,97.75,101.5,107.5,105.85,0,0,0,0.0,0,0,0,0.0,0,0,0,0,207.08,199.04,203.06
2014-10-29,1610612757,1610612760,2014,106.0,89.0,195.0,104.75,105.45,101.8,103.4,0,0,0,0.0,0,0,0,0.0,0,0,0,0,209.44,210.36,209.9
2014-10-28,1610612740,1610612753,2014,101.0,84.0,185.0,100.45,104.8,96.55,103.5,7,5,2,0.7140000000000001,8,4,4,0.5,3,2,2,2,200.8,203.64,202.22
2014-10-28,1610612759,1610612742,2014,101.0,100.0,201.0,107.75,96.55,104.45,102.7,7,2,5,0.28600000000000003,8,4,4,0.5,1,1,2,2,204.12,213.0,208.56
2014-10-28,1610612747,1610612745,2014,90.0,108.0,198.0,107.3,114.65,112.7,109.85,8,3,5,0.375,8,6,2,0.75,3,0,4,2,219.28,216.24,217.76
2014-10-24,1610612753,1610612742,2014,92.0,117.0,209.0,96.55,103.5,104.45,102.7,7,4,3,0.5710000000000001,7,3,4,0.429,2,2,2,1,203.64,213.0,208.32
2014-10-24,1610612761,1610612752,2014,83.0,80.0,163.0,100.6,99.2,101.2,97.2,7,6,1,0.857,6,3,3,0.5,3,3,1,2,206.0,200.28,203.14
2014-10-24,1610612741,1610612750,2014,112.0,113.0,225.0,94.0,91.0,110.05,111.2,7,4,3,0.5710000000000001,6,4,2,0.667,3,1,2,2,185.44,209.4,197.42000000000002
2014-10-24,1610612763,1610612748,2014,98.0,104.0,202.0,98.25,97.5,97.25,95.5,7,3,4,0.429,7,3,4,0.429,3,0,2,1,193.96,195.0,194.48000000000002
2014-10-24,1610612745,1610612759,2014,96.0,87.0,183.0,112.7,109.85,107.75,96.55,7,5,2,0.7140000000000001,6,2,4,0.333,3,2,1,1,216.24,204.12,210.18
2014-10-24,1610612762,1610612756,2014,100.0,105.0,205.0,95.55,106.55,106.25,103.85,7,5,2,0.7140000000000001,6,4,2,0.667,2,3,3,1,200.2,212.88,206.54
2014-10-24,1610612747,1610612758,2014,92.0,93.0,185.0,107.3,114.65,97.75,101.5,7,3,4,0.429,6,2,4,0.333,3,0,2,0,219.28,207.08,213.18
2014-10-24,1610612744,1610612743,2014,119.0,112.0,231.0,107.5,105.85,109.2,110.3,7,5,2,0.7140000000000001,7,2,5,0.28600000000000003,2,3,1,1,199.04,217.04,208.04
2014-10-24,1610612746,1610612757,2014,89.0,99.0,188.0,109.85,106.5,104.75,105.45,7,2,5,0.28600000000000003,6,3,3,0.5,2,0,2,1,214.36,209.44,211.9
2014-10-23,1610612766,1610612754,2014,79.0,88.0,167.0,99.45,97.7,92.05,92.25,7,3,4,0.429,6,2,4,0.333,2,1,2,0,194.96,187.28,191.12
2014-10-23,1610612765,1610612755,2014,109.0,103.0,212.0,100.85,105.95,97.85,106.0,6,4,2,0.667,7,2,5,0.28600000000000003,2,2,2,0,206.0,207.68,206.84
2014-10-23,1610612740,1610612742,2014,88.0,85.0,173.0,100.45,104.8,104.45,102.7,6,4,2,0.667,6,3,3,0.5,2,2,2,1,200.8,213.0,206.9
2014-10-22,1610612753,1610612745,2014,89.0,90.0,179.0,96.55,103.5,112.7,109.85,6,4,2,0.667,6,4,2,0.667,2,2,3,1,203.64,216.24,209.94
2014-10-22,1610612738,1610612751,2014,100.0,86.0,186.0,99.65,105.5,96.7,98.4,7,4,3,0.5710000000000001,5,4,1,0.8,2,2,3,1,195.08,196.96,196.02
2014-10-22,1610612752,1610612764,2014,103.0,100.0,203.0,101.2,97.2,94.7,91.35,5,2,3,0.4,7,4,3,0.5710000000000001,0,2,2,2,200.28,193.0,196.64
2014-10-22,1610612763,1610612739,2014,96.0,92.0,188.0,98.25,97.5,101.9,101.55,6,2,4,0.333,6,5,1,0.833,2,0,4,1,193.96,195.48,194.72
2014-10-22,1610612749,1610612750,2014,91.0,110.0,201.0,99.8,108.15,110.05,111.2,6,3,3,0.5,5,3,2,0.6,1,2,2,1,200.48,209.4,204.94
2014-10-22,1610612759,1610612737,2014,107.0,117.0,224.0,107.75,96.55,96.35,95.7,5,2,3,0.4,6,3,3,0.5,1,1,2,1,204.12,199.44,201.78
2014-10-22,1610612747,1610612757,2014,94.0,86.0,180.0,107.3,114.65,104.75,105.45,6,2,4,0.333,5,3,2,0.6,2,0,2,1,219.28,209.44,214.36
2014-10-22,1610612746,1610612756,2014,108.0,105.0,213.0,109.85,106.5,106.25,103.85,6,1,5,0.16699999999999998,5,4,1,0.8,1,0,3,1,214.36,212.88,213.62
2014-10-21,1610612750,1610612754,2014,107.0,89.0,196.0,110.05,111.2,92.05,92.25,4,2,2,0.5,5,2,3,0.4,1,1,2,0,209.4,187.28,198.34
2014-10-21,1610612760,1610612762,2014,91.0,105.0,196.0,101.8,103.4,95.55,106.55,6,2,4,0.333,6,4,2,0.667,1,1,2,2,210.36,200.2,205.28
2014-10-21,1610612748,1610612745,2014,90.0,85.0,175.0,97.25,95.5,112.7,109.85,6,2,4,0.333,5,4,1,0.8,1,1,3,1,195.0,216.24,205.62
2014-10-21,1610612743,1610612757,2014,75.0,93.0,168.0,109.2,110.3,104.75,105.45,6,2,4,0.333,4,2,2,0.5,1,1,2,0,217.04,209.44,213.24
2014-10-21,1610612747,1610612756,2014,108.0,114.0,222.0,107.3,114.65,106.25,103.85,5,2,3,0.4,4,3,1,0.75,2,0,3,0,219.28,212.88,216.07999999999998
2014-10-21,1610612744,1610612746,2014,125.0,107.0,232.0,107.5,105.85,109.85,106.5,6,4,2,0.667,5,1,4,0.2,1,3,1,0,199.04,214.36,206.7
2014-10-20,1610612764,1610612740,2014,84.0,88.0,172.0,94.7,91.35,100.45,104.8,6,4,2,0.667,5,3,2,0.6,2,2,2,1,193.0,200.8,196.9
2014-10-20,1610612739,1610612741,2014,107.0,98.0,205.0,101.9,101.55,94.0,91.0,5,4,1,0.8,6,4,2,0.667,3,1,3,1,195.48,185.44,190.45999999999998
2014-10-20,1610612751,1610612755,2014,99.0,88.0,187.0,96.7,98.4,97.85,106.0,4,3,1,0.75,6,2,4,0.333,2,1,2,0,196.96,207.68,202.32
2014-10-20,1610612752,1610612749,2014,107.0,120.0,227.0,101.2,97.2,99.8,108.15,4,2,2,0.5,5,2,3,0.4,0,2,1,1,200.28,200.48,200.38
2014-10-20,1610612737,1610612766,2014,117.0,114.0,231.0,96.35,95.7,99.45,97.7,5,2,3,0.4,6,3,3,0.5,1,1,2,1,199.44,194.96,197.2
2014-10-20,1610612742,1610612763,2014,108.0,103.0,211.0,104.45,102.7,98.25,97.5,5,2,3,0.4,5,2,3,0.4,1,1,2,0,213.0,193.96,203.48000000000002
2014-10-20,1610612759,1610612758,2014,106.0,99.0,205.0,107.75,96.55,97.75,101.5,4,1,3,0.25,5,2,3,0.4,0,1,2,0,204.12,207.08,205.60000000000002
2014-10-19,1610612751,1610612738,2014,90.0,95.0,185.0,96.7,98.4,99.65,105.5,3,3,0,1.0,6,3,3,0.5,2,1,2,1,196.96,195.08,196.02
2014-10-19,1610612760,1610612750,2014,94.0,112.0,206.0,101.8,103.4,110.05,111.2,5,2,3,0.4,3,1,2,0.333,1,1,1,0,210.36,209.4,209.88
2014-10-19,1610612741,1610612766,2014,101.0,96.0,197.0,94.0,91.0,99.45,97.7,5,3,2,0.6,5,3,2,0.6,2,1,2,1,185.44,194.96,190.2
2014-10-19,1610612745,1610612744,2014,90.0,83.0,173.0,112.7,109.85,107.5,105.85,4,3,1,0.75,5,4,1,0.8,2,1,1,3,216.24,199.04,207.64
2014-10-19,1610612747,1610612762,2014,98.0,91.0,189.0,107.3,114.65,95.55,106.55,4,1,3,0.25,5,4,1,0.8,1,0,2,2,219.28,200.2,209.74
2014-10-18,1610612754,1610612742,2014,98.0,93.0,191.0,92.05,92.25,104.45,102.7,4,1,3,0.25,4,2,2,0.5,1,0,1,1,187.28,213.0,200.14
2014-10-18,1610612755,1610612753,2014,95.0,84.0,179.0,97.85,106.0,96.55,103.5,5,1,4,0.2,5,4,1,0.8,1,0,2,2,207.68,203.64,205.66
2014-10-18,1610612737,1610612765,2014,100.0,104.0,204.0,96.35,95.7,100.85,105.95,4,2,2,0.5,5,3,2,0.6,1,1,2,1,199.44,206.0,202.72
2014-10-18,1610612759,1610612748,2014,108.0,111.0,219.0,107.75,96.55,97.25,95.5,3,1,2,0.333,5,1,4,0.2,0,1,1,0,204.12,195.0,199.56
2014-10-18,1610612746,1610612743,2014,93.0,104.0,197.0,109.85,106.5,109.2,110.3,4,1,3,0.25,5,1,4,0.2,1,0,1,0,214.36,217.04,215.7
2014-10-17,1610612764,1610612766,2014,86.0,96.0,182.0,94.7,91.35,99.45,97.7,5,4,1,0.8,4,2,2,0.5,2,2,2,0,193.0,194.96,193.98000000000002
2014-10-17,1610612753,1610612765,2014,99.0,87.0,186.0,96.55,103.5,100.85,105.95,4,3,1,0.75,4,3,1,0.75,1,2,2,1,203.64,206.0,204.82
2014-10-17,1610612739,1610612742,2014,102.0,108.0,210.0,101.9,101.55,104.45,102.7,4,4,0,1.0,3,1,2,0.333,3,1,1,0,195.48,213.0,204.24
2014-10-17,1610612750,1610612749,2014,98.0,105.0,203.0,110.05,111.2,99.8,108.15,2,1,1,0.5,4,1,3,0.25,1,0,1,0,209.4,200.48,204.94
2014-10-17,1610612760,1610612761,2014,90.0,109.0,199.0,101.8,103.4,100.6,99.2,4,2,2,0.5,5,4,1,0.8,1,1,2,2,210.36,206.0,208.18
2014-10-17,1610612748,1610612744,2014,115.0,108.0,223.0,97.25,95.5,107.5,105.85,4,0,4,0.0,4,4,0,1.0,0,0,1,3,195.0,199.04,197.01999999999998
2014-10-17,1610612746,1610612762,2014,101.0,97.0,198.0,109.85,106.5,95.55,106.55,3,0,3,0.0,4,4,0,1.0,0,0,2,2,214.36,200.2,207.28
2014-10-16,1610612755,1610612738,2014,91.0,111.0,202.0,97.85,106.0,99.65,105.5,4,1,3,0.25,5,2,3,0.4,1,0,2,0,207.68,195.08,201.38
2014-10-16,1610612741,1610612737,2014,85.0,84.0,169.0,94.0,91.0,96.35,95.7,4,2,2,0.5,3,2,1,0.667,1,1,1,1,185.44,199.44,192.44
2014-10-16,1610612740,1610612760,2014,120.0,86.0,206.0,100.45,104.8,101.8,103.4,4,2,2,0.5,3,2,1,0.667,1,1,1,1,200.8,210.36,205.58
2014-10-16,1610612744,1610612743,2014,104.0,101.0,205.0,107.5,105.85,109.2,110.3,3,3,0,1.0,4,1,3,0.25,0,3,1,0,199.04,217.04,208.04
2014-10-16,1610612756,1610612759,2014,121.0,90.0,211.0,106.25,103.85,107.75,96.55,3,2,1,0.667,2,1,1,0.5,2,0,0,1,212.88,204.12,208.5
2014-10-16,1610612747,1610612762,2014,86.0,119.0,205.0,107.3,114.65,95.55,106.55,3,1,2,0.333,3,3,0,1.0,1,0,2,1,219.28,200.2,209.74
2014-10-15,1610612751,1610612758,2014,129.0,117.0,246.0,96.7,98.4,97.75,101.5,2,2,0,1.0,3,1,2,0.333,1,1,1,0,196.96,207.08,202.02
2014-10-15,1610612766,1610612765,2014,84.0,104.0,188.0,99.45,97.7,100.85,105.95,3,2,1,0.667,3,2,1,0.667,2,0,2,0,194.96,206.0,200.48000000000002
2014-10-15,1610612739,1610612754,2014,98.0,93.0,191.0,101.9,101.55,92.05,92.25,3,3,0,1.0,3,1,2,0.333,2,1,1,0,195.48,187.28,191.38
2014-10-15,1610612738,1610612761,2014,89.0,92.0,181.0,99.65,105.5,100.6,99.2,4,2,2,0.5,4,3,1,0.75,2,0,2,1,195.08,206.0,200.54000000000002
2014-10-14,1610612755,1610612752,2014,77.0,84.0,161.0,97.85,106.0,101.2,97.2,3,1,2,0.333,3,1,2,0.333,1,0,0,1,207.68,200.28,203.98000000000002
2014-10-14,1610612739,1610612749,2014,106.0,100.0,206.0,101.9,101.55,99.8,108.15,2,2,0,1.0,3,1,2,0.333,1,1,1,0,195.48,200.48,197.98
2014-10-14,1610612748,1610612737,2014,103.0,109.0,212.0,97.25,95.5,96.35,95.7,3,0,3,0.0,2,1,1,0.5,0,0,1,0,195.0,199.44,197.22
2014-10-14,1610612740,1610612745,2014,117.0,98.0,215.0,100.45,104.8,112.7,109.85,3,1,2,0.333,3,3,0,1.0,0,1,2,1,200.8,216.24,208.52
2014-10-14,1610612760,1610612763,2014,117.0,107.0,224.0,101.8,103.4,98.25,97.5,2,1,1,0.5,3,1,2,0.333,0,1,1,0,210.36,193.96,202.16000000000003
2014-10-13,1610612766,1610612753,2014,99.0,97.0,196.0,99.45,97.7,96.55,103.5,2,1,1,0.5,2,2,0,1.0,1,0,0,2,194.96,203.64,199.3
2014-10-13,1610612752,1610612761,2014,76.0,81.0,157.0,101.2,97.2,100.6,99.2,2,1,1,0.5,3,2,1,0.667,0,1,2,0,200.28,206.0,203.14
2014-10-13,1610612741,1610612743,2014,110.0,90.0,200.0,94.0,91.0,109.2,110.3,3,1,2,0.333,3,1,2,0.333,0,1,1,0,185.44,217.04,201.24
2014-10-13,1610612745,1610612756,2014,95.0,92.0,187.0,112.7,109.85,106.25,103.85,2,2,0,1.0,2,2,0,1.0,1,1,2,0,216.24,212.88,214.56
2014-10-13,1610612762,1610612746,2014,102.0,89.0,191.0,95.55,106.55,109.85,106.5,2,2,0,1.0,2,0,2,0.0,1,1,0,0,200.2,214.36,207.28
2014-10-12,1610612758,1610612751,2014,95.0,97.0,192.0,97.75,101.5,96.7,98.4,2,1,1,0.5,1,1,0,1.0,1,0,1,0,207.08,196.96,202.02
2014-10-12,1610612764,1610612765,2014,91.0,89.0,180.0,94.7,91.35,100.85,105.95,3,2,1,0.667,2,2,0,1.0,0,2,2,0,193.0,206.0,199.5
2014-10-12,1610612742,1610612754,2014,106.0,98.0,204.0,104.45,102.7,92.05,92.25,2,0,2,0.0,2,1,1,0.5,0,0,1,0,213.0,187.28,200.14
2014-10-12,1610612757,1610612746,2014,119.0,114.0,233.0,104.75,105.45,109.85,106.5,2,0,2,0.0,1,0,1,0.0,0,0,0,0,209.44,214.36,211.9
2014-10-12,1610612747,1610612744,2014,75.0,116.0,191.0,107.3,114.65,107.5,105.85,2,1,1,0.5,2,2,0,1.0,1,0,0,2,219.28,199.04,209.16
2014-10-11,1610612748,1610612739,2014,119.0,122.0,241.0,97.25,95.5,101.9,101.55,2,0,2,0.0,1,1,0,1.0,0,0,1,0,195.0,195.48,195.24
2014-10-11,1610612738,1610612752,2014,80.0,96.0,176.0,99.65,105.5,101.2,97.2,3,2,1,0.667,1,0,1,0.0,2,0,0,0,195.08,200.28,197.68
2014-10-11,1610612763,1610612737,2014,93.0,88.0,181.0,98.25,97.5,96.35,95.7,2,0,2,0.0,1,1,0,1.0,0,0,1,0,193.96,199.44,196.7
2014-10-11,1610612749,1610612741,2014,85.0,91.0,176.0,99.8,108.15,94.0,91.0,2,1,1,0.5,2,0,2,0.0,1,0,0,0,200.48,185.44,192.95999999999998
2014-10-10,1610612766,1610612764,2014,99.0,86.0,185.0,99.45,97.7,94.7,91.35,1,0,1,0.0,2,2,0,1.0,0,0,0,2,194.96,193.0,193.98000000000002
2014-10-10,1610612754,1610612753,2014,93.0,96.0,189.0,92.05,92.25,96.55,103.5,1,1,0,1.0,1,1,0,1.0,1,0,0,1,187.28,203.64,195.45999999999998
2014-10-10,1610612761,1610612738,2014,116.0,109.0,225.0,100.6,99.2,99.65,105.5,2,1,1,0.5,2,2,0,1.0,1,0,2,0,206.0,195.08,200.54000000000002
2014-10-10,1610612750,1610612755,2014,116.0,110.0,226.0,110.05,111.2,97.85,106.0,1,0,1,0.0,2,1,1,0.5,0,0,1,0,209.4,207.68,208.54000000000002
2014-10-10,1610612742,1610612760,2014,109.0,118.0,227.0,104.45,102.7,101.8,103.4,1,0,1,0.0,1,0,1,0.0,0,0,0,0,213.0,210.36,211.68
2014-10-10,1610612756,1610612743,2014,97.0,89.0,186.0,106.25,103.85,109.2,110.3,1,1,0,1.0,2,1,1,0.5,1,0,1,0,212.88,217.04,214.95999999999998
2014-10-09,1610612765,1610612749,2014,94.0,80.0,174.0,100.85,105.95,99.8,108.15,1,1,0,1.0,1,1,0,1.0,1,0,1,0,206.0,200.48,203.24
2014-10-09,1610612745,1610612763,2014,113.0,93.0,206.0,112.7,109.85,98.25,97.5,1,1,0,1.0,1,0,1,0.0,0,1,0,0,216.24,193.96,205.10000000000002
2014-10-09,1610612757,1610612762,2014,105.0,109.0,214.0,104.75,105.45,95.55,106.55,1,0,1,0.0,1,1,0,1.0,0,0,1,0,209.44,200.2,204.82
2014-10-09,1610612747,1610612744,2014,105.0,120.0,225.0,107.3,114.65,107.5,105.85,1,1,0,1.0,1,1,0,1.0,1,0,0,1,219.28,199.04,209.16
2014-10-08,1610612755,1610612766,2014,106.0,92.0,198.0,97.85,106.0,99.45,97.7,1,0,1,0.0,0,0,0,0.0,0,0,0,0,207.68,194.96,201.32
2014-10-08,1610612740,1610612764,2014,89.0,94.0,183.0,100.45,104.8,94.7,91.35,2,1,1,0.5,1,1,0,1.0,0,1,0,1,200.8,193.0,196.9
2014-10-08,1610612738,1610612752,2014,106.0,86.0,192.0,99.65,105.5,101.2,97.2,1,1,0,1.0,0,0,0,0.0,1,0,0,0,195.08,200.28,197.68
2014-10-08,1610612749,1610612763,2014,86.0,83.0,169.0,99.8,108.15,98.25,97.5,0,0,0,0.0,0,0,0,0.0,0,0,0,0,200.48,193.96,197.22
2014-10-08,1610612743,1610612760,2014,114.0,101.0,215.0,109.2,110.3,101.8,103.4,1,0,1,0.0,0,0,0,0.0,0,0,0,0,217.04,210.36,213.7
2014-10-07,1610612754,1610612750,2014,103.0,90.0,193.0,92.05,92.25,110.05,111.2,0,0,0,0.0,0,0,0,0.0,0,0,0,0,187.28,209.4,198.34
2014-10-07,1610612748,1610612753,2014,101.0,108.0,209.0,97.25,95.5,96.55,103.5,1,0,1,0.0,0,0,0,0.0,0,0,0,0,195.0,203.64,199.32
2014-10-07,1610612765,1610612741,2014,111.0,109.0,220.0,100.85,105.95,94.0,91.0,0,0,0,0.0,1,0,1,0.0,0,0,0,0,206.0,185.44,195.72
2014-10-07,1610612742,1610612745,2014,108.0,111.0,219.0,104.45,102.7,112.7,109.85,0,0,0,0.0,0,0,0,0.0,0,0,0,0,213.0,216.24,214.62
2014-10-07,1610612762,1610612757,2014,92.0,73.0,165.0,95.55,106.55,104.75,105.45,0,0,0,0.0,0,0,0,0.0,0,0,0,0,200.2,209.44,204.82
2014-10-07,1610612758,1610612761,2014,113.0,106.0,219.0,97.75,101.5,100.6,99.2,1,0,1,0.0,1,1,0,1.0,0,0,1,0,207.08,206.0,206.54000000000002
2014-10-07,1610612746,1610612744,2014,94.0,112.0,206.0,109.85,106.5,107.5,105.85,0,0,0,0.0,0,0,0,0.0,0,0,0,0,214.36,199.04,206.7
2014-10-06,1610612738,1610612755,2014,98.0,78.0,176.0,99.65,105.5,97.85,106.0,0,0,0,0.0,0,0,0,0.0,0,0,0,0,195.08,207.68,201.38
2014-10-06,1610612737,1610612740,2014,93.0,87.0,180.0,96.35,95.7,100.45,104.8,0,0,0,0.0,1,1,0,1.0,0,0,0,1,199.44,200.8,200.12
2014-10-06,1610612741,1610612764,2014,81.0,85.0,166.0,94.0,91.0,94.7,91.35,0,0,0,0.0,0,0,0,0.0,0,0,0,0,185.44,193.0,189.22
2014-10-06,1610612747,1610612743,2014,98.0,95.0,193.0,107.3,114.65,109.2,110.3,0,0,0,0.0,0,0,0,0.0,0,0,0,0,219.28,217.04,218.16
2014-10-05,1610612761,1610612758,2014,99.0,94.0,193.0,100.6,99.2,97.75,101.5,0,0,0,0.0,0,0,0,0.0,0,0,0,0,206.0,207.08,206.54000000000002
2014-10-04,1610612748,1610612740,2014,86.0,98.0,184.0,97.25,95.5,100.45,104.8,0,0,0,0.0,0,0,0,0.0,0,0,0,0,195.0,200.8,197.9
