GAME_DATE_EST,HOME_TEAM_ID,VISITOR_TEAM_ID,SEASON,PTS_home,PTS_away,point_total,point_average_last10,point_againts_average_last10,away_point_average_last10,away_point_againts_average_last10,cgp,wins,losses,winpercent,cgp_away,wins_away,losses_away,winpercen_away,hometeam-homewins,hometeam-awaywins,awayteam-homewins,awayteam-awaywins
2020-03-01,1610612766,1610612749,2019,85.0,93.0,178.0,98.55000000000001,108.05000000000001,122.2,107.5,59,21,38,0.35600000000000004,59,51,8,0.8640000000000001,9,12,27,24
2020-03-01,1610612750,1610612742,2019,91.0,111.0,202.0,116.1,123.15,115.45,112.9,58,17,41,0.293,60,36,24,0.6,7,10,16,20
2020-03-01,1610612746,1610612755,2019,136.0,130.0,266.0,116.65,109.3,107.55,107.9,59,40,19,0.6779999999999999,60,37,23,0.617,24,16,28,9
2020-03-01,1610612743,1610612761,2019,133.0,118.0,251.0,112.35,109.5,115.95,107.4,59,40,19,0.6779999999999999,59,42,17,0.7120000000000001,23,17,23,19
2020-03-01,1610612758,1610612765,2019,106.0,100.0,206.0,112.65,112.55,106.85,110.05,59,25,34,0.424,61,20,41,0.32799999999999996,12,13,11,9
2020-03-01,1610612740,1610612747,2019,114.0,122.0,236.0,120.8,117.30000000000001,116.19999999999999,109.4,59,26,33,0.441,58,45,13,0.7759999999999999,12,14,21,24
2020-03-01,1610612744,1610612764,2019,110.0,124.0,234.0,108.0,118.3,116.3,120.55,60,13,47,0.217,58,21,37,0.36200000000000004,7,6,14,7
2020-02-29,1610612752,1610612741,2019,125.0,115.0,240.0,105.4,110.2,108.5,113.5,59,17,42,0.28800000000000003,59,20,39,0.33899999999999997,8,9,12,8
2020-02-29,1610612737,1610612757,2019,129.0,117.0,246.0,118.15,122.4,115.4,118.05,61,18,43,0.295,60,26,34,0.433,12,6,16,10
2020-02-29,1610612748,1610612751,2019,116.0,113.0,229.0,114.75,112.3,112.3,111.4,59,37,22,0.627,58,26,32,0.44799999999999995,24,13,16,10
2020-02-29,1610612739,1610612754,2019,104.0,113.0,217.0,110.69999999999999,117.5,109.4,108.85,59,17,42,0.28800000000000003,59,35,24,0.593,9,8,21,14
2020-02-29,1610612763,1610612747,2019,105.0,88.0,193.0,113.4,112.75,118.05,109.65,59,28,31,0.475,57,45,12,0.789,16,12,21,24
2020-02-29,1610612738,1610612745,2019,110.0,111.0,221.0,116.7,109.25,117.65,114.7,58,41,17,0.7070000000000001,58,38,20,0.655,23,18,21,17
2020-02-29,1610612759,1610612753,2019,114.0,113.0,227.0,111.4,113.0,108.80000000000001,111.35,57,24,33,0.42100000000000004,59,27,32,0.45799999999999996,14,10,16,11
2020-02-29,1610612756,1610612744,2019,99.0,115.0,214.0,108.1,109.85,107.15,118.9,60,24,36,0.4,59,12,47,0.203,11,13,7,5
2020-02-28,1610612753,1610612750,2019,136.0,125.0,261.0,107.05000000000001,109.55000000000001,115.45,122.30000000000001,58,26,32,0.44799999999999995,57,17,40,0.298,15,11,7,10
2020-02-28,1610612737,1610612751,2019,141.0,118.0,259.0,116.25,123.30000000000001,110.85,109.4,60,17,43,0.28300000000000003,57,26,31,0.456,11,6,16,10
2020-02-28,1610612761,1610612766,2019,96.0,99.0,195.0,118.15,108.0,98.2,108.25,58,42,16,0.7240000000000001,58,20,38,0.345,23,19,9,11
2020-02-28,1610612748,1610612742,2019,126.0,118.0,244.0,114.55,111.94999999999999,116.2,112.85,58,36,22,0.621,59,36,23,0.61,23,13,16,20
2020-02-28,1610612763,1610612758,2019,101.0,104.0,205.0,114.3,113.15,113.1,113.4,58,28,30,0.483,58,24,34,0.414,16,12,12,12
2020-02-28,1610612749,1610612760,2019,133.0,86.0,219.0,121.9,109.1,115.5,108.25,58,50,8,0.862,59,37,22,0.627,26,24,20,17
2020-02-28,1610612740,1610612739,2019,116.0,104.0,220.0,121.15,117.5,111.25,117.3,58,25,33,0.431,58,17,41,0.293,11,14,9,8
2020-02-28,1610612756,1610612765,2019,111.0,113.0,224.0,107.7,109.9,106.95,110.15,59,24,35,0.40700000000000003,60,19,41,0.317,11,13,11,8
2020-02-28,1610612762,1610612764,2019,129.0,119.0,248.0,115.05,114.2,115.44999999999999,120.69999999999999,58,36,22,0.621,57,21,36,0.368,20,16,14,7
2020-02-28,1610612746,1610612743,2019,132.0,103.0,235.0,116.8,110.75,113.9,109.44999999999999,58,39,19,0.672,58,40,18,0.69,23,16,23,17
2020-02-27,1610612755,1610612752,2019,115.0,106.0,221.0,107.25,107.5,105.3,110.85,59,36,23,0.61,58,17,41,0.293,27,9,8,9
2020-02-27,1610612754,1610612757,2019,106.0,100.0,206.0,109.15,108.6,115.45,117.69999999999999,58,34,24,0.586,59,26,33,0.441,20,14,16,10
2020-02-27,1610612760,1610612758,2019,112.0,108.0,220.0,115.30000000000001,108.6,112.75,113.94999999999999,58,36,22,0.621,57,24,33,0.42100000000000004,19,17,12,12
2020-02-27,1610612744,1610612747,2019,86.0,116.0,202.0,107.7,119.3,118.69999999999999,111.05,58,12,46,0.207,56,44,12,0.7859999999999999,7,5,21,23
2020-02-26,1610612766,1610612752,2019,107.0,101.0,208.0,97.95,108.4,104.6,111.35,57,19,38,0.33299999999999996,57,17,40,0.298,8,11,8,9
2020-02-26,1610612739,1610612755,2019,108.0,94.0,202.0,110.15,117.9,107.1,107.55,57,16,41,0.281,58,36,22,0.621,8,8,27,9
2020-02-26,1610612764,1610612751,2019,110.0,106.0,216.0,115.75,121.75,111.1,110.05000000000001,56,20,36,0.35700000000000004,56,26,30,0.46399999999999997,13,7,16,10
2020-02-26,1610612737,1610612753,2019,120.0,130.0,250.0,116.4,122.30000000000001,106.25,109.15,59,17,42,0.28800000000000003,57,25,32,0.439,11,6,15,10
2020-02-26,1610612748,1610612750,2019,126.0,129.0,255.0,112.44999999999999,109.3,114.9,121.15,57,36,21,0.632,56,16,40,0.28600000000000003,23,13,7,9
2020-02-26,1610612745,1610612763,2019,140.0,112.0,252.0,116.0,114.95,113.45,112.1,57,37,20,0.649,57,28,29,0.491,20,17,16,12
2020-02-26,1610612759,1610612742,2019,103.0,109.0,212.0,113.05,113.0,117.1,113.85,56,24,32,0.429,58,35,23,0.603,14,10,16,19
2020-02-26,1610612756,1610612746,2019,92.0,102.0,194.0,108.80000000000001,110.85,116.9,111.85,58,24,34,0.414,57,38,19,0.667,11,13,23,15
2020-02-26,1610612762,1610612738,2019,103.0,114.0,217.0,116.05,113.55000000000001,117.15,110.5,57,36,21,0.632,57,40,17,0.7020000000000001,20,16,23,17
2020-02-25,1610612754,1610612766,2019,119.0,80.0,199.0,108.6,110.7,98.55000000000001,107.9,57,33,24,0.579,56,19,37,0.33899999999999997,19,14,8,11
2020-02-25,1610612761,1610612749,2019,97.0,108.0,205.0,118.5,107.85,121.85,109.15,57,42,15,0.737,57,49,8,0.86,23,19,26,23
2020-02-25,1610612741,1610612760,2019,122.0,124.0,246.0,107.65,113.1,115.15,107.8,58,20,38,0.345,57,35,22,0.614,12,8,19,16
2020-02-25,1610612743,1610612765,2019,115.0,98.0,213.0,113.3,110.1,107.0,109.69999999999999,57,39,18,0.684,59,19,40,0.322,22,17,11,8
2020-02-25,1610612747,1610612740,2019,118.0,109.0,227.0,118.1,110.55,121.85,117.15,55,43,12,0.782,57,25,32,0.439,20,23,11,14
2020-02-25,1610612757,1610612738,2019,106.0,118.0,224.0,115.9,117.4,116.15,110.65,58,26,32,0.44799999999999995,56,39,17,0.696,16,10,23,16
2020-02-25,1610612744,1610612758,2019,94.0,112.0,206.0,107.9,119.05,112.85,114.4,57,12,45,0.21100000000000002,56,23,33,0.41100000000000003,7,5,12,11
2020-02-24,1610612739,1610612748,2019,125.0,119.0,244.0,109.55000000000001,117.69999999999999,112.55,109.25,56,15,41,0.268,56,36,20,0.643,7,8,23,13
2020-02-24,1610612755,1610612737,2019,129.0,112.0,241.0,106.65,107.6,115.85,121.4,57,35,22,0.614,58,17,41,0.293,26,9,11,6
2020-02-24,1610612764,1610612749,2019,134.0,137.0,271.0,114.6,119.94999999999999,120.19999999999999,108.75,55,20,35,0.364,56,48,8,0.857,13,7,26,22
2020-02-24,1610612751,1610612753,2019,113.0,115.0,228.0,110.85,108.6,105.2,108.4,55,26,29,0.473,56,24,32,0.429,16,10,15,9
2020-02-24,1610612745,1610612752,2019,123.0,112.0,235.0,116.8,114.8,105.6,111.95,56,36,20,0.643,56,17,39,0.304,19,17,8,9
2020-02-24,1610612742,1610612750,2019,139.0,123.0,262.0,115.45,113.05000000000001,113.95,119.5,57,34,23,0.596,55,16,39,0.29100000000000004,15,19,7,9
2020-02-24,1610612762,1610612756,2019,111.0,131.0,242.0,115.94999999999999,111.6,108.4,111.25,56,36,20,0.643,57,23,34,0.40399999999999997,20,16,11,12
2020-02-24,1610612746,1610612763,2019,124.0,97.0,221.0,116.4,114.0,114.65,111.6,56,37,19,0.6609999999999999,56,28,28,0.5,22,15,16,12
2020-02-23,1610612747,1610612738,2019,114.0,112.0,226.0,118.55,110.6,115.25,109.9,54,42,12,0.778,55,39,16,0.7090000000000001,19,23,23,16
2020-02-23,1610612761,1610612754,2019,127.0,81.0,208.0,117.1,108.85,110.30000000000001,109.55000000000001,56,41,15,0.732,56,33,23,0.589,22,19,19,14
2020-02-23,1610612743,1610612750,2019,128.0,116.0,244.0,112.9,110.05,113.4,118.30000000000001,56,38,18,0.679,54,16,38,0.29600000000000004,21,17,7,9
2020-02-23,1610612741,1610612764,2019,126.0,117.0,243.0,106.55,112.8,114.8,119.4,57,19,38,0.33299999999999996,54,20,34,0.37,11,8,13,7
2020-02-23,1610612760,1610612759,2019,131.0,103.0,234.0,114.65,109.15,113.9,112.35,56,34,22,0.607,55,24,31,0.436,18,16,14,10
2020-02-23,1610612744,1610612740,2019,101.0,115.0,216.0,108.05000000000001,118.85,121.95,117.85,56,12,44,0.214,56,24,32,0.429,7,5,11,13
2020-02-23,1610612757,1610612765,2019,107.0,104.0,211.0,115.6,118.3,107.35,109.55,57,25,32,0.439,58,19,39,0.32799999999999996,15,10,11,8
2020-02-22,1610612746,1610612758,2019,103.0,112.0,215.0,117.55,114.0,113.0,115.25,55,37,18,0.6729999999999999,55,22,33,0.4,22,15,12,10
2020-02-22,1610612766,1610612751,2019,86.0,115.0,201.0,99.6,107.85,110.85,110.4,55,19,36,0.345,54,25,29,0.46299999999999997,8,11,16,9
2020-02-22,1610612737,1610612742,2019,111.0,107.0,218.0,116.05,122.15,116.30000000000001,112.35,57,16,41,0.281,56,34,22,0.607,10,6,15,19
2020-02-22,1610612748,1610612739,2019,124.0,105.0,229.0,112.2,109.80000000000001,109.15,117.35,55,35,20,0.636,55,15,40,0.273,22,13,7,8
2020-02-22,1610612741,1610612756,2019,104.0,112.0,216.0,106.25,112.3,108.85,110.94999999999999,56,19,37,0.33899999999999997,56,22,34,0.39299999999999996,11,8,11,11
2020-02-22,1610612749,1610612755,2019,119.0,98.0,217.0,119.55,109.05,107.15,107.55,55,47,8,0.855,56,35,21,0.625,25,22,26,9
2020-02-22,1610612762,1610612745,2019,110.0,120.0,230.0,116.85,110.80000000000001,116.9,115.05,55,36,19,0.655,55,35,20,0.636,20,16,19,16
2020-02-21,1610612753,1610612742,2019,106.0,122.0,228.0,104.7,107.75,115.25,112.35,55,24,31,0.436,55,33,22,0.6,15,9,15,18
2020-02-21,1610612764,1610612739,2019,108.0,113.0,221.0,114.35,118.45,108.2,116.35,53,20,33,0.377,54,14,40,0.259,13,7,7,7
2020-02-21,1610612752,1610612754,2019,98.0,106.0,204.0,106.25,112.80000000000001,110.55000000000001,110.45,55,17,38,0.309,55,32,23,0.5820000000000001,8,9,19,13
2020-02-21,1610612761,1610612756,2019,118.0,101.0,219.0,117.05,108.65,109.30000000000001,111.19999999999999,55,40,15,0.727,55,22,33,0.4,21,19,11,11
2020-02-21,1610612750,1610612738,2019,117.0,127.0,244.0,112.75,117.80000000000001,114.45,109.25,53,16,37,0.302,54,38,16,0.7040000000000001,7,9,23,15
2020-02-21,1610612760,1610612743,2019,113.0,101.0,214.0,114.5,110.35,113.2,109.7,55,33,22,0.6,55,38,17,0.691,17,16,21,17
2020-02-21,1610612762,1610612759,2019,104.0,113.0,217.0,116.85,109.2,113.25,112.44999999999999,54,36,18,0.667,54,23,31,0.426,20,16,14,9
2020-02-21,1610612747,1610612763,2019,117.0,105.0,222.0,118.55,110.7,116.4,111.44999999999999,53,41,12,0.774,55,28,27,0.509,18,23,16,12
2020-02-21,1610612757,1610612740,2019,115.0,128.0,243.0,115.65,118.0,121.2,118.25,56,25,31,0.446,55,23,32,0.418,15,10,11,12
2020-02-20,1610612765,1610612749,2019,106.0,126.0,232.0,107.55000000000001,109.1,119.4,108.85,57,19,38,0.33299999999999996,54,46,8,0.852,11,8,25,21
2020-02-20,1610612737,1610612748,2019,129.0,124.0,253.0,115.35,122.1,111.65,109.2,56,15,41,0.268,54,35,19,0.648,9,6,22,13
2020-02-20,1610612755,1610612751,2019,112.0,104.0,216.0,107.6,107.8,110.55,110.2,55,34,21,0.618,53,25,28,0.47200000000000003,25,9,16,9
2020-02-20,1610612741,1610612766,2019,93.0,103.0,196.0,106.7,113.3,100.6,109.19999999999999,55,19,36,0.345,54,18,36,0.33299999999999996,11,8,8,10
2020-02-20,1610612758,1610612763,2019,129.0,125.0,254.0,112.3,114.85,116.3,111.4,54,21,33,0.389,54,28,26,0.519,11,10,16,12
2020-02-20,1610612744,1610612745,2019,105.0,135.0,240.0,108.85,119.15,115.75,116.15,55,12,43,0.218,54,34,20,0.63,7,5,19,15
2020-02-13,1610612738,1610612746,2019,141.0,133.0,274.0,114.4,107.85,116.15,111.3,53,37,16,0.698,54,37,17,0.685,22,15,22,15
2020-02-13,1610612740,1610612760,2019,118.0,123.0,241.0,121.6,118.5,113.80000000000001,109.6,54,23,31,0.426,54,32,22,0.593,11,12,17,15
2020-02-12,1610612739,1610612737,2019,127.0,105.0,232.0,107.0,117.0,115.4,121.19999999999999,53,13,40,0.245,55,15,40,0.273,6,7,9,6
2020-02-12,1610612753,1610612765,2019,116.0,112.0,228.0,104.15,106.4,107.55000000000001,109.6,54,23,31,0.426,56,19,37,0.33899999999999997,14,9,11,8
2020-02-12,1610612751,1610612761,2019,101.0,91.0,192.0,111.35,111.30000000000001,118.55,108.7,52,24,28,0.462,54,40,14,0.741,15,9,21,19
2020-02-12,1610612754,1610612749,2019,118.0,111.0,229.0,110.45,111.1,119.45,107.25,54,31,23,0.574,53,46,7,0.868,18,13,25,21
2020-02-12,1610612752,1610612764,2019,96.0,114.0,210.0,107.30000000000001,111.75,114.05000000000001,119.9,54,17,37,0.315,52,19,33,0.365,8,9,13,6
2020-02-12,1610612763,1610612757,2019,111.0,104.0,215.0,116.6,111.4,116.0,118.55000000000001,53,27,26,0.509,55,25,30,0.455,15,12,15,10
2020-02-12,1610612750,1610612766,2019,108.0,115.0,223.0,113.15,117.15,100.3,109.1,52,16,36,0.308,53,17,36,0.321,7,9,8,9
2020-02-12,1610612742,1610612758,2019,130.0,111.0,241.0,114.65,112.3,112.5,114.3,54,32,22,0.593,53,21,32,0.396,14,18,11,10
2020-02-12,1610612756,1610612744,2019,112.0,106.0,218.0,109.7,111.5,107.75,118.5,54,21,33,0.389,54,12,42,0.222,10,11,7,5
2020-02-12,1610612762,1610612748,2019,116.0,101.0,217.0,117.1,109.9,112.7,108.80000000000001,53,35,18,0.66,53,35,18,0.66,19,16,22,13
2020-02-12,1610612743,1610612747,2019,116.0,120.0,236.0,113.35,109.2,118.94999999999999,110.9,54,38,16,0.7040000000000001,52,40,12,0.769,21,17,18,22
2020-02-11,1610612755,1610612746,2019,110.0,103.0,213.0,108.35,108.05,116.55,111.1,54,33,21,0.611,53,37,16,0.698,24,9,22,15
2020-02-11,1610612764,1610612741,2019,126.0,114.0,240.0,114.15,119.9,106.4,113.15,51,18,33,0.353,54,19,35,0.35200000000000004,12,6,11,8
2020-02-11,1610612740,1610612757,2019,138.0,117.0,255.0,121.05000000000001,118.25,116.25,116.80000000000001,53,22,31,0.415,54,25,29,0.46299999999999997,10,12,15,10
2020-02-11,1610612760,1610612759,2019,106.0,114.0,220.0,114.15,108.5,112.8,112.35,53,32,21,0.604,53,22,31,0.415,17,15,14,8
2020-02-11,1610612745,1610612738,2019,116.0,105.0,221.0,115.85,116.30000000000001,114.6,106.65,53,33,20,0.623,52,37,15,0.7120000000000001,18,15,22,15
2020-02-10,1610612765,1610612766,2019,76.0,87.0,163.0,108.7,110.65,101.15,111.15,55,19,36,0.345,52,16,36,0.308,11,8,8,8
2020-02-10,1610612754,1610612751,2019,105.0,106.0,211.0,110.95,110.65,111.30000000000001,111.95,53,31,22,0.585,51,23,28,0.451,18,13,15,8
2020-02-10,1610612753,1610612737,2019,135.0,126.0,261.0,102.05,105.15,114.15,119.1,53,22,31,0.415,54,15,39,0.278,13,9,9,6
2020-02-10,1610612761,1610612750,2019,137.0,126.0,263.0,116.55,107.30000000000001,112.05,115.94999999999999,53,39,14,0.736,51,16,35,0.314,20,19,7,9
2020-02-10,1610612749,1610612758,2019,123.0,111.0,234.0,118.85,106.7,112.2,114.1,52,45,7,0.865,52,21,31,0.40399999999999997,24,21,11,10
2020-02-10,1610612742,1610612762,2019,119.0,123.0,242.0,114.69999999999999,112.3,116.4,108.75,53,32,21,0.604,52,34,18,0.654,14,18,19,15
2020-02-10,1610612743,1610612759,2019,127.0,120.0,247.0,112.0,108.80000000000001,112.85,112.69999999999999,53,37,16,0.698,52,22,30,0.423,20,17,14,8
2020-02-10,1610612744,1610612748,2019,101.0,113.0,214.0,107.95,117.65,111.30000000000001,109.0,53,12,41,0.226,52,34,18,0.654,7,5,22,12
2020-02-10,1610612747,1610612756,2019,125.0,100.0,225.0,118.1,110.65,110.05000000000001,111.1,51,39,12,0.765,53,21,32,0.396,17,22,10,11
2020-02-09,1610612760,1610612738,2019,111.0,112.0,223.0,113.9,107.94999999999999,114.9,106.19999999999999,52,32,20,0.615,51,36,15,0.706,17,15,22,14
2020-02-09,1610612737,1610612752,2019,140.0,135.0,275.0,112.95,117.9,106.15,110.75,53,14,39,0.264,53,17,36,0.321,8,6,8,9
2020-02-09,1610612755,1610612741,2019,118.0,111.0,229.0,107.35,108.35,106.35,113.15,53,32,21,0.604,53,19,34,0.358,23,9,11,8
2020-02-09,1610612764,1610612763,2019,99.0,106.0,205.0,114.35,120.7,116.8,112.4,50,18,32,0.36,52,26,26,0.5,12,6,15,11
2020-02-09,1610612745,1610612762,2019,113.0,114.0,227.0,116.7,115.80000000000001,115.80000000000001,108.0,52,33,19,0.635,51,33,18,0.647,18,15,19,14
2020-02-09,1610612739,1610612746,2019,92.0,133.0,225.0,107.7,116.4,115.5,112.4,52,13,39,0.25,52,36,16,0.6920000000000001,6,7,22,14
2020-02-09,1610612757,1610612748,2019,115.0,109.0,224.0,116.5,117.75,111.1,109.4,53,24,29,0.45299999999999996,51,34,17,0.667,14,10,22,12
2020-02-08,1610612753,1610612749,2019,95.0,111.0,206.0,102.2,104.44999999999999,118.75,108.0,52,22,30,0.423,51,44,7,0.863,13,9,24,20
2020-02-08,1610612766,1610612742,2019,100.0,116.0,216.0,101.65,110.45,113.65,112.69999999999999,51,16,35,0.314,52,31,21,0.596,8,8,14,17
2020-02-08,1610612765,1610612752,2019,92.0,95.0,187.0,109.7,111.65,106.75,111.15,54,19,35,0.35200000000000004,52,16,36,0.308,11,8,8,8
2020-02-08,1610612754,1610612740,2019,117.0,124.0,241.0,111.1,110.2,120.45,117.4,52,31,21,0.596,52,21,31,0.40399999999999997,18,13,10,11
2020-02-08,1610612761,1610612751,2019,119.0,118.0,237.0,115.7,107.30000000000001,110.80000000000001,111.05000000000001,52,38,14,0.731,50,23,27,0.46,19,19,15,8
2020-02-08,1610612750,1610612746,2019,142.0,115.0,257.0,109.9,114.4,116.44999999999999,110.75,50,15,35,0.3,51,36,15,0.706,6,9,22,14
2020-02-08,1610612744,1610612747,2019,120.0,125.0,245.0,107.75,116.6,117.05,110.2,52,12,40,0.231,50,38,12,0.76,7,5,17,21
2020-02-08,1610612756,1610612743,2019,108.0,117.0,225.0,110.2,110.9,112.3,109.15,52,21,31,0.40399999999999997,52,36,16,0.6920000000000001,10,11,20,16
2020-02-08,1610612758,1610612759,2019,122.0,102.0,224.0,112.5,115.15,114.2,112.3,51,20,31,0.392,51,22,29,0.431,10,10,14,8
2020-02-07,1610612755,1610612763,2019,119.0,107.0,226.0,106.6,108.4,116.94999999999999,111.3,52,31,21,0.596,51,26,25,0.51,22,9,15,11
2020-02-07,1610612764,1610612742,2019,119.0,118.0,237.0,113.45,120.9,114.8,112.8,49,17,32,0.34700000000000003,51,31,20,0.608,11,6,14,17
2020-02-07,1610612738,1610612737,2019,112.0,107.0,219.0,115.0,107.3,111.65,118.1,50,35,15,0.7,52,14,38,0.26899999999999996,21,14,8,6
2020-02-07,1610612754,1610612761,2019,106.0,115.0,221.0,111.75,109.7,113.75,106.2,51,31,20,0.608,51,37,14,0.725,18,13,19,18
2020-02-07,1610612760,1610612765,2019,108.0,101.0,209.0,113.35,108.4,108.7,111.44999999999999,51,31,20,0.608,53,19,34,0.358,16,15,11,8
2020-02-07,1610612756,1610612745,2019,127.0,91.0,218.0,110.1,113.3,117.35,115.25,51,20,31,0.392,51,33,18,0.647,9,11,18,15
2020-02-07,1610612758,1610612748,2019,105.0,97.0,202.0,111.6,115.55000000000001,111.65,109.35,50,19,31,0.38,50,34,16,0.68,9,10,22,12
2020-02-07,1610612762,1610612757,2019,117.0,114.0,231.0,115.4,107.4,115.45,117.75,50,32,18,0.64,52,24,28,0.462,18,14,14,10
2020-02-06,1610612752,1610612753,2019,105.0,103.0,208.0,107.25,112.05,103.15,104.25,51,15,36,0.294,51,22,29,0.431,7,8,13,9
2020-02-06,1610612741,1610612740,2019,119.0,125.0,244.0,106.19999999999999,110.95,119.30000000000001,116.15,52,19,33,0.365,51,20,31,0.392,11,8,10,10
2020-02-06,1610612749,1610612755,2019,112.0,101.0,213.0,119.0,107.4,106.4,108.55,50,43,7,0.86,51,31,20,0.608,23,20,22,9
2020-02-06,1610612757,1610612759,2019,125.0,117.0,242.0,113.9,117.0,114.25,112.4,51,23,28,0.451,50,22,28,0.44,13,10,14,8
2020-02-06,1610612747,1610612745,2019,111.0,121.0,232.0,116.8,109.7,116.95,114.9,49,38,11,0.7759999999999999,50,32,18,0.64,17,21,18,14
2020-02-05,1610612765,1610612756,2019,116.0,108.0,224.0,109.5,111.15,110.8,113.3,52,18,34,0.34600000000000003,50,20,30,0.4,10,8,9,11
2020-02-05,1610612738,1610612753,2019,116.0,100.0,216.0,114.65,107.6,103.15,104.0,49,34,15,0.6940000000000001,50,22,28,0.44,20,14,13,9
2020-02-05,1610612751,1610612744,2019,129.0,88.0,217.0,109.5,112.2,109.0,116.0,49,22,27,0.449,51,12,39,0.235,14,8,7,5
2020-02-05,1610612761,1610612754,2019,119.0,118.0,237.0,113.3,105.65,110.75,109.75,50,36,14,0.72,50,31,19,0.62,18,18,18,13
2020-02-05,1610612750,1610612737,2019,120.0,127.0,247.0,110.0,113.8,111.2,118.15,49,15,34,0.306,51,13,38,0.255,6,9,8,5
2020-02-05,1610612760,1610612739,2019,109.0,103.0,212.0,113.80000000000001,108.85,108.4,117.4,50,30,20,0.6,51,13,38,0.255,15,15,6,7
2020-02-05,1610612742,1610612763,2019,107.0,121.0,228.0,115.6,112.3,116.25,111.65,50,31,19,0.62,50,25,25,0.5,14,17,15,10
2020-02-05,1610612762,1610612743,2019,95.0,98.0,193.0,116.35,107.80000000000001,113.1,110.80000000000001,49,32,17,0.653,51,35,16,0.6859999999999999,18,14,20,15
2020-02-05,1610612746,1610612748,2019,128.0,111.0,239.0,115.4,111.2,111.65,108.85,50,35,15,0.7,49,34,15,0.6940000000000001,21,14,22,12
2020-02-04,1610612740,1610612749,2019,108.0,120.0,228.0,119.9,115.05000000000001,119.15,107.1,50,20,30,0.4,49,42,7,0.857,10,10,23,19
2020-02-04,1610612745,1610612766,2019,125.0,110.0,235.0,116.1,114.30000000000001,100.8,110.15,49,31,18,0.633,50,16,34,0.32,17,14,8,8
2020-02-04,1610612743,1610612757,2019,127.0,99.0,226.0,112.2,110.85,114.69999999999999,116.69999999999999,50,34,16,0.68,50,23,27,0.46,19,15,13,10
2020-02-04,1610612747,1610612759,2019,129.0,102.0,231.0,115.55,111.0,114.05,111.05,48,37,11,0.7709999999999999,49,22,27,0.449,16,21,14,8
2020-02-03,1610612766,1610612753,2019,100.0,112.0,212.0,101.5,109.9,102.7,104.9,49,16,33,0.327,49,21,28,0.429,8,8,13,8
2020-02-03,1610612739,1610612752,2019,134.0,139.0,273.0,107.0,115.9,105.0,109.44999999999999,50,13,37,0.26,50,14,36,0.28,6,7,7,7
2020-02-03,1610612754,1610612742,2019,103.0,112.0,215.0,110.85,109.25,115.35,112.65,49,31,18,0.633,49,30,19,0.612,18,13,14,16
2020-02-03,1610612764,1610612744,2019,117.0,125.0,242.0,113.75,119.9,108.35,116.25,48,17,31,0.354,50,11,39,0.22,11,6,7,4
2020-02-03,1610612737,1610612738,2019,115.0,123.0,238.0,109.75,117.6,113.94999999999999,107.0,50,13,37,0.26,48,33,15,0.688,8,5,20,13
2020-02-03,1610612751,1610612756,2019,119.0,97.0,216.0,108.65,113.4,111.55,112.85,48,21,27,0.438,49,20,29,0.408,13,8,9,11
2020-02-03,1610612748,1610612755,2019,137.0,106.0,243.0,110.45,109.15,106.9,107.55,48,33,15,0.688,50,31,19,0.62,21,12,22,9
2020-02-03,1610612763,1610612765,2019,96.0,82.0,178.0,117.2,114.80000000000001,110.85,113.15,49,24,25,0.49,51,18,33,0.353,14,10,10,8
2020-02-03,1610612758,1610612750,2019,113.0,109.0,222.0,111.45,115.7,109.85,113.8,49,18,31,0.3670000000000001,48,15,33,0.313,8,10,6,9
2020-02-03,1610612746,1610612759,2019,108.0,105.0,213.0,115.85,112.05000000000001,116.05,111.4,49,34,15,0.6940000000000001,48,22,26,0.458,20,14,14,8
2020-02-02,1610612765,1610612743,2019,128.0,123.0,251.0,109.9,113.25,112.25,110.25,50,17,33,0.34,49,34,15,0.6940000000000001,9,8,19,15
2020-02-02,1610612745,1610612740,2019,117.0,109.0,226.0,115.7,114.2,119.55000000000001,114.5,48,30,18,0.625,49,20,29,0.408,16,14,10,10
2020-02-02,1610612749,1610612756,2019,129.0,108.0,237.0,118.25,106.9,110.94999999999999,111.65,48,41,7,0.8540000000000001,48,20,28,0.417,22,19,9,11
2020-02-02,1610612761,1610612741,2019,129.0,102.0,231.0,112.94999999999999,106.45,105.85,109.65,49,35,14,0.7140000000000001,51,19,32,0.373,17,18,11,8
2020-02-01,1610612746,1610612750,2019,118.0,106.0,224.0,115.94999999999999,111.7,109.55000000000001,113.35,48,33,15,0.688,47,15,32,0.319,19,14,6,9
2020-02-01,1610612754,1610612752,2019,85.0,92.0,177.0,111.95,108.9,106.1,111.65,48,31,17,0.6459999999999999,49,13,36,0.265,18,13,7,6
2020-02-01,1610612753,1610612748,2019,89.0,102.0,191.0,103.4,104.55,111.45,110.6,48,21,27,0.438,47,32,15,0.6809999999999999,13,8,21,11
2020-02-01,1610612739,1610612744,2019,112.0,131.0,243.0,107.44999999999999,115.25,107.1,116.35,49,13,36,0.265,49,10,39,0.204,6,7,7,3
2020-02-01,1610612764,1610612751,2019,113.0,107.0,220.0,113.1,119.9,108.4,113.25,47,16,31,0.34,47,21,26,0.447,10,6,13,8
2020-02-01,1610612738,1610612755,2019,116.0,95.0,211.0,113.0,107.9,107.0,106.65,47,32,15,0.6809999999999999,49,31,18,0.633,19,13,22,9
2020-02-01,1610612742,1610612737,2019,123.0,100.0,223.0,114.3,112.55000000000001,110.35,117.55,48,29,19,0.604,49,13,36,0.265,13,16,8,5
2020-02-01,1610612759,1610612766,2019,114.0,90.0,204.0,115.8,113.6,101.9,109.2,47,21,26,0.447,48,16,32,0.333,13,8,8,8
2020-02-01,1610612758,1610612747,2019,113.0,129.0,242.0,111.0,114.5,114.19999999999999,110.6,48,18,30,0.375,47,36,11,0.7659999999999999,8,10,16,20
2020-02-01,1610612757,1610612762,2019,124.0,107.0,231.0,114.15,116.65,117.0,106.95,49,22,27,0.449,48,32,16,0.667,12,10,18,14
2020-01-31,1610612765,1610612761,2019,92.0,105.0,197.0,110.65,113.94999999999999,113.35,106.7,49,17,32,0.34700000000000003,48,34,14,0.708,9,8,17,17
2020-01-31,1610612751,1610612741,2019,133.0,118.0,251.0,105.85,112.05,105.9,108.35,46,20,26,0.435,50,19,31,0.38,12,8,11,8
2020-01-31,1610612745,1610612742,2019,128.0,121.0,249.0,114.65,113.9,114.1,111.05000000000001,47,29,18,0.617,47,29,18,0.617,15,14,13,16
2020-01-31,1610612740,1610612763,2019,139.0,111.0,250.0,117.65,114.35,117.75,114.15,48,19,29,0.396,48,24,24,0.5,9,10,14,10
2020-01-31,1610612749,1610612743,2019,115.0,127.0,242.0,118.3,106.55000000000001,111.1,111.0,47,41,6,0.872,48,33,15,0.688,22,19,19,14
2020-01-31,1610612756,1610612760,2019,107.0,111.0,218.0,111.1,111.65,113.15,108.35,47,20,27,0.426,49,29,20,0.5920000000000001,9,11,15,14
2020-01-31,1610612747,1610612757,2019,119.0,127.0,246.0,115.35,110.5,113.35,116.2,46,36,10,0.7829999999999999,48,21,27,0.438,16,20,12,9
2020-01-30,1610612739,1610612761,2019,109.0,115.0,224.0,107.69999999999999,114.85,113.35,107.25,48,13,35,0.271,47,33,14,0.7020000000000001,6,7,17,16
2020-01-30,1610612764,1610612766,2019,121.0,107.0,228.0,112.5,120.05000000000001,100.80000000000001,108.5,46,15,31,0.326,47,16,31,0.34,9,6,8,8
2020-01-30,1610612737,1610612755,2019,127.0,117.0,244.0,109.3,117.25,107.4,105.75,48,12,36,0.25,48,31,17,0.6459999999999999,7,5,22,9
2020-01-30,1610612738,1610612744,2019,119.0,104.0,223.0,113.5,108.55000000000001,106.9,115.3,46,31,15,0.674,48,10,38,0.208,18,13,7,3
2020-01-30,1610612743,1610612762,2019,106.0,100.0,206.0,111.45,111.2,117.2,107.0,47,32,15,0.6809999999999999,47,32,15,0.6809999999999999,18,14,18,14
2020-01-30,1610612746,1610612758,2019,103.0,124.0,227.0,116.65,110.35,109.9,114.85,47,33,14,0.7020000000000001,47,17,30,0.362,19,14,8,9
2020-01-29,1610612754,1610612741,2019,115.0,106.0,221.0,112.30000000000001,109.44999999999999,106.1,108.05000000000001,47,30,17,0.638,49,19,30,0.38799999999999996,17,13,11,8
2020-01-29,1610612751,1610612765,2019,125.0,115.0,240.0,105.7,111.9,109.55000000000001,113.4,45,19,26,0.42200000000000004,48,17,31,0.354,11,8,9,8
2020-01-29,1610612752,1610612763,2019,106.0,127.0,233.0,105.9,111.45,117.15,114.25,48,13,35,0.271,47,23,24,0.489,7,6,14,9
2020-01-29,1610612759,1610612762,2019,127.0,120.0,247.0,115.35,112.85,116.9,106.0,46,20,26,0.435,46,32,14,0.696,12,8,18,14
2020-01-29,1610612757,1610612745,2019,125.0,112.0,237.0,113.0,115.75,116.0,113.9,47,20,27,0.426,46,29,17,0.63,11,9,15,14
2020-01-29,1610612758,1610612760,2019,100.0,120.0,220.0,110.1,114.5,112.35,108.45,46,17,29,0.37,48,28,20,0.583,8,9,15,13
2020-01-28,1610612766,1610612752,2019,97.0,92.0,189.0,101.30000000000001,110.0,106.55,112.15,46,15,31,0.326,47,13,34,0.27699999999999997,7,8,7,6
2020-01-28,1610612755,1610612744,2019,115.0,104.0,219.0,107.44999999999999,106.0,106.25,114.85,47,30,17,0.638,47,10,37,0.213,21,9,7,3
2020-01-28,1610612739,1610612740,2019,111.0,125.0,236.0,107.15,113.5,116.75,113.75,47,13,34,0.27699999999999997,47,18,29,0.38299999999999995,6,7,9,9
2020-01-28,1610612761,1610612737,2019,130.0,114.0,244.0,113.5,107.19999999999999,109.6,117.9,46,32,14,0.696,47,12,35,0.255,16,16,7,5
2020-01-28,1610612748,1610612738,2019,101.0,109.0,210.0,111.75,110.35,113.9,109.6,46,32,14,0.696,45,30,15,0.667,21,11,18,12
2020-01-28,1610612763,1610612743,2019,104.0,96.0,200.0,117.9,115.19999999999999,112.30000000000001,111.55000000000001,46,22,24,0.478,46,32,14,0.696,13,9,18,14
2020-01-28,1610612749,1610612764,2019,151.0,131.0,282.0,117.0,105.4,111.85,118.6,46,40,6,0.87,45,15,30,0.33299999999999996,21,19,9,6
2020-01-28,1610612742,1610612756,2019,104.0,133.0,237.0,114.05000000000001,109.85,109.85,112.75,46,29,17,0.63,46,19,27,0.413,13,16,9,10
2020-01-27,1610612765,1610612739,2019,100.0,115.0,215.0,109.5,113.25,107.05000000000001,115.15,47,17,30,0.36200000000000004,46,12,34,0.261,9,8,6,6
2020-01-27,1610612748,1610612753,2019,113.0,92.0,205.0,112.55000000000001,111.45,104.0,104.55,45,31,14,0.6890000000000001,47,21,26,0.447,20,11,13,8
2020-01-27,1610612741,1610612759,2019,110.0,109.0,219.0,106.05,107.9,115.25,112.8,48,18,30,0.375,45,20,25,0.444,10,8,12,8
2020-01-27,1610612750,1610612758,2019,129.0,133.0,262.0,107.5,111.4,108.45,112.0,46,15,31,0.326,45,16,29,0.35600000000000004,6,9,8,8
2020-01-27,1610612760,1610612742,2019,97.0,107.0,204.0,113.8,108.5,114.7,110.8,47,28,19,0.596,45,28,17,0.622,15,13,13,15
2020-01-27,1610612762,1610612745,2019,117.0,126.0,243.0,115.55,104.9,115.8,113.9,45,32,13,0.711,45,28,17,0.622,18,14,15,13
2020-01-26,1610612743,1610612745,2019,117.0,110.0,227.0,112.0,111.30000000000001,116.8,113.4,45,31,14,0.6890000000000001,44,28,16,0.636,17,14,15,13
2020-01-26,1610612759,1610612761,2019,106.0,110.0,216.0,115.4,113.15,113.6,106.85,44,20,24,0.455,45,31,14,0.6890000000000001,12,8,16,15
2020-01-26,1610612737,1610612764,2019,152.0,133.0,285.0,106.80000000000001,116.3,111.85,116.95,46,11,35,0.239,44,15,29,0.341,6,5,9,6
2020-01-26,1610612752,1610612751,2019,110.0,97.0,207.0,108.19999999999999,113.3,106.4,111.6,46,12,34,0.261,44,19,25,0.4320000000000001,6,6,11,8
2020-01-26,1610612753,1610612746,2019,97.0,112.0,209.0,104.5,105.45,116.35,110.95,46,21,25,0.457,46,32,14,0.696,13,8,19,13
2020-01-26,1610612763,1610612756,2019,114.0,109.0,223.0,118.1,115.3,109.35,113.05,45,21,24,0.467,45,19,26,0.42200000000000004,12,9,9,10
2020-01-26,1610612740,1610612738,2019,123.0,108.0,231.0,116.55000000000001,114.85,114.15,108.65,46,17,29,0.37,44,30,14,0.682,8,9,18,12
2020-01-26,1610612757,1610612754,2019,139.0,129.0,268.0,112.15,114.9,111.45,108.15,46,19,27,0.413,46,30,16,0.652,10,9,17,13
2020-01-25,1610612762,1610612742,2019,112.0,107.0,219.0,116.25,105.15,115.45,110.75,44,31,13,0.705,44,28,16,0.636,17,14,13,15
2020-01-25,1610612765,1610612751,2019,111.0,121.0,232.0,109.9,113.85,106.85,111.95,46,17,29,0.37,43,18,25,0.419,9,8,11,7
2020-01-25,1610612739,1610612741,2019,106.0,118.0,224.0,107.25,115.05000000000001,105.45,108.05000000000001,45,12,33,0.267,47,17,30,0.36200000000000004,6,6,10,7
2020-01-25,1610612750,1610612760,2019,104.0,113.0,217.0,107.25,111.1,113.25,108.8,45,15,30,0.33299999999999996,46,27,19,0.5870000000000001,6,9,15,12
2020-01-25,1610612755,1610612747,2019,108.0,91.0,199.0,106.9,106.05000000000001,115.85,109.9,46,29,17,0.63,45,36,9,0.8,20,9,16,20
2020-01-24,1610612766,1610612749,2019,103.0,116.0,219.0,101.35,109.75,117.55,105.94999999999999,45,15,30,0.33299999999999996,45,39,6,0.867,7,8,21,18
2020-01-24,1610612765,1610612763,2019,112.0,125.0,237.0,109.85,113.7,117.35,114.8,45,17,28,0.37799999999999995,44,20,24,0.455,9,8,12,8
2020-01-24,1610612753,1610612738,2019,98.0,109.0,207.0,103.95,104.8,114.05000000000001,109.35,45,21,24,0.467,43,29,14,0.674,13,8,18,11
2020-01-24,1610612752,1610612761,2019,112.0,118.0,230.0,107.75,112.6,112.35,105.85,45,12,33,0.267,44,30,14,0.682,6,6,16,14
2020-01-24,1610612748,1610612746,2019,117.0,122.0,239.0,112.2,111.0,116.45,110.95,44,31,13,0.705,45,31,14,0.6890000000000001,20,11,19,12
2020-01-24,1610612741,1610612758,2019,81.0,98.0,179.0,105.05000000000001,107.30000000000001,109.5,113.85,46,17,29,0.37,44,15,29,0.341,10,7,8,7
2020-01-24,1610612750,1610612745,2019,124.0,131.0,255.0,106.9,110.75,116.05,112.7,44,15,29,0.341,43,27,16,0.628,6,9,15,12
2020-01-24,1610612740,1610612743,2019,106.0,113.0,219.0,116.4,114.45,112.75,111.2,45,17,28,0.37799999999999995,44,30,14,0.682,8,9,17,13
2020-01-24,1610612760,1610612737,2019,140.0,111.0,251.0,112.55000000000001,109.35,106.35,116.1,45,26,19,0.578,45,11,34,0.244,14,12,6,5
2020-01-24,1610612759,1610612756,2019,99.0,103.0,202.0,115.7,113.19999999999999,109.65,113.85,43,20,23,0.465,44,18,26,0.409,12,8,9,9
2020-01-24,1610612744,1610612754,2019,118.0,129.0,247.0,106.0,113.6,109.45,108.1,46,10,36,0.217,45,29,16,0.644,7,3,17,12
2020-01-23,1610612739,1610612764,2019,112.0,124.0,236.0,106.0,113.5,111.19999999999999,117.75,44,12,32,0.273,43,14,29,0.326,6,6,9,5
2020-01-23,1610612751,1610612747,2019,113.0,128.0,241.0,106.65,110.0,115.1,109.75,42,18,24,0.429,44,35,9,0.795,11,7,16,19
2020-01-23,1610612757,1610612742,2019,125.0,133.0,258.0,111.65,112.6,114.7,109.35,45,19,26,0.42200000000000004,43,27,16,0.628,10,9,13,14
2020-01-22,1610612765,1610612758,2019,127.0,106.0,233.0,108.9,113.45,109.7,112.8,44,16,28,0.364,43,15,28,0.349,8,8,8,7
2020-01-22,1610612753,1610612760,2019,114.0,120.0,234.0,104.65,104.5,111.2,108.35,44,21,23,0.47700000000000004,44,25,19,0.568,13,8,14,11
2020-01-22,1610612761,1610612755,2019,107.0,95.0,202.0,112.5,106.2,106.6,106.15,43,29,14,0.674,45,29,16,0.644,15,14,20,9
2020-01-22,1610612737,1610612746,2019,102.0,95.0,197.0,106.25,116.85,117.3,110.45,44,10,34,0.22699999999999998,44,31,13,0.705,5,5,19,12
2020-01-22,1610612738,1610612763,2019,119.0,95.0,214.0,114.05000000000001,109.25,118.2,115.15,42,28,14,0.667,43,20,23,0.465,17,11,12,8
2020-01-22,1610612748,1610612764,2019,134.0,129.0,263.0,112.25,110.6,110.1,116.75,43,30,13,0.698,42,14,28,0.33299999999999996,19,11,9,5
2020-01-22,1610612752,1610612747,2019,92.0,100.0,192.0,107.75,114.05,114.9,109.5,44,12,32,0.273,43,34,9,0.7909999999999999,6,6,16,18
2020-01-22,1610612741,1610612750,2019,117.0,110.0,227.0,106.0,106.9,106.85,111.15,45,16,29,0.35600000000000004,43,15,28,0.349,9,7,6,9
2020-01-22,1610612745,1610612743,2019,121.0,105.0,226.0,115.9,113.4,112.1,110.0,42,26,16,0.619,43,30,13,0.698,14,12,17,13
2020-01-22,1610612756,1610612754,2019,87.0,112.0,199.0,111.25,114.30000000000001,109.35,108.75,43,18,25,0.419,44,28,16,0.636,9,9,17,11
2020-01-22,1610612740,1610612759,2019,117.0,121.0,238.0,117.15,115.35,115.7,113.3,44,17,27,0.386,42,19,23,0.452,8,9,12,7
2020-01-22,1610612744,1610612762,2019,96.0,129.0,225.0,106.5,112.25,115.35,105.65,45,10,35,0.222,43,30,13,0.698,7,3,17,13
2020-01-21,1610612742,1610612746,2019,107.0,110.0,217.0,115.25,109.95,117.3,110.05,42,27,15,0.643,43,30,13,0.698,13,14,19,11
2020-01-20,1610612764,1610612765,2019,106.0,100.0,206.0,110.75,118.5,109.65,113.5,41,13,28,0.317,43,16,27,0.3720000000000001,8,5,8,8
2020-01-20,1610612737,1610612761,2019,117.0,122.0,239.0,106.3,117.25,111.6,105.85,43,10,33,0.233,42,28,14,0.667,5,5,15,13
2020-01-20,1610612751,1610612755,2019,111.0,117.0,228.0,106.5,109.80000000000001,106.5,106.05000000000001,41,18,23,0.439,44,28,16,0.636,11,7,20,8
2020-01-20,1610612766,1610612753,2019,83.0,106.0,189.0,102.5,109.0,104.44999999999999,105.8,44,15,29,0.341,43,20,23,0.465,7,8,13,7
2020-01-20,1610612739,1610612752,2019,86.0,106.0,192.0,106.4,114.55000000000001,107.6,114.8,43,12,31,0.27899999999999997,43,11,32,0.256,6,6,6,5
2020-01-20,1610612748,1610612758,2019,118.0,113.0,231.0,111.85,110.2,109.25,112.15,42,29,13,0.69,42,15,27,0.35700000000000004,18,11,8,7
2020-01-20,1610612745,1610612760,2019,107.0,112.0,219.0,116.3,113.25,110.80000000000001,107.5,41,26,15,0.634,43,24,19,0.5579999999999999,14,12,14,10
2020-01-20,1610612763,1610612740,2019,116.0,126.0,242.0,118.8,114.4,116.30000000000001,115.35,42,20,22,0.47600000000000003,43,16,27,0.3720000000000001,12,8,8,8
2020-01-20,1610612749,1610612741,2019,111.0,98.0,209.0,118.35,106.65,106.35,106.85,44,38,6,0.8640000000000001,44,16,28,0.364,20,18,9,7
2020-01-20,1610612738,1610612747,2019,139.0,107.0,246.0,112.80000000000001,108.55,116.35,108.19999999999999,41,27,14,0.659,42,34,8,0.81,16,11,16,18
2020-01-20,1610612750,1610612743,2019,100.0,107.0,207.0,107.65,112.15,111.85,110.25,42,15,27,0.35700000000000004,42,29,13,0.69,6,9,17,12
2020-01-20,1610612756,1610612759,2019,118.0,120.0,238.0,110.75,114.05000000000001,114.6,114.0,42,18,24,0.429,41,18,23,0.439,9,9,12,6
2020-01-20,1610612762,1610612754,2019,118.0,88.0,206.0,114.25,107.3,110.15,108.0,42,29,13,0.69,43,28,15,0.6509999999999999,16,13,17,11
2020-01-20,1610612757,1610612744,2019,129.0,124.0,253.0,110.0,111.80000000000001,104.25,111.0,44,18,26,0.409,44,10,34,0.22699999999999998,9,9,7,3
2020-01-19,1610612759,1610612748,2019,107.0,102.0,209.0,116.0,115.55000000000001,111.4,110.45,40,17,23,0.425,41,29,12,0.7070000000000001,11,6,18,11
2020-01-19,1610612743,1610612754,2019,107.0,115.0,222.0,112.0,109.6,109.45,108.05,41,29,12,0.7070000000000001,42,27,15,0.643,17,12,17,10
2020-01-18,1610612740,1610612746,2019,130.0,133.0,263.0,114.65,114.6,117.4,109.5,42,16,26,0.381,42,29,13,0.69,8,8,19,10
2020-01-18,1610612751,1610612749,2019,97.0,117.0,214.0,106.9,109.05000000000001,118.85,106.95,40,18,22,0.45,43,37,6,0.86,11,7,20,17
2020-01-18,1610612738,1610612756,2019,119.0,123.0,242.0,112.30000000000001,108.15,111.55,114.7,40,27,13,0.675,41,17,24,0.415,16,11,9,8
2020-01-18,1610612737,1610612765,2019,103.0,136.0,239.0,106.35,114.4,108.1,113.5,42,10,32,0.23800000000000002,42,15,27,0.35700000000000004,5,5,8,7
2020-01-18,1610612752,1610612755,2019,87.0,90.0,177.0,108.45,115.94999999999999,107.65,107.65,42,11,31,0.262,43,27,16,0.628,6,5,20,7
2020-01-18,1610612741,1610612739,2019,118.0,116.0,234.0,105.05,105.69999999999999,106.0,114.9,43,15,28,0.349,42,12,30,0.28600000000000003,8,7,6,6
2020-01-18,1610612750,1610612761,2019,112.0,122.0,234.0,107.4,111.80000000000001,110.0,104.4,41,15,26,0.366,41,27,14,0.659,6,9,15,12
2020-01-18,1610612745,1610612747,2019,115.0,124.0,239.0,118.45,112.6,116.2,107.25,40,26,14,0.65,41,33,8,0.805,14,12,16,17
2020-01-18,1610612744,1610612753,2019,109.0,95.0,204.0,102.75,111.25,106.19999999999999,106.3,43,9,34,0.209,42,20,22,0.47600000000000003,6,3,13,7
2020-01-18,1610612760,1610612757,2019,119.0,106.0,225.0,110.30000000000001,107.5,109.65,111.55000000000001,42,23,19,0.5479999999999999,43,18,25,0.419,13,10,9,9
2020-01-18,1610612762,1610612758,2019,123.0,101.0,224.0,114.5,108.25,110.0,112.35,41,28,13,0.6829999999999999,41,15,26,0.366,15,13,8,7
2020-01-17,1610612754,1610612750,2019,116.0,114.0,230.0,108.6,107.85,107.95,113.1,41,26,15,0.634,40,15,25,0.375,16,10,6,9
2020-01-17,1610612755,1610612741,2019,100.0,89.0,189.0,108.15,108.4,106.25,106.0,42,26,16,0.619,42,15,27,0.35700000000000004,19,7,8,7
2020-01-17,1610612761,1610612764,2019,140.0,111.0,251.0,107.6,104.44999999999999,110.35,117.1,40,26,14,0.65,40,13,27,0.325,14,12,8,5
2020-01-17,1610612763,1610612739,2019,113.0,109.0,222.0,118.85,115.3,106.4,114.7,41,19,22,0.46299999999999997,41,12,29,0.293,11,8,6,6
2020-01-17,1610612760,1610612748,2019,108.0,115.0,223.0,111.85,108.1,111.69999999999999,110.55000000000001,41,23,18,0.561,40,28,12,0.7,13,10,18,10
2020-01-17,1610612759,1610612737,2019,120.0,121.0,241.0,115.35,114.35,106.35,115.15,39,17,22,0.436,41,9,32,0.22,11,6,5,4
2020-01-17,1610612742,1610612757,2019,120.0,112.0,232.0,114.55000000000001,109.85,108.9,111.4,41,26,15,0.634,42,18,24,0.429,12,14,9,9
2020-01-16,1610612752,1610612756,2019,98.0,121.0,219.0,108.3,114.94999999999999,111.19999999999999,116.2,41,11,30,0.268,40,16,24,0.4,6,5,9,7
2020-01-16,1610612749,1610612738,2019,128.0,123.0,251.0,117.94999999999999,105.85,110.75,106.55,42,36,6,0.857,39,27,12,0.6920000000000001,19,17,16,11
2020-01-16,1610612740,1610612762,2019,138.0,132.0,270.0,112.95,113.35,114.25,107.15,41,15,26,0.366,40,28,12,0.7,7,8,15,13
2020-01-16,1610612744,1610612743,2019,131.0,134.0,265.0,102.3,110.75,110.05000000000001,108.45,42,9,33,0.214,40,28,12,0.7,6,3,17,11
2020-01-16,1610612746,1610612753,2019,122.0,95.0,217.0,118.8,111.0,106.5,105.7,41,28,13,0.6829999999999999,41,20,21,0.488,18,10,13,7
2020-01-15,1610612738,1610612765,2019,103.0,116.0,219.0,111.1,105.15,108.65,113.05000000000001,38,27,11,0.711,41,14,27,0.341,16,11,8,6
2020-01-15,1610612755,1610612751,2019,117.0,106.0,223.0,109.35,107.80000000000001,107.1,109.25,41,25,16,0.61,39,18,21,0.462,18,7,11,7
2020-01-15,1610612748,1610612759,2019,106.0,100.0,206.0,112.0,110.7,115.9,114.25,39,27,12,0.6920000000000001,38,17,21,0.447,17,10,11,6
2020-01-15,1610612741,1610612764,2019,115.0,106.0,221.0,105.4,105.7,111.30000000000001,118.85,41,14,27,0.341,39,13,26,0.33299999999999996,7,7,8,5
2020-01-15,1610612750,1610612754,2019,99.0,104.0,203.0,107.9,112.9,108.75,107.9,39,15,24,0.385,40,25,15,0.625,6,9,16,9
2020-01-15,1610612760,1610612761,2019,121.0,130.0,251.0,110.80000000000001,106.95,107.05,104.19999999999999,40,23,17,0.575,39,25,14,0.6409999999999999,13,10,14,11
2020-01-15,1610612743,1610612766,2019,100.0,86.0,186.0,110.75,109.1,102.35,107.65,39,27,12,0.6920000000000001,43,15,28,0.349,16,11,7,8
2020-01-15,1610612745,1610612757,2019,107.0,117.0,224.0,118.95,112.15,108.9,110.75,39,26,13,0.667,41,17,24,0.415,14,12,9,8
2020-01-15,1610612758,1610612742,2019,123.0,127.0,250.0,108.9,111.15,113.9,108.7,40,15,25,0.375,40,25,15,0.625,8,7,12,13
2020-01-15,1610612747,1610612753,2019,118.0,119.0,237.0,115.3,107.0,105.19999999999999,104.15,40,33,7,0.825,40,19,21,0.475,16,17,13,6
2020-01-14,1610612737,1610612756,2019,123.0,110.0,233.0,105.85,115.9,111.15,115.25,40,8,32,0.2,39,16,23,0.41,4,4,9,7
2020-01-14,1610612751,1610612762,2019,107.0,118.0,225.0,107.05000000000001,108.8,113.05,106.95,38,18,20,0.474,39,27,12,0.6920000000000001,11,7,15,12
2020-01-14,1610612763,1610612745,2019,121.0,110.0,231.0,118.0,115.65,119.4,111.55,40,18,22,0.45,38,26,12,0.684,10,8,14,12
2020-01-14,1610612749,1610612752,2019,128.0,102.0,230.0,117.5,105.30000000000001,109.4,114.65,41,35,6,0.8540000000000001,40,11,29,0.275,18,17,6,5
2020-01-14,1610612744,1610612742,2019,97.0,124.0,221.0,102.55,110.05000000000001,113.7,109.5,41,9,32,0.22,39,24,15,0.615,6,3,12,12
2020-01-14,1610612746,1610612739,2019,128.0,103.0,231.0,119.1,111.3,105.65,113.80000000000001,40,27,13,0.675,40,12,28,0.3,17,10,6,6
2020-01-13,1610612765,1610612740,2019,110.0,117.0,227.0,108.30000000000001,113.55000000000001,112.7,114.19999999999999,40,14,26,0.35,40,14,26,0.35,8,6,7,7
2020-01-13,1610612754,1610612755,2019,101.0,95.0,196.0,108.94999999999999,108.35,109.65,107.5,39,24,15,0.615,40,25,15,0.625,15,9,18,7
2020-01-13,1610612738,1610612741,2019,113.0,101.0,214.0,110.85,104.85,105.5,105.4,37,26,11,0.703,40,14,26,0.35,15,11,7,7
2020-01-13,1610612750,1610612760,2019,104.0,117.0,221.0,107.45,112.19999999999999,110.35,106.55,38,15,23,0.395,39,22,17,0.564,6,9,13,9
2020-01-13,1610612757,1610612766,2019,115.0,112.0,227.0,108.8,111.94999999999999,102.4,107.30000000000001,40,16,24,0.4,42,15,27,0.35700000000000004,8,8,7,8
2020-01-13,1610612758,1610612753,2019,112.0,114.0,226.0,108.0,110.1,105.85,104.55,39,15,24,0.385,39,18,21,0.462,8,7,13,5
2020-01-13,1610612747,1610612739,2019,128.0,99.0,227.0,115.15,107.2,105.4,114.45,39,32,7,0.821,39,12,27,0.308,15,17,6,6
2020-01-12,1610612752,1610612748,2019,124.0,121.0,245.0,108.25,113.75,111.4,109.8,39,10,29,0.256,38,27,11,0.711,5,5,17,10
2020-01-12,1610612764,1610612762,2019,116.0,127.0,243.0,111.45,118.15,112.2,107.65,38,13,25,0.342,38,26,12,0.684,8,5,15,11
2020-01-12,1610612751,1610612737,2019,108.0,86.0,194.0,107.25,109.85,107.65,115.85,37,17,20,0.45899999999999996,39,8,31,0.205,10,7,4,4
2020-01-12,1610612761,1610612759,2019,104.0,105.0,209.0,107.3,104.9,115.85,114.8,38,25,13,0.6579999999999999,37,16,21,0.4320000000000001,14,11,11,5
2020-01-12,1610612763,1610612744,2019,122.0,102.0,224.0,116.6,115.69999999999999,102.25,108.95,39,17,22,0.436,40,9,31,0.225,9,8,6,3
2020-01-12,1610612743,1610612746,2019,114.0,104.0,218.0,109.85,109.15,118.45,111.55,38,26,12,0.684,39,27,12,0.6920000000000001,15,11,17,10
2020-01-12,1610612756,1610612766,2019,100.0,92.0,192.0,112.4,116.1,102.6,109.15,38,15,23,0.395,41,15,26,0.366,8,7,7,8
2020-01-11,1610612745,1610612750,2019,139.0,109.0,248.0,118.6,112.94999999999999,108.35,112.19999999999999,37,25,12,0.6759999999999999,37,15,22,0.405,13,12,6,9
2020-01-11,1610612738,1610612740,2019,140.0,105.0,245.0,109.44999999999999,104.25,111.65,113.69999999999999,36,25,11,0.6940000000000001,39,14,25,0.359,14,11,7,7
2020-01-11,1610612765,1610612741,2019,99.0,108.0,207.0,109.95,113.05000000000001,104.6,105.65,39,14,25,0.359,39,13,26,0.33299999999999996,8,6,7,6
2020-01-11,1610612760,1610612747,2019,110.0,125.0,235.0,110.3,105.5,114.15,106.5,38,22,16,0.579,38,31,7,0.816,13,9,15,16
2020-01-11,1610612742,1610612755,2019,109.0,91.0,200.0,114.75,109.15,109.9,107.1,38,23,15,0.605,39,25,14,0.6409999999999999,11,12,18,7
2020-01-11,1610612743,1610612739,2019,103.0,111.0,214.0,110.55000000000001,108.8,104.9,116.45,37,26,11,0.703,38,11,27,0.289,15,11,6,5
2020-01-11,1610612757,1610612749,2019,101.0,122.0,223.0,110.1,111.65,117.35,105.75,39,16,23,0.41,40,34,6,0.85,8,8,18,16
2020-01-10,1610612764,1610612737,2019,111.0,101.0,212.0,111.9,119.45,108.15,118.2,37,12,25,0.324,38,8,30,0.21100000000000002,7,5,4,4
2020-01-10,1610612752,1610612740,2019,111.0,123.0,234.0,107.9,113.15,110.7,113.6,38,10,28,0.263,38,13,25,0.342,5,5,7,6
2020-01-10,1610612751,1610612748,2019,117.0,113.0,230.0,107.2,109.05,111.15,109.8,36,16,20,0.444,37,27,10,0.73,9,7,17,10
2020-01-10,1610612741,1610612754,2019,105.0,116.0,221.0,104.65,104.8,109.0,108.3,38,13,25,0.342,38,23,15,0.605,7,6,15,8
2020-01-10,1610612763,1610612759,2019,134.0,121.0,255.0,115.85,115.69999999999999,116.4,115.0,38,16,22,0.42100000000000004,36,16,20,0.444,8,8,11,5
2020-01-10,1610612756,1610612753,2019,98.0,94.0,192.0,113.15,117.4,106.94999999999999,104.85,37,14,23,0.37799999999999995,38,18,20,0.474,7,7,13,5
2020-01-10,1610612762,1610612766,2019,109.0,92.0,201.0,112.4,108.5,103.5,109.05000000000001,37,25,12,0.6759999999999999,40,15,25,0.375,14,11,7,8
2020-01-10,1610612742,1610612747,2019,114.0,129.0,243.0,115.1,108.4,113.4,106.30000000000001,37,23,14,0.622,37,30,7,0.8109999999999999,11,12,15,15
2020-01-10,1610612758,1610612749,2019,106.0,127.0,233.0,108.0,109.4,117.75,106.80000000000001,38,15,23,0.395,39,33,6,0.846,8,7,18,15
2020-01-10,1610612746,1610612744,2019,109.0,100.0,209.0,119.1,112.5,102.5,109.6,38,26,12,0.684,39,9,30,0.231,16,10,6,3
2020-01-09,1610612765,1610612739,2019,112.0,115.0,227.0,109.7,112.80000000000001,104.15,117.05000000000001,38,14,24,0.368,37,10,27,0.27,8,6,6,4
2020-01-09,1610612755,1610612738,2019,109.0,98.0,207.0,109.6,106.9,109.75,104.15,38,24,14,0.632,35,25,10,0.7140000000000001,17,7,14,11
2020-01-09,1610612750,1610612757,2019,116.0,102.0,218.0,107.8,113.35,110.2,111.35,36,14,22,0.389,38,16,22,0.42100000000000004,5,9,8,8
2020-01-09,1610612760,1610612745,2019,113.0,92.0,205.0,111.0,107.4,120.65,114.05,37,21,16,0.568,36,25,11,0.6940000000000001,12,9,13,12
2020-01-08,1610612738,1610612759,2019,114.0,129.0,243.0,110.1,103.19999999999999,115.45,115.15,34,25,9,0.735,35,15,20,0.429,14,11,11,4
2020-01-08,1610612766,1610612761,2019,110.0,112.0,222.0,103.2,108.9,106.8,104.9,39,15,24,0.385,37,24,13,0.649,7,8,14,10
2020-01-08,1610612754,1610612748,2019,108.0,122.0,230.0,109.65,107.3,109.35,110.05,37,23,14,0.622,36,26,10,0.722,15,8,17,9
2020-01-08,1610612753,1610612764,2019,123.0,89.0,212.0,105.8,105.2,112.6,119.55000000000001,37,17,20,0.45899999999999996,36,12,24,0.33299999999999996,12,5,7,5
2020-01-08,1610612737,1610612745,2019,115.0,122.0,237.0,108.2,118.05,120.5,114.4,37,8,29,0.21600000000000005,35,24,11,0.6859999999999999,4,4,13,11
2020-01-08,1610612742,1610612743,2019,106.0,107.0,213.0,114.75,108.75,111.65,108.1,36,23,13,0.639,36,25,11,0.6940000000000001,11,12,15,10
2020-01-08,1610612740,1610612741,2019,123.0,108.0,231.0,110.05000000000001,113.9,105.05000000000001,104.4,37,12,25,0.324,37,13,24,0.35100000000000003,6,6,7,6
2020-01-08,1610612762,1610612752,2019,128.0,104.0,232.0,111.1,108.9,107.05,112.5,36,24,12,0.667,37,10,27,0.27,13,11,5,5
2020-01-08,1610612744,1610612749,2019,98.0,107.0,205.0,102.80000000000001,108.75,118.15,106.95,38,9,29,0.237,38,32,6,0.8420000000000001,6,3,18,14
2020-01-07,1610612739,1610612765,2019,113.0,115.0,228.0,104.0,117.25,109.0,112.25,36,10,26,0.278,37,13,24,0.35100000000000003,6,4,8,5
2020-01-07,1610612761,1610612757,2019,99.0,101.0,200.0,107.35,105.9,111.6,113.25,36,24,12,0.667,37,15,22,0.405,14,10,8,7
2020-01-07,1610612751,1610612760,2019,103.0,111.0,214.0,107.1,108.05,110.80000000000001,107.45,35,16,19,0.457,36,20,16,0.556,9,7,12,8
2020-01-07,1610612763,1610612750,2019,119.0,112.0,231.0,115.3,115.55,107.9,113.45,37,15,22,0.405,35,14,21,0.4,7,8,5,9
2020-01-07,1610612756,1610612758,2019,103.0,114.0,217.0,114.6,118.69999999999999,106.85,109.1,36,14,22,0.389,37,14,23,0.37799999999999995,7,7,8,6
2020-01-07,1610612747,1610612752,2019,117.0,87.0,204.0,113.15,107.30000000000001,107.1,113.25,36,29,7,0.8059999999999999,36,10,26,0.278,14,15,5,5
2020-01-06,1610612766,1610612754,2019,104.0,115.0,219.0,103.1,108.2,109.7,108.05,38,15,23,0.395,36,22,14,0.611,7,8,15,7
2020-01-06,1610612753,1610612751,2019,101.0,89.0,190.0,104.9,105.25,108.05,108.3,36,16,20,0.444,34,16,18,0.47100000000000003,11,5,9,7
2020-01-06,1610612755,1610612760,2019,120.0,113.0,233.0,109.55000000000001,107.05,111.1,108.25,37,23,14,0.622,35,20,15,0.5710000000000001,16,7,12,8
2020-01-06,1610612764,1610612738,2019,99.0,94.0,193.0,112.94999999999999,120.5,110.35,102.5,35,11,24,0.314,33,25,8,0.758,6,5,14,11
2020-01-06,1610612737,1610612743,2019,115.0,123.0,238.0,108.80000000000001,118.65,110.35,107.35,36,8,28,0.222,35,24,11,0.6859999999999999,4,4,15,9
2020-01-06,1610612740,1610612762,2019,126.0,128.0,254.0,109.5,112.7,109.85,107.30000000000001,36,12,24,0.33299999999999996,35,23,12,0.657,6,6,13,10
2020-01-06,1610612742,1610612741,2019,118.0,110.0,228.0,116.0,108.3,105.30000000000001,104.7,35,22,13,0.629,36,13,23,0.361,10,12,7,6
2020-01-06,1610612759,1610612749,2019,126.0,104.0,230.0,114.2,115.6,118.05000000000001,104.80000000000001,34,14,20,0.41200000000000003,37,32,5,0.865,10,4,18,14
2020-01-06,1610612758,1610612744,2019,111.0,98.0,209.0,106.30000000000001,109.05,103.35,108.85,36,13,23,0.361,37,9,28,0.243,7,6,6,3
2020-01-05,1610612746,1610612752,2019,135.0,132.0,267.0,117.7,111.1,105.4,112.8,37,25,12,0.6759999999999999,35,10,25,0.28600000000000003,15,10,5,5
2020-01-05,1610612748,1610612757,2019,122.0,111.0,233.0,109.35,109.75,111.25,112.9,35,25,10,0.7140000000000001,36,15,21,0.41700000000000004,16,9,8,7
2020-01-05,1610612739,1610612750,2019,103.0,118.0,221.0,104.05000000000001,117.15,107.65,113.35,35,10,25,0.28600000000000003,34,13,21,0.382,6,4,5,8
2020-01-05,1610612756,1610612763,2019,114.0,121.0,235.0,114.95,118.85,114.19999999999999,115.15,35,14,21,0.4,36,14,22,0.389,7,7,7,7
2020-01-05,1610612747,1610612765,2019,106.0,99.0,205.0,113.95,107.4,108.55000000000001,112.15,35,28,7,0.8,36,13,23,0.361,13,15,8,5
2020-01-04,1610612746,1610612763,2019,114.0,140.0,254.0,116.5,108.5,112.94999999999999,114.8,36,25,11,0.6940000000000001,35,13,22,0.371,15,10,7,6
2020-01-04,1610612751,1610612761,2019,102.0,121.0,223.0,107.25,108.0,107.0,106.1,33,16,17,0.485,35,23,12,0.657,9,7,14,9
2020-01-04,1610612753,1610612762,2019,96.0,109.0,205.0,106.35,105.85,109.5,108.55000000000001,35,16,19,0.457,34,22,12,0.647,11,5,13,9
2020-01-04,1610612737,1610612754,2019,116.0,111.0,227.0,108.45,119.15,109.9,106.55,35,7,28,0.2,35,22,13,0.629,3,4,15,7
2020-01-04,1610612739,1610612760,2019,106.0,121.0,227.0,104.05000000000001,116.5,110.05000000000001,107.80000000000001,34,10,24,0.294,34,19,15,0.5589999999999999,6,4,12,7
2020-01-04,1610612764,1610612743,2019,128.0,114.0,242.0,112.8,120.7,111.2,106.65,34,10,24,0.294,34,24,10,0.706,5,5,15,9
2020-01-04,1610612741,1610612738,2019,104.0,111.0,215.0,104.80000000000001,105.0,109.75,102.3,35,13,22,0.371,32,24,8,0.75,7,6,14,10
2020-01-04,1610612742,1610612766,2019,120.0,123.0,243.0,117.1,106.85,101.94999999999999,108.05,34,22,12,0.647,37,14,23,0.37799999999999995,10,12,7,7
2020-01-04,1610612749,1610612759,2019,127.0,118.0,245.0,118.30000000000001,103.30000000000001,113.75,114.80000000000001,36,31,5,0.861,33,14,19,0.424,17,14,10,4
2020-01-04,1610612744,1610612765,2019,104.0,111.0,215.0,103.0,108.3,107.45,112.4,36,9,27,0.25,35,12,23,0.34299999999999997,6,3,8,4
2020-01-04,1610612758,1610612740,2019,115.0,117.0,232.0,106.55000000000001,109.0,109.1,113.65,35,13,22,0.371,35,11,24,0.314,7,6,6,5
2020-01-03,1610612738,1610612737,2019,109.0,106.0,215.0,109.45,102.1,108.35,118.94999999999999,31,23,8,0.742,34,7,27,0.20600000000000002,13,10,3,4
2020-01-03,1610612753,1610612748,2019,105.0,85.0,190.0,106.65,107.05000000000001,110.9,109.9,34,15,19,0.441,34,25,9,0.735,10,5,16,9
2020-01-03,1610612764,1610612757,2019,103.0,122.0,225.0,114.55,121.2,110.55000000000001,114.35,33,10,23,0.303,35,14,21,0.4,5,5,8,6
2020-01-03,1610612745,1610612755,2019,118.0,108.0,226.0,121.2,114.4,109.85,105.9,34,23,11,0.6759999999999999,36,23,13,0.639,12,11,16,7
2020-01-03,1610612756,1610612752,2019,120.0,112.0,232.0,113.2,118.19999999999999,105.0,112.25,34,13,21,0.382,34,10,24,0.294,6,7,5,5
2020-01-03,1610612747,1610612740,2019,123.0,113.0,236.0,112.75,106.6,109.44999999999999,113.9,34,27,7,0.794,34,11,23,0.324,12,15,6,5
2020-01-02,1610612739,1610612766,2019,106.0,109.0,215.0,104.25,116.25,102.4,109.0,33,10,23,0.303,36,13,23,0.361,6,4,7,6
2020-01-02,1610612754,1610612743,2019,116.0,124.0,240.0,110.4,106.05,110.0,105.75,34,22,12,0.647,33,23,10,0.6970000000000001,15,7,15,8
2020-01-02,1610612748,1610612761,2019,84.0,76.0,160.0,112.55000000000001,111.1,107.6,106.8,33,24,9,0.727,34,23,11,0.6759999999999999,15,9,14,9
2020-01-02,1610612741,1610612762,2019,98.0,102.0,200.0,105.30000000000001,105.7,110.3,109.75,34,13,21,0.382,33,21,12,0.636,7,6,13,8
2020-01-02,1610612750,1610612744,2019,99.0,84.0,183.0,108.5,116.0,103.5,110.44999999999999,33,12,21,0.364,35,9,26,0.257,4,8,6,3
2020-01-02,1610612742,1610612751,2019,123.0,111.0,234.0,116.8,106.8,106.85,106.9,33,21,12,0.636,32,16,16,0.5,9,12,9,7
2020-01-02,1610612759,1610612760,2019,103.0,109.0,212.0,113.8,115.05000000000001,109.95,108.25,32,14,18,0.438,33,18,15,0.545,10,4,12,6
2020-01-02,1610612758,1610612763,2019,128.0,123.0,251.0,105.15,107.8,112.5,114.69999999999999,34,12,22,0.353,34,13,21,0.382,6,6,7,6
2020-01-02,1610612746,1610612765,2019,126.0,112.0,238.0,117.7,107.95,107.15,111.55000000000001,35,24,11,0.6859999999999999,34,12,22,0.353,14,10,8,4
2020-01-01,1610612764,1610612753,2019,101.0,122.0,223.0,114.5,120.75,104.95,107.15,32,10,22,0.313,33,14,19,0.424,5,5,10,4
2020-01-01,1610612752,1610612757,2019,117.0,93.0,210.0,105.30000000000001,112.85,111.95,114.3,33,9,24,0.273,34,14,20,0.412,4,5,8,6
2020-01-01,1610612749,1610612750,2019,106.0,104.0,210.0,119.85,102.9,109.55,116.35,35,30,5,0.857,32,12,20,0.375,16,14,4,8
2020-01-01,1610612747,1610612756,2019,117.0,107.0,224.0,112.9,105.95,113.05000000000001,118.15,33,26,7,0.7879999999999999,33,13,20,0.394,11,15,6,7
2019-12-31,1610612766,1610612738,2019,92.0,109.0,201.0,103.55,109.35,109.25,102.5,35,13,22,0.371,30,22,8,0.733,7,6,13,9
2019-12-31,1610612754,1610612755,2019,115.0,97.0,212.0,110.2,106.5,110.95,106.5,33,21,12,0.636,35,23,12,0.657,14,7,16,7
2019-12-31,1610612758,1610612746,2019,87.0,105.0,192.0,106.15,107.5,117.30000000000001,108.95,33,12,21,0.364,34,23,11,0.6759999999999999,6,6,14,9
2019-12-31,1610612761,1610612739,2019,117.0,97.0,214.0,108.25,107.44999999999999,104.65,116.55,33,22,11,0.667,32,10,22,0.313,13,9,6,4
2019-12-31,1610612745,1610612743,2019,130.0,104.0,234.0,120.25,114.30000000000001,109.35,103.6,33,22,11,0.667,32,23,9,0.7190000000000001,11,11,15,8
2019-12-31,1610612759,1610612744,2019,117.0,113.0,230.0,113.75,115.45,103.55,109.35,31,13,18,0.419,34,9,25,0.265,9,4,6,3
2019-12-31,1610612760,1610612742,2019,106.0,101.0,207.0,111.0,109.15,118.6,107.65,32,17,15,0.531,32,21,11,0.6559999999999999,11,6,9,12
2019-12-30,1610612753,1610612737,2019,93.0,101.0,194.0,105.9,106.95,108.4,119.85,32,14,18,0.43799999999999994,33,6,27,0.182,10,4,3,3
2019-12-30,1610612764,1610612748,2019,123.0,105.0,228.0,114.1,120.45,112.7,109.8,31,9,22,0.29,32,24,8,0.75,4,5,15,9
2019-12-30,1610612741,1610612749,2019,102.0,123.0,225.0,105.65,104.0,119.75,103.75,33,13,20,0.39399999999999996,34,29,5,0.853,7,6,16,13
2019-12-30,1610612750,1610612751,2019,122.0,115.0,237.0,109.9,116.3,106.95,106.35,31,11,20,0.355,31,16,15,0.516,3,8,9,7
2019-12-30,1610612762,1610612765,2019,104.0,81.0,185.0,111.05,111.4,108.5,112.2,32,20,12,0.625,33,12,21,0.364,12,8,8,4
2019-12-30,1610612757,1610612756,2019,116.0,122.0,238.0,111.5,113.35,111.95,117.25,33,14,19,0.424,32,12,20,0.375,8,6,6,6
2019-12-29,1610612761,1610612760,2019,97.0,98.0,195.0,109.7,107.44999999999999,110.5,108.8,32,22,10,0.688,31,16,15,0.516,13,9,11,5
2019-12-29,1610612763,1610612766,2019,117.0,104.0,221.0,111.4,115.19999999999999,102.9,108.55000000000001,33,12,21,0.364,34,13,21,0.382,6,6,7,6
2019-12-29,1610612740,1610612745,2019,127.0,112.0,239.0,108.5,113.3,119.4,113.2,33,10,23,0.303,32,22,10,0.688,5,5,11,11
2019-12-29,1610612743,1610612758,2019,120.0,115.0,235.0,109.15,103.05,105.5,106.65,31,22,9,0.71,32,12,20,0.375,14,8,6,6
2019-12-29,1610612747,1610612742,2019,108.0,95.0,203.0,112.7,106.85,119.0,107.55,32,25,7,0.7809999999999999,31,21,10,0.677,10,15,9,12
2019-12-28,1610612743,1610612763,2019,119.0,110.0,229.0,108.0,102.15,111.85,115.1,30,21,9,0.7,32,12,20,0.375,13,8,6,6
2019-12-28,1610612738,1610612761,2019,97.0,113.0,210.0,111.4,103.5,109.7,107.8,29,22,7,0.759,31,21,10,0.677,13,9,13,8
2019-12-28,1610612740,1610612754,2019,120.0,98.0,218.0,109.1,114.75,110.4,106.05,32,9,23,0.281,32,21,11,0.6559999999999999,4,5,14,7
2019-12-28,1610612748,1610612755,2019,117.0,116.0,233.0,113.05000000000001,109.0,110.0,106.25,31,23,8,0.742,34,23,11,0.6759999999999999,14,9,16,7
2019-12-28,1610612764,1610612752,2019,100.0,107.0,207.0,114.55,121.65,105.05000000000001,113.85,30,9,21,0.3,32,8,24,0.25,4,5,4,4
2019-12-28,1610612741,1610612737,2019,116.0,81.0,197.0,104.9,105.7,109.5,120.44999999999999,32,12,20,0.375,32,6,26,0.188,6,6,3,3
2019-12-28,1610612745,1610612751,2019,108.0,98.0,206.0,119.1,112.95,106.7,106.0,31,21,10,0.677,30,16,14,0.5329999999999999,10,11,9,7
2019-12-28,1610612750,1610612739,2019,88.0,94.0,182.0,110.4,116.6,104.8,117.05,30,11,19,0.3670000000000001,31,9,22,0.29,3,8,6,3
2019-12-28,1610612749,1610612753,2019,111.0,100.0,211.0,119.75,103.85,106.2,106.95,33,28,5,0.848,31,14,17,0.452,15,13,10,4
2019-12-28,1610612759,1610612765,2019,136.0,109.0,245.0,112.4,115.65,108.35,111.0,30,12,18,0.4,32,12,20,0.375,8,4,8,4
2019-12-28,1610612744,1610612742,2019,121.0,141.0,262.0,102.5,107.55,117.25,107.3,33,9,24,0.273,30,20,10,0.667,6,3,9,11
2019-12-28,1610612758,1610612756,2019,110.0,112.0,222.0,105.1,106.1,112.15,117.75,31,12,19,0.387,31,11,20,0.355,6,6,6,5
2019-12-28,1610612757,1610612747,2019,120.0,128.0,248.0,112.3,112.9,112.0,106.05,32,14,18,0.43799999999999994,31,24,7,0.774,8,6,10,14
2019-12-28,1610612746,1610612762,2019,107.0,120.0,227.0,116.85,107.35,110.19999999999999,110.8,33,23,10,0.6970000000000001,31,19,12,0.613,14,9,12,7
2019-12-27,1610612738,1610612739,2019,129.0,117.0,246.0,110.75,102.94999999999999,104.35,114.94999999999999,28,21,7,0.75,30,9,21,0.3,12,9,6,3
2019-12-27,1610612766,1610612760,2019,102.0,104.0,206.0,103.25,108.65,109.55,109.25,33,13,20,0.39399999999999996,30,15,15,0.5,7,6,11,4
2019-12-27,1610612753,1610612755,2019,98.0,97.0,195.0,106.4,107.55000000000001,110.0,106.35,30,13,17,0.433,33,23,10,0.6970000000000001,9,4,16,7
2019-12-27,1610612737,1610612749,2019,86.0,112.0,198.0,109.85,120.5,119.15,104.69999999999999,31,6,25,0.19399999999999998,32,27,5,0.8440000000000001,3,3,15,12
2019-12-27,1610612748,1610612754,2019,113.0,112.0,225.0,112.85,108.1,110.25,105.5,30,22,8,0.733,31,21,10,0.677,13,9,14,7
2019-12-27,1610612744,1610612756,2019,105.0,96.0,201.0,102.65,108.85,113.05000000000001,117.75,32,8,24,0.25,30,11,19,0.3670000000000001,5,3,6,5
2019-12-26,1610612765,1610612764,2019,132.0,102.0,234.0,106.9,110.3,116.45,121.65,31,11,20,0.355,29,9,20,0.31,7,4,4,5
2019-12-26,1610612751,1610612752,2019,82.0,94.0,176.0,109.35,107.55,105.65,114.85,29,16,13,0.552,31,7,24,0.226,9,7,4,3
2019-12-26,1610612760,1610612763,2019,97.0,110.0,207.0,110.65,109.8,112.0,115.69999999999999,29,15,14,0.517,31,11,20,0.355,11,4,6,5
2019-12-26,1610612742,1610612759,2019,102.0,98.0,200.0,117.65,107.5,113.19999999999999,117.0,29,19,10,0.655,29,12,17,0.414,8,11,8,4
2019-12-26,1610612758,1610612750,2019,104.0,105.0,209.0,105.45,106.75,110.75,116.5,30,12,18,0.4,29,10,19,0.345,6,6,3,7
2019-12-26,1610612762,1610612757,2019,121.0,115.0,236.0,109.3,110.05,111.5,112.2,30,18,12,0.6,31,14,17,0.452,11,7,8,6
2019-12-25,1610612761,1610612738,2019,102.0,118.0,220.0,109.65,106.69999999999999,111.6,103.6,30,21,9,0.7,27,20,7,0.741,13,8,12,8
2019-12-25,1610612755,1610612749,2019,121.0,109.0,230.0,108.8,105.44999999999999,120.15,104.85,32,22,10,0.688,31,27,4,0.871,15,7,15,12
2019-12-25,1610612744,1610612745,2019,116.0,104.0,220.0,103.19999999999999,109.55,120.15,112.4,31,7,24,0.226,30,21,9,0.7,4,3,10,11
2019-12-25,1610612747,1610612746,2019,106.0,111.0,217.0,111.44999999999999,104.5,117.35,108.0,30,24,6,0.8,32,22,10,0.688,10,14,14,8
2019-12-25,1610612743,1610612740,2019,100.0,112.0,212.0,108.25,101.3,109.69999999999999,115.80000000000001,29,21,8,0.7240000000000001,31,8,23,0.258,13,8,4,4
2019-12-23,1610612739,1610612737,2019,121.0,118.0,239.0,103.05,114.75,109.0,120.55000000000001,29,8,21,0.276,30,6,24,0.2,5,3,3,3
2019-12-23,1610612765,1610612755,2019,109.0,125.0,234.0,107.85,109.19999999999999,107.75,105.3,30,11,19,0.3670000000000001,31,21,10,0.677,7,4,15,6
2019-12-23,1610612754,1610612761,2019,120.0,115.0,235.0,108.4,104.85,110.0,105.9,30,20,10,0.667,29,21,8,0.7240000000000001,13,7,13,8
2019-12-23,1610612752,1610612764,2019,115.0,121.0,236.0,105.0,113.95,115.6,121.75,30,7,23,0.233,28,8,20,0.28600000000000003,4,3,4,4
2019-12-23,1610612753,1610612741,2019,103.0,95.0,198.0,107.15,107.1,105.8,105.2,29,12,17,0.414,31,12,19,0.387,8,4,6,6
2019-12-23,1610612748,1610612762,2019,107.0,104.0,211.0,113.35,108.3,109.4,110.05,29,21,8,0.7240000000000001,29,18,11,0.621,12,9,11,7
2019-12-23,1610612763,1610612759,2019,115.0,145.0,260.0,111.94999999999999,115.0,110.94999999999999,116.65,30,11,19,0.3670000000000001,28,11,17,0.39299999999999996,6,5,8,3
2019-12-23,1610612756,1610612743,2019,111.0,113.0,224.0,113.9,117.7,107.95,101.85,29,11,18,0.379,28,20,8,0.7140000000000001,6,5,13,7
2019-12-23,1610612757,1610612740,2019,94.0,102.0,196.0,112.1,112.80000000000001,109.3,116.55000000000001,30,14,16,0.467,30,7,23,0.233,8,6,4,3
2019-12-23,1610612758,1610612745,2019,104.0,113.0,217.0,104.95,106.15,120.6,113.0,29,12,17,0.414,29,20,9,0.69,6,6,10,10
2019-12-23,1610612744,1610612750,2019,113.0,104.0,217.0,101.9,109.0,111.55,116.55000000000001,30,6,24,0.2,28,10,18,0.35700000000000004,3,3,3,7
2019-12-22,1610612761,1610612742,2019,110.0,107.0,217.0,110.15,105.4,119.2,108.1,28,20,8,0.7140000000000001,28,19,9,0.679,12,8,8,11
2019-12-22,1610612738,1610612766,2019,119.0,93.0,212.0,110.85,104.05000000000001,103.4,109.30000000000001,26,19,7,0.731,32,13,19,0.406,11,8,7,6
2019-12-22,1610612749,1610612754,2019,117.0,89.0,206.0,120.4,106.3,109.94999999999999,105.1,30,26,4,0.867,29,20,9,0.69,14,12,13,7
2019-12-22,1610612760,1610612746,2019,118.0,112.0,230.0,110.44999999999999,109.6,117.45,107.05000000000001,28,14,14,0.5,31,22,9,0.71,10,4,14,8
2019-12-22,1610612747,1610612743,2019,104.0,128.0,232.0,112.25,102.65,106.6,101.35,29,24,5,0.828,27,19,8,0.7040000000000001,10,14,13,6
2019-12-21,1610612766,1610612762,2019,107.0,114.0,221.0,103.9,109.55000000000001,109.8,110.1,31,13,18,0.419,28,17,11,0.607,7,6,11,6
2019-12-21,1610612751,1610612737,2019,122.0,112.0,234.0,109.4,107.75,108.45,121.95,28,15,13,0.536,29,6,23,0.207,8,7,3,3
2019-12-21,1610612765,1610612741,2019,107.0,119.0,226.0,108.2,109.25,104.6,105.25,29,11,18,0.379,30,11,19,0.3670000000000001,7,4,6,5
2019-12-21,1610612755,1610612764,2019,125.0,108.0,233.0,107.15,104.19999999999999,116.25,121.75,30,20,10,0.667,27,8,19,0.29600000000000004,14,6,4,4
2019-12-21,1610612752,1610612749,2019,102.0,123.0,225.0,105.19999999999999,112.95,120.95,106.5,29,7,22,0.24100000000000002,29,25,4,0.862,4,3,14,11
2019-12-21,1610612763,1610612758,2019,119.0,115.0,234.0,111.35,114.55,104.85,105.5,29,10,19,0.345,28,12,16,0.429,5,5,6,6
2019-12-21,1610612759,1610612746,2019,109.0,134.0,243.0,111.25,116.7,117.1,108.2,27,11,16,0.40700000000000003,30,21,9,0.7,8,3,14,7
2019-12-21,1610612756,1610612745,2019,125.0,139.0,264.0,113.4,116.9,119.5,111.45,28,11,17,0.39299999999999996,28,19,9,0.679,6,5,10,9
2019-12-21,1610612757,1610612750,2019,113.0,106.0,219.0,112.65,113.15,112.3,117.75,29,13,16,0.44799999999999995,27,10,17,0.37,7,6,3,7
2019-12-20,1610612739,1610612763,2019,114.0,107.0,221.0,102.19999999999999,114.8,110.3,114.75,28,7,21,0.25,28,10,18,0.35700000000000004,4,3,5,5
2019-12-20,1610612754,1610612758,2019,119.0,105.0,224.0,109.55,104.1,104.45,105.35,28,19,9,0.679,27,12,15,0.444,12,7,6,6
2019-12-20,1610612738,1610612765,2019,114.0,93.0,207.0,110.95,104.65,108.5,109.30000000000001,25,18,7,0.72,28,11,17,0.39299999999999996,10,8,7,4
2019-12-20,1610612761,1610612764,2019,122.0,118.0,240.0,110.65,104.30000000000001,117.2,121.44999999999999,27,19,8,0.7040000000000001,26,8,18,0.308,11,8,4,4
2019-12-20,1610612748,1610612752,2019,129.0,114.0,243.0,113.35,107.6,104.6,112.6,28,20,8,0.7140000000000001,28,7,21,0.25,11,9,4,3
2019-12-20,1610612755,1610612742,2019,98.0,117.0,215.0,108.0,103.55,119.9,108.75,29,20,9,0.69,27,18,9,0.667,14,6,8,10
2019-12-20,1610612760,1610612756,2019,126.0,108.0,234.0,109.25,108.9,114.05,116.1,27,13,14,0.48100000000000004,27,11,16,0.40700000000000003,9,4,6,5
2019-12-20,1610612743,1610612750,2019,109.0,100.0,209.0,106.2,101.0,113.85,117.75,26,18,8,0.6920000000000001,26,10,16,0.385,12,6,3,7
2019-12-20,1610612757,1610612753,2019,118.0,103.0,221.0,112.5,113.95,106.85,106.85,28,12,16,0.429,28,12,16,0.429,6,6,8,4
2019-12-20,1610612744,1610612740,2019,106.0,102.0,208.0,102.1,110.25,109.94999999999999,116.75,29,5,24,0.172,29,7,22,0.24100000000000002,2,3,4,3
2019-12-19,1610612737,1610612762,2019,106.0,111.0,217.0,108.55000000000001,121.4,108.95,110.05,28,6,22,0.214,27,16,11,0.593,3,3,11,5
2019-12-19,1610612749,1610612747,2019,111.0,104.0,215.0,120.6,105.8,112.5,102.5,28,24,4,0.857,28,24,4,0.857,13,11,10,14
2019-12-19,1610612759,1610612751,2019,118.0,105.0,223.0,111.4,117.05000000000001,109.85,107.80000000000001,26,10,16,0.385,27,15,12,0.556,7,3,8,7
2019-12-19,1610612746,1610612745,2019,117.0,122.0,239.0,116.6,107.15,118.75,110.6,29,21,8,0.7240000000000001,27,18,9,0.667,14,7,10,8
2019-12-18,1610612739,1610612766,2019,100.0,98.0,198.0,102.85,115.85,104.15,109.65,27,6,21,0.222,30,13,17,0.433,3,3,7,6
2019-12-18,1610612765,1610612761,2019,99.0,112.0,211.0,109.65,108.80000000000001,110.3,105.1,27,11,16,0.40700000000000003,26,18,8,0.6920000000000001,7,4,11,7
2019-12-18,1610612764,1610612741,2019,109.0,110.0,219.0,119.65,123.9,104.65,105.65,25,8,17,0.32,29,10,19,0.345,4,4,6,4
2019-12-18,1610612755,1610612748,2019,104.0,108.0,212.0,108.25,103.35,111.95,107.15,28,20,8,0.7140000000000001,27,19,8,0.7040000000000001,14,6,11,8
2019-12-18,1610612750,1610612740,2019,99.0,107.0,206.0,115.15,118.35,110.85,118.55000000000001,25,10,15,0.4,28,6,22,0.214,3,7,4,2
2019-12-18,1610612760,1610612763,2019,126.0,122.0,248.0,108.69999999999999,108.0,108.75,114.45,26,12,14,0.462,27,10,17,0.37,8,4,5,5
2019-12-18,1610612743,1610612753,2019,113.0,104.0,217.0,106.6,102.05000000000001,106.94999999999999,106.55,25,17,8,0.68,27,12,15,0.444,11,6,8,4
2019-12-18,1610612742,1610612738,2019,103.0,109.0,212.0,119.85,108.6,110.9,103.85,26,18,8,0.6920000000000001,24,17,7,0.708,8,10,10,7
2019-12-18,1610612757,1610612744,2019,122.0,112.0,234.0,112.80000000000001,114.80000000000001,101.5,109.55000000000001,27,11,16,0.40700000000000003,28,5,23,0.179,5,6,2,3
2019-12-17,1610612766,1610612758,2019,110.0,102.0,212.0,104.15,110.30000000000001,104.2,104.8,29,12,17,0.414,26,12,14,0.462,6,6,6,6
2019-12-17,1610612754,1610612747,2019,105.0,102.0,207.0,109.9,104.3,113.9,103.6,27,18,9,0.667,27,24,3,0.889,11,7,10,14
2019-12-17,1610612752,1610612737,2019,143.0,120.0,263.0,101.80000000000001,112.0,108.15,120.65,27,6,21,0.222,27,6,21,0.222,3,3,3,3
2019-12-17,1610612740,1610612751,2019,101.0,108.0,209.0,111.6,119.25,110.05,109.65,27,6,21,0.222,26,14,12,0.5379999999999999,4,2,8,6
2019-12-17,1610612762,1610612753,2019,109.0,102.0,211.0,108.80000000000001,110.15,106.55,106.19999999999999,26,15,11,0.5770000000000001,26,12,14,0.462,10,5,8,4
2019-12-17,1610612746,1610612756,2019,120.0,99.0,219.0,116.80000000000001,108.65,114.44999999999999,115.5,28,20,8,0.7140000000000001,26,11,15,0.423,13,7,6,5
2019-12-16,1610612765,1610612764,2019,119.0,133.0,252.0,109.35,107.6,119.65,124.95,26,11,15,0.423,24,7,17,0.292,7,4,4,3
2019-12-16,1610612761,1610612739,2019,133.0,113.0,246.0,109.85,105.44999999999999,102.85,114.2,25,17,8,0.68,26,6,20,0.231,10,7,3,3
2019-12-16,1610612745,1610612759,2019,109.0,107.0,216.0,119.75,110.85,112.4,117.1,26,17,9,0.654,25,10,15,0.4,9,8,7,3
2019-12-16,1610612763,1610612748,2019,118.0,111.0,229.0,108.95,115.80000000000001,112.6,106.65,26,9,17,0.34600000000000003,26,19,7,0.731,4,5,11,8
2019-12-16,1610612749,1610612742,2019,116.0,120.0,236.0,121.65,106.25,119.3,108.1,27,24,3,0.889,25,17,8,0.68,13,11,8,9
2019-12-16,1610612760,1610612741,2019,109.0,106.0,215.0,108.19999999999999,107.8,104.25,105.45,25,11,14,0.44,28,10,18,0.35700000000000004,7,4,6,4
2019-12-16,1610612756,1610612757,2019,110.0,111.0,221.0,115.85,115.55,112.30000000000001,114.65,25,11,14,0.44,26,10,16,0.385,6,5,5,5
2019-12-15,1610612740,1610612753,2019,119.0,130.0,249.0,110.85,118.85,104.8,105.44999999999999,26,6,20,0.231,25,11,14,0.44,4,2,8,3
2019-12-15,1610612754,1610612766,2019,107.0,85.0,192.0,110.6,105.35,105.19999999999999,110.65,26,17,9,0.654,28,12,16,0.429,10,7,6,6
2019-12-15,1610612737,1610612747,2019,96.0,101.0,197.0,108.2,120.9,115.0,104.55,26,6,20,0.231,26,23,3,0.885,3,3,10,13
2019-12-15,1610612751,1610612755,2019,109.0,89.0,198.0,110.0,111.1,109.25,103.6,25,13,12,0.52,27,20,7,0.741,7,6,14,6
2019-12-15,1610612743,1610612752,2019,111.0,105.0,216.0,106.05,101.65,101.65,111.65,24,16,8,0.667,26,6,20,0.231,10,6,3,3
2019-12-15,1610612744,1610612758,2019,79.0,100.0,179.0,103.05000000000001,110.6,105.25,106.3,27,5,22,0.185,25,11,14,0.44,2,3,6,5
2019-12-14,1610612756,1610612759,2019,119.0,121.0,240.0,115.3,115.69999999999999,111.2,116.30000000000001,24,11,13,0.45799999999999996,24,9,15,0.375,6,5,7,2
2019-12-14,1610612761,1610612751,2019,110.0,102.0,212.0,110.6,106.0,110.85,111.35,24,16,8,0.667,24,13,11,0.542,9,7,7,6
2019-12-14,1610612741,1610612746,2019,109.0,106.0,215.0,104.35,106.0,116.15,108.3,27,9,18,0.33299999999999996,27,20,7,0.741,5,4,13,7
2019-12-14,1610612763,1610612764,2019,128.0,111.0,239.0,109.4,116.30000000000001,119.4,124.6,25,8,17,0.32,23,7,16,0.304,3,5,4,3
2019-12-14,1610612742,1610612748,2019,118.0,122.0,240.0,118.75,107.3,110.95,106.2,24,17,7,0.708,25,18,7,0.72,8,9,11,7
2019-12-14,1610612749,1610612739,2019,125.0,108.0,233.0,121.6,106.6,102.19999999999999,113.05000000000001,26,23,3,0.885,25,6,19,0.24,12,11,3,3
2019-12-14,1610612745,1610612765,2019,107.0,115.0,222.0,120.19999999999999,110.69999999999999,108.9,107.85,25,17,8,0.68,25,10,15,0.4,9,8,7,3
2019-12-14,1610612743,1610612760,2019,110.0,102.0,212.0,106.0,101.0,108.69999999999999,108.35,23,15,8,0.652,24,11,13,0.45799999999999996,9,6,7,4
2019-12-13,1610612753,1610612745,2019,107.0,130.0,237.0,103.8,103.5,118.69999999999999,111.8,24,11,13,0.45799999999999996,24,16,8,0.667,8,3,9,7
2019-12-13,1610612755,1610612740,2019,116.0,109.0,225.0,108.35,103.0,110.6,118.8,26,19,7,0.731,25,6,19,0.24,13,6,4,2
2019-12-13,1610612748,1610612747,2019,110.0,113.0,223.0,111.05000000000001,105.4,115.25,104.65,24,18,6,0.75,25,22,3,0.88,11,7,10,12
2019-12-13,1610612737,1610612754,2019,100.0,110.0,210.0,108.35,120.65,111.0,105.75,25,6,19,0.24,25,16,9,0.64,3,3,10,6
2019-12-13,1610612741,1610612766,2019,73.0,83.0,156.0,106.7,106.95,105.69999999999999,111.35,26,9,17,0.34600000000000003,27,11,16,0.40700000000000003,5,4,6,5
2019-12-13,1610612763,1610612749,2019,114.0,127.0,241.0,108.7,115.30000000000001,121.4,105.45,24,8,16,0.33299999999999996,25,22,3,0.88,3,5,12,10
2019-12-13,1610612762,1610612744,2019,114.0,106.0,220.0,108.6,109.65,102.45,110.9,25,14,11,0.56,26,5,21,0.192,9,5,2,3
2019-12-13,1610612750,1610612746,2019,117.0,124.0,241.0,114.6,118.85,114.75,107.94999999999999,24,10,14,0.41700000000000004,26,19,7,0.731,3,7,13,6
2019-12-13,1610612758,1610612752,2019,101.0,103.0,204.0,105.8,107.25,100.65,111.35,24,11,13,0.45799999999999996,25,5,20,0.2,6,5,3,2
2019-12-12,1610612738,1610612755,2019,109.0,115.0,224.0,111.05000000000001,103.4,109.05000000000001,103.95,23,17,6,0.7390000000000001,25,18,7,0.72,10,7,13,5
2019-12-12,1610612759,1610612739,2019,109.0,117.0,226.0,110.55000000000001,115.6,101.94999999999999,114.05000000000001,23,9,14,0.391,24,5,19,0.20800000000000002,7,2,3,2
2019-12-12,1610612765,1610612742,2019,111.0,122.0,233.0,108.15,106.45,118.80000000000001,107.55,24,10,14,0.41700000000000004,23,16,7,0.696,7,3,8,8
2019-12-12,1610612743,1610612757,2019,114.0,99.0,213.0,105.6,101.5,113.25,115.30000000000001,22,14,8,0.636,25,10,15,0.4,8,6,5,5
2019-12-11,1610612739,1610612745,2019,110.0,116.0,226.0,102.0,114.80000000000001,118.69999999999999,112.44999999999999,23,5,18,0.217,23,15,8,0.652,3,2,9,6
2019-12-11,1610612754,1610612738,2019,122.0,117.0,239.0,110.30000000000001,104.65,111.15,102.95,24,15,9,0.625,22,17,5,0.773,9,6,10,7
2019-12-11,1610612753,1610612747,2019,87.0,96.0,183.0,104.0,104.85,115.6,105.1,23,11,12,0.478,24,21,3,0.875,8,3,10,11
2019-12-11,1610612761,1610612746,2019,92.0,112.0,204.0,111.2,105.15,115.25,109.85,23,16,7,0.696,25,18,7,0.72,9,7,13,5
2019-12-11,1610612751,1610612766,2019,108.0,113.0,221.0,111.1,111.15,105.94999999999999,111.5,23,13,10,0.565,26,10,16,0.385,7,6,6,4
2019-12-11,1610612741,1610612737,2019,136.0,102.0,238.0,104.6,107.7,109.5,119.9,25,8,17,0.32,24,6,18,0.25,4,4,3,3
2019-12-11,1610612750,1610612762,2019,116.0,127.0,243.0,114.6,117.94999999999999,107.3,108.95,23,10,13,0.435,24,13,11,0.542,3,7,9,4
2019-12-11,1610612756,1610612763,2019,108.0,115.0,223.0,115.6,115.4,108.0,115.9,23,11,12,0.478,23,7,16,0.304,6,5,3,4
2019-12-11,1610612749,1610612740,2019,127.0,112.0,239.0,120.8,105.1,111.15,118.75,24,21,3,0.875,24,6,18,0.25,11,10,4,2
2019-12-11,1610612758,1610612760,2019,94.0,93.0,187.0,106.35,107.0,109.65,109.44999999999999,23,10,13,0.435,23,11,12,0.478,5,5,7,4
2019-12-11,1610612744,1610612752,2019,122.0,124.0,246.0,102.45,111.75,99.9,110.9,25,5,20,0.2,24,4,20,0.16699999999999998,2,3,3,1
2019-12-10,1610612766,1610612764,2019,114.0,107.0,221.0,104.6,111.55,120.15,125.1,25,9,16,0.36,22,7,15,0.318,5,4,4,3
2019-12-10,1610612755,1610612743,2019,97.0,92.0,189.0,109.9,104.65,106.4,101.65,24,17,7,0.708,21,14,7,0.667,12,5,8,6
2019-12-10,1610612748,1610612737,2019,135.0,121.0,256.0,110.30000000000001,104.4,109.1,119.35,23,17,6,0.7390000000000001,23,6,17,0.261,10,7,3,3
2019-12-10,1610612757,1610612752,2019,115.0,87.0,202.0,112.5,116.35,101.1,111.15,24,9,15,0.375,23,4,19,0.174,4,5,3,1
2019-12-09,1610612754,1610612746,2019,99.0,110.0,209.0,110.45,103.9,116.80000000000001,111.0,23,15,8,0.652,24,17,7,0.708,9,6,13,4
2019-12-09,1610612738,1610612739,2019,110.0,88.0,198.0,111.55,102.15,101.85,114.0,21,16,5,0.762,22,5,17,0.22699999999999998,9,7,3,2
2019-12-09,1610612741,1610612761,2019,92.0,93.0,185.0,105.6,108.95,111.95,104.75,24,8,16,0.33299999999999996,22,15,7,0.682,4,4,9,6
2019-12-09,1610612745,1610612758,2019,118.0,119.0,237.0,119.1,112.65,106.4,107.30000000000001,22,15,7,0.682,22,9,13,0.409,9,6,5,4
2019-12-09,1610612749,1610612753,2019,110.0,101.0,211.0,121.75,105.65,103.9,104.5,23,20,3,0.87,22,11,11,0.5,10,10,8,3
2019-12-09,1610612740,1610612765,2019,103.0,105.0,208.0,112.1,118.85,108.55,107.55000000000001,23,6,17,0.261,23,9,14,0.391,4,2,7,2
2019-12-09,1610612756,1610612750,2019,125.0,109.0,234.0,114.1,114.75,113.9,117.55,22,10,12,0.455,22,10,12,0.455,5,5,3,7
2019-12-09,1610612762,1610612760,2019,90.0,104.0,194.0,108.44999999999999,107.80000000000001,109.19999999999999,109.94999999999999,23,13,10,0.565,22,10,12,0.455,9,4,7,3
2019-12-09,1610612744,1610612763,2019,102.0,110.0,212.0,103.55000000000001,111.4,107.05,116.0,24,5,19,0.20800000000000002,22,6,16,0.273,2,3,3,3
2019-12-08,1610612751,1610612743,2019,105.0,102.0,207.0,112.15,112.4,106.65,101.5,22,12,10,0.545,20,14,6,0.7,6,6,8,6
2019-12-08,1610612766,1610612737,2019,107.0,122.0,229.0,105.35,111.44999999999999,107.85,119.6,24,9,15,0.375,22,5,17,0.22699999999999998,5,4,3,2
2019-12-08,1610612748,1610612741,2019,110.0,105.0,215.0,111.45,106.35,105.85,108.55,22,16,6,0.727,23,8,15,0.348,9,7,4,4
2019-12-08,1610612755,1610612761,2019,110.0,104.0,214.0,110.25,104.2,112.05000000000001,104.85,23,16,7,0.696,21,15,6,0.7140000000000001,11,5,9,6
2019-12-08,1610612764,1610612746,2019,119.0,135.0,254.0,119.6,124.1,116.5,111.1,21,7,14,0.33299999999999996,23,16,7,0.696,4,3,13,3
2019-12-08,1610612742,1610612758,2019,106.0,110.0,216.0,119.0,108.0,106.55000000000001,106.6,22,16,6,0.727,21,8,13,0.381,8,8,5,3
2019-12-08,1610612757,1610612760,2019,96.0,108.0,204.0,113.6,117.65,107.3,110.5,23,9,14,0.391,21,9,12,0.429,4,5,7,2
2019-12-08,1610612747,1610612750,2019,142.0,125.0,267.0,114.5,103.9,113.7,115.4,23,20,3,0.87,21,10,11,0.47600000000000003,9,11,3,7
2019-12-07,1610612742,1610612740,2019,130.0,84.0,214.0,118.45,109.85,114.0,118.85,21,15,6,0.7140000000000001,22,6,16,0.273,7,8,4,2
2019-12-07,1610612752,1610612754,2019,103.0,104.0,207.0,100.55,111.6,109.95,103.55,22,4,18,0.182,22,14,8,0.636,3,1,9,5
2019-12-07,1610612755,1610612739,2019,141.0,94.0,235.0,108.55000000000001,104.15,100.75,112.85,22,15,7,0.682,21,5,16,0.23800000000000002,10,5,3,2
2019-12-07,1610612745,1610612756,2019,115.0,109.0,224.0,118.9,113.05,115.35,114.9,21,14,7,0.667,21,10,11,0.47600000000000003,8,6,5,5
2019-12-07,1610612762,1610612763,2019,126.0,112.0,238.0,107.15,106.95,107.65,115.65,22,12,10,0.545,21,6,15,0.28600000000000003,8,4,3,3
2019-12-06,1610612766,1610612751,2019,104.0,111.0,215.0,105.1,111.94999999999999,112.05,112.85,23,9,14,0.391,21,11,10,0.524,5,4,6,5
2019-12-06,1610612739,1610612753,2019,87.0,93.0,180.0,102.25,113.75,104.1,104.55,20,5,15,0.25,21,10,11,0.47600000000000003,3,2,8,2
2019-12-06,1610612765,1610612754,2019,108.0,101.0,209.0,108.7,108.35,109.85,103.65,22,8,14,0.364,21,14,7,0.667,6,2,9,5
2019-12-06,1610612738,1610612743,2019,108.0,95.0,203.0,111.5,102.7,107.45,100.65,20,15,5,0.75,19,14,5,0.737,8,7,8,6
2019-12-06,1610612748,1610612764,2019,112.0,103.0,215.0,111.85,105.55,119.3,122.75,21,15,6,0.7140000000000001,20,7,13,0.35,8,7,4,3
2019-12-06,1610612741,1610612744,2019,98.0,100.0,198.0,106.55000000000001,108.85,103.95,112.2,22,8,14,0.364,23,4,19,0.174,4,4,2,2
2019-12-06,1610612760,1610612750,2019,139.0,127.0,266.0,106.35,108.75,113.7,114.75,20,8,12,0.4,20,10,10,0.5,6,2,3,7
2019-12-06,1610612749,1610612746,2019,119.0,91.0,210.0,122.1,107.65,118.7,111.69999999999999,22,19,3,0.8640000000000001,22,16,6,0.727,9,10,13,3
2019-12-06,1610612759,1610612758,2019,105.0,104.0,209.0,110.95,115.9,105.4,107.0,22,8,14,0.364,20,8,12,0.4,6,2,5,3
2019-12-06,1610612757,1610612747,2019,113.0,136.0,249.0,112.65,116.1,113.65,103.75,22,9,13,0.409,22,19,3,0.8640000000000001,4,5,9,10
2019-12-05,1610612764,1610612755,2019,119.0,113.0,232.0,118.3,122.3,108.15,103.35,19,6,13,0.316,21,15,6,0.7140000000000001,3,3,10,5
2019-12-05,1610612752,1610612743,2019,92.0,129.0,221.0,101.2,110.05,106.25,100.75,21,4,17,0.19,18,13,5,0.722,3,1,8,5
2019-12-05,1610612761,1610612745,2019,109.0,119.0,228.0,113.1,105.0,120.9,115.5,20,15,5,0.75,20,13,7,0.65,9,6,8,5
2019-12-05,1610612740,1610612756,2019,132.0,139.0,271.0,113.55,118.6,112.80000000000001,113.55000000000001,21,6,15,0.28600000000000003,20,9,11,0.45,4,2,5,4
2019-12-04,1610612766,1610612744,2019,106.0,91.0,197.0,106.1,113.65,105.35,113.15,22,8,14,0.364,22,4,18,0.182,4,4,2,2
2019-12-04,1610612765,1610612749,2019,103.0,127.0,230.0,108.55,107.85,121.0,108.3,21,8,13,0.381,21,18,3,0.857,6,2,9,9
2019-12-04,1610612753,1610612756,2019,128.0,114.0,242.0,102.45,103.0,112.55000000000001,113.15,20,9,11,0.45,19,9,10,0.474,7,2,5,4
2019-12-04,1610612737,1610612751,2019,118.0,130.0,248.0,107.1,118.05000000000001,112.19999999999999,113.65,21,5,16,0.23800000000000002,20,10,10,0.5,3,2,6,4
2019-12-04,1610612738,1610612748,2019,112.0,93.0,205.0,110.94999999999999,103.7,112.5,104.8,19,14,5,0.737,20,15,5,0.75,7,7,8,7
2019-12-04,1610612741,1610612763,2019,106.0,99.0,205.0,105.45,109.3,107.35,115.35,21,7,14,0.33299999999999996,20,6,14,0.3,3,4,3,3
2019-12-04,1610612760,1610612754,2019,100.0,107.0,207.0,105.6,108.25,111.1,105.2,19,8,11,0.42100000000000004,20,13,7,0.65,6,2,9,4
2019-12-04,1610612742,1610612750,2019,121.0,114.0,235.0,117.80000000000001,109.15,112.8,114.6,20,14,6,0.7,19,10,9,0.526,6,8,3,7
2019-12-04,1610612762,1610612747,2019,96.0,121.0,217.0,108.25,107.2,112.7,104.55,21,12,9,0.5710000000000001,21,18,3,0.857,8,4,9,9
2019-12-04,1610612757,1610612758,2019,127.0,116.0,243.0,112.15,116.25,104.35,106.85,21,8,13,0.381,19,8,11,0.42100000000000004,3,5,5,3
2019-12-03,1610612739,1610612765,2019,94.0,127.0,221.0,103.05,112.35,108.15,108.65,19,5,14,0.263,20,7,13,0.35,3,2,6,1
2019-12-03,1610612764,1610612753,2019,120.0,127.0,247.0,117.8,121.75,101.85,101.55,18,6,12,0.33299999999999996,19,8,11,0.42100000000000004,3,3,7,1
2019-12-03,1610612761,1610612748,2019,110.0,121.0,231.0,112.15,104.2,111.9,105.1,19,15,4,0.789,19,14,5,0.737,9,6,8,6
2019-12-03,1610612740,1610612742,2019,97.0,118.0,215.0,114.5,118.85,117.0,108.65,20,6,14,0.3,19,13,6,0.684,4,2,6,7
2019-12-03,1610612759,1610612745,2019,135.0,133.0,268.0,110.4,115.35,121.45,115.4,21,7,14,0.33299999999999996,19,13,6,0.684,5,2,8,5
2019-12-03,1610612743,1610612747,2019,96.0,105.0,201.0,106.85,100.85,112.6,105.94999999999999,17,13,4,0.765,20,17,3,0.85,8,5,9,8
2019-12-03,1610612746,1610612757,2019,117.0,97.0,214.0,118.1,111.55,112.4,115.35,21,15,6,0.7140000000000001,20,8,12,0.4,12,3,3,5
2019-12-02,1610612766,1610612756,2019,104.0,109.0,213.0,106.4,114.0,112.75,115.4,21,8,13,0.381,18,8,10,0.444,4,4,5,3
2019-12-02,1610612755,1610612762,2019,103.0,94.0,197.0,107.65,104.25,108.35,106.80000000000001,20,14,6,0.7,20,12,8,0.6,9,5,8,4
2019-12-02,1610612737,1610612744,2019,104.0,79.0,183.0,106.30000000000001,118.95,107.0,114.4,20,4,16,0.2,21,4,17,0.19,2,2,2,2
2019-12-02,1610612763,1610612754,2019,104.0,117.0,221.0,107.4,115.2,109.8,104.95,19,6,13,0.316,19,12,7,0.632,3,3,9,3
2019-12-02,1610612749,1610612752,2019,132.0,88.0,220.0,120.3,108.7,102.0,108.4,20,17,3,0.85,20,4,16,0.2,8,9,3,1
2019-12-02,1610612758,1610612741,2019,106.0,113.0,219.0,105.6,107.8,106.05,110.3,18,8,10,0.444,20,6,14,0.3,5,3,3,3
2019-12-01,1610612751,1610612748,2019,106.0,109.0,215.0,112.25,114.35,113.0,106.1,19,10,9,0.526,18,13,5,0.722,6,4,8,5
2019-12-01,1610612752,1610612738,2019,104.0,113.0,217.0,101.55,108.65,111.19999999999999,103.25,19,4,15,0.21100000000000002,18,13,5,0.722,3,1,7,6
2019-12-01,1610612750,1610612763,2019,107.0,115.0,222.0,112.44999999999999,114.85,107.75,115.45,18,10,8,0.556,18,5,13,0.278,3,7,3,2
2019-12-01,1610612747,1610612742,2019,100.0,114.0,214.0,112.35,104.55,117.15,109.85,19,17,2,0.895,18,12,6,0.667,9,8,6,6
2019-12-01,1610612765,1610612759,2019,132.0,98.0,230.0,107.0,109.0,111.9,114.45,19,6,13,0.316,20,7,13,0.35,5,1,5,2
2019-12-01,1610612740,1610612760,2019,104.0,107.0,211.0,115.7,119.85,106.0,108.94999999999999,19,6,13,0.316,18,7,11,0.389,4,2,6,1
2019-12-01,1610612753,1610612744,2019,100.0,96.0,196.0,101.55,101.0,108.9,115.55,18,7,11,0.389,20,4,16,0.2,6,1,2,2
2019-12-01,1610612761,1610612762,2019,130.0,110.0,240.0,112.35,105.15,107.15,105.05000000000001,18,14,4,0.778,19,12,7,0.632,8,6,8,4
2019-12-01,1610612746,1610612764,2019,150.0,125.0,275.0,115.75,110.15,116.55,119.65,20,14,6,0.7,17,6,11,0.353,11,3,3,3
2019-11-30,1610612758,1610612743,2019,100.0,97.0,197.0,107.05,109.6,107.4,101.8,17,7,10,0.41200000000000003,16,13,3,0.813,4,3,8,5
2019-11-30,1610612755,1610612754,2019,119.0,116.0,235.0,107.0,102.75,107.7,103.2,19,13,6,0.684,18,12,6,0.667,8,5,9,3
2019-11-30,1610612745,1610612737,2019,158.0,111.0,269.0,119.25,116.25,106.6,116.05,18,12,6,0.667,19,4,15,0.21100000000000002,7,5,2,2
2019-11-30,1610612749,1610612766,2019,137.0,96.0,233.0,120.1,108.85,106.4,112.7,19,16,3,0.8420000000000001,20,8,12,0.4,7,9,4,4
2019-11-29,1610612751,1610612738,2019,112.0,107.0,219.0,111.19999999999999,112.85,110.5,103.0,18,9,9,0.5,17,13,4,0.765,5,4,7,6
2019-11-29,1610612765,1610612766,2019,107.0,110.0,217.0,107.85,109.35,105.95,113.35,18,6,12,0.33299999999999996,19,7,12,0.368,5,1,4,3
2019-11-29,1610612753,1610612761,2019,83.0,90.0,173.0,102.3,101.85,114.0,106.35,17,7,10,0.41200000000000003,17,13,4,0.765,6,1,8,5
2019-11-29,1610612739,1610612749,2019,110.0,119.0,229.0,102.3,112.3,120.0,108.9,18,5,13,0.278,18,15,3,0.833,3,2,7,8
2019-11-29,1610612752,1610612755,2019,95.0,101.0,196.0,102.6,109.45,107.80000000000001,103.55000000000001,18,4,14,0.222,18,12,6,0.667,3,1,8,4
2019-11-29,1610612754,1610612737,2019,105.0,104.0,209.0,107.95,103.95,106.05000000000001,116.35,17,11,6,0.647,18,4,14,0.222,8,3,2,2
2019-11-29,1610612748,1610612744,2019,122.0,105.0,227.0,112.25,105.3,108.25,115.45,17,12,5,0.706,19,4,15,0.21100000000000002,7,5,2,2
2019-11-29,1610612763,1610612762,2019,94.0,103.0,197.0,109.75,116.95,108.35,106.75,17,5,12,0.294,18,11,7,0.611,3,2,8,3
2019-11-29,1610612760,1610612740,2019,109.0,104.0,213.0,106.5,109.94999999999999,116.35,120.2,17,6,11,0.353,18,6,12,0.33299999999999996,5,1,4,2
2019-11-29,1610612759,1610612746,2019,107.0,97.0,204.0,112.55000000000001,115.15,116.1,110.85,19,6,13,0.316,19,14,5,0.737,4,2,11,3
2019-11-29,1610612756,1610612742,2019,113.0,120.0,233.0,113.6,115.5,116.35,110.15,17,8,9,0.47100000000000003,17,11,6,0.647,5,3,6,5
2019-11-29,1610612757,1610612741,2019,107.0,103.0,210.0,112.0,115.7,106.15,109.5,19,7,12,0.368,19,6,13,0.316,2,5,3,3
2019-11-29,1610612747,1610612764,2019,125.0,103.0,228.0,112.4,104.05,117.0,118.05,18,16,2,0.889,16,6,10,0.375,8,8,3,3
2019-11-27,1610612738,1610612751,2019,121.0,110.0,231.0,110.25,103.65,111.4,112.35,16,12,4,0.75,17,9,8,0.529,6,6,5,4
2019-11-27,1610612766,1610612765,2019,102.0,101.0,203.0,105.2,113.3,108.6,109.75,18,6,12,0.33299999999999996,17,6,11,0.353,3,3,5,1
2019-11-27,1610612739,1610612753,2019,104.0,116.0,220.0,101.94999999999999,112.69999999999999,102.75,101.1,17,5,12,0.294,16,6,10,0.375,3,2,6,0
2019-11-27,1610612754,1610612762,2019,121.0,102.0,223.0,107.45,104.80000000000001,108.2,107.35,16,10,6,0.625,17,11,6,0.647,7,3,8,3
2019-11-27,1610612755,1610612758,2019,97.0,91.0,188.0,108.55000000000001,104.05000000000001,108.9,110.5,17,11,6,0.647,16,7,9,0.43799999999999994,7,4,4,3
2019-11-27,1610612761,1610612752,2019,126.0,98.0,224.0,112.95,106.75,102.5,107.45,16,12,4,0.75,17,4,13,0.235,7,5,3,1
2019-11-27,1610612745,1610612748,2019,117.0,108.0,225.0,119.30000000000001,116.4,112.19999999999999,104.35,17,11,6,0.647,16,12,4,0.75,6,5,7,5
2019-11-27,1610612763,1610612746,2019,119.0,121.0,240.0,108.9,116.4,115.25,111.45,16,5,11,0.313,18,13,5,0.722,3,2,11,2
2019-11-27,1610612749,1610612737,2019,111.0,102.0,213.0,119.4,109.05,105.95,115.6,17,14,3,0.8240000000000001,17,4,13,0.235,6,8,2,2
2019-11-27,1610612759,1610612750,2019,101.0,113.0,214.0,112.7,114.05000000000001,112.75,115.35,18,6,12,0.33299999999999996,17,9,8,0.529,4,2,3,6
2019-11-27,1610612756,1610612764,2019,132.0,140.0,272.0,113.19999999999999,113.25,115.75,116.4,16,8,8,0.5,15,5,10,0.33299999999999996,5,3,3,2
2019-11-27,1610612740,1610612747,2019,110.0,114.0,224.0,116.0,120.1,110.55,103.1,17,6,11,0.353,17,15,2,0.882,4,2,8,7
2019-11-27,1610612757,1610612760,2019,136.0,119.0,255.0,111.15,115.15,105.25,108.85,18,6,12,0.33299999999999996,16,6,10,0.375,1,5,5,1
2019-11-27,1610612744,1610612741,2019,104.0,90.0,194.0,110.19999999999999,117.1,106.0,109.55,18,3,15,0.16699999999999998,18,6,12,0.33299999999999996,1,2,3,3
2019-11-26,1610612742,1610612746,2019,99.0,114.0,213.0,116.75,107.95,115.45,112.9,16,11,5,0.688,17,12,5,0.706,6,5,11,1
2019-11-26,1610612743,1610612764,2019,117.0,104.0,221.0,107.05000000000001,101.8,116.05,116.2,15,12,3,0.8,14,5,9,0.35700000000000004,7,5,3,2
2019-11-25,1610612739,1610612751,2019,106.0,108.0,214.0,101.15,112.9,111.0,113.15,16,5,11,0.313,16,8,8,0.5,3,2,5,3
2019-11-25,1610612765,1610612753,2019,103.0,88.0,191.0,108.0,111.1,103.15,101.69999999999999,16,5,11,0.313,15,6,9,0.4,4,1,6,0
2019-11-25,1610612754,1610612763,2019,126.0,114.0,240.0,106.4,103.45,107.65,115.9,15,9,6,0.6,15,5,10,0.33299999999999996,6,3,3,2
2019-11-25,1610612737,1610612750,2019,113.0,125.0,238.0,105.75,116.0,112.65,116.85,16,4,12,0.25,16,8,8,0.5,2,2,3,5
2019-11-25,1610612738,1610612758,2019,103.0,102.0,205.0,110.05000000000001,103.1,109.1,111.85,15,11,4,0.733,15,7,8,0.467,5,6,4,3
2019-11-25,1610612748,1610612766,2019,117.0,100.0,217.0,112.44999999999999,104.30000000000001,106.2,112.4,15,11,4,0.733,17,6,11,0.353,6,5,3,3
2019-11-25,1610612761,1610612755,2019,101.0,96.0,197.0,113.1,107.4,110.05000000000001,103.7,15,11,4,0.733,16,11,5,0.688,6,5,7,4
2019-11-25,1610612741,1610612757,2019,94.0,117.0,211.0,106.85,108.35,110.8,116.1,17,6,11,0.353,17,5,12,0.294,3,3,1,4
2019-11-25,1610612749,1610612762,2019,122.0,118.0,240.0,119.55,108.3,106.95,106.25,16,13,3,0.813,16,11,5,0.688,5,8,8,3
2019-11-25,1610612759,1610612747,2019,104.0,114.0,218.0,113.2,114.5,111.0,102.94999999999999,17,6,11,0.353,16,14,2,0.875,4,2,8,6
2019-11-25,1610612744,1610612760,2019,97.0,100.0,197.0,110.4,118.25,105.2,109.19999999999999,17,3,14,0.17600000000000002,15,5,10,0.33299999999999996,1,2,5,0
2019-11-24,1610612745,1610612742,2019,123.0,137.0,260.0,118.80000000000001,115.45,114.6,107.05000000000001,16,11,5,0.688,15,10,5,0.667,6,5,6,4
2019-11-24,1610612752,1610612751,2019,101.0,103.0,204.0,102.25,107.3,112.0,115.35,16,4,12,0.25,15,7,8,0.467,3,1,5,2
2019-11-24,1610612764,1610612758,2019,106.0,113.0,219.0,116.35,117.0,110.0,113.35,13,5,8,0.385,14,6,8,0.429,3,2,4,2
2019-11-24,1610612743,1610612756,2019,116.0,104.0,220.0,106.05000000000001,101.6,112.6,113.69999999999999,14,11,3,0.7859999999999999,15,8,7,0.5329999999999999,6,5,5,3
2019-11-24,1610612746,1610612740,2019,134.0,109.0,243.0,114.30000000000001,112.25,116.7,119.1,16,11,5,0.688,16,6,10,0.375,10,1,4,2
2019-11-23,1610612750,1610612756,2019,98.0,100.0,198.0,114.05,118.44999999999999,112.75,114.4,15,8,7,0.5329999999999999,14,7,7,0.5,3,5,5,2
2019-11-23,1610612766,1610612741,2019,115.0,116.0,231.0,105.15,112.0,106.5,108.85,16,6,10,0.375,16,5,11,0.313,3,3,3,2
2019-11-23,1610612754,1610612753,2019,111.0,106.0,217.0,107.35,103.45,101.94999999999999,101.69999999999999,14,8,6,0.5710000000000001,14,6,8,0.429,5,3,6,0
2019-11-23,1610612737,1610612761,2019,116.0,119.0,235.0,106.65,116.80000000000001,112.7,107.5,15,4,11,0.267,14,10,4,0.7140000000000001,2,2,6,4
2019-11-23,1610612752,1610612759,2019,104.0,111.0,215.0,102.0,107.5,112.1,114.65,15,4,11,0.267,16,5,11,0.313,3,1,4,1
2019-11-23,1610612755,1610612748,2019,113.0,86.0,199.0,109.2,104.45,113.55,103.35,15,10,5,0.667,14,11,3,0.7859999999999999,6,4,6,5
2019-11-23,1610612739,1610612757,2019,110.0,104.0,214.0,100.94999999999999,113.5,111.65,116.55000000000001,15,4,11,0.267,16,5,11,0.313,2,2,1,4
2019-11-23,1610612763,1610612747,2019,108.0,109.0,217.0,107.2,116.45,111.65,103.4,14,5,9,0.35700000000000004,15,13,2,0.867,3,2,8,5
2019-11-23,1610612749,1610612765,2019,104.0,90.0,194.0,119.75,108.8,107.8,111.2,15,12,3,0.8,15,5,10,0.33299999999999996,4,8,4,1
2019-11-23,1610612762,1610612740,2019,128.0,120.0,248.0,106.30000000000001,106.65,117.05000000000001,118.94999999999999,15,10,5,0.667,15,6,9,0.4,7,3,4,2
2019-11-22,1610612765,1610612737,2019,128.0,103.0,231.0,106.6,112.4,105.85,116.4,14,4,10,0.28600000000000003,14,4,10,0.28600000000000003,3,1,2,2
2019-11-22,1610612764,1610612766,2019,125.0,118.0,243.0,115.8,116.85,104.55,111.1,12,4,8,0.33299999999999996,15,6,9,0.4,2,2,3,3
2019-11-22,1610612751,1610612758,2019,116.0,97.0,213.0,111.6,116.1,110.05,113.5,14,6,8,0.429,13,6,7,0.462,4,2,4,2
2019-11-22,1610612755,1610612759,2019,115.0,104.0,219.0,109.25,104.0,111.2,113.4,14,9,5,0.643,15,5,10,0.33299999999999996,5,4,4,1
2019-11-22,1610612741,1610612748,2019,108.0,116.0,224.0,107.35,109.4,112.44999999999999,103.6,15,5,10,0.33299999999999996,13,10,3,0.769,3,2,6,4
2019-11-22,1610612760,1610612747,2019,127.0,130.0,257.0,104.80000000000001,107.9,110.3,103.0,14,5,9,0.35700000000000004,14,12,2,0.857,5,0,8,4
2019-11-22,1610612742,1610612739,2019,143.0,101.0,244.0,113.0,107.9,101.15,111.80000000000001,14,9,5,0.643,14,4,10,0.28600000000000003,5,4,2,2
2019-11-22,1610612743,1610612738,2019,96.0,92.0,188.0,107.45,101.9,111.35,103.05000000000001,13,10,3,0.769,14,11,3,0.7859999999999999,5,5,5,6
2019-11-22,1610612762,1610612744,2019,113.0,109.0,222.0,106.0,105.75,109.6,118.9,14,9,5,0.643,16,3,13,0.188,6,3,1,2
2019-11-22,1610612746,1610612745,2019,122.0,119.0,241.0,113.80000000000001,111.4,119.30000000000001,116.05000000000001,15,10,5,0.667,15,11,4,0.733,9,1,6,5
2019-11-21,1610612749,1610612757,2019,137.0,129.0,266.0,118.69999999999999,106.9,111.3,115.30000000000001,14,11,3,0.7859999999999999,15,5,10,0.33299999999999996,3,8,1,4
2019-11-21,1610612756,1610612740,2019,121.0,124.0,245.0,111.80000000000001,113.55000000000001,117.5,118.35,13,7,6,0.5379999999999999,14,5,9,0.35700000000000004,5,2,4,1
2019-11-20,1610612755,1610612752,2019,109.0,104.0,213.0,109.9,103.8,101.6,108.05,13,8,5,0.615,14,4,10,0.28600000000000003,4,4,3,1
2019-11-20,1610612764,1610612759,2019,138.0,132.0,270.0,114.3,115.9,109.1,111.9,11,3,8,0.273,14,5,9,0.35700000000000004,1,2,4,1
2019-11-20,1610612737,1610612749,2019,127.0,135.0,262.0,106.0,115.75,117.69999999999999,105.95,13,4,9,0.308,13,10,3,0.769,2,2,3,7
2019-11-20,1610612751,1610612766,2019,101.0,91.0,192.0,112.30000000000001,118.1,106.19999999999999,110.9,13,5,8,0.385,14,6,8,0.429,3,2,3,3
2019-11-20,1610612748,1610612739,2019,124.0,100.0,224.0,111.35,104.19999999999999,101.85,111.6,12,9,3,0.75,13,4,9,0.308,5,4,2,2
2019-11-20,1610612761,1610612753,2019,113.0,97.0,210.0,112.95,108.1,102.3,101.1,13,9,4,0.6920000000000001,13,6,7,0.462,5,4,6,0
2019-11-20,1610612742,1610612744,2019,142.0,94.0,236.0,111.9,108.65,109.80000000000001,117.0,13,8,5,0.615,15,3,12,0.2,4,4,1,2
2019-11-20,1610612741,1610612765,2019,109.0,89.0,198.0,107.5,111.05,107.1,112.94999999999999,14,4,10,0.28600000000000003,13,4,9,0.308,2,2,3,1
2019-11-20,1610612750,1610612762,2019,95.0,103.0,198.0,114.85,118.75,105.75,106.9,14,8,6,0.5710000000000001,13,8,5,0.615,3,5,6,2
2019-11-20,1610612743,1610612745,2019,105.0,95.0,200.0,106.7,102.0,120.0,115.6,12,9,3,0.75,14,11,3,0.7859999999999999,4,5,6,5
2019-11-20,1610612746,1610612738,2019,107.0,104.0,211.0,112.80000000000001,111.3,111.15,101.45,14,9,5,0.643,13,11,2,0.846,8,1,5,6
2019-11-19,1610612763,1610612744,2019,95.0,114.0,209.0,109.05000000000001,116.6,109.4,117.5,13,5,8,0.385,14,2,12,0.14300000000000002,3,2,1,1
2019-11-19,1610612740,1610612757,2019,115.0,104.0,219.0,117.19999999999999,118.9,111.3,115.05000000000001,13,4,9,0.308,14,5,9,0.35700000000000004,3,1,1,4
2019-11-19,1610612758,1610612756,2019,120.0,116.0,236.0,109.9,112.9,112.9,114.35,12,5,7,0.41700000000000004,12,7,5,0.583,3,2,5,2
2019-11-19,1610612747,1610612760,2019,112.0,107.0,219.0,109.9,102.55000000000001,105.80000000000001,108.1,13,11,2,0.846,13,5,8,0.385,7,4,5,0
2019-11-18,1610612752,1610612739,2019,123.0,105.0,228.0,99.9,108.55,101.8,111.30000000000001,13,3,10,0.231,12,4,8,0.33299999999999996,2,1,2,2
2019-11-18,1610612751,1610612754,2019,86.0,115.0,201.0,113.65,117.05000000000001,108.35,105.85,12,5,7,0.41700000000000004,13,7,6,0.5379999999999999,3,2,5,2
2019-11-18,1610612761,1610612766,2019,132.0,96.0,228.0,111.35,108.0,106.6,108.85,12,8,4,0.667,13,6,7,0.462,4,4,3,3
2019-11-18,1610612741,1610612749,2019,101.0,115.0,216.0,106.75,110.1,117.85,106.45,13,4,9,0.308,12,9,3,0.75,2,2,3,6
2019-11-18,1610612745,1610612757,2019,132.0,108.0,240.0,119.0,115.6,112.2,114.35,13,10,3,0.769,13,5,8,0.385,5,5,1,4
2019-11-18,1610612742,1610612759,2019,117.0,110.0,227.0,111.65,109.25,108.85,111.75,12,7,5,0.583,13,5,8,0.385,3,4,4,1
2019-11-18,1610612756,1610612738,2019,85.0,99.0,184.0,114.2,114.69999999999999,110.75,103.0,11,7,4,0.636,12,10,2,0.833,5,2,5,5
2019-11-18,1610612762,1610612750,2019,102.0,112.0,214.0,105.7,106.5,114.55000000000001,119.2,12,8,4,0.667,13,7,6,0.5379999999999999,6,2,3,4
2019-11-18,1610612746,1610612760,2019,90.0,88.0,178.0,112.85,112.44999999999999,108.0,109.9,13,8,5,0.615,12,5,7,0.41700000000000004,7,1,5,0
2019-11-17,1610612739,1610612755,2019,95.0,114.0,209.0,102.45,111.1,109.19999999999999,103.4,11,4,7,0.364,12,7,5,0.583,2,2,4,3
2019-11-17,1610612758,1610612738,2019,100.0,99.0,199.0,110.15,114.44999999999999,110.9,104.15,11,4,7,0.364,11,10,1,0.909,2,2,5,5
2019-11-17,1610612753,1610612764,2019,125.0,121.0,246.0,100.75,101.35,113.0,114.15,12,5,7,0.41700000000000004,10,3,7,0.3,5,0,1,2
2019-11-17,1610612763,1610612743,2019,114.0,131.0,245.0,109.7,116.5,105.95,101.9,12,5,7,0.41700000000000004,11,8,3,0.727,3,2,4,4
2019-11-17,1610612740,1610612744,2019,108.0,100.0,208.0,116.9,120.4,109.85,117.3,12,3,9,0.25,13,2,11,0.154,2,1,1,1
2019-11-17,1610612747,1610612737,2019,122.0,101.0,223.0,109.35,103.2,106.30000000000001,115.4,12,10,2,0.833,12,4,8,0.33299999999999996,6,4,2,2
2019-11-16,1610612741,1610612751,2019,111.0,117.0,228.0,106.0,110.05,113.35,116.6,12,4,8,0.33299999999999996,11,4,7,0.364,2,2,3,1
2019-11-16,1610612754,1610612749,2019,83.0,102.0,185.0,109.5,106.25,118.85,107.9,12,7,5,0.583,11,8,3,0.727,5,2,3,5
2019-11-16,1610612752,1610612766,2019,102.0,103.0,205.0,100.44999999999999,108.9,107.19999999999999,109.19999999999999,12,3,9,0.25,12,5,7,0.41700000000000004,2,1,3,2
2019-11-16,1610612748,1610612740,2019,109.0,94.0,203.0,111.15,104.44999999999999,118.85,121.4,11,8,3,0.727,11,3,8,0.273,4,4,2,1
2019-11-16,1610612750,1610612745,2019,105.0,125.0,230.0,115.4,119.55,117.7,115.55000000000001,12,7,5,0.583,12,9,3,0.75,3,4,5,4
2019-11-16,1610612742,1610612761,2019,110.0,102.0,212.0,111.55000000000001,109.65,111.95,108.0,11,6,5,0.545,11,8,3,0.727,2,4,4,4
2019-11-16,1610612759,1610612757,2019,116.0,121.0,237.0,107.5,111.95,111.7,114.25,12,5,7,0.41700000000000004,12,4,8,0.33299999999999996,4,1,1,3
2019-11-16,1610612746,1610612737,2019,150.0,101.0,251.0,110.15,112.85,106.9,115.35,12,7,5,0.583,11,4,7,0.364,6,1,2,2
2019-11-15,1610612766,1610612765,2019,109.0,106.0,215.0,107.44999999999999,110.0,106.1,113.55,11,4,7,0.364,12,4,8,0.33299999999999996,2,2,3,1
2019-11-15,1610612753,1610612759,2019,111.0,109.0,220.0,98.94999999999999,100.9,107.1,111.2,11,4,7,0.364,11,5,6,0.455,4,0,4,1
2019-11-15,1610612745,1610612754,2019,111.0,102.0,213.0,118.45,116.5,109.8,105.15,11,8,3,0.727,11,7,4,0.636,4,4,5,2
2019-11-15,1610612763,1610612762,2019,107.0,106.0,213.0,109.5,117.1,104.9,107.25,11,4,7,0.364,11,8,3,0.727,2,2,6,2
2019-11-15,1610612750,1610612764,2019,116.0,137.0,253.0,115.05000000000001,118.6,112.35,114.75,11,7,4,0.636,9,2,7,0.222,3,4,1,1
2019-11-15,1610612760,1610612755,2019,127.0,119.0,246.0,106.55,109.5,107.75,101.65,11,4,7,0.364,11,7,4,0.636,4,0,4,3
2019-11-15,1610612744,1610612738,2019,100.0,105.0,205.0,110.35,117.75,111.25,103.65,12,2,10,0.16699999999999998,10,9,1,0.9,1,1,5,4
2019-11-15,1610612747,1610612758,2019,99.0,97.0,196.0,109.44999999999999,103.55000000000001,110.94999999999999,114.8,11,9,2,0.818,10,4,6,0.4,5,4,2,2
2019-11-14,1610612739,1610612748,2019,97.0,108.0,205.0,102.95,110.80000000000001,111.2,105.44999999999999,10,4,6,0.4,10,7,3,0.7,2,2,4,3
2019-11-14,1610612752,1610612742,2019,106.0,103.0,209.0,100.8,109.0,112.85,110.69999999999999,11,2,9,0.182,10,6,4,0.6,1,1,2,4
2019-11-14,1610612749,1610612741,2019,124.0,115.0,239.0,118.80000000000001,107.25,106.0,109.55,10,7,3,0.7,11,4,7,0.364,2,5,2,2
2019-11-14,1610612740,1610612746,2019,132.0,127.0,259.0,118.30000000000001,120.95,109.9,111.80000000000001,10,2,8,0.2,11,7,4,0.636,1,1,6,1
2019-11-14,1610612756,1610612737,2019,128.0,112.0,240.0,114.45,115.4,106.85,114.8,10,6,4,0.6,10,4,6,0.4,4,2,2,2
2019-11-14,1610612743,1610612751,2019,101.0,93.0,194.0,106.95,102.9,114.1,116.35,10,7,3,0.7,10,4,6,0.4,3,4,3,1
2019-11-13,1610612766,1610612763,2019,117.0,119.0,236.0,107.25,109.6,108.35,116.9,10,4,6,0.4,10,3,7,0.3,2,2,2,1
2019-11-13,1610612753,1610612755,2019,112.0,97.0,209.0,97.6,101.4,107.35,102.3,10,3,7,0.3,10,7,3,0.7,3,0,4,3
2019-11-13,1610612738,1610612764,2019,140.0,133.0,273.0,108.44999999999999,100.69999999999999,111.9,113.80000000000001,9,8,1,0.889,8,2,6,0.25,4,4,1,1
2019-11-13,1610612745,1610612746,2019,102.0,93.0,195.0,118.35,116.5,111.45,112.35,10,7,3,0.7,10,7,3,0.7,3,4,6,1
2019-11-13,1610612750,1610612759,2019,129.0,114.0,243.0,115.15,119.4,107.0,109.25,10,6,4,0.6,10,5,5,0.5,2,4,4,1
2019-11-13,1610612747,1610612744,2019,120.0,94.0,214.0,109.1,104.30000000000001,111.1,117.65,10,8,2,0.8,11,2,9,0.182,4,4,1,1
2019-11-13,1610612757,1610612761,2019,106.0,114.0,220.0,112.0,114.35,111.5,107.30000000000001,11,4,7,0.364,10,7,3,0.7,1,3,4,3
2019-11-12,1610612754,1610612760,2019,111.0,85.0,196.0,109.05,106.1,107.45,109.7,10,6,4,0.6,10,4,6,0.4,4,2,4,0
2019-11-12,1610612755,1610612739,2019,98.0,97.0,195.0,109.69999999999999,103.6,103.75,112.0,9,6,3,0.667,9,4,5,0.444,3,3,2,2
2019-11-12,1610612748,1610612765,2019,117.0,108.0,225.0,110.30000000000001,105.25,106.45,112.15,9,6,3,0.667,11,4,7,0.364,3,3,3,1
2019-11-12,1610612741,1610612752,2019,120.0,102.0,222.0,105.05,110.65,100.7,108.7,10,3,7,0.3,10,2,8,0.2,1,2,1,1
2019-11-12,1610612743,1610612737,2019,121.0,125.0,246.0,105.4,100.95,107.1,114.75,9,7,2,0.778,9,3,6,0.33299999999999996,3,4,2,1
2019-11-12,1610612756,1610612747,2019,115.0,123.0,238.0,113.55000000000001,115.15,109.45,103.65,9,6,3,0.667,9,7,2,0.778,4,2,4,3
2019-11-12,1610612762,1610612751,2019,119.0,114.0,233.0,104.85,106.94999999999999,115.05000000000001,116.80000000000001,10,7,3,0.7,9,4,5,0.444,5,2,3,1
2019-11-12,1610612758,1610612757,2019,107.0,99.0,206.0,111.19999999999999,115.0,111.75,114.8,9,3,6,0.33299999999999996,10,4,6,0.4,1,2,1,3
2019-11-11,1610612765,1610612750,2019,114.0,120.0,234.0,105.9,112.1,113.9,118.65,10,4,6,0.4,9,5,4,0.556,3,1,2,3
2019-11-11,1610612738,1610612742,2019,116.0,106.0,222.0,108.05,101.19999999999999,112.85,110.05,8,7,1,0.875,9,6,3,0.667,3,4,2,4
2019-11-11,1610612759,1610612763,2019,109.0,113.0,222.0,107.55,108.75,108.69999999999999,117.2,9,5,4,0.556,9,2,7,0.222,4,1,2,0
2019-11-11,1610612740,1610612745,2019,116.0,122.0,238.0,118.5,121.35,117.7,116.44999999999999,9,2,7,0.222,9,6,3,0.667,1,1,3,3
2019-11-11,1610612744,1610612762,2019,108.0,122.0,230.0,110.3,116.8,105.6,108.69999999999999,10,2,8,0.2,9,6,3,0.667,1,1,5,1
2019-11-11,1610612746,1610612761,2019,98.0,88.0,186.0,112.05,114.4,113.25,107.85,9,6,3,0.667,9,7,2,0.778,5,1,4,3
2019-11-10,1610612750,1610612743,2019,98.0,100.0,198.0,114.55000000000001,119.75,107.25,103.05,8,5,3,0.625,8,6,2,0.75,2,3,3,3
2019-11-10,1610612753,1610612754,2019,102.0,109.0,211.0,97.15,100.85,109.19999999999999,106.7,9,3,6,0.33299999999999996,9,5,4,0.556,3,0,4,1
2019-11-10,1610612755,1610612766,2019,114.0,106.0,220.0,109.1,103.85,107.05000000000001,109.44999999999999,8,5,3,0.625,9,4,5,0.444,2,3,2,2
2019-11-10,1610612760,1610612749,2019,119.0,121.0,240.0,107.5,109.05000000000001,117.45,106.30000000000001,9,4,5,0.444,9,6,3,0.667,4,0,2,4
2019-11-10,1610612752,1610612739,2019,87.0,108.0,195.0,100.95,108.3,103.75,114.25,9,2,7,0.222,8,3,5,0.375,1,1,2,1
2019-11-10,1610612756,1610612751,2019,138.0,112.0,250.0,112.75,115.19999999999999,114.95,116.05000000000001,8,5,3,0.625,8,4,4,0.5,3,2,3,1
2019-11-10,1610612757,1610612737,2019,124.0,113.0,237.0,112.55000000000001,116.0,106.0,113.6,9,3,6,0.33299999999999996,8,3,5,0.375,0,3,2,1
2019-11-10,1610612747,1610612761,2019,104.0,113.0,217.0,108.75,103.4,112.85,107.6,8,7,1,0.875,8,6,2,0.75,4,3,4,2
2019-11-09,1610612759,1610612738,2019,115.0,135.0,250.0,106.95,107.85,106.8,100.75,8,5,3,0.625,7,6,1,0.857,4,1,3,3
2019-11-09,1610612766,1610612740,2019,110.0,115.0,225.0,107.80000000000001,109.5,119.05,122.5,8,4,4,0.5,8,1,7,0.125,2,2,1,0
2019-11-09,1610612741,1610612745,2019,94.0,117.0,211.0,105.25,110.69999999999999,116.85,116.94999999999999,9,3,6,0.33299999999999996,8,5,3,0.625,1,2,3,2
2019-11-09,1610612763,1610612742,2019,122.0,138.0,260.0,108.35,115.45,110.9,109.19999999999999,8,2,6,0.25,8,5,3,0.625,2,0,2,3
2019-11-09,1610612760,1610612744,2019,114.0,108.0,222.0,107.4,109.2,110.85,116.94999999999999,8,3,5,0.375,9,2,7,0.222,3,0,1,1
2019-11-08,1610612754,1610612765,2019,112.0,106.0,218.0,108.4,106.80000000000001,106.1,112.65,8,4,4,0.5,9,4,5,0.444,3,1,3,1
2019-11-08,1610612753,1610612763,2019,118.0,86.0,204.0,98.69999999999999,102.19999999999999,110.0,115.7,8,2,6,0.25,7,2,5,0.28600000000000003,2,0,2,0
2019-11-08,1610612764,1610612739,2019,100.0,113.0,213.0,112.3,113.80000000000001,103.6,115.05000000000001,7,2,5,0.28600000000000003,7,2,5,0.28600000000000003,1,1,2,0
2019-11-08,1610612737,1610612758,2019,109.0,121.0,230.0,107.35,114.3,110.55,115.5,7,3,4,0.429,8,2,6,0.25,2,1,1,1
2019-11-08,1610612750,1610612744,2019,125.0,119.0,244.0,113.65,119.65,110.4,115.65,7,4,3,0.5710000000000001,8,2,6,0.25,1,3,1,1
2019-11-08,1610612740,1610612761,2019,104.0,122.0,226.0,118.35,122.05000000000001,111.9,108.65,7,1,6,0.14300000000000002,7,5,2,0.7140000000000001,1,0,4,1
2019-11-08,1610612742,1610612752,2019,102.0,106.0,208.0,111.9,109.0,100.25,109.6,7,5,2,0.7140000000000001,8,1,7,0.125,2,3,1,0
2019-11-08,1610612743,1610612755,2019,100.0,97.0,197.0,107.65,102.69999999999999,108.94999999999999,103.30000000000001,7,5,2,0.7140000000000001,7,5,2,0.7140000000000001,2,3,2,3
2019-11-08,1610612762,1610612749,2019,103.0,100.0,203.0,106.4,108.6,117.55000000000001,107.15,8,5,3,0.625,8,6,2,0.75,4,1,2,4
2019-11-08,1610612757,1610612751,2019,115.0,119.0,234.0,112.7,115.8,116.2,117.7,8,3,5,0.375,7,3,4,0.429,0,3,3,0
2019-11-08,1610612747,1610612748,2019,95.0,80.0,175.0,110.45,105.15,111.75,106.05000000000001,7,6,1,0.857,8,6,2,0.75,3,3,3,3
2019-11-07,1610612766,1610612738,2019,87.0,108.0,195.0,109.65,109.94999999999999,106.6,101.19999999999999,7,4,3,0.5710000000000001,6,5,1,0.833,2,2,3,2
2019-11-07,1610612759,1610612760,2019,121.0,112.0,233.0,106.8,107.65,107.6,108.6,7,4,3,0.5710000000000001,7,3,4,0.429,3,1,3,0
2019-11-07,1610612756,1610612748,2019,108.0,124.0,232.0,113.1,115.0,110.80000000000001,106.15,7,5,2,0.7140000000000001,7,5,2,0.7140000000000001,3,2,3,2
2019-11-07,1610612746,1610612757,2019,107.0,101.0,208.0,111.95,115.0,112.65,115.25,8,5,3,0.625,7,3,4,0.429,4,1,0,3
2019-11-06,1610612765,1610612752,2019,122.0,102.0,224.0,105.0,112.19999999999999,99.3,108.94999999999999,8,3,5,0.375,7,1,6,0.14300000000000002,2,1,1,0
2019-11-06,1610612754,1610612764,2019,121.0,106.0,227.0,107.19999999999999,107.35,112.3,113.95,7,3,4,0.429,6,2,4,0.33299999999999996,2,1,1,1
2019-11-06,1610612737,1610612741,2019,93.0,113.0,206.0,107.6,114.55,104.85,111.69999999999999,6,3,3,0.5,8,2,6,0.25,2,1,1,1
2019-11-06,1610612761,1610612758,2019,124.0,120.0,244.0,111.69999999999999,107.75,110.44999999999999,115.35,6,4,2,0.667,7,2,5,0.28600000000000003,3,1,1,1
2019-11-06,1610612745,1610612744,2019,129.0,112.0,241.0,116.30000000000001,116.25,110.69999999999999,114.85,7,4,3,0.5710000000000001,7,2,5,0.28600000000000003,2,2,1,1
2019-11-06,1610612763,1610612750,2019,137.0,121.0,258.0,108.1,115.25,113.1,118.19999999999999,6,1,5,0.16699999999999998,6,4,2,0.667,1,0,1,3
2019-11-06,1610612742,1610612753,2019,107.0,106.0,213.0,112.6,109.94999999999999,99.5,102.55,6,4,2,0.667,7,2,5,0.28600000000000003,1,3,2,0
2019-11-06,1610612762,1610612755,2019,106.0,104.0,210.0,106.65,108.5,108.5,103.4,7,4,3,0.5710000000000001,6,5,1,0.833,3,1,2,3
2019-11-06,1610612746,1610612749,2019,124.0,129.0,253.0,111.0,115.15,116.7,106.85,7,5,2,0.7140000000000001,7,5,2,0.7140000000000001,4,1,2,3
2019-11-05,1610612766,1610612754,2019,122.0,120.0,242.0,109.2,109.25,106.15,106.6,6,3,3,0.5,6,3,3,0.5,1,2,2,1
2019-11-05,1610612739,1610612738,2019,113.0,119.0,232.0,104.25,115.05000000000001,106.45,101.05,6,2,4,0.33299999999999996,5,4,1,0.8,2,0,3,1
2019-11-05,1610612737,1610612759,2019,108.0,100.0,208.0,108.65,115.9,108.25,107.85,5,2,3,0.4,6,4,2,0.667,1,1,3,1
2019-11-05,1610612741,1610612747,2019,112.0,118.0,230.0,103.4,111.5,109.55000000000001,105.30000000000001,7,2,5,0.28600000000000003,6,5,1,0.833,1,1,3,2
2019-11-05,1610612760,1610612753,2019,102.0,94.0,196.0,108.65,109.4,100.6,102.85,6,2,4,0.33299999999999996,6,2,4,0.33299999999999996,2,0,2,0
2019-11-05,1610612743,1610612748,2019,109.0,89.0,198.0,107.9,103.5,111.35,105.30000000000001,6,4,2,0.667,6,5,1,0.833,1,3,3,2
2019-11-04,1610612764,1610612765,2019,115.0,99.0,214.0,111.3,114.8,105.15,112.0,5,1,4,0.2,7,3,4,0.429,0,1,2,1
2019-11-04,1610612751,1610612740,2019,135.0,125.0,260.0,114.7,117.2,116.9,121.25,6,2,4,0.33299999999999996,6,1,5,0.16699999999999998,2,0,1,0
2019-11-04,1610612763,1610612745,2019,100.0,107.0,207.0,109.4,116.15,115.5,116.6,5,1,4,0.2,6,3,3,0.5,1,0,2,1
2019-11-04,1610612750,1610612749,2019,106.0,134.0,240.0,112.94999999999999,116.1,115.65,106.6,5,4,1,0.8,6,4,2,0.667,1,3,2,2
2019-11-04,1610612756,1610612755,2019,114.0,109.0,223.0,113.45,115.75,108.65,103.1,6,4,2,0.667,5,5,0,1.0,2,2,2,3
2019-11-04,1610612744,1610612757,2019,127.0,118.0,245.0,109.8,115.1,111.65,115.1,6,1,5,0.16699999999999998,6,3,3,0.5,0,1,0,3
2019-11-03,1610612754,1610612741,2019,108.0,95.0,203.0,106.30000000000001,106.95,103.8,111.7,5,2,3,0.4,6,2,4,0.33299999999999996,1,1,1,1
2019-11-03,1610612748,1610612745,2019,129.0,100.0,229.0,109.55,104.05000000000001,115.7,115.2,5,4,1,0.8,5,3,2,0.6,2,2,2,1
2019-11-03,1610612752,1610612758,2019,92.0,113.0,205.0,99.3,109.15,111.05,116.80000000000001,6,1,5,0.16699999999999998,6,1,5,0.16699999999999998,1,0,1,0
2019-11-03,1610612759,1610612747,2019,96.0,103.0,199.0,108.7,107.4,109.45,106.25,5,4,1,0.8,5,4,1,0.8,3,1,3,1
2019-11-03,1610612739,1610612742,2019,111.0,131.0,242.0,105.0,113.55000000000001,112.35,108.94999999999999,5,2,3,0.4,5,3,2,0.6,2,0,1,2
2019-11-03,1610612746,1610612762,2019,105.0,94.0,199.0,112.9,117.3,107.4,108.9,6,4,2,0.667,6,4,2,0.667,3,1,3,1
2019-11-02,1610612760,1610612740,2019,115.0,104.0,219.0,108.85,109.35,118.15,121.75,5,1,4,0.2,5,1,4,0.2,1,0,1,0
2019-11-02,1610612765,1610612751,2019,113.0,109.0,222.0,104.05000000000001,111.75,114.80000000000001,116.85,6,2,4,0.33299999999999996,5,2,3,0.4,1,1,2,0
2019-11-02,1610612753,1610612743,2019,87.0,91.0,178.0,101.94999999999999,103.30000000000001,108.5,105.15,5,2,3,0.4,5,3,2,0.6,2,0,1,2
2019-11-02,1610612764,1610612750,2019,109.0,131.0,240.0,112.6,114.65,112.0,115.6,4,1,3,0.25,4,3,1,0.75,0,1,1,2
2019-11-02,1610612763,1610612756,2019,105.0,114.0,219.0,109.4,115.30000000000001,112.85,115.9,4,1,3,0.25,5,3,2,0.6,1,0,2,1
2019-11-02,1610612749,1610612761,2019,115.0,105.0,220.0,114.4,106.94999999999999,111.44999999999999,107.4,5,3,2,0.6,5,4,1,0.8,1,2,3,1
2019-11-02,1610612744,1610612766,2019,87.0,93.0,180.0,111.15,116.0,109.05,111.75,5,1,4,0.2,5,2,3,0.4,0,1,1,1
2019-11-02,1610612757,1610612755,2019,128.0,129.0,257.0,110.94999999999999,113.35,108.75,102.45,5,3,2,0.6,4,4,0,1.0,0,3,2,2
2019-11-01,1610612751,1610612745,2019,123.0,116.0,239.0,114.7,117.6,115.45,114.65,4,1,3,0.25,4,3,1,0.75,1,0,2,1
2019-11-01,1610612754,1610612739,2019,102.0,95.0,197.0,107.0,108.25,105.5,114.80000000000001,4,1,3,0.25,4,2,2,0.5,0,1,2,0
2019-11-01,1610612753,1610612749,2019,91.0,123.0,214.0,103.35,102.05000000000001,114.4,108.19999999999999,4,2,2,0.5,4,2,2,0.5,2,0,1,1
2019-11-01,1610612738,1610612752,2019,104.0,102.0,206.0,106.75,101.19999999999999,99.1,109.1,4,3,1,0.75,5,1,4,0.2,2,1,1,0
2019-11-01,1610612741,1610612765,2019,112.0,106.0,218.0,104.5,112.4,103.35,110.9,5,1,4,0.2,5,2,3,0.4,0,1,1,1
2019-11-01,1610612742,1610612747,2019,110.0,119.0,229.0,113.1,109.44999999999999,109.65,106.95,4,3,1,0.75,4,3,1,0.75,1,2,3,0
2019-11-01,1610612758,1610612762,2019,102.0,101.0,203.0,111.75,116.75,108.25,108.65,5,0,5,0.0,5,4,1,0.8,0,0,3,1
2019-11-01,1610612744,1610612759,2019,110.0,127.0,237.0,111.44999999999999,114.35,106.6,107.55000000000001,4,1,3,0.25,4,3,1,0.75,0,1,3,0
2019-10-31,1610612737,1610612748,2019,97.0,106.0,203.0,109.65,116.3,109.9,104.6,4,2,2,0.5,4,3,1,0.75,1,1,2,1
2019-10-31,1610612740,1610612743,2019,122.0,107.0,229.0,118.85,123.3,109.0,104.2,4,0,4,0.0,4,3,1,0.75,0,0,1,2
2019-10-31,1610612746,1610612759,2019,103.0,97.0,200.0,113.6,118.55,107.55,108.65,5,3,2,0.6,3,3,0,1.0,2,1,3,0
2019-10-30,1610612739,1610612741,2019,117.0,111.0,228.0,105.0,113.9,104.75,111.6,3,1,2,0.33299999999999996,4,1,3,0.25,1,0,0,1
2019-10-30,1610612753,1610612752,2019,95.0,83.0,178.0,104.75,103.85,99.55,109.5,3,1,2,0.33299999999999996,4,1,3,0.25,1,0,1,0
2019-10-30,1610612755,1610612750,2019,117.0,95.0,212.0,109.15,103.15,112.55,115.4,3,3,0,1.0,3,3,0,1.0,1,2,1,2
2019-10-30,1610612738,1610612749,2019,116.0,105.0,221.0,106.65,101.55,115.5,107.6,3,2,1,0.667,3,2,1,0.667,1,1,1,1
2019-10-30,1610612751,1610612754,2019,108.0,118.0,226.0,114.80000000000001,116.5,105.55,108.44999999999999,3,1,2,0.33299999999999996,3,0,3,0.0,1,0,0,0
2019-10-30,1610612761,1610612765,2019,125.0,113.0,238.0,111.1,107.35,103.4,110.69999999999999,4,3,1,0.75,4,2,2,0.5,2,1,1,1
2019-10-30,1610612764,1610612745,2019,158.0,159.0,317.0,110.2,112.5,114.25,111.9,3,1,2,0.33299999999999996,3,2,1,0.667,0,1,2,0
2019-10-30,1610612760,1610612757,2019,99.0,102.0,201.0,109.05,109.55,110.69999999999999,112.9,4,1,3,0.25,4,2,2,0.5,1,0,0,2
2019-10-30,1610612762,1610612746,2019,110.0,96.0,206.0,109.15,110.05000000000001,114.30000000000001,118.44999999999999,4,3,1,0.75,4,3,1,0.75,2,1,2,1
2019-10-30,1610612758,1610612766,2019,111.0,118.0,229.0,112.25,117.0,108.9,112.65,4,0,4,0.0,4,1,3,0.25,0,0,1,0
2019-10-30,1610612744,1610612756,2019,110.0,121.0,231.0,111.15,113.25,112.55,115.95,3,1,2,0.33299999999999996,4,2,2,0.5,0,1,2,0
2019-10-29,1610612748,1610612737,2019,112.0,97.0,209.0,109.2,105.4,110.80000000000001,117.15,3,2,1,0.667,3,2,1,0.667,1,1,1,1
2019-10-29,1610612743,1610612742,2019,106.0,109.0,215.0,108.5,103.8,112.65,109.94999999999999,3,3,0,1.0,3,2,1,0.667,1,2,1,1
2019-10-29,1610612747,1610612763,2019,120.0,91.0,211.0,109.85,107.7,111.25,116.05000000000001,3,2,1,0.667,3,1,2,0.33299999999999996,2,0,1,0
2019-10-28,1610612765,1610612754,2019,96.0,94.0,190.0,103.05000000000001,111.4,106.3,109.4,3,1,2,0.33299999999999996,2,0,2,0.0,0,1,0,0
2019-10-28,1610612752,1610612741,2019,105.0,98.0,203.0,99.94999999999999,110.8,104.95,112.8,3,0,3,0.0,3,1,2,0.33299999999999996,0,0,0,1
2019-10-28,1610612737,1610612755,2019,103.0,105.0,208.0,110.9,117.94999999999999,108.85,104.1,2,2,0,1.0,2,2,0,1.0,1,1,1,1
2019-10-28,1610612761,1610612753,2019,104.0,95.0,199.0,110.5,107.1,105.45,104.69999999999999,3,2,1,0.667,2,1,1,0.5,1,1,1,0
2019-10-28,1610612745,1610612760,2019,116.0,112.0,228.0,114.55,110.80000000000001,108.75,109.15,2,1,1,0.5,3,1,2,0.33299999999999996,1,0,1,0
2019-10-28,1610612749,1610612739,2019,129.0,112.0,241.0,115.05,106.94999999999999,105.2,113.5,2,1,1,0.5,2,1,1,0.5,0,1,1,0
2019-10-28,1610612740,1610612744,2019,123.0,134.0,257.0,118.2,122.69999999999999,109.85,112.69999999999999,3,0,3,0.0,2,0,2,0.0,0,0,0,0
2019-10-28,1610612759,1610612757,2019,113.0,110.0,223.0,107.75,108.7,110.85,113.3,2,2,0,1.0,3,2,1,0.667,2,0,0,2
2019-10-28,1610612756,1610612762,2019,95.0,96.0,191.0,112.69999999999999,117.05000000000001,110.05,109.45,3,2,1,0.667,3,2,1,0.667,2,0,2,0
2019-10-28,1610612758,1610612743,2019,94.0,101.0,195.0,114.0,117.05000000000001,108.85,105.0,3,0,3,0.0,2,2,0,1.0,0,0,1,1
2019-10-28,1610612746,1610612766,2019,111.0,96.0,207.0,113.9,120.4,109.85,112.80000000000001,3,2,1,0.667,3,1,2,0.33299999999999996,1,1,1,0
2019-10-27,1610612760,1610612744,2019,120.0,92.0,212.0,108.0,110.30000000000001,111.3,113.0,2,0,2,0.0,1,0,1,0.0,0,0,0,0
2019-10-27,1610612763,1610612751,2019,134.0,133.0,267.0,110.25,114.6,114.30000000000001,115.85,2,0,2,0.0,2,1,1,0.5,0,0,1,0
2019-10-27,1610612742,1610612757,2019,119.0,121.0,240.0,112.75,109.69999999999999,110.35,112.25,2,2,0,1.0,2,1,1,0.5,1,1,0,1
2019-10-27,1610612750,1610612748,2019,116.0,109.0,225.0,113.5,116.45,108.1,105.4,2,2,0,1.0,2,2,0,1.0,0,2,1,1
2019-10-27,1610612747,1610612766,2019,120.0,101.0,221.0,109.4,107.95,108.55,111.45,2,1,1,0.5,2,1,1,0.5,1,0,1,0
2019-10-26,1610612749,1610612748,2019,126.0,131.0,257.0,114.8,104.69999999999999,107.05000000000001,104.35,1,1,0,1.0,1,1,0,1.0,0,1,1,0
2019-10-26,1610612765,1610612755,2019,111.0,117.0,228.0,102.45,110.05,108.80000000000001,103.35,2,1,1,0.5,1,1,0,1.0,0,1,1,0
2019-10-26,1610612737,1610612753,2019,103.0,99.0,202.0,112.35,118.55,106.55000000000001,105.35,1,1,0,1.0,1,1,0,1.0,0,1,1,0
2019-10-26,1610612752,1610612738,2019,95.0,118.0,213.0,99.85,110.45,106.6,101.65,2,0,2,0.0,2,1,1,0.5,0,0,1,0
2019-10-26,1610612739,1610612754,2019,110.0,99.0,209.0,104.35,115.0,106.25,109.19999999999999,1,0,1,0.0,1,0,1,0.0,0,0,0,0
2019-10-26,1610612741,1610612761,2019,84.0,108.0,192.0,106.1,113.55,110.15,108.5,2,1,1,0.5,2,1,1,0.5,0,1,1,0
2019-10-26,1610612745,1610612740,2019,126.0,123.0,249.0,115.69999999999999,110.30000000000001,117.85,122.8,1,0,1,0.0,2,0,2,0.0,0,0,0,0
2019-10-26,1610612759,1610612764,2019,124.0,122.0,246.0,106.85,108.25,110.1,112.6,1,1,0,1.0,2,1,1,0.5,1,0,0,1
2019-10-26,1610612762,1610612758,2019,113.0,81.0,194.0,110.15,110.4,115.25,116.95,2,1,1,0.5,2,0,2,0.0,1,0,0,0
2019-10-26,1610612756,1610612746,2019,130.0,122.0,252.0,111.25,116.75,113.45,119.15,2,1,1,0.5,2,2,0,1.0,1,0,1,1
2019-10-25,1610612738,1610612761,2019,112.0,106.0,218.0,105.8,102.1,109.9,107.69999999999999,1,0,1,0.0,1,1,0,1.0,0,0,1,0
2019-10-25,1610612766,1610612750,2019,99.0,121.0,220.0,109.3,111.30000000000001,112.55,117.35,1,1,0,1.0,1,1,0,1.0,1,0,0,1
2019-10-25,1610612751,1610612752,2019,113.0,109.0,222.0,113.80000000000001,114.15,99.19999999999999,110.15,1,0,1,0.0,1,0,1,0.0,0,0,0,0
2019-10-25,1610612763,1610612741,2019,102.0,110.0,212.0,111.15,114.65,106.65,114.85,1,0,1,0.0,1,0,1,0.0,0,0,0,0
2019-10-25,1610612740,1610612742,2019,116.0,123.0,239.0,117.7,123.15,112.5,110.19999999999999,1,0,1,0.0,1,1,0,1.0,0,0,1,0
2019-10-25,1610612760,1610612764,2019,85.0,97.0,182.0,109.1,110.4,111.75,115.1,1,0,1,0.0,1,0,1,0.0,0,0,0,0
2019-10-25,1610612743,1610612756,2019,108.0,107.0,215.0,108.4,104.4,111.9,117.69999999999999,1,1,0,1.0,1,1,0,1.0,0,1,1,0
2019-10-25,1610612758,1610612757,2019,112.0,122.0,234.0,115.1,116.4,109.65,112.65,1,0,1,0.0,1,0,1,0.0,0,0,0,0
2019-10-25,1610612747,1610612762,2019,95.0,86.0,181.0,109.95,109.2,111.55000000000001,111.5,1,0,1,0.0,1,1,0,1.0,0,0,1,0
2019-10-24,1610612765,1610612737,2019,100.0,117.0,217.0,103.2,109.1,112.15,119.25,1,1,0,1.0,0,0,0,0.0,0,1,0,0
2019-10-24,1610612745,1610612749,2019,111.0,117.0,228.0,116.15,109.25,114.9,104.3,0,0,0,0.0,0,0,0,0.0,0,0,0,0
2019-10-24,1610612744,1610612746,2019,122.0,141.0,263.0,110.94999999999999,111.4,112.2,118.5,0,0,0,0.0,1,1,0,1.0,0,0,1,0
2019-10-23,1610612766,1610612741,2019,126.0,125.0,251.0,108.6,110.6,105.8,115.1,0,0,0,0.0,0,0,0,0.0,0,0,0,0
2019-10-23,1610612754,1610612765,2019,110.0,119.0,229.0,106.95,107.65,102.85,109.44999999999999,0,0,0,0.0,0,0,0,0.0,0,0,0,0
2019-10-23,1610612753,1610612739,2019,94.0,85.0,179.0,107.80000000000001,105.9,104.65,116.30000000000001,0,0,0,0.0,0,0,0,0.0,0,0,0,0
2019-10-23,1610612751,1610612750,2019,126.0,127.0,253.0,113.15,113.15,111.2,117.05000000000001,0,0,0,0.0,0,0,0,0.0,0,0,0,0
2019-10-23,1610612748,1610612763,2019,120.0,101.0,221.0,106.45,103.0,111.65,115.25,0,0,0,0.0,0,0,0,0.0,0,0,0,0
2019-10-23,1610612755,1610612738,2019,107.0,93.0,200.0,109.55000000000001,105.1,106.75,101.85,0,0,0,0.0,0,0,0,0.0,0,0,0,0
2019-10-23,1610612742,1610612764,2019,108.0,100.0,208.0,112.35,110.8,112.30000000000001,115.3,0,0,0,0.0,0,0,0,0.0,0,0,0,0
2019-10-23,1610612759,1610612752,2019,120.0,111.0,231.0,106.65,108.2,99.05,109.9,0,0,0,0.0,0,0,0,0.0,0,0,0,0
2019-10-23,1610612762,1610612760,2019,100.0,95.0,195.0,112.80000000000001,111.35,109.25,109.85,0,0,0,0.0,0,0,0,0.0,0,0,0,0
2019-10-23,1610612756,1610612758,2019,124.0,95.0,219.0,110.55000000000001,118.65,116.05000000000001,116.35,0,0,0,0.0,0,0,0,0.0,0,0,0,0
2019-10-23,1610612757,1610612743,2019,100.0,108.0,208.0,109.85,112.2,108.4,105.30000000000001,0,0,0,0.0,0,0,0,0.0,0,0,0,0
2019-10-22,1610612761,1610612740,2019,130.0,122.0,252.0,109.65,106.05,117.35,122.25,0,0,0,0.0,0,0,0,0.0,0,0,0,0
2019-10-22,1610612746,1610612747,2019,112.0,102.0,214.0,112.25,118.19999999999999,109.7,109.15,0,0,0,0.0,0,0,0,0.0,0,0,0,0
2019-10-18,1610612755,1610612764,2019,93.0,112.0,205.0,111.05000000000001,105.0,111.5,116.0,0,0,0,0.0,0,0,0,0.0,0,0,0,0
2019-10-18,1610612751,1610612761,2019,107.0,123.0,230.0,114.15,111.4,108.25,106.5,0,0,0,0.0,0,0,0,0.0,0,0,0,0
2019-10-18,1610612748,1610612745,2019,133.0,144.0,277.0,105.0,102.05000000000001,115.45,107.85,0,0,0,0.0,0,0,0,0.0,0,0,0,0
2019-10-18,1610612752,1610612740,2019,116.0,117.0,233.0,99.05,110.9,117.5,122.05,0,0,0,0.0,0,0,0,0.0,0,0,0,0
2019-10-18,1610612759,1610612763,2019,104.0,91.0,195.0,106.69999999999999,109.15,111.85,115.0,0,0,0,0.0,0,0,0,0.0,0,0,0,0
2019-10-18,1610612744,1610612747,2019,124.0,103.0,227.0,109.94999999999999,111.25,109.45,108.5,0,0,0,0.0,0,0,0,0.0,0,0,0,0
2019-10-17,1610612753,1610612748,2019,98.0,107.0,205.0,107.95,105.1,105.44999999999999,102.5,0,0,0,0.0,0,0,0,0.0,0,0,0,0
2019-10-17,1610612741,1610612737,2019,111.0,93.0,204.0,105.44999999999999,116.05000000000001,113.65,119.6,0,0,0,0.0,0,0,0,0.0,0,0,0,0
2019-10-17,1610612749,1610612750,2019,118.0,96.0,214.0,114.8,105.85,111.75,117.80000000000001,0,0,0,0.0,0,0,0,0.0,0,0,0,0
2019-10-17,1610612743,1610612757,2019,110.0,104.0,214.0,108.85,105.6,109.85,111.75,0,0,0,0.0,0,0,0,0.0,0,0,0,0
2019-10-17,1610612746,1610612742,2019,87.0,102.0,189.0,114.5,118.5,112.2,111.44999999999999,0,0,0,0.0,0,0,0,0.0,0,0,0,0
2019-10-16,1610612766,1610612765,2019,110.0,116.0,226.0,107.3,109.35,102.95,108.85,0,0,0,0.0,0,0,0,0.0,0,0,0,0
2019-10-16,1610612752,1610612737,2019,96.0,100.0,196.0,100.45,112.05000000000001,114.19999999999999,120.75,0,0,0,0.0,0,0,0,0.0,0,0,0,0
2019-10-16,1610612745,1610612759,2019,114.0,128.0,242.0,115.7,106.85,106.05,108.25,0,0,0,0.0,0,0,0,0.0,0,0,0,0
2019-10-16,1610612760,1610612763,2019,119.0,124.0,243.0,109.0,109.8,111.2,113.1,0,0,0,0.0,0,0,0,0.0,0,0,0,0
2019-10-16,1610612762,1610612757,2019,118.0,126.0,244.0,112.6,109.95,109.05,111.80000000000001,0,0,0,0.0,0,0,0,0.0,0,0,0,0
2019-10-16,1610612747,1610612744,2019,126.0,93.0,219.0,108.5,109.85,111.75,110.44999999999999,0,0,0,0.0,0,0,0,0.0,0,0,0,0
2019-10-15,1610612739,1610612738,2019,95.0,118.0,213.0,105.4,116.55000000000001,105.65,102.6,0,0,0,0.0,0,0,0,0.0,0,0,0,0
2019-10-15,1610612754,1610612750,2019,111.0,119.0,230.0,106.80000000000001,107.0,111.5,118.80000000000001,0,0,0,0.0,0,0,0,0.0,0,0,0,0
2019-10-15,1610612755,1610612765,2019,106.0,86.0,192.0,111.65,106.44999999999999,104.6,109.85,0,0,0,0.0,0,0,0,0.0,0,0,0,0
2019-10-14,1610612748,1610612737,2019,120.0,87.0,207.0,105.75,103.65,116.69999999999999,121.19999999999999,0,0,0,0.0,0,0,0,0.0,0,0,0,0
2019-10-14,1610612763,1610612766,2019,99.0,120.0,219.0,111.6,112.55,107.1,109.9,0,0,0,0.0,0,0,0,0.0,0,0,0,0
2019-10-14,1610612742,1610612760,2019,107.0,70.0,177.0,111.5,112.65,111.0,110.35,0,0,0,0.0,0,0,0,0.0,0,0,0,0
2019-10-14,1610612762,1610612758,2019,115.0,128.0,243.0,112.85,108.55000000000001,115.65,116.9,0,0,0,0.0,0,0,0,0.0,0,0,0,0
2019-10-14,1610612756,1610612743,2019,102.0,107.0,209.0,110.80000000000001,118.1,108.9,106.25,0,0,0,0.0,0,0,0,0.0,0,0,0,0
2019-10-14,1610612747,1610612744,2019,104.0,98.0,202.0,108.25,110.69999999999999,112.5,110.5,0,0,0,0.0,0,0,0,0.0,0,0,0,0
2019-10-13,1610612738,1610612739,2019,118.0,72.0,190.0,105.0,104.7,106.75,115.95,0,0,0,0.0,0,0,0,0.0,0,0,0,0
2019-10-13,1610612759,1610612740,2019,114.0,123.0,237.0,105.9,107.35,117.85,122.15,0,0,0,0.0,0,0,0,0.0,0,0,0,0
2019-10-13,1610612753,1610612755,2019,94.0,126.0,220.0,109.25,103.35,111.44999999999999,108.25,0,0,0,0.0,0,0,0,0.0,0,0,0,0
2019-10-13,1610612761,1610612741,2019,91.0,105.0,196.0,108.15,105.95,105.0,116.75,0,0,0,0.0,0,0,0,0.0,0,0,0,0
2019-10-13,1610612764,1610612749,2019,108.0,115.0,223.0,111.1,114.75,115.44999999999999,106.55000000000001,0,0,0,0.0,0,0,0,0.0,0,0,0,0
2019-10-12,1610612751,1610612747,2019,91.0,77.0,168.0,115.2,113.7,110.55,111.5,0,0,0,0.0,0,0,0,0.0,0,0,0,0
2019-10-12,1610612757,1610612756,2019,118.0,134.0,252.0,109.94999999999999,111.65,110.30000000000001,118.25,0,0,0,0.0,0,0,0,0.0,0,0,0,0
2019-10-11,1610612765,1610612739,2019,109.0,105.0,214.0,104.65,109.94999999999999,107.0,116.80000000000001,0,0,0,0.0,0,0,0,0.0,0,0,0,0
2019-10-11,1610612754,1610612741,2019,105.0,87.0,192.0,106.7,107.55,109.05,119.55000000000001,0,0,0,0.0,0,0,0,0.0,0,0,0,0
2019-10-11,1610612753,1610612738,2019,75.0,100.0,175.0,111.05000000000001,103.65,105.8,106.25,0,0,0,0.0,0,0,0,0.0,0,0,0,0
2019-10-11,1610612766,1610612755,2019,87.0,100.0,187.0,108.15,110.8,111.55,110.0,0,0,0,0.0,0,0,0,0.0,0,0,0,0
2019-10-11,1610612752,1610612764,2019,99.0,115.0,214.0,100.2,111.4,111.6,115.6,0,0,0,0.0,0,0,0,0.0,0,0,0,0
2019-10-11,1610612740,1610612762,2019,128.0,127.0,255.0,116.65,122.15,113.35,107.95,0,0,0,0.0,0,0,0,0.0,0,0,0,0
2019-10-11,1610612742,1610612749,2019,111.0,118.0,229.0,110.0,112.3,116.1,107.05000000000001,0,0,0,0.0,0,0,0,0.0,0,0,0,0
2019-10-10,1610612745,1610612761,2019,118.0,111.0,229.0,115.4,105.55,107.95,104.30000000000001,0,0,0,0.0,0,0,0,0.0,0,0,0,0
2019-10-10,1610612747,1610612751,2019,111.0,114.0,225.0,110.25,111.45,115.30000000000001,114.1,0,0,0,0.0,0,0,0,0.0,0,0,0,0
2019-10-10,1610612758,1610612756,2019,105.0,88.0,193.0,116.15,117.9,111.5,119.0,0,0,0,0.0,0,0,0,0.0,0,0,0,0
2019-10-10,1610612744,1610612750,2019,143.0,123.0,266.0,111.4,110.80000000000001,111.4,118.4,0,0,0,0.0,0,0,0,0.0,0,0,0,0
2019-10-10,1610612746,1610612743,2019,91.0,111.0,202.0,115.7,118.4,108.45,107.5,0,0,0,0.0,0,0,0,0.0,0,0,0,0
2019-10-09,1610612765,1610612742,2019,124.0,117.0,241.0,104.0,108.94999999999999,109.44999999999999,111.65,0,0,0,0.0,0,0,0,0.0,0,0,0,0
2019-10-09,1610612737,1610612753,2019,88.0,97.0,185.0,118.69999999999999,122.15,111.1,105.0,0,0,0,0.0,0,0,0,0.0,0,0,0,0
2019-10-09,1610612766,1610612748,2019,94.0,108.0,202.0,109.1,111.3,104.9,103.15,0,0,0,0.0,0,0,0,0.0,0,0,0,0
2019-10-09,1610612741,1610612740,2019,125.0,127.0,252.0,108.19999999999999,118.55000000000001,116.25,122.15,0,0,0,0.0,0,0,0,0.0,0,0,0,0
2019-10-09,1610612749,1610612762,2019,133.0,99.0,232.0,115.19999999999999,107.45,114.19999999999999,106.05000000000001,0,0,0,0.0,0,0,0,0.0,0,0,0,0
2019-10-08,1610612761,1610612745,2019,134.0,129.0,263.0,106.65,102.6,113.65,104.25,0,0,0,0.0,0,0,0,0.0,0,0,0,0
2019-10-08,1610612748,1610612759,2019,107.0,89.0,196.0,105.25,104.35,106.7,107.55,0,0,0,0.0,0,0,0,0.0,0,0,0,0
2019-10-08,1610612760,1610612742,2019,119.0,104.0,223.0,110.4,110.95,110.4,112.3,0,0,0,0.0,0,0,0,0.0,0,0,0,0
2019-10-08,1610612756,1610612750,2019,111.0,106.0,217.0,111.65,118.95,111.85,118.95,0,0,0,0.0,0,0,0,0.0,0,0,0,0
2019-10-08,1610612757,1610612743,2019,94.0,105.0,199.0,111.0,111.80000000000001,108.95,108.05,0,0,0,0.0,0,0,0,0.0,0,0,0,0
2019-10-07,1610612765,1610612753,2019,91.0,115.0,206.0,106.0,108.6,110.55000000000001,105.4,0,0,0,0.0,0,0,0,0.0,0,0,0,0
2019-10-07,1610612764,1610612752,2019,99.0,104.0,203.0,112.69999999999999,116.15,100.35,112.85,0,0,0,0.0,0,0,0,0.0,0,0,0,0
2019-10-07,1610612737,1610612740,2019,109.0,133.0,242.0,118.85,121.19999999999999,115.15,123.0,0,0,0,0.0,0,0,0,0.0,0,0,0,0
2019-10-07,1610612741,1610612749,2019,112.0,122.0,234.0,108.5,118.6,115.85,108.65,0,0,0,0.0,0,0,0,0.0,0,0,0,0
2019-10-06,1610612738,1610612766,2019,107.0,106.0,213.0,106.9,106.94999999999999,109.1,111.85,0,0,0,0.0,0,0,0,0.0,0,0,0,0
2019-10-05,1610612754,1610612758,2019,130.0,106.0,236.0,105.45,107.05,116.6,117.44999999999999,0,0,0,0.0,0,0,0,0.0,0,0,0,0
2019-10-05,1610612744,1610612747,2019,101.0,123.0,224.0,112.9,111.4,109.55,112.30000000000001,0,0,0,0.0,0,0,0,0.0,0,0,0,0
2019-10-05,1610612759,1610612753,2019,89.0,125.0,214.0,107.65,106.45,108.80000000000001,105.95,0,0,0,0.0,0,0,0,0.0,0,0,0,0
2019-10-04,1610612746,1610612745,2019,96.0,109.0,205.0,116.85,118.75,113.85,103.95,0,0,0,0.0,0,0,0,0.0,0,0,0,0
2019-10-04,1610612758,1610612754,2019,131.0,132.0,263.0,115.5,116.65,103.85,105.6,0,0,0,0.0,0,0,0,0.0,0,0,0,0
2019-06-13,1610612744,1610612761,2018,110.0,114.0,224.0,113.45,110.9,105.85,101.75,82,57,25,0.695,82,58,24,0.7070000000000001,30,27,32,26
2019-06-10,1610612761,1610612744,2018,105.0,106.0,211.0,106.35,101.25,114.75,110.9,82,58,24,0.7070000000000001,82,57,25,0.695,32,26,30,27
2019-06-07,1610612744,1610612761,2018,92.0,105.0,197.0,116.69999999999999,110.85,107.1,101.65,82,57,25,0.695,82,58,24,0.7070000000000001,30,27,32,26
2019-06-05,1610612744,1610612761,2018,109.0,123.0,232.0,117.25,110.4,106.5,101.85,82,57,25,0.695,82,58,24,0.7070000000000001,30,27,32,26
2019-06-02,1610612761,1610612744,2018,104.0,109.0,213.0,106.85,100.5,117.65,111.80000000000001,82,58,24,0.7070000000000001,82,57,25,0.695,32,26,30,27
2019-05-30,1610612761,1610612744,2018,118.0,109.0,227.0,106.0,100.25,117.80000000000001,111.05000000000001,82,58,24,0.7070000000000001,82,57,25,0.695,32,26,30,27
2019-05-25,1610612761,1610612749,2018,100.0,94.0,194.0,106.85,101.0,116.25,109.0,82,58,24,0.7070000000000001,82,60,22,0.732,32,26,33,27
2019-05-23,1610612749,1610612761,2018,99.0,105.0,204.0,117.7,110.4,107.35,101.3,82,60,22,0.732,82,58,24,0.7070000000000001,33,27,32,26
2019-05-21,1610612761,1610612749,2018,120.0,102.0,222.0,107.4,101.65,118.25,109.3,82,58,24,0.7070000000000001,82,60,22,0.732,32,26,33,27
2019-05-20,1610612757,1610612744,2018,117.0,119.0,236.0,110.94999999999999,110.30000000000001,117.25,109.7,82,53,29,0.6459999999999999,82,57,25,0.695,32,21,30,27
2019-05-19,1610612761,1610612749,2018,118.0,112.0,230.0,107.1,101.19999999999999,119.15,109.05,82,58,24,0.7070000000000001,82,60,22,0.732,32,26,33,27
2019-05-18,1610612757,1610612744,2018,99.0,110.0,209.0,113.4,112.0,118.25,111.30000000000001,82,53,29,0.6459999999999999,82,57,25,0.695,32,21,30,27
2019-05-17,1610612749,1610612761,2018,125.0,103.0,228.0,119.3,109.8,108.15,100.0,82,60,22,0.732,82,58,24,0.7070000000000001,33,27,32,26
2019-05-16,1610612744,1610612757,2018,114.0,111.0,225.0,118.35,110.85,114.45,112.4,82,57,25,0.695,82,53,29,0.6459999999999999,30,27,32,21
2019-05-15,1610612749,1610612761,2018,108.0,100.0,208.0,119.3,109.5,109.0,99.19999999999999,82,60,22,0.732,82,58,24,0.7070000000000001,33,27,32,26
2019-05-14,1610612744,1610612757,2018,116.0,94.0,210.0,119.4,110.65,114.25,111.55,82,57,25,0.695,82,53,29,0.6459999999999999,30,27,32,21
2019-05-12,1610612743,1610612757,2018,96.0,100.0,196.0,109.80000000000001,107.3,115.15,111.65,82,54,28,0.659,82,53,29,0.6459999999999999,34,20,32,21
2019-05-12,1610612761,1610612755,2018,92.0,90.0,182.0,110.1,100.44999999999999,112.94999999999999,110.85,82,58,24,0.7070000000000001,82,51,31,0.622,32,26,31,20
2019-05-10,1610612745,1610612744,2018,113.0,118.0,231.0,113.75,103.30000000000001,119.4,110.15,82,53,29,0.6459999999999999,82,57,25,0.695,31,22,30,27
2019-05-09,1610612755,1610612761,2018,112.0,101.0,213.0,113.5,111.5,111.19999999999999,100.55,82,51,31,0.622,82,58,24,0.7070000000000001,31,20,32,26
2019-05-09,1610612757,1610612743,2018,119.0,108.0,227.0,115.05,111.85,108.65,106.95,82,53,29,0.6459999999999999,82,54,28,0.659,32,21,34,20
2019-05-08,1610612749,1610612738,2018,116.0,91.0,207.0,119.85,110.19999999999999,108.2,107.35,82,60,22,0.732,82,49,33,0.598,33,27,28,21
2019-05-08,1610612744,1610612745,2018,104.0,99.0,203.0,120.25,110.9,115.05000000000001,104.4,82,57,25,0.695,82,53,29,0.6459999999999999,30,27,31,22
2019-05-07,1610612761,1610612755,2018,125.0,89.0,214.0,110.4,101.9,113.95,111.19999999999999,82,58,24,0.7070000000000001,82,51,31,0.622,32,26,31,20
2019-05-07,1610612743,1610612757,2018,124.0,98.0,222.0,106.95,106.80000000000001,116.05,110.55,82,54,28,0.659,82,53,29,0.6459999999999999,34,20,32,21
2019-05-06,1610612738,1610612749,2018,101.0,113.0,214.0,109.45,107.7,119.9,111.19999999999999,82,49,33,0.598,82,60,22,0.732,28,21,33,27
2019-05-06,1610612745,1610612744,2018,112.0,108.0,220.0,115.30000000000001,104.1,120.7,110.65,82,53,29,0.6459999999999999,82,57,25,0.695,31,22,30,27
2019-05-05,1610612755,1610612761,2018,96.0,101.0,197.0,114.45,111.1,110.7,102.6,82,51,31,0.622,82,58,24,0.7070000000000001,31,20,32,26
2019-05-05,1610612757,1610612743,2018,112.0,116.0,228.0,116.75,110.65,105.55,107.4,82,53,29,0.6459999999999999,82,54,28,0.659,32,21,34,20
2019-05-04,1610612745,1610612744,2018,126.0,121.0,247.0,114.4,103.15,119.9,109.9,82,53,29,0.6459999999999999,82,57,25,0.695,31,22,30,27
2019-05-03,1610612738,1610612749,2018,116.0,123.0,239.0,108.85,107.30000000000001,119.0,111.1,82,49,33,0.598,82,60,22,0.732,28,21,33,27
2019-05-03,1610612757,1610612743,2018,140.0,137.0,277.0,115.05,108.69999999999999,104.25,105.05000000000001,82,53,29,0.6459999999999999,82,54,28,0.659,32,21,34,20
2019-05-02,1610612755,1610612761,2018,116.0,95.0,211.0,113.95,110.8,111.0,103.1,82,51,31,0.622,82,58,24,0.7070000000000001,31,20,32,26
2019-05-01,1610612743,1610612757,2018,90.0,97.0,187.0,104.5,104.80000000000001,115.35,109.6,82,54,28,0.659,82,53,29,0.6459999999999999,34,20,32,21
2019-04-30,1610612749,1610612738,2018,123.0,102.0,225.0,118.65,110.35,109.5,107.05000000000001,82,60,22,0.732,82,49,33,0.598,33,27,28,21
2019-04-30,1610612744,1610612745,2018,115.0,109.0,224.0,118.69999999999999,110.75,115.0,102.65,82,57,25,0.695,82,53,29,0.6459999999999999,30,27,31,22
2019-04-29,1610612761,1610612755,2018,89.0,94.0,183.0,112.94999999999999,103.0,115.6,112.8,82,58,24,0.7070000000000001,82,51,31,0.622,32,26,31,20
2019-04-29,1610612743,1610612757,2018,121.0,113.0,234.0,103.55,104.15,115.8,109.05,82,54,28,0.659,82,53,29,0.6459999999999999,34,20,32,21
2019-04-28,1610612749,1610612738,2018,90.0,112.0,202.0,119.9,109.80000000000001,109.65,109.55000000000001,82,60,22,0.732,82,49,33,0.598,33,27,28,21
2019-04-28,1610612744,1610612745,2018,104.0,100.0,204.0,119.1,110.2,114.69999999999999,102.1,82,57,25,0.695,82,53,29,0.6459999999999999,30,27,31,22
2019-04-27,1610612761,1610612755,2018,108.0,95.0,203.0,113.1,103.15,116.75,113.1,82,58,24,0.7070000000000001,82,51,31,0.622,32,26,31,20
2019-04-27,1610612743,1610612759,2018,90.0,86.0,176.0,104.05,104.80000000000001,108.95,107.2,82,54,28,0.659,82,48,34,0.585,34,20,32,16
2019-04-26,1610612746,1610612744,2018,110.0,129.0,239.0,117.75,118.35,118.15,109.1,82,48,34,0.585,82,57,25,0.695,26,22,30,27
2019-04-25,1610612759,1610612743,2018,120.0,103.0,223.0,108.4,106.2,104.55,104.2,82,48,34,0.585,82,54,28,0.659,32,16,34,20
2019-04-24,1610612745,1610612762,2018,100.0,93.0,193.0,114.9,102.75,115.25,105.9,82,53,29,0.6459999999999999,82,50,32,0.61,31,22,29,21
2019-04-24,1610612744,1610612746,2018,121.0,129.0,250.0,117.65,108.4,116.55,117.85,82,57,25,0.695,82,48,34,0.585,30,27,26,22
2019-04-23,1610612761,1610612753,2018,115.0,96.0,211.0,112.1,103.7,108.85,105.45,82,58,24,0.7070000000000001,82,42,40,0.512,32,26,25,17
2019-04-23,1610612755,1610612751,2018,122.0,100.0,222.0,116.35,113.4,115.2,113.7,82,51,31,0.622,82,42,40,0.512,31,20,23,19
2019-04-23,1610612743,1610612759,2018,108.0,90.0,198.0,105.8,105.05000000000001,109.44999999999999,106.0,82,54,28,0.659,82,48,34,0.585,34,20,32,16
2019-04-23,1610612757,1610612760,2018,118.0,115.0,233.0,116.25,109.3,111.1,111.1,82,53,29,0.6459999999999999,82,49,33,0.598,32,21,27,22
2019-04-22,1610612765,1610612749,2018,104.0,127.0,231.0,107.35,107.94999999999999,119.1,110.35,82,41,41,0.5,82,60,22,0.732,26,15,33,27
2019-04-22,1610612762,1610612745,2018,107.0,91.0,198.0,114.35,106.25,115.7,102.15,82,50,32,0.61,82,53,29,0.6459999999999999,29,21,31,22
2019-04-21,1610612754,1610612738,2018,106.0,110.0,216.0,104.15,105.95,110.15,109.6,82,48,34,0.585,82,49,33,0.598,29,19,28,21
2019-04-21,1610612746,1610612744,2018,105.0,113.0,218.0,116.5,118.44999999999999,117.3,108.35,82,48,34,0.585,82,57,25,0.695,26,22,30,27
2019-04-21,1610612753,1610612761,2018,85.0,107.0,192.0,109.75,104.9,113.0,104.65,82,42,40,0.512,82,58,24,0.7070000000000001,25,17,32,26
2019-04-21,1610612760,1610612757,2018,98.0,111.0,209.0,110.6,111.05,116.95,109.6,82,49,33,0.598,82,53,29,0.6459999999999999,27,22,32,21
2019-04-20,1610612751,1610612755,2018,108.0,112.0,220.0,115.6,114.35,117.25,114.25,82,42,40,0.512,82,51,31,0.622,23,19,31,20
2019-04-20,1610612759,1610612743,2018,103.0,117.0,220.0,110.35,105.85,105.65,105.15,82,48,34,0.585,82,54,28,0.659,32,16,34,20
2019-04-20,1610612765,1610612749,2018,103.0,119.0,222.0,107.80000000000001,107.35,119.7,111.2,82,41,41,0.5,82,60,22,0.732,26,15,33,27
2019-04-20,1610612762,1610612745,2018,101.0,104.0,205.0,114.9,106.8,116.25,102.3,82,50,32,0.61,82,53,29,0.6459999999999999,29,21,31,22
2019-04-19,1610612753,1610612761,2018,93.0,98.0,191.0,110.55,105.5,114.45,105.2,82,42,40,0.512,82,58,24,0.7070000000000001,25,17,32,26
2019-04-19,1610612754,1610612738,2018,96.0,104.0,200.0,105.45,106.5,110.5,110.25,82,48,34,0.585,82,49,33,0.598,29,19,28,21
2019-04-19,1610612760,1610612757,2018,120.0,108.0,228.0,110.0,110.45,117.1,109.6,82,49,33,0.598,82,53,29,0.6459999999999999,27,22,32,21
2019-04-18,1610612751,1610612755,2018,115.0,131.0,246.0,114.9,112.05000000000001,115.25,113.85,82,42,40,0.512,82,51,31,0.622,23,19,31,20
2019-04-18,1610612759,1610612743,2018,118.0,108.0,226.0,109.65,105.6,105.5,105.35,82,48,34,0.585,82,54,28,0.659,32,16,34,20
2019-04-18,1610612746,1610612744,2018,105.0,132.0,237.0,118.25,117.6,116.69999999999999,108.94999999999999,82,48,34,0.585,82,57,25,0.695,26,22,30,27
2019-04-17,1610612738,1610612754,2018,99.0,91.0,190.0,110.9,110.5,105.35,106.85,82,49,33,0.598,82,48,34,0.585,28,21,29,19
2019-04-17,1610612749,1610612765,2018,120.0,99.0,219.0,119.95,112.75,106.55000000000001,106.75,82,60,22,0.732,82,41,41,0.5,33,27,26,15
2019-04-17,1610612745,1610612762,2018,118.0,98.0,216.0,116.25,102.69999999999999,115.19999999999999,106.6,82,53,29,0.6459999999999999,82,50,32,0.61,31,22,29,21
2019-04-16,1610612761,1610612753,2018,111.0,82.0,193.0,114.85,106.95,111.75,105.65,82,58,24,0.7070000000000001,82,42,40,0.512,32,26,25,17
2019-04-16,1610612743,1610612759,2018,114.0,105.0,219.0,105.4,106.1,108.65,104.94999999999999,82,54,28,0.659,82,48,34,0.585,34,20,32,16
2019-04-16,1610612757,1610612760,2018,114.0,94.0,208.0,117.44999999999999,111.35,111.3,111.30000000000001,82,53,29,0.6459999999999999,82,49,33,0.598,32,21,27,22
2019-04-15,1610612755,1610612751,2018,145.0,123.0,268.0,113.85,113.69999999999999,113.55,110.2,82,51,31,0.622,82,42,40,0.512,31,20,23,19
2019-04-15,1610612744,1610612746,2018,131.0,135.0,266.0,116.25,107.44999999999999,116.30000000000001,117.2,82,57,25,0.695,82,48,34,0.585,30,27,26,22
2019-04-14,1610612738,1610612754,2018,84.0,74.0,158.0,111.3,111.65,106.55000000000001,108.5,82,49,33,0.598,82,48,34,0.585,28,21,29,19
2019-04-14,1610612757,1610612760,2018,104.0,99.0,203.0,118.69999999999999,111.75,111.44999999999999,111.9,82,53,29,0.6459999999999999,82,49,33,0.598,32,21,27,22
2019-04-14,1610612749,1610612765,2018,121.0,86.0,207.0,120.45,114.15,106.0,105.85,82,60,22,0.732,82,41,41,0.5,33,27,26,15
2019-04-14,1610612745,1610612762,2018,122.0,90.0,212.0,115.5,102.75,116.4,105.7,82,53,29,0.6459999999999999,82,50,32,0.61,31,22,29,21
2019-04-13,1610612755,1610612751,2018,102.0,111.0,213.0,114.5,114.65,113.69999999999999,110.7,82,51,31,0.622,82,42,40,0.512,31,20,23,19
2019-04-13,1610612761,1610612753,2018,101.0,104.0,205.0,115.7,106.5,111.19999999999999,105.95,82,58,24,0.7070000000000001,82,42,40,0.512,32,26,25,17
2019-04-13,1610612744,1610612746,2018,121.0,104.0,225.0,114.94999999999999,108.65,116.7,116.45,82,57,25,0.695,82,48,34,0.585,30,27,26,22
2019-04-13,1610612743,1610612759,2018,96.0,101.0,197.0,105.80000000000001,106.6,109.5,106.65,82,54,28,0.659,82,48,34,0.585,34,20,32,16
2019-04-10,1610612737,1610612754,2018,134.0,135.0,269.0,117.35,120.0,104.85,107.3,81,29,52,0.358,81,47,34,0.58,17,12,29,18
2019-04-10,1610612751,1610612748,2018,113.0,94.0,207.0,113.0,111.65,106.44999999999999,104.75,81,41,40,0.506,81,39,42,0.48100000000000004,22,19,19,20
2019-04-10,1610612766,1610612753,2018,114.0,122.0,236.0,108.9,111.80000000000001,110.94999999999999,105.85,81,39,42,0.48100000000000004,81,41,40,0.506,25,14,25,16
2019-04-10,1610612752,1610612765,2018,89.0,115.0,204.0,101.8,113.35,105.85,106.6,81,17,64,0.21,81,40,41,0.494,9,8,26,14
2019-04-10,1610612755,1610612741,2018,125.0,109.0,234.0,113.55,114.3,108.5,117.69999999999999,81,50,31,0.617,81,22,59,0.272,30,20,9,13
2019-04-10,1610612763,1610612744,2018,132.0,117.0,249.0,110.5,111.94999999999999,113.9,107.2,81,32,49,0.395,81,57,24,0.7040000000000001,20,12,30,27
2019-04-10,1610612749,1610612760,2018,116.0,127.0,243.0,120.5,112.7,110.69999999999999,112.15,81,60,21,0.741,81,48,33,0.593,33,27,27,21
2019-04-10,1610612759,1610612742,2018,105.0,94.0,199.0,110.05,107.05000000000001,110.1,113.4,81,47,34,0.58,81,33,48,0.40700000000000003,31,16,24,9
2019-04-10,1610612743,1610612750,2018,99.0,95.0,194.0,106.9,107.44999999999999,113.25,120.55000000000001,81,53,28,0.654,81,36,45,0.444,33,20,25,11
2019-04-10,1610612746,1610612762,2018,143.0,137.0,280.0,115.45,115.1,115.1,103.75,81,47,34,0.58,81,50,31,0.617,25,22,29,21
2019-04-10,1610612757,1610612758,2018,136.0,131.0,267.0,118.25,111.1,114.05000000000001,114.55,81,52,29,0.642,81,39,42,0.48100000000000004,31,21,24,15
2019-04-09,1610612739,1610612766,2018,97.0,124.0,221.0,107.75,115.95,108.4,113.5,81,19,62,0.235,80,38,42,0.475,13,6,25,13
2019-04-09,1610612765,1610612763,2018,100.0,93.0,193.0,106.5,107.4,111.19999999999999,112.55,80,39,41,0.488,80,32,48,0.4,25,14,20,12
2019-04-09,1610612764,1610612738,2018,110.0,116.0,226.0,113.8,116.5,111.9,110.9,81,32,49,0.395,81,48,33,0.593,22,10,28,20
2019-04-09,1610612748,1610612755,2018,122.0,99.0,221.0,106.19999999999999,104.19999999999999,113.95,113.6,80,38,42,0.475,80,50,30,0.625,18,20,30,20
2019-04-09,1610612741,1610612752,2018,86.0,96.0,182.0,109.5,118.75,102.3,113.6,80,22,58,0.275,80,16,64,0.2,9,13,9,7
2019-04-09,1610612750,1610612761,2018,100.0,120.0,220.0,114.8,120.55000000000001,115.05000000000001,107.1,80,36,44,0.45,81,57,24,0.7040000000000001,25,11,32,25
2019-04-09,1610612740,1610612744,2018,103.0,112.0,215.0,115.2,123.1,114.55,108.35,81,33,48,0.40700000000000003,80,56,24,0.7,19,14,30,26
2019-04-09,1610612742,1610612756,2018,120.0,109.0,229.0,109.6,113.0,111.1,118.5,80,32,48,0.4,81,19,62,0.235,23,9,12,7
2019-04-09,1610612762,1610612743,2018,118.0,108.0,226.0,114.94999999999999,103.9,107.25,106.5,80,49,31,0.613,80,53,27,0.6629999999999999,28,21,33,20
2019-04-09,1610612760,1610612745,2018,112.0,111.0,223.0,110.05,111.35,115.85,102.80000000000001,80,47,33,0.588,81,53,28,0.654,26,21,31,22
2019-04-09,1610612747,1610612757,2018,101.0,104.0,205.0,110.5,113.65,118.95,111.44999999999999,81,37,44,0.457,80,51,29,0.638,22,15,31,20
2019-04-07,1610612761,1610612748,2018,117.0,109.0,226.0,114.1,107.3,105.85,103.65,80,56,24,0.7,79,38,41,0.48100000000000004,31,25,18,20
2019-04-07,1610612739,1610612759,2018,90.0,112.0,202.0,108.8,115.25,110.3,108.55000000000001,80,19,61,0.23800000000000002,80,46,34,0.575,13,6,31,15
2019-04-07,1610612750,1610612760,2018,126.0,132.0,258.0,114.1,119.2,109.55,111.6,79,36,43,0.456,79,46,33,0.5820000000000001,25,11,26,20
2019-04-07,1610612765,1610612766,2018,91.0,104.0,195.0,108.0,107.8,109.35,114.55000000000001,79,39,40,0.494,79,37,42,0.46799999999999997,25,14,25,12
2019-04-07,1610612754,1610612751,2018,96.0,108.0,204.0,106.35,107.44999999999999,112.0,112.69999999999999,80,47,33,0.588,80,40,40,0.5,29,18,22,18
2019-04-07,1610612763,1610612742,2018,127.0,129.0,256.0,110.15,111.69999999999999,108.75,112.7,79,32,47,0.405,79,31,48,0.392,20,12,23,8
2019-04-07,1610612745,1610612756,2018,149.0,113.0,262.0,114.45,103.05000000000001,110.8,117.75,80,52,28,0.65,80,19,61,0.23800000000000002,30,22,12,7
2019-04-07,1610612749,1610612737,2018,115.0,107.0,222.0,121.75,113.75,117.9,119.85,80,59,21,0.738,80,29,51,0.363,32,27,17,12
2019-04-07,1610612738,1610612753,2018,108.0,116.0,224.0,112.4,110.6,110.3,105.85,80,48,32,0.6,80,40,40,0.5,28,20,25,15
2019-04-07,1610612752,1610612764,2018,113.0,110.0,223.0,102.05,113.25,113.8,117.0,79,15,64,0.19,80,32,48,0.4,8,7,22,10
2019-04-07,1610612744,1610612746,2018,131.0,104.0,235.0,113.6,109.05,116.25,115.05000000000001,79,55,24,0.696,80,47,33,0.588,29,26,25,22
2019-04-07,1610612757,1610612743,2018,115.0,108.0,223.0,118.6,111.94999999999999,107.0,105.94999999999999,79,50,29,0.633,79,53,26,0.6709999999999999,30,20,33,20
2019-04-07,1610612758,1610612740,2018,129.0,133.0,262.0,114.6,114.94999999999999,113.05000000000001,121.6,80,39,41,0.488,80,32,48,0.4,24,15,19,13
2019-04-07,1610612747,1610612762,2018,113.0,109.0,222.0,111.1,114.15,116.85,105.65,80,36,44,0.45,79,49,30,0.62,21,15,28,21
2019-04-06,1610612749,1610612751,2018,128.0,133.0,261.0,120.25,111.95,111.2,112.05,79,59,20,0.747,79,39,40,0.494,32,27,22,17
2019-04-06,1610612741,1610612755,2018,96.0,116.0,212.0,111.0,118.75,113.55,114.0,79,22,57,0.278,79,49,30,0.62,9,13,30,19
2019-04-05,1610612766,1610612761,2018,113.0,111.0,224.0,109.44999999999999,114.85,113.75,106.6,78,36,42,0.462,79,56,23,0.7090000000000001,24,12,31,25
2019-04-05,1610612753,1610612737,2018,149.0,113.0,262.0,109.19999999999999,104.65,117.85,118.80000000000001,79,39,40,0.494,79,29,50,0.3670000000000001,24,15,17,12
2019-04-05,1610612764,1610612759,2018,112.0,129.0,241.0,114.94999999999999,116.6,109.25,108.30000000000001,79,32,47,0.405,79,45,34,0.57,22,10,31,14
2019-04-05,1610612754,1610612738,2018,97.0,117.0,214.0,106.35,106.9,111.3,111.65,79,47,32,0.595,79,47,32,0.595,29,18,28,19
2019-04-05,1610612745,1610612752,2018,120.0,96.0,216.0,114.4,103.80000000000001,102.44999999999999,112.6,79,51,28,0.6459999999999999,78,15,63,0.192,29,22,8,7
2019-04-05,1610612750,1610612748,2018,111.0,109.0,220.0,114.6,119.30000000000001,106.0,103.15,78,35,43,0.449,78,38,40,0.48700000000000004,24,11,18,20
2019-04-05,1610612760,1610612765,2018,123.0,110.0,233.0,108.6,111.5,108.95,106.3,78,45,33,0.5770000000000001,78,39,39,0.5,25,20,25,14
2019-04-05,1610612742,1610612763,2018,112.0,122.0,234.0,108.35,112.30000000000001,109.55,112.19999999999999,78,31,47,0.397,78,31,47,0.397,23,8,20,11
2019-04-05,1610612762,1610612758,2018,119.0,98.0,217.0,116.45,106.0,114.94999999999999,114.6,78,48,30,0.615,79,39,40,0.494,27,21,24,15
2019-04-05,1610612756,1610612740,2018,133.0,126.0,259.0,110.05,116.9,113.0,120.95,79,18,61,0.228,79,32,47,0.405,11,7,19,13
2019-04-05,1610612743,1610612757,2018,119.0,110.0,229.0,107.19999999999999,105.25,118.95,111.94999999999999,78,52,26,0.667,78,50,28,0.6409999999999999,32,20,30,20
2019-04-05,1610612744,1610612739,2018,120.0,114.0,234.0,113.85,109.5,108.44999999999999,114.9,78,54,24,0.6920000000000001,79,19,60,0.24100000000000002,28,26,13,6
2019-04-05,1610612746,1610612747,2018,117.0,122.0,239.0,116.8,114.30000000000001,110.25,113.80000000000001,79,47,32,0.595,79,35,44,0.44299999999999995,25,22,21,14
2019-04-04,1610612755,1610612749,2018,122.0,128.0,250.0,112.9,113.2,120.9,112.85,78,49,29,0.628,78,58,20,0.7440000000000001,30,19,32,26
2019-04-04,1610612758,1610612739,2018,117.0,104.0,221.0,114.94999999999999,114.6,109.5,114.94999999999999,78,38,40,0.48700000000000004,78,19,59,0.244,23,15,13,6
2019-04-04,1610612747,1610612744,2018,90.0,108.0,198.0,111.30000000000001,113.7,114.5,110.5,78,35,43,0.449,77,53,24,0.688,21,14,28,25
2019-04-03,1610612765,1610612754,2018,89.0,108.0,197.0,110.5,106.05,106.4,108.1,77,39,38,0.506,78,46,32,0.59,25,14,29,17
2019-04-03,1610612753,1610612752,2018,114.0,100.0,214.0,109.6,105.25,102.6,112.9,78,38,40,0.48700000000000004,77,15,62,0.195,23,15,8,7
2019-04-03,1610612764,1610612741,2018,114.0,115.0,229.0,114.85,116.80000000000001,110.75,118.5,78,32,46,0.41,78,21,57,0.26899999999999996,22,10,9,12
2019-04-03,1610612737,1610612755,2018,130.0,122.0,252.0,119.4,121.1,112.35,112.2,78,28,50,0.359,77,49,28,0.636,16,12,30,19
2019-04-03,1610612751,1610612761,2018,105.0,115.0,220.0,111.25,112.55,113.95,106.4,78,39,39,0.5,78,55,23,0.705,22,17,31,24
2019-04-03,1610612748,1610612738,2018,102.0,112.0,214.0,107.2,103.8,111.5,112.85,77,38,39,0.494,78,46,32,0.59,18,20,28,18
2019-04-03,1610612740,1610612766,2018,109.0,115.0,224.0,113.05,120.75,108.15,115.75,78,32,46,0.41,77,35,42,0.455,19,13,24,11
2019-04-03,1610612742,1610612750,2018,108.0,110.0,218.0,108.0,112.4,115.5,120.9,77,31,46,0.40299999999999997,77,34,43,0.442,23,8,24,10
2019-04-03,1610612743,1610612759,2018,113.0,85.0,198.0,107.55,106.9,110.25,108.9,77,51,26,0.662,78,45,33,0.5770000000000001,31,20,31,14
2019-04-03,1610612756,1610612762,2018,97.0,118.0,215.0,111.0,117.5,115.95,106.9,78,18,60,0.231,77,47,30,0.61,11,7,27,20
2019-04-03,1610612757,1610612763,2018,116.0,89.0,205.0,119.75,112.75,109.85,112.25,77,49,28,0.636,77,31,46,0.40299999999999997,29,20,20,11
2019-04-03,1610612746,1610612745,2018,103.0,135.0,238.0,117.69999999999999,113.15,113.55,104.25,78,47,31,0.603,78,50,28,0.6409999999999999,25,22,29,21
2019-04-02,1610612760,1610612747,2018,119.0,103.0,222.0,108.44999999999999,112.30000000000001,111.9,114.15,77,44,33,0.5710000000000001,77,35,42,0.455,24,20,21,14
2019-04-02,1610612759,1610612737,2018,117.0,111.0,228.0,109.65,108.0,119.5,122.0,77,44,33,0.5710000000000001,77,28,49,0.364,30,14,16,12
2019-04-02,1610612758,1610612745,2018,105.0,130.0,235.0,114.8,112.9,112.35,104.55000000000001,77,38,39,0.494,77,49,28,0.636,23,15,29,20
2019-04-02,1610612744,1610612743,2018,116.0,102.0,218.0,114.44999999999999,110.8,108.15,106.3,76,52,24,0.684,76,51,25,0.6709999999999999,27,25,31,20
2019-04-01,1610612754,1610612765,2018,111.0,102.0,213.0,105.80000000000001,107.5,110.05,105.75,77,45,32,0.584,76,39,37,0.513,28,17,25,14
2019-04-01,1610612738,1610612748,2018,110.0,105.0,215.0,111.6,113.75,106.3,103.44999999999999,77,45,32,0.584,76,38,38,0.5,27,18,18,20
2019-04-01,1610612751,1610612749,2018,121.0,131.0,252.0,111.95,112.5,120.2,112.1,77,39,38,0.506,77,57,20,0.74,22,17,32,25
2019-04-01,1610612752,1610612741,2018,113.0,105.0,218.0,103.45,113.55,111.75,118.15,76,14,62,0.184,77,21,56,0.273,7,7,9,12
2019-04-01,1610612761,1610612753,2018,121.0,109.0,230.0,113.9,106.8,109.80000000000001,104.1,77,54,23,0.701,77,38,39,0.494,30,24,23,15
2019-04-01,1610612750,1610612757,2018,122.0,132.0,254.0,115.9,120.3,118.0,111.25,76,34,42,0.447,76,48,28,0.632,24,10,29,19
2019-04-01,1610612742,1610612755,2018,122.0,102.0,224.0,107.0,112.35,113.55000000000001,111.65,76,30,46,0.395,76,49,27,0.645,22,8,30,19
2019-04-01,1610612762,1610612766,2018,111.0,102.0,213.0,116.65,107.25,107.55,115.15,76,46,30,0.605,76,35,41,0.461,26,20,24,11
2019-04-01,1610612756,1610612739,2018,122.0,113.0,235.0,110.25,117.7,108.35,114.1,77,17,60,0.221,77,19,58,0.247,10,7,13,6
2019-03-31,1610612737,1610612749,2018,136.0,135.0,271.0,119.25,121.4,118.75,110.15,76,27,49,0.355,76,57,19,0.75,15,12,32,25
2019-03-31,1610612760,1610612742,2018,103.0,106.0,209.0,110.69999999999999,114.35,107.15,113.45,76,44,32,0.579,75,29,46,0.387,24,20,22,7
2019-03-31,1610612740,1610612747,2018,102.0,130.0,232.0,114.35,120.0,111.05000000000001,114.9,77,32,45,0.41600000000000004,76,34,42,0.447,19,13,21,13
2019-03-31,1610612759,1610612758,2018,106.0,113.0,219.0,110.0,107.75,115.1,113.4,76,44,32,0.579,76,37,39,0.48700000000000004,30,14,23,14
2019-03-31,1610612743,1610612764,2018,90.0,95.0,185.0,108.8,105.9,116.1,118.75,75,51,24,0.68,77,31,46,0.40299999999999997,31,20,22,9
2019-03-31,1610612744,1610612766,2018,137.0,90.0,227.0,113.6,112.2,109.5,114.3,75,51,24,0.68,75,35,40,0.467,26,25,24,11
2019-03-31,1610612746,1610612763,2018,113.0,96.0,209.0,118.75,113.7,109.85,110.8,77,46,31,0.597,76,31,45,0.408,24,22,20,11
2019-03-30,1610612746,1610612739,2018,132.0,108.0,240.0,118.15,114.45,108.25,113.44999999999999,76,45,31,0.5920000000000001,76,19,57,0.25,23,22,13,6
2019-03-30,1610612751,1610612738,2018,110.0,96.0,206.0,111.15,113.35,111.65,113.15,76,38,38,0.5,76,45,31,0.5920000000000001,21,17,27,18
2019-03-30,1610612745,1610612758,2018,119.0,108.0,227.0,112.4,104.35,115.85,113.7,76,48,28,0.632,75,37,38,0.493,28,20,23,14
2019-03-30,1610612765,1610612757,2018,99.0,90.0,189.0,111.55,106.4,119.65,111.80000000000001,75,38,37,0.507,75,48,27,0.64,24,14,29,19
2019-03-30,1610612754,1610612753,2018,116.0,121.0,237.0,105.25,105.95,109.65,102.69999999999999,76,45,31,0.5920000000000001,76,37,39,0.48700000000000004,28,17,23,14
2019-03-30,1610612752,1610612748,2018,92.0,100.0,192.0,104.05000000000001,114.3,107.2,104.85,75,14,61,0.187,75,37,38,0.493,7,7,18,19
2019-03-30,1610612741,1610612761,2018,101.0,124.0,225.0,112.8,117.45,113.65,107.1,76,21,55,0.276,76,53,23,0.6970000000000001,9,12,30,23
2019-03-30,1610612750,1610612755,2018,109.0,118.0,227.0,115.75,119.75,113.05000000000001,111.95,75,34,41,0.45299999999999996,75,48,27,0.64,24,10,30,18
2019-03-30,1610612756,1610612763,2018,115.0,120.0,235.0,110.0,117.6,108.45,110.05,76,17,59,0.22399999999999998,75,30,45,0.4,10,7,20,10
2019-03-29,1610612738,1610612754,2018,114.0,112.0,226.0,112.35,114.0,105.6,105.85,75,44,31,0.5870000000000001,75,45,30,0.6,26,18,28,17
2019-03-29,1610612737,1610612757,2018,98.0,118.0,216.0,120.35,121.1,120.25,112.65,75,27,48,0.36,74,47,27,0.635,15,12,29,18
2019-03-29,1610612750,1610612744,2018,131.0,130.0,261.0,114.15,118.1,112.45,112.1,74,33,41,0.446,74,51,23,0.6890000000000001,23,10,26,25
2019-03-29,1610612760,1610612743,2018,105.0,115.0,220.0,111.44999999999999,114.15,108.55,106.5,75,44,31,0.5870000000000001,74,50,24,0.6759999999999999,24,20,31,19
2019-03-29,1610612762,1610612764,2018,128.0,124.0,252.0,116.5,106.3,115.5,118.4,75,45,30,0.6,76,31,45,0.408,25,20,22,9
2019-03-29,1610612747,1610612766,2018,129.0,115.0,244.0,109.85,115.19999999999999,108.4,112.8,75,33,42,0.44,74,35,39,0.473,20,13,24,11
2019-03-28,1610612765,1610612753,2018,115.0,98.0,213.0,110.85,107.05,110.95,102.35,74,37,37,0.5,75,37,38,0.493,23,14,23,14
2019-03-28,1610612755,1610612751,2018,123.0,110.0,233.0,114.05000000000001,112.45,113.05,114.15,74,47,27,0.635,75,38,37,0.507,29,18,21,17
2019-03-28,1610612748,1610612742,2018,105.0,99.0,204.0,108.0,106.1,107.4,114.2,74,36,38,0.486,74,29,45,0.392,17,19,22,7
2019-03-28,1610612752,1610612761,2018,92.0,117.0,209.0,105.0,114.75,113.95,108.5,74,14,60,0.18899999999999997,75,52,23,0.693,7,7,30,22
2019-03-28,1610612745,1610612743,2018,112.0,85.0,197.0,112.4,105.95,110.8,107.65,75,47,28,0.627,73,50,23,0.685,27,20,31,19
2019-03-28,1610612749,1610612746,2018,128.0,118.0,246.0,116.5,109.4,118.4,113.65,75,56,19,0.747,75,45,30,0.6,31,25,23,22
2019-03-28,1610612740,1610612758,2018,121.0,118.0,239.0,114.85,120.2,115.85,113.65,76,31,45,0.408,74,37,37,0.5,18,13,23,14
2019-03-28,1610612759,1610612739,2018,116.0,110.0,226.0,110.05000000000001,107.95,107.94999999999999,112.69999999999999,75,43,32,0.573,75,19,56,0.253,29,14,13,6
2019-03-27,1610612741,1610612757,2018,98.0,118.0,216.0,112.85,117.15,120.0,112.7,75,21,54,0.28,73,46,27,0.63,9,12,29,17
2019-03-27,1610612763,1610612744,2018,103.0,118.0,221.0,108.65,109.55,112.4,112.30000000000001,74,30,44,0.405,73,50,23,0.685,20,10,26,24
2019-03-27,1610612760,1610612754,2018,107.0,99.0,206.0,111.94999999999999,113.95,106.1,105.85,74,43,31,0.581,74,45,29,0.608,23,20,28,17
2019-03-27,1610612756,1610612764,2018,121.0,124.0,245.0,109.55,117.3,116.0,118.6,75,17,58,0.22699999999999998,75,30,45,0.4,10,7,22,8
2019-03-27,1610612762,1610612747,2018,115.0,100.0,215.0,116.55000000000001,105.69999999999999,110.85,116.6,74,44,30,0.595,74,33,41,0.446,24,20,20,13
2019-03-26,1610612766,1610612759,2018,125.0,116.0,241.0,108.3,112.5,110.15,108.05,73,34,39,0.466,74,43,31,0.581,23,11,29,14
2019-03-26,1610612739,1610612738,2018,106.0,116.0,222.0,109.6,114.3,112.15,114.15,74,19,55,0.257,74,43,31,0.581,13,6,26,17
2019-03-26,1610612748,1610612753,2018,99.0,104.0,203.0,107.85,106.85,110.9,101.55,73,36,37,0.493,74,36,38,0.486,17,19,23,13
2019-03-26,1610612761,1610612741,2018,112.0,103.0,215.0,114.8,109.35,113.6,117.80000000000001,74,51,23,0.6890000000000001,74,21,53,0.284,29,22,9,12
2019-03-26,1610612749,1610612745,2018,108.0,94.0,202.0,118.5,111.15,113.25,106.6,74,55,19,0.743,74,47,27,0.635,30,25,27,20
2019-03-26,1610612750,1610612746,2018,111.0,122.0,233.0,114.15,118.25,116.9,113.9,73,33,40,0.452,74,44,30,0.595,23,10,23,21
2019-03-26,1610612740,1610612737,2018,120.0,130.0,250.0,113.25,119.6,120.0,121.0,75,31,44,0.413,74,26,48,0.35100000000000003,18,13,15,11
2019-03-26,1610612742,1610612758,2018,121.0,125.0,246.0,106.7,114.05000000000001,115.0,113.7,73,29,44,0.397,73,36,37,0.493,22,7,23,13
2019-03-26,1610612743,1610612765,2018,95.0,92.0,187.0,112.85,109.15,112.2,107.1,72,49,23,0.6809999999999999,73,37,36,0.507,30,19,23,14
2019-03-26,1610612747,1610612764,2018,124.0,106.0,230.0,110.45,116.4,117.15,119.80000000000001,73,32,41,0.43799999999999994,74,30,44,0.405,19,13,22,8
2019-03-25,1610612753,1610612755,2018,119.0,98.0,217.0,110.05000000000001,101.1,114.80000000000001,111.7,73,35,38,0.479,73,47,26,0.644,22,13,29,18
2019-03-25,1610612763,1610612760,2018,115.0,103.0,218.0,107.85,108.9,112.65,113.8,73,29,44,0.397,73,43,30,0.589,19,10,23,20
2019-03-25,1610612762,1610612756,2018,125.0,92.0,217.0,115.2,107.35,110.15,116.9,73,43,30,0.589,74,17,57,0.23,23,20,10,7
2019-03-25,1610612757,1610612751,2018,148.0,144.0,292.0,118.6,111.05,112.1,113.1,72,45,27,0.625,74,38,36,0.514,28,17,21,17
2019-03-24,1610612752,1610612746,2018,113.0,124.0,237.0,104.30000000000001,113.75,116.55000000000001,114.0,73,14,59,0.192,73,43,30,0.589,7,7,23,20
2019-03-24,1610612749,1610612739,2018,127.0,105.0,232.0,117.55,110.85,109.5,114.1,73,54,19,0.74,73,19,54,0.26,29,25,13,6
2019-03-24,1610612754,1610612743,2018,124.0,88.0,212.0,105.69999999999999,106.05,113.6,109.4,73,44,29,0.603,71,49,22,0.69,27,17,30,19
2019-03-24,1610612761,1610612766,2018,114.0,115.0,229.0,115.45,109.85,107.25,113.1,73,51,22,0.6990000000000001,72,33,39,0.45799999999999996,29,22,23,10
2019-03-24,1610612740,1610612745,2018,90.0,113.0,203.0,114.85,119.80000000000001,113.95,107.15,74,31,43,0.419,73,46,27,0.63,18,13,27,19
2019-03-24,1610612738,1610612759,2018,96.0,115.0,211.0,114.05,114.85,109.5,110.3,73,43,30,0.589,73,42,31,0.575,26,17,29,13
2019-03-24,1610612744,1610612765,2018,121.0,114.0,235.0,113.4,111.7,112.75,107.15,72,49,23,0.6809999999999999,72,37,35,0.514,25,24,23,14
2019-03-24,1610612747,1610612758,2018,111.0,106.0,217.0,110.15,117.1,114.65,112.95,72,31,41,0.431,72,36,36,0.5,18,13,23,13
2019-03-23,1610612766,1610612738,2018,124.0,117.0,241.0,106.80000000000001,113.1,113.35,113.44999999999999,71,32,39,0.451,72,43,29,0.597,22,10,26,17
2019-03-23,1610612764,1610612748,2018,108.0,113.0,221.0,117.7,119.45,107.0,106.55,73,30,43,0.41100000000000003,72,35,37,0.486,22,8,17,18
2019-03-23,1610612737,1610612755,2018,129.0,127.0,256.0,119.65,120.9,114.5,110.5,73,25,48,0.342,72,47,25,0.653,14,11,29,18
2019-03-23,1610612741,1610612762,2018,83.0,114.0,197.0,115.69999999999999,118.80000000000001,114.75,109.80000000000001,73,21,52,0.28800000000000003,72,42,30,0.583,9,12,23,19
2019-03-23,1610612763,1610612750,2018,99.0,112.0,211.0,108.30000000000001,108.6,114.3,118.5,72,29,43,0.40299999999999997,72,32,40,0.444,19,10,23,9
2019-03-23,1610612744,1610612742,2018,91.0,126.0,217.0,114.6,110.45,105.95,114.4,71,49,22,0.69,72,28,44,0.389,25,24,22,6
2019-03-23,1610612757,1610612765,2018,117.0,112.0,229.0,119.15,111.05,112.65,107.19999999999999,71,44,27,0.62,71,37,34,0.521,27,17,23,14
2019-03-23,1610612758,1610612756,2018,112.0,103.0,215.0,114.1,114.15,109.4,117.1,71,35,36,0.493,73,17,56,0.233,22,13,10,7
2019-03-22,1610612753,1610612763,2018,123.0,119.0,242.0,109.25,100.15,107.2,107.4,72,34,38,0.47200000000000003,71,29,42,0.408,21,13,19,10
2019-03-22,1610612739,1610612746,2018,108.0,110.0,218.0,109.44999999999999,113.80000000000001,116.2,114.65,72,19,53,0.264,72,42,30,0.583,13,6,23,19
2019-03-22,1610612752,1610612743,2018,93.0,111.0,204.0,104.25,113.44999999999999,113.4,110.05000000000001,72,14,58,0.19399999999999998,70,48,22,0.6859999999999999,7,7,30,18
2019-03-22,1610612761,1610612760,2018,109.0,116.0,225.0,116.05,109.2,113.3,115.05,72,51,21,0.708,72,42,30,0.583,29,22,23,19
2019-03-22,1610612745,1610612759,2018,111.0,105.0,216.0,114.2,107.94999999999999,109.85,111.1,72,45,27,0.625,72,42,30,0.583,26,19,29,13
2019-03-22,1610612749,1610612748,2018,116.0,87.0,203.0,117.55,111.8,108.55,106.15,72,53,19,0.736,71,35,36,0.493,28,25,17,18
2019-03-22,1610612747,1610612751,2018,106.0,111.0,217.0,110.4,118.05000000000001,111.0,112.9,71,31,40,0.4370000000000001,73,37,36,0.507,18,13,21,16
2019-03-21,1610612766,1610612750,2018,113.0,106.0,219.0,107.4,113.7,114.85,118.95,70,31,39,0.44299999999999995,71,32,39,0.451,21,10,23,9
2019-03-21,1610612764,1610612743,2018,108.0,113.0,221.0,118.75,120.65,113.0,109.6,72,30,42,0.41700000000000004,69,47,22,0.6809999999999999,22,8,30,17
2019-03-21,1610612737,1610612762,2018,117.0,114.0,231.0,118.35,120.5,115.3,109.5,72,24,48,0.33299999999999996,71,42,29,0.5920000000000001,13,11,23,19
2019-03-21,1610612756,1610612765,2018,98.0,118.0,216.0,109.8,117.19999999999999,112.0,106.9,72,17,55,0.23600000000000002,70,36,34,0.514,10,7,23,13
2019-03-21,1610612758,1610612742,2018,116.0,100.0,216.0,114.65,114.75,105.4,113.25,70,34,36,0.486,71,28,43,0.39399999999999996,21,13,22,6
2019-03-21,1610612744,1610612754,2018,112.0,89.0,201.0,114.2,111.65,106.0,104.85,70,48,22,0.6859999999999999,72,44,28,0.611,24,24,27,17
2019-03-20,1610612739,1610612749,2018,107.0,102.0,209.0,108.9,113.85,118.05,111.4,71,18,53,0.254,71,53,18,0.746,12,6,28,25
2019-03-20,1610612753,1610612740,2018,119.0,96.0,215.0,109.15,101.65,115.44999999999999,119.5,71,33,38,0.465,73,31,42,0.425,20,13,18,13
2019-03-20,1610612755,1610612738,2018,118.0,115.0,233.0,114.44999999999999,110.25,113.25,112.5,71,46,25,0.648,71,43,28,0.606,28,18,26,17
2019-03-20,1610612752,1610612762,2018,116.0,137.0,253.0,102.65,111.4,114.9,109.15,71,14,57,0.19699999999999998,70,41,29,0.586,7,7,23,18
2019-03-20,1610612741,1610612764,2018,126.0,120.0,246.0,115.4,119.05000000000001,118.4,120.15,72,20,52,0.278,71,30,41,0.423,8,12,22,8
2019-03-20,1610612763,1610612745,2018,126.0,125.0,251.0,105.5,105.9,113.85,107.15,70,28,42,0.4,71,45,26,0.634,18,10,26,19
2019-03-20,1610612759,1610612748,2018,105.0,110.0,215.0,110.9,111.80000000000001,108.35,105.75,71,42,29,0.5920000000000001,70,34,36,0.486,29,13,17,17
2019-03-20,1610612760,1610612761,2018,114.0,123.0,237.0,114.2,115.0,115.85,109.55000000000001,71,42,29,0.5920000000000001,71,50,21,0.7040000000000001,23,19,29,21
2019-03-20,1610612757,1610612742,2018,126.0,118.0,244.0,119.30000000000001,110.75,105.2,111.45,70,43,27,0.614,70,28,42,0.4,26,17,22,6
2019-03-19,1610612766,1610612755,2018,114.0,118.0,232.0,106.7,112.4,114.05,110.85,69,31,38,0.449,70,45,25,0.643,21,10,28,17
2019-03-19,1610612737,1610612745,2018,105.0,121.0,226.0,118.94999999999999,120.1,114.05000000000001,106.8,71,24,47,0.33799999999999997,70,44,26,0.629,13,11,26,18
2019-03-19,1610612749,1610612747,2018,115.0,101.0,216.0,118.5,110.65,111.80000000000001,118.7,70,52,18,0.743,70,31,39,0.44299999999999995,27,25,18,13
2019-03-19,1610612750,1610612744,2018,107.0,117.0,224.0,115.30000000000001,118.8,114.95,111.3,70,32,38,0.457,69,47,22,0.6809999999999999,23,9,24,23
2019-03-19,1610612758,1610612751,2018,121.0,123.0,244.0,114.35,114.0,110.55,112.7,69,34,35,0.493,72,36,36,0.5,21,13,21,15
2019-03-19,1610612746,1610612754,2018,115.0,109.0,224.0,116.35,115.35,105.55,104.44999999999999,71,41,30,0.5770000000000001,71,44,27,0.62,22,19,27,17
2019-03-18,1610612739,1610612765,2018,126.0,119.0,245.0,107.5,113.45,111.1,105.9,70,17,53,0.243,69,36,33,0.522,11,6,23,13
2019-03-18,1610612764,1610612762,2018,95.0,116.0,211.0,119.4,120.9,114.2,110.1,70,30,40,0.429,69,40,29,0.58,22,8,23,17
2019-03-18,1610612738,1610612743,2018,105.0,114.0,219.0,114.3,111.5,112.05000000000001,108.95,70,43,27,0.614,68,46,22,0.6759999999999999,26,17,30,16
2019-03-18,1610612761,1610612752,2018,128.0,92.0,220.0,114.05,110.2,102.65,110.05000000000001,70,49,21,0.7,70,14,56,0.2,28,21,7,7
2019-03-18,1610612760,1610612748,2018,107.0,116.0,223.0,114.75,114.8,107.55,105.1,70,42,28,0.6,69,33,36,0.478,23,19,17,16
2019-03-18,1610612759,1610612744,2018,111.0,105.0,216.0,111.94999999999999,112.5,115.45,111.3,70,41,29,0.586,68,47,21,0.691,28,13,24,23
2019-03-18,1610612742,1610612740,2018,125.0,129.0,254.0,103.9,109.65,115.05,119.05000000000001,69,28,41,0.406,72,30,42,0.41700000000000004,22,6,18,12
2019-03-18,1610612756,1610612741,2018,101.0,116.0,217.0,109.3,117.3,114.85,118.45,71,17,54,0.239,71,19,52,0.268,10,7,8,11
2019-03-18,1610612757,1610612754,2018,106.0,98.0,204.0,120.35,110.65,105.1,104.5,69,42,27,0.609,70,44,26,0.629,25,17,27,17
2019-03-17,1610612752,1610612747,2018,124.0,123.0,247.0,101.4,109.55000000000001,110.35,119.30000000000001,69,13,56,0.188,69,31,38,0.449,6,7,18,13
2019-03-17,1610612748,1610612766,2018,93.0,75.0,168.0,107.3,106.1,107.9,113.15,68,32,36,0.47100000000000003,68,31,37,0.456,16,16,21,10
2019-03-17,1610612749,1610612755,2018,125.0,130.0,255.0,117.95,109.25,113.55,109.4,69,52,17,0.754,69,44,25,0.638,27,25,28,16
2019-03-17,1610612765,1610612761,2018,110.0,107.0,217.0,110.25,105.0,114.0,110.2,68,35,33,0.515,69,49,20,0.71,22,13,28,21
2019-03-17,1610612753,1610612737,2018,101.0,91.0,192.0,108.65,101.85,119.94999999999999,121.05000000000001,70,32,38,0.457,70,24,46,0.34299999999999997,19,13,13,11
2019-03-17,1610612758,1610612741,2018,129.0,102.0,231.0,114.65,114.55,115.6,118.1,68,33,35,0.485,70,19,51,0.271,20,13,8,11
2019-03-17,1610612745,1610612750,2018,117.0,102.0,219.0,113.35,106.6,115.80000000000001,119.05,69,43,26,0.623,69,32,37,0.46399999999999997,25,18,23,9
2019-03-17,1610612746,1610612751,2018,119.0,116.0,235.0,116.5,114.94999999999999,109.94999999999999,112.35,70,40,30,0.5710000000000001,71,36,35,0.507,21,19,21,15
2019-03-16,1610612738,1610612737,2018,129.0,120.0,249.0,113.45,110.7,120.0,119.65,69,42,27,0.609,69,24,45,0.348,25,17,13,11
2019-03-16,1610612764,1610612763,2018,135.0,128.0,263.0,118.0,118.95,103.6,105.1,69,29,40,0.42,69,28,41,0.406,21,8,18,10
2019-03-16,1610612740,1610612756,2018,136.0,138.0,274.0,113.6,117.6,108.6,116.8,71,30,41,0.423,70,16,54,0.22899999999999998,18,12,10,6
2019-03-16,1610612742,1610612739,2018,121.0,116.0,237.0,103.85,110.0,106.80000000000001,113.6,68,27,41,0.397,69,17,52,0.24600000000000002,21,6,11,6
2019-03-16,1610612760,1610612744,2018,88.0,110.0,198.0,116.45,115.1,116.25,112.8,69,42,27,0.609,67,46,21,0.687,23,19,24,22
2019-03-16,1610612759,1610612757,2018,108.0,103.0,211.0,111.3,112.5,120.75,111.25,69,40,29,0.58,68,42,26,0.618,27,13,25,17
2019-03-16,1610612743,1610612754,2018,102.0,100.0,202.0,113.25,109.45,105.25,104.69999999999999,67,45,22,0.672,69,44,25,0.638,29,16,27,17
2019-03-16,1610612762,1610612751,2018,114.0,98.0,212.0,114.9,110.8,110.9,112.4,68,39,29,0.574,70,36,34,0.514,22,17,21,15
2019-03-15,1610612765,1610612747,2018,111.0,97.0,208.0,109.94999999999999,105.9,110.55000000000001,119.5,67,34,33,0.507,68,31,37,0.456,21,13,18,13
2019-03-15,1610612755,1610612758,2018,123.0,114.0,237.0,112.75,109.65,114.2,114.4,68,43,25,0.632,67,33,34,0.493,27,16,20,13
2019-03-15,1610612764,1610612766,2018,110.0,116.0,226.0,118.4,119.45,108.0,113.0,68,29,39,0.426,67,30,37,0.44799999999999995,21,8,21,9
2019-03-15,1610612748,1610612749,2018,98.0,113.0,211.0,107.5,106.35,118.4,109.7,67,32,35,0.478,68,51,17,0.75,16,16,27,24
2019-03-15,1610612745,1610612756,2018,108.0,102.0,210.0,114.0,107.44999999999999,108.6,117.2,68,42,26,0.618,69,16,53,0.23199999999999998,24,18,10,6
2019-03-15,1610612740,1610612757,2018,110.0,122.0,232.0,113.05,116.75,119.69999999999999,110.85,70,30,40,0.429,67,41,26,0.612,18,12,25,16
2019-03-15,1610612759,1610612752,2018,109.0,83.0,192.0,110.5,113.75,102.2,109.55000000000001,68,39,29,0.574,68,13,55,0.191,26,13,6,7
2019-03-15,1610612746,1610612741,2018,128.0,121.0,249.0,114.80000000000001,114.5,114.75,116.1,69,39,30,0.565,69,19,50,0.275,20,19,8,11
2019-03-14,1610612754,1610612760,2018,108.0,106.0,214.0,106.65,104.1,117.05000000000001,114.8,68,43,25,0.632,68,42,26,0.618,26,17,23,19
2019-03-14,1610612753,1610612739,2018,120.0,91.0,211.0,108.05000000000001,103.19999999999999,107.2,113.35,69,31,38,0.449,68,17,51,0.25,18,13,11,6
2019-03-14,1610612738,1610612758,2018,126.0,120.0,246.0,112.7,110.45,112.9,114.25,68,41,27,0.603,66,33,33,0.5,24,17,20,13
2019-03-14,1610612761,1610612747,2018,111.0,98.0,209.0,114.45,110.55000000000001,111.80000000000001,119.95,68,48,20,0.706,67,31,36,0.46299999999999997,27,21,18,13
2019-03-14,1610612762,1610612750,2018,120.0,100.0,220.0,114.2,110.9,116.1,118.44999999999999,67,38,29,0.5670000000000001,68,32,36,0.47100000000000003,21,17,23,9
2019-03-14,1610612743,1610612742,2018,100.0,99.0,199.0,114.85,109.25,104.2,110.8,66,44,22,0.667,67,27,40,0.40299999999999997,28,16,21,6
2019-03-13,1610612764,1610612753,2018,100.0,90.0,190.0,118.45,119.30000000000001,109.65,104.8,67,28,39,0.418,68,31,37,0.456,20,8,18,13
2019-03-13,1610612760,1610612751,2018,108.0,96.0,204.0,117.80000000000001,115.7,113.35,114.1,67,41,26,0.612,69,36,33,0.522,22,19,21,15
2019-03-13,1610612748,1610612765,2018,108.0,74.0,182.0,106.55,107.9,111.15,105.19999999999999,66,31,35,0.47,66,34,32,0.515,15,16,21,13
2019-03-13,1610612737,1610612763,2018,132.0,111.0,243.0,118.80000000000001,120.30000000000001,103.85,104.6,68,23,45,0.33799999999999997,68,28,40,0.41200000000000003,12,11,18,10
2019-03-13,1610612745,1610612744,2018,104.0,106.0,210.0,115.7,108.85,117.45,113.15,67,42,25,0.627,66,45,21,0.682,24,18,24,21
2019-03-13,1610612756,1610612762,2018,97.0,114.0,211.0,108.85,116.15,114.0,111.3,68,16,52,0.235,66,37,29,0.561,10,6,21,16
2019-03-12,1610612754,1610612752,2018,103.0,98.0,201.0,106.5,105.8,102.30000000000001,109.45,67,42,25,0.627,67,13,54,0.19399999999999998,25,17,6,7
2019-03-12,1610612755,1610612739,2018,106.0,99.0,205.0,113.55,110.69999999999999,107.85,114.5,67,42,25,0.627,67,17,50,0.254,26,16,11,6
2019-03-12,1610612741,1610612747,2018,107.0,123.0,230.0,114.45,115.15,112.35,121.5,68,19,49,0.27899999999999997,66,30,36,0.455,8,11,18,12
2019-03-12,1610612740,1610612749,2018,113.0,130.0,243.0,113.1,116.55000000000001,117.55000000000001,108.75,69,30,39,0.435,67,50,17,0.746,18,12,27,23
2019-03-12,1610612742,1610612759,2018,105.0,112.0,217.0,104.25,110.25,111.2,114.19999999999999,66,27,39,0.409,67,38,29,0.5670000000000001,21,6,26,12
2019-03-12,1610612743,1610612750,2018,133.0,107.0,240.0,114.4,109.0,115.85,117.1,65,43,22,0.662,67,32,35,0.478,27,16,23,9
2019-03-12,1610612746,1610612757,2018,104.0,125.0,229.0,115.05000000000001,114.69999999999999,119.44999999999999,110.94999999999999,68,39,29,0.574,66,40,26,0.606,20,19,25,15
2019-03-11,1610612739,1610612761,2018,126.0,101.0,227.0,107.35,115.1,114.80000000000001,110.1,66,16,50,0.242,67,48,19,0.716,10,6,27,21
2019-03-11,1610612764,1610612758,2018,121.0,115.0,236.0,117.45,118.55000000000001,112.3,113.25,66,27,39,0.409,65,33,32,0.508,19,8,20,13
2019-03-11,1610612751,1610612765,2018,103.0,75.0,178.0,114.3,116.19999999999999,111.75,105.1,68,35,33,0.515,65,34,31,0.523,20,15,21,13
2019-03-11,1610612745,1610612766,2018,118.0,106.0,224.0,116.9,110.8,107.45,113.1,66,41,25,0.621,66,30,36,0.455,23,18,21,9
2019-03-11,1610612762,1610612760,2018,89.0,98.0,187.0,115.25,111.8,119.2,117.1,65,37,28,0.569,66,40,26,0.606,21,16,22,18
2019-03-11,1610612746,1610612738,2018,140.0,115.0,255.0,113.9,115.0,112.6,108.7,67,38,29,0.5670000000000001,67,41,26,0.612,19,19,24,17
2019-03-10,1610612765,1610612741,2018,131.0,108.0,239.0,110.25,104.85,114.30000000000001,115.35,64,33,31,0.516,67,19,48,0.284,20,13,8,11
2019-03-10,1610612748,1610612761,2018,104.0,125.0,229.0,106.3,107.19999999999999,115.55000000000001,111.80000000000001,65,31,34,0.47700000000000004,66,47,19,0.7120000000000001,15,16,27,20
2019-03-10,1610612755,1610612754,2018,106.0,89.0,195.0,114.3,110.9,108.1,105.8,66,41,25,0.621,66,42,24,0.636,25,16,25,17
2019-03-10,1610612737,1610612740,2018,128.0,116.0,244.0,118.4,120.95,113.1,116.25,67,22,45,0.32799999999999996,68,30,38,0.441,11,11,18,12
2019-03-10,1610612763,1610612753,2018,105.0,97.0,202.0,103.9,104.9,109.7,104.69999999999999,67,27,40,0.40299999999999997,67,31,36,0.46299999999999997,17,10,18,13
2019-03-10,1610612742,1610612745,2018,93.0,94.0,187.0,104.9,110.44999999999999,118.30000000000001,112.94999999999999,65,27,38,0.415,65,40,25,0.615,21,6,23,17
2019-03-10,1610612750,1610612752,2018,103.0,92.0,195.0,116.35,118.3,102.45,110.4,66,31,35,0.47,66,13,53,0.19699999999999998,22,9,6,7
2019-03-10,1610612759,1610612749,2018,121.0,114.0,235.0,112.85,115.85,118.4,108.45,66,37,29,0.561,66,50,16,0.758,25,12,27,23
2019-03-10,1610612744,1610612756,2018,111.0,115.0,226.0,119.25,114.4,107.85,117.2,65,45,20,0.6920000000000001,67,15,52,0.22399999999999998,24,21,10,5
2019-03-09,1610612752,1610612758,2018,94.0,102.0,196.0,102.25,111.0,111.95,114.25,65,13,52,0.2,64,32,32,0.5,6,7,20,12
2019-03-09,1610612737,1610612751,2018,112.0,114.0,226.0,117.85,121.2,113.85,116.69999999999999,66,22,44,0.33299999999999996,67,34,33,0.507,11,11,20,14
2019-03-09,1610612750,1610612764,2018,135.0,130.0,265.0,115.1,117.1,116.9,118.4,65,30,35,0.462,65,27,38,0.415,21,9,19,8
2019-03-09,1610612747,1610612738,2018,107.0,120.0,227.0,112.35,120.5,111.7,108.80000000000001,65,30,35,0.462,66,40,26,0.606,18,12,24,16
2019-03-09,1610612749,1610612766,2018,131.0,114.0,245.0,117.65,108.9,107.15,111.19999999999999,65,49,16,0.754,65,30,35,0.462,26,23,21,9
2019-03-09,1610612757,1610612756,2018,127.0,120.0,247.0,119.3,110.55,107.55,116.65,65,39,26,0.6,66,15,51,0.22699999999999998,24,15,10,5
2019-03-08,1610612766,1610612764,2018,112.0,111.0,223.0,106.6,110.25,116.1,117.35,64,29,35,0.45299999999999996,64,27,37,0.42200000000000004,20,9,19,8
2019-03-08,1610612753,1610612742,2018,111.0,106.0,217.0,109.9,105.25,104.55,110.44999999999999,66,30,36,0.455,64,27,37,0.42200000000000004,17,13,21,6
2019-03-08,1610612748,1610612739,2018,126.0,110.0,236.0,105.6,107.1,106.9,113.55000000000001,64,30,34,0.469,65,16,49,0.24600000000000002,14,16,10,6
2019-03-08,1610612741,1610612765,2018,104.0,112.0,216.0,114.15,115.05000000000001,109.35,104.65,66,19,47,0.28800000000000003,63,32,31,0.508,8,11,20,12
2019-03-08,1610612745,1610612755,2018,107.0,91.0,198.0,118.55000000000001,113.1,115.15,110.80000000000001,64,39,25,0.609,65,41,24,0.631,22,17,25,16
2019-03-08,1610612763,1610612762,2018,114.0,104.0,218.0,103.0,104.65,115.9,110.65,66,26,40,0.39399999999999996,64,37,27,0.578,16,10,21,16
2019-03-08,1610612740,1610612761,2018,104.0,127.0,231.0,112.6,114.8,115.35,112.4,67,30,37,0.44799999999999995,65,46,19,0.708,18,12,27,19
2019-03-08,1610612744,1610612743,2018,122.0,105.0,227.0,120.45,114.6,114.55,108.6,64,44,20,0.688,64,43,21,0.672,23,21,27,16
2019-03-08,1610612746,1610612760,2018,118.0,110.0,228.0,113.2,114.94999999999999,120.05000000000001,116.65,66,37,29,0.561,65,40,25,0.615,18,19,22,18
2019-03-07,1610612749,1610612754,2018,117.0,98.0,215.0,119.0,109.6,108.6,106.69999999999999,64,48,16,0.75,65,42,23,0.6459999999999999,25,23,25,17
2019-03-07,1610612757,1610612760,2018,121.0,129.0,250.0,118.8,109.15,119.45,116.35,64,39,25,0.609,64,39,25,0.609,24,15,22,17
2019-03-06,1610612766,1610612748,2018,84.0,91.0,175.0,109.15,111.44999999999999,106.0,108.25,63,29,34,0.46,63,29,34,0.46,20,9,14,15
2019-03-06,1610612765,1610612750,2018,131.0,114.0,245.0,107.69999999999999,103.6,115.4,115.8,62,31,31,0.5,64,30,34,0.469,19,12,21,9
2019-03-06,1610612764,1610612742,2018,132.0,123.0,255.0,116.4,118.19999999999999,104.35,109.6,63,26,37,0.413,63,27,36,0.429,18,8,21,6
2019-03-06,1610612737,1610612759,2018,104.0,111.0,215.0,117.80000000000001,121.75,113.3,116.75,65,22,43,0.33799999999999997,65,36,29,0.5539999999999999,11,11,25,11
2019-03-06,1610612751,1610612739,2018,113.0,107.0,220.0,113.65,116.3,107.2,114.95,66,33,33,0.5,64,16,48,0.25,19,14,10,6
2019-03-06,1610612741,1610612755,2018,108.0,107.0,215.0,113.80000000000001,115.75,115.1,111.55000000000001,65,18,47,0.27699999999999997,64,41,23,0.6409999999999999,7,11,25,16
2019-03-06,1610612740,1610612762,2018,104.0,114.0,218.0,114.4,115.3,116.0,111.55,66,30,36,0.455,63,36,27,0.5710000000000001,18,12,21,15
2019-03-06,1610612756,1610612752,2018,107.0,96.0,203.0,107.94999999999999,117.4,102.5,111.2,65,14,51,0.215,64,13,51,0.203,9,5,6,7
2019-03-06,1610612758,1610612738,2018,109.0,111.0,220.0,112.25,114.05000000000001,111.30000000000001,108.6,63,32,31,0.508,65,39,26,0.6,20,12,24,15
2019-03-06,1610612747,1610612743,2018,99.0,115.0,214.0,112.15,119.8,113.44999999999999,108.75,64,30,34,0.469,63,42,21,0.667,18,12,27,15
2019-03-05,1610612754,1610612741,2018,105.0,96.0,201.0,108.85,107.19999999999999,114.0,115.85,64,41,23,0.6409999999999999,64,18,46,0.281,24,17,7,11
2019-03-05,1610612755,1610612753,2018,114.0,106.0,220.0,115.15,112.1,110.1,105.25,63,40,23,0.635,65,30,35,0.462,24,16,17,13
2019-03-05,1610612761,1610612745,2018,95.0,107.0,202.0,116.55,111.55,118.9,113.85,64,46,18,0.7190000000000001,63,38,25,0.603,27,19,22,16
2019-03-05,1610612763,1610612757,2018,120.0,111.0,231.0,102.35,105.0,118.95,109.30000000000001,65,25,40,0.385,63,39,24,0.619,15,10,24,15
2019-03-05,1610612750,1610612760,2018,131.0,120.0,251.0,114.6,115.75,119.75,116.9,63,29,34,0.46,63,39,24,0.619,20,9,22,17
2019-03-05,1610612744,1610612738,2018,95.0,128.0,223.0,121.80000000000001,112.95,109.85,109.6,63,44,19,0.698,64,38,26,0.594,23,21,24,14
2019-03-04,1610612751,1610612742,2018,127.0,88.0,215.0,113.0,117.4,104.94999999999999,108.55,65,32,33,0.4920000000000001,62,27,35,0.435,18,14,21,6
2019-03-04,1610612748,1610612737,2018,114.0,113.0,227.0,106.05,107.55000000000001,118.30000000000001,122.1,62,28,34,0.452,64,22,42,0.344,13,15,11,11
2019-03-04,1610612759,1610612743,2018,104.0,103.0,207.0,113.5,116.0,113.44999999999999,108.5,64,35,29,0.547,62,42,20,0.677,24,11,27,15
2019-03-04,1610612756,1610612749,2018,114.0,105.0,219.0,107.9,118.1,119.0,108.5,64,13,51,0.203,63,48,15,0.762,8,5,25,23
2019-03-04,1610612762,1610612740,2018,112.0,115.0,227.0,115.6,111.25,113.9,113.95,62,36,26,0.581,65,29,36,0.446,21,15,18,11
2019-03-04,1610612758,1610612752,2018,115.0,108.0,223.0,111.7,113.5,103.05,111.05000000000001,62,31,31,0.5,63,13,50,0.20600000000000002,19,12,6,7
2019-03-04,1610612747,1610612746,2018,105.0,113.0,218.0,112.55,119.15,113.1,114.75,63,30,33,0.47600000000000003,65,36,29,0.5539999999999999,18,12,18,18
2019-03-03,1610612766,1610612757,2018,108.0,118.0,226.0,109.44999999999999,110.3,118.5,109.1,62,29,33,0.46799999999999997,62,38,24,0.613,20,9,24,14
2019-03-03,1610612738,1610612745,2018,104.0,115.0,219.0,110.8,109.0,117.80000000000001,114.69999999999999,63,38,25,0.603,62,37,25,0.597,24,14,22,15
2019-03-03,1610612741,1610612737,2018,118.0,123.0,241.0,113.25,115.55000000000001,117.15,122.0,63,18,45,0.28600000000000003,63,21,42,0.33299999999999996,7,11,11,10
2019-03-03,1610612746,1610612752,2018,128.0,107.0,235.0,113.1,114.85,103.1,110.4,64,35,29,0.547,62,13,49,0.21,17,18,6,7
2019-03-03,1610612739,1610612753,2018,107.0,93.0,200.0,106.55,115.3,111.55,105.05000000000001,63,15,48,0.23800000000000002,64,30,34,0.469,9,6,17,13
2019-03-03,1610612765,1610612761,2018,112.0,107.0,219.0,108.1,104.0,116.55,112.2,61,30,31,0.4920000000000001,63,46,17,0.73,18,12,27,19
2019-03-03,1610612764,1610612750,2018,135.0,121.0,256.0,115.3,117.44999999999999,114.44999999999999,113.55,62,25,37,0.40299999999999997,62,29,33,0.46799999999999997,17,8,20,9
2019-03-03,1610612760,1610612763,2018,99.0,95.0,194.0,121.19999999999999,119.05000000000001,102.3,105.65,62,38,24,0.613,64,25,39,0.391,21,17,15,10
2019-03-02,1610612739,1610612765,2018,93.0,129.0,222.0,106.3,114.05,107.1,104.55,62,15,47,0.242,60,29,31,0.483,9,6,18,11
2019-03-02,1610612754,1610612753,2018,112.0,117.0,229.0,109.25,106.1,111.44999999999999,105.45,63,41,22,0.6509999999999999,63,29,34,0.46,24,17,17,12
2019-03-02,1610612748,1610612751,2018,117.0,88.0,205.0,105.15,108.30000000000001,113.35,117.35,61,27,34,0.44299999999999995,64,32,32,0.5,12,15,18,14
2019-03-02,1610612755,1610612744,2018,117.0,120.0,237.0,116.75,111.45,121.4,111.80000000000001,62,40,22,0.645,62,43,19,0.6940000000000001,24,16,23,20
2019-03-02,1610612742,1610612763,2018,81.0,111.0,192.0,105.94999999999999,108.25,102.15,107.2,61,27,34,0.44299999999999995,63,24,39,0.381,21,6,15,9
2019-03-02,1610612759,1610612760,2018,116.0,102.0,218.0,113.94999999999999,116.25,123.44999999999999,120.95,63,34,29,0.54,61,38,23,0.623,23,11,21,17
2019-03-02,1610612743,1610612740,2018,112.0,120.0,232.0,114.6,107.75,113.5,114.75,61,42,19,0.6890000000000001,64,28,36,0.43799999999999994,27,15,18,10
2019-03-02,1610612756,1610612747,2018,118.0,109.0,227.0,107.55,118.7,114.0,119.65,63,12,51,0.19,62,30,32,0.484,7,5,18,12
2019-03-02,1610612762,1610612749,2018,115.0,111.0,226.0,115.6,110.65,119.19999999999999,108.0,61,35,26,0.574,62,48,14,0.774,20,15,25,23
2019-03-01,1610612737,1610612741,2018,161.0,168.0,329.0,114.35,119.25,109.95,113.0,62,21,41,0.33899999999999997,62,17,45,0.27399999999999997,11,10,7,10
2019-03-01,1610612751,1610612766,2018,112.0,123.0,235.0,113.9,115.9,108.15,109.9,63,32,31,0.508,61,28,33,0.45899999999999996,18,14,20,8
2019-03-01,1610612761,1610612757,2018,119.0,117.0,236.0,116.15,111.80000000000001,118.0,108.9,62,45,17,0.726,61,38,23,0.623,26,19,24,14
2019-03-01,1610612738,1610612764,2018,107.0,96.0,203.0,110.8,109.15,116.25,118.69999999999999,62,37,25,0.597,61,25,36,0.41,23,14,17,8
2019-03-01,1610612756,1610612740,2018,116.0,130.0,246.0,108.1,118.80000000000001,114.0,116.3,62,12,50,0.19399999999999998,63,27,36,0.429,7,5,18,9
2019-03-01,1610612758,1610612746,2018,109.0,116.0,225.0,111.85,112.80000000000001,112.6,114.44999999999999,61,31,30,0.508,63,34,29,0.54,19,12,17,17
2019-03-01,1610612747,1610612749,2018,120.0,131.0,251.0,113.6,119.05,118.25,107.9,61,30,31,0.4920000000000001,61,47,14,0.77,18,12,25,22
2019-02-28,1610612754,1610612750,2018,122.0,115.0,237.0,108.7,105.3,114.05,114.9,62,40,22,0.645,61,29,32,0.475,23,17,20,9
2019-02-28,1610612753,1610612744,2018,103.0,96.0,199.0,112.1,106.1,123.7,112.2,62,28,34,0.452,61,43,18,0.705,16,12,23,20
2019-02-28,1610612752,1610612739,2018,118.0,125.0,243.0,102.05000000000001,109.45,106.25,115.15,61,13,48,0.213,61,14,47,0.23,6,7,9,5
2019-02-28,1610612745,1610612748,2018,121.0,118.0,239.0,118.80000000000001,114.44999999999999,105.1,107.4,61,36,25,0.59,60,27,33,0.45,21,15,12,15
2019-02-28,1610612760,1610612755,2018,104.0,108.0,212.0,124.35,121.15,117.95,112.6,60,38,22,0.633,61,39,22,0.639,21,17,24,15
2019-02-28,1610612743,1610612762,2018,104.0,111.0,215.0,114.94999999999999,109.30000000000001,116.05000000000001,109.95,60,42,18,0.7,60,34,26,0.5670000000000001,27,15,20,14
2019-02-27,1610612766,1610612745,2018,113.0,118.0,231.0,106.7,110.1,118.35,114.6,60,28,32,0.467,60,35,25,0.583,20,8,21,14
2019-02-27,1610612737,1610612750,2018,131.0,123.0,254.0,114.9,119.4,113.85,114.2,61,20,41,0.32799999999999996,60,29,31,0.483,10,10,20,9
2019-02-27,1610612751,1610612764,2018,116.0,125.0,241.0,113.55000000000001,114.75,115.8,117.8,62,32,30,0.516,60,24,36,0.4,18,14,17,7
2019-02-27,1610612748,1610612744,2018,126.0,125.0,251.0,104.55,106.6,123.4,111.6,59,26,33,0.441,60,43,17,0.7170000000000001,11,15,23,20
2019-02-27,1610612738,1610612757,2018,92.0,97.0,189.0,112.3,110.1,118.8,110.1,61,37,24,0.607,60,37,23,0.617,23,14,24,13
2019-02-27,1610612763,1610612741,2018,107.0,109.0,216.0,101.05,107.0,109.95,114.95,62,24,38,0.387,61,16,45,0.262,15,9,7,9
2019-02-27,1610612759,1610612765,2018,105.0,93.0,198.0,114.69999999999999,117.15,107.55,104.9,62,33,29,0.532,59,29,30,0.4920000000000001,22,11,18,11
2019-02-27,1610612742,1610612754,2018,110.0,101.0,211.0,106.15,109.15,109.8,105.55,60,26,34,0.433,61,40,21,0.6559999999999999,20,6,23,17
2019-02-27,1610612762,1610612746,2018,111.0,105.0,216.0,115.5,109.4,112.9,113.85,59,33,26,0.5589999999999999,62,34,28,0.5479999999999999,19,14,17,17
2019-02-27,1610612758,1610612749,2018,140.0,141.0,281.0,110.4,110.5,117.1,106.3,60,31,29,0.517,60,46,14,0.767,19,12,25,21
2019-02-27,1610612747,1610612740,2018,125.0,119.0,244.0,112.35,118.44999999999999,114.1,115.9,60,29,31,0.483,62,27,35,0.435,17,12,18,9
2019-02-26,1610612752,1610612753,2018,108.0,103.0,211.0,102.15,110.0,111.6,106.0,60,12,48,0.2,61,28,33,0.45899999999999996,5,7,16,12
2019-02-26,1610612761,1610612738,2018,118.0,95.0,213.0,116.35,112.30000000000001,113.1,110.2,61,44,17,0.721,60,37,23,0.617,25,19,23,14
2019-02-26,1610612743,1610612760,2018,121.0,112.0,233.0,114.69999999999999,109.35,124.3,120.55,59,41,18,0.695,59,38,21,0.644,26,15,21,17
2019-02-25,1610612766,1610612744,2018,110.0,121.0,231.0,107.45,109.05,123.7,112.25,59,28,31,0.475,59,42,17,0.7120000000000001,20,8,23,19
2019-02-25,1610612739,1610612757,2018,110.0,123.0,233.0,106.5,115.15,118.3,110.0,60,14,46,0.233,59,36,23,0.61,9,5,24,12
2019-02-25,1610612765,1610612754,2018,113.0,109.0,222.0,107.25,105.4,109.6,105.95,58,28,30,0.483,60,40,20,0.667,17,11,23,17
2019-02-25,1610612751,1610612759,2018,101.0,85.0,186.0,114.30000000000001,115.5,116.25,117.75,61,31,30,0.508,61,33,28,0.541,17,14,22,11
2019-02-25,1610612748,1610612756,2018,121.0,124.0,245.0,103.7,106.05,107.65,119.5,58,26,32,0.44799999999999995,61,11,50,0.18,11,15,7,4
2019-02-25,1610612741,1610612749,2018,106.0,117.0,223.0,109.65,114.95,116.8,106.05,60,16,44,0.267,59,45,14,0.763,7,9,25,20
2019-02-25,1610612745,1610612737,2018,119.0,111.0,230.0,117.85,114.85,114.4,118.65,59,34,25,0.5760000000000001,60,20,40,0.33299999999999996,20,14,10,10
2019-02-25,1610612763,1610612747,2018,110.0,105.0,215.0,100.6,107.30000000000001,111.85,118.6,61,23,38,0.377,59,29,30,0.4920000000000001,14,9,17,12
2019-02-25,1610612750,1610612758,2018,112.0,105.0,217.0,113.65,113.25,110.7,110.65,59,28,31,0.475,59,31,28,0.525,19,9,19,12
2019-02-25,1610612740,1610612755,2018,110.0,111.0,221.0,114.30000000000001,115.1,118.35,112.75,61,27,34,0.44299999999999995,60,38,22,0.633,18,9,24,14
2019-02-25,1610612746,1610612742,2018,121.0,112.0,233.0,112.15,113.05000000000001,105.2,108.8,61,33,28,0.541,59,26,33,0.441,16,17,20,6
2019-02-24,1610612761,1610612753,2018,98.0,113.0,211.0,116.65,111.7,110.7,106.65,60,44,16,0.733,60,27,33,0.45,25,19,16,11
2019-02-24,1610612743,1610612746,2018,123.0,96.0,219.0,114.6,109.55000000000001,112.25,112.2,58,40,18,0.69,60,33,27,0.55,25,15,16,17
2019-02-24,1610612752,1610612759,2018,130.0,118.0,248.0,101.1,110.45,115.6,116.30000000000001,59,11,48,0.18600000000000005,60,33,27,0.55,4,7,22,11
2019-02-23,1610612755,1610612757,2018,115.0,130.0,245.0,118.65,112.4,117.3,109.7,59,38,21,0.644,58,35,23,0.603,24,14,24,11
2019-02-23,1610612737,1610612756,2018,120.0,112.0,232.0,114.1,119.7,107.5,119.05000000000001,59,19,40,0.322,60,11,49,0.183,9,10,7,4
2019-02-23,1610612766,1610612751,2018,115.0,117.0,232.0,106.7,107.55,114.30000000000001,114.75,58,28,30,0.483,60,30,30,0.5,20,8,17,13
2019-02-23,1610612739,1610612763,2018,112.0,107.0,219.0,105.80000000000001,116.45,100.0,107.4,59,13,46,0.22,60,23,37,0.38299999999999995,8,5,14,9
2019-02-23,1610612764,1610612754,2018,112.0,119.0,231.0,116.35,117.15,109.6,106.15,59,24,35,0.40700000000000003,59,39,20,0.6609999999999999,17,7,23,16
2019-02-23,1610612740,1610612747,2018,128.0,115.0,243.0,114.05000000000001,115.05,111.45,117.05,60,26,34,0.433,58,29,29,0.5,17,9,17,12
2019-02-23,1610612748,1610612765,2018,96.0,119.0,215.0,104.8,104.8,106.3,106.25,57,26,31,0.456,57,27,30,0.474,11,15,17,10
2019-02-23,1610612741,1610612738,2018,126.0,116.0,242.0,109.15,115.1,112.9,109.05000000000001,59,15,44,0.254,59,37,22,0.627,6,9,23,14
2019-02-23,1610612760,1610612758,2018,116.0,119.0,235.0,124.35,120.55,110.45,110.9,58,38,20,0.655,58,30,28,0.517,21,17,19,11
2019-02-23,1610612749,1610612750,2018,140.0,128.0,268.0,115.85,104.55,112.35,112.0,58,44,14,0.759,58,28,30,0.483,24,20,19,9
2019-02-23,1610612744,1610612745,2018,112.0,118.0,230.0,124.80000000000001,113.1,117.0,114.75,58,42,16,0.7240000000000001,58,33,25,0.569,23,19,20,13
2019-02-23,1610612762,1610612742,2018,125.0,109.0,234.0,114.75,109.05000000000001,105.85,106.75,58,32,26,0.552,58,26,32,0.44799999999999995,18,14,20,6
2019-02-22,1610612766,1610612764,2018,123.0,110.0,233.0,105.45,106.35,116.30000000000001,116.75,57,27,30,0.474,58,24,34,0.414,19,8,17,7
2019-02-22,1610612754,1610612740,2018,126.0,111.0,237.0,108.1,106.6,113.80000000000001,114.25,58,38,20,0.655,59,26,33,0.441,22,16,17,9
2019-02-22,1610612753,1610612741,2018,109.0,110.0,219.0,110.5,106.3,109.25,115.85,59,27,32,0.45799999999999996,58,14,44,0.24100000000000002,16,11,6,8
2019-02-22,1610612761,1610612759,2018,120.0,117.0,237.0,116.69999999999999,111.1,115.35,116.4,59,43,16,0.7290000000000001,59,33,26,0.5589999999999999,24,19,22,11
2019-02-22,1610612737,1610612765,2018,122.0,125.0,247.0,113.30000000000001,117.55000000000001,105.1,104.85,58,19,39,0.32799999999999996,56,26,30,0.46399999999999997,9,10,17,9
2019-02-22,1610612752,1610612750,2018,104.0,115.0,219.0,101.15,110.1,112.30000000000001,112.94999999999999,58,11,47,0.19,57,27,30,0.474,4,7,19,8
2019-02-22,1610612763,1610612746,2018,106.0,112.0,218.0,99.5,106.1,111.80000000000001,111.65,59,23,36,0.39,59,32,27,0.542,14,9,16,16
2019-02-22,1610612742,1610612743,2018,104.0,114.0,218.0,105.85,105.75,114.55000000000001,110.6,57,26,31,0.456,57,39,18,0.684,20,6,25,14
2019-02-22,1610612760,1610612762,2018,148.0,147.0,295.0,121.85,119.0,112.25,106.75,57,37,20,0.649,57,32,25,0.561,20,17,18,14
2019-02-21,1610612739,1610612756,2018,111.0,98.0,209.0,104.80000000000001,117.4,107.45,120.05000000000001,58,12,46,0.207,59,11,48,0.18600000000000005,7,5,7,4
2019-02-21,1610612755,1610612748,2018,106.0,102.0,208.0,119.94999999999999,113.05,104.35,104.4,58,37,21,0.638,56,26,30,0.46399999999999997,23,14,11,15
2019-02-21,1610612751,1610612757,2018,99.0,113.0,212.0,115.65,115.15,116.45,110.6,59,30,29,0.508,57,34,23,0.596,17,13,24,10
2019-02-21,1610612749,1610612738,2018,98.0,97.0,195.0,117.4,105.44999999999999,113.69999999999999,110.5,57,43,14,0.754,58,37,21,0.638,23,20,23,14
2019-02-21,1610612744,1610612758,2018,125.0,123.0,248.0,124.0,112.44999999999999,110.2,111.0,57,41,16,0.7190000000000001,57,30,27,0.526,22,19,19,11
2019-02-21,1610612747,1610612745,2018,111.0,106.0,217.0,111.95,117.45,118.45,115.9,57,28,29,0.491,57,33,24,0.579,16,12,20,13
2019-02-14,1610612753,1610612766,2018,127.0,89.0,216.0,109.6,107.19999999999999,105.80000000000001,106.35,58,26,32,0.44799999999999995,56,27,29,0.48200000000000004,15,11,19,8
2019-02-14,1610612737,1610612752,2018,91.0,106.0,197.0,114.30000000000001,117.65,100.69999999999999,112.0,57,19,38,0.33299999999999996,57,10,47,0.175,9,10,4,6
2019-02-14,1610612740,1610612760,2018,131.0,122.0,253.0,112.45,113.55000000000001,121.1,117.45,58,25,33,0.431,56,37,19,0.6609999999999999,16,9,20,17
2019-02-13,1610612739,1610612751,2018,139.0,148.0,287.0,102.45,115.85,113.7,113.19999999999999,57,12,45,0.21100000000000002,58,29,29,0.5,7,5,17,12
2019-02-13,1610612754,1610612749,2018,97.0,106.0,203.0,109.80000000000001,106.15,118.75,106.3,57,38,19,0.667,56,42,14,0.75,22,16,23,19
2019-02-13,1610612738,1610612765,2018,118.0,110.0,228.0,113.65,110.4,104.5,105.0,57,36,21,0.632,55,26,29,0.473,22,14,17,9
2019-02-13,1610612752,1610612755,2018,111.0,126.0,237.0,100.44999999999999,111.75,118.4,113.94999999999999,56,10,46,0.179,57,36,21,0.632,4,6,23,13
2019-02-13,1610612761,1610612764,2018,129.0,120.0,249.0,116.35,110.9,115.05000000000001,115.6,58,42,16,0.7240000000000001,57,24,33,0.42100000000000004,23,19,17,7
2019-02-13,1610612741,1610612763,2018,122.0,110.0,232.0,107.35,115.95,98.4,105.4,57,13,44,0.228,58,23,35,0.397,5,8,14,9
2019-02-13,1610612750,1610612745,2018,121.0,111.0,232.0,112.25,112.55,118.30000000000001,115.05,56,26,30,0.46399999999999997,56,33,23,0.589,18,8,20,13
2019-02-13,1610612742,1610612748,2018,101.0,112.0,213.0,105.65,105.5,103.05,105.55,56,26,30,0.46399999999999997,55,25,30,0.455,20,6,11,14
2019-02-13,1610612743,1610612758,2018,120.0,118.0,238.0,114.7,110.19999999999999,109.55000000000001,111.6,56,38,18,0.679,56,30,26,0.536,24,14,19,11
2019-02-13,1610612757,1610612744,2018,129.0,107.0,236.0,115.5,110.3,125.25,111.44999999999999,56,33,23,0.589,56,41,15,0.732,23,10,22,19
2019-02-13,1610612746,1610612756,2018,134.0,107.0,241.0,110.75,112.25,106.80000000000001,118.55000000000001,58,31,27,0.534,58,11,47,0.19,15,16,7,4
2019-02-12,1610612737,1610612747,2018,117.0,113.0,230.0,114.5,118.45,110.6,117.0,56,18,38,0.321,56,28,28,0.5,8,10,16,12
2019-02-12,1610612755,1610612738,2018,109.0,112.0,221.0,118.25,113.35,113.25,110.6,56,36,20,0.643,56,35,21,0.625,23,13,22,13
2019-02-12,1610612763,1610612759,2018,107.0,108.0,215.0,98.05,105.45,114.25,115.85,57,23,34,0.40399999999999997,58,32,26,0.552,14,9,22,10
2019-02-12,1610612740,1610612753,2018,88.0,118.0,206.0,113.75,113.25,108.5,108.1,57,25,32,0.439,57,25,32,0.439,16,9,15,10
2019-02-12,1610612744,1610612762,2018,115.0,108.0,223.0,124.55000000000001,112.4,111.3,105.80000000000001,55,40,15,0.727,56,32,24,0.5710000000000001,21,19,18,14
2019-02-11,1610612739,1610612752,2018,107.0,104.0,211.0,101.7,116.25,100.05,112.0,56,11,45,0.196,55,10,45,0.182,6,5,4,6
2019-02-11,1610612765,1610612764,2018,121.0,112.0,233.0,103.7,104.9,113.9,114.8,54,25,29,0.46299999999999997,56,24,32,0.429,16,9,17,7
2019-02-11,1610612754,1610612766,2018,99.0,90.0,189.0,110.65,107.05,106.75,107.80000000000001,56,37,19,0.6609999999999999,55,27,28,0.491,21,16,19,8
2019-02-11,1610612761,1610612751,2018,127.0,125.0,252.0,114.75,109.1,113.2,113.3,57,41,16,0.7190000000000001,57,29,28,0.509,22,19,17,12
2019-02-11,1610612741,1610612749,2018,99.0,112.0,211.0,107.1,116.30000000000001,118.44999999999999,107.0,56,13,43,0.23199999999999998,55,41,14,0.745,5,8,23,18
2019-02-11,1610612745,1610612742,2018,120.0,104.0,224.0,118.55000000000001,115.5,105.55,105.6,55,32,23,0.5820000000000001,55,26,29,0.473,19,13,20,6
2019-02-11,1610612750,1610612746,2018,130.0,120.0,250.0,111.75,112.69999999999999,109.75,111.80000000000001,55,25,30,0.455,57,31,26,0.544,17,8,15,16
2019-02-11,1610612760,1610612757,2018,120.0,111.0,231.0,121.2,117.0,116.5,110.65,55,36,19,0.655,55,33,22,0.6,19,17,23,10
2019-02-11,1610612743,1610612748,2018,103.0,87.0,190.0,115.30000000000001,111.25,102.8,105.7,55,37,18,0.6729999999999999,54,25,29,0.46299999999999997,23,14,11,14
2019-02-10,1610612742,1610612757,2018,102.0,101.0,203.0,105.7,105.7,115.6,110.15,54,25,29,0.46299999999999997,54,33,21,0.611,19,6,23,10
2019-02-10,1610612755,1610612747,2018,143.0,120.0,263.0,117.4,112.4,110.4,115.7,55,35,20,0.636,55,28,27,0.509,22,13,16,12
2019-02-10,1610612758,1610612756,2018,117.0,104.0,221.0,109.85,112.75,107.7,118.7,55,29,26,0.527,57,11,46,0.193,18,11,7,4
2019-02-10,1610612737,1610612753,2018,108.0,124.0,232.0,115.0,117.75,107.45,108.69999999999999,55,18,37,0.327,56,24,32,0.429,8,10,15,9
2019-02-10,1610612744,1610612748,2018,120.0,118.0,238.0,125.0,112.85,102.75,104.3,54,39,15,0.722,53,25,28,0.47200000000000003,20,19,11,14
2019-02-09,1610612762,1610612759,2018,125.0,105.0,230.0,110.7,105.30000000000001,114.94999999999999,114.95,55,31,24,0.564,57,32,25,0.561,17,14,22,10
2019-02-09,1610612754,1610612739,2018,105.0,90.0,195.0,111.65,106.94999999999999,102.6,116.55,55,36,19,0.655,55,11,44,0.2,20,16,6,5
2019-02-09,1610612737,1610612766,2018,120.0,129.0,249.0,114.30000000000001,116.2,106.25,107.45,54,18,36,0.33299999999999996,54,26,28,0.48100000000000004,8,10,19,7
2019-02-09,1610612752,1610612761,2018,99.0,104.0,203.0,99.85,112.25,113.9,109.94999999999999,54,10,44,0.185,56,40,16,0.7140000000000001,4,6,22,18
2019-02-09,1610612738,1610612746,2018,112.0,123.0,235.0,114.4,109.85,109.65,111.75,55,35,20,0.636,56,30,26,0.536,22,13,15,15
2019-02-09,1610612741,1610612764,2018,125.0,134.0,259.0,105.35,113.6,113.1,115.35,55,13,42,0.23600000000000002,55,23,32,0.418,5,8,17,6
2019-02-09,1610612763,1610612740,2018,99.0,90.0,189.0,97.8,106.0,115.9,113.19999999999999,56,22,34,0.39299999999999996,56,25,31,0.446,13,9,16,9
2019-02-09,1610612745,1610612760,2018,112.0,117.0,229.0,118.6,114.7,120.5,116.65,54,32,22,0.593,54,35,19,0.648,19,13,19,16
2019-02-09,1610612749,1610612753,2018,83.0,103.0,186.0,119.9,106.65,107.9,108.75,54,41,13,0.759,55,23,32,0.418,23,18,15,8
2019-02-08,1610612765,1610612752,2018,120.0,103.0,223.0,103.0,104.5,100.15,112.8,53,24,29,0.45299999999999996,53,10,43,0.18899999999999997,15,9,4,6
2019-02-08,1610612755,1610612743,2018,117.0,110.0,227.0,118.1,112.35,115.65,111.05000000000001,54,34,20,0.63,54,37,17,0.685,21,13,23,14
2019-02-08,1610612764,1610612739,2018,119.0,106.0,225.0,112.85,114.95,102.0,116.5,54,22,32,0.40700000000000003,54,11,43,0.204,16,6,6,5
2019-02-08,1610612751,1610612741,2018,106.0,125.0,231.0,114.6,113.65,103.55,113.05,56,29,27,0.518,54,12,42,0.222,17,12,5,7
2019-02-08,1610612742,1610612749,2018,107.0,122.0,229.0,106.45,105.55000000000001,119.6,106.75,53,25,28,0.47200000000000003,53,40,13,0.755,19,6,23,17
2019-02-08,1610612756,1610612744,2018,107.0,117.0,224.0,107.8,119.45,124.9,112.75,56,11,45,0.196,53,38,15,0.7170000000000001,7,4,20,18
2019-02-08,1610612740,1610612750,2018,122.0,117.0,239.0,114.6,112.44999999999999,111.55,111.8,55,24,31,0.436,54,25,29,0.46299999999999997,15,9,17,8
2019-02-08,1610612758,1610612748,2018,102.0,96.0,198.0,110.4,113.8,103.69999999999999,103.75,54,28,26,0.519,52,25,27,0.48100000000000004,17,11,11,14
2019-02-07,1610612754,1610612746,2018,116.0,92.0,208.0,111.1,106.8,110.94999999999999,111.30000000000001,54,35,19,0.648,55,30,25,0.545,19,16,15,15
2019-02-07,1610612753,1610612750,2018,122.0,112.0,234.0,107.6,107.5,111.9,110.4,54,22,32,0.40700000000000003,53,25,28,0.47200000000000003,14,8,17,8
2019-02-07,1610612737,1610612761,2018,101.0,119.0,220.0,115.1,116.80000000000001,113.25,110.1,53,18,35,0.34,55,39,16,0.7090000000000001,8,10,22,17
2019-02-07,1610612738,1610612747,2018,128.0,129.0,257.0,113.8,108.15,110.3,114.35,54,35,19,0.648,54,27,27,0.5,22,13,16,11
2019-02-07,1610612760,1610612763,2018,117.0,95.0,212.0,120.25,117.6,98.1,105.8,53,34,19,0.642,55,22,33,0.4,18,16,13,9
2019-02-07,1610612757,1610612759,2018,127.0,118.0,245.0,114.69999999999999,109.80000000000001,115.15,114.15,53,32,21,0.604,56,32,24,0.5710000000000001,22,10,22,10
2019-02-06,1610612751,1610612743,2018,135.0,130.0,265.0,113.4,112.3,115.25,110.2,55,28,27,0.509,53,37,16,0.698,16,12,23,14
2019-02-06,1610612741,1610612740,2018,120.0,125.0,245.0,102.19999999999999,111.6,114.4,112.75,53,12,41,0.226,54,23,31,0.426,5,7,15,8
2019-02-06,1610612749,1610612764,2018,148.0,129.0,277.0,118.35,106.05000000000001,111.9,113.45,52,39,13,0.75,53,22,31,0.415,22,17,16,6
2019-02-06,1610612742,1610612766,2018,99.0,93.0,192.0,107.15,106.9,107.1,108.65,52,24,28,0.462,53,26,27,0.491,18,6,19,7
2019-02-06,1610612762,1610612756,2018,116.0,88.0,204.0,110.2,105.55000000000001,108.55,119.2,54,30,24,0.556,55,11,44,0.2,16,14,7,4
2019-02-06,1610612758,1610612745,2018,101.0,127.0,228.0,110.75,113.1,117.2,114.7,53,28,25,0.528,53,31,22,0.585,17,11,19,12
2019-02-06,1610612744,1610612759,2018,141.0,102.0,243.0,123.85,113.44999999999999,115.0,112.2,52,37,15,0.7120000000000001,55,32,23,0.5820000000000001,19,18,22,10
2019-02-05,1610612766,1610612746,2018,115.0,117.0,232.0,106.85,107.75,111.44999999999999,112.0,52,26,26,0.5,54,29,25,0.537,19,7,15,14
2019-02-05,1610612739,1610612738,2018,96.0,103.0,199.0,102.45,117.75,115.15,109.6,53,11,42,0.20800000000000002,53,34,19,0.642,6,5,22,12
2019-02-05,1610612754,1610612747,2018,136.0,94.0,230.0,108.85,106.69999999999999,111.1,113.30000000000001,53,34,19,0.642,53,27,26,0.509,18,16,16,11
2019-02-05,1610612752,1610612765,2018,92.0,105.0,197.0,100.9,113.25,103.1,105.35,52,10,42,0.192,52,23,29,0.442,4,6,15,8
2019-02-05,1610612755,1610612761,2018,107.0,119.0,226.0,117.80000000000001,112.05,112.35,111.05,53,34,19,0.642,54,38,16,0.7040000000000001,21,13,22,16
2019-02-05,1610612763,1610612750,2018,108.0,106.0,214.0,97.85,106.1,112.3,110.6,54,21,33,0.389,52,25,27,0.48100000000000004,12,9,17,8
2019-02-05,1610612760,1610612753,2018,132.0,122.0,254.0,119.69999999999999,116.30000000000001,106.5,107.15,52,33,19,0.635,53,22,31,0.415,17,16,14,8
2019-02-05,1610612757,1610612748,2018,108.0,118.0,226.0,115.75,108.65,102.9,103.15,52,32,20,0.615,51,24,27,0.47100000000000003,22,10,11,13
2019-02-04,1610612765,1610612743,2018,129.0,103.0,232.0,101.4,105.1,115.25,109.30000000000001,51,22,29,0.431,52,37,15,0.7120000000000001,14,8,23,14
2019-02-04,1610612764,1610612737,2018,129.0,137.0,266.0,111.95,112.9,113.85,117.55000000000001,52,22,30,0.423,52,17,35,0.327,16,6,8,9
2019-02-04,1610612751,1610612749,2018,94.0,113.0,207.0,114.0,112.35,118.15,106.1,54,28,26,0.519,51,38,13,0.745,16,12,22,16
2019-02-04,1610612740,1610612754,2018,107.0,109.0,216.0,114.94999999999999,113.0,109.85,107.4,53,23,30,0.434,52,33,19,0.635,15,8,18,15
2019-02-04,1610612756,1610612745,2018,110.0,118.0,228.0,108.95,119.4,116.55,114.05000000000001,54,11,43,0.204,52,30,22,0.5770000000000001,7,4,19,11
2019-02-04,1610612758,1610612759,2018,127.0,112.0,239.0,110.25,113.3,114.44999999999999,111.25,52,27,25,0.519,54,32,22,0.593,16,11,22,10
2019-02-03,1610612752,1610612763,2018,84.0,96.0,180.0,102.19999999999999,114.85,98.4,106.85,51,10,41,0.196,53,20,33,0.377,4,6,12,8
2019-02-03,1610612738,1610612760,2018,134.0,129.0,263.0,114.15,107.8,119.15,114.7,52,33,19,0.635,51,33,18,0.647,21,12,17,16
2019-02-03,1610612761,1610612746,2018,121.0,103.0,224.0,112.6,111.4,111.5,111.45,53,37,16,0.698,53,29,24,0.547,21,16,15,14
2019-02-02,1610612765,1610612746,2018,101.0,111.0,212.0,101.55000000000001,104.9,110.3,112.65,50,22,28,0.44,52,28,24,0.5379999999999999,14,8,15,13
2019-02-02,1610612766,1610612741,2018,125.0,118.0,243.0,105.6,108.25,101.35,109.94999999999999,51,25,26,0.49,52,12,40,0.231,18,7,5,7
2019-02-02,1610612753,1610612751,2018,102.0,89.0,191.0,107.4,108.80000000000001,113.9,112.25,52,21,31,0.40399999999999997,53,28,25,0.528,13,8,16,12
2019-02-02,1610612764,1610612749,2018,115.0,131.0,246.0,110.80000000000001,111.4,115.95,105.05000000000001,51,22,29,0.431,50,37,13,0.74,16,6,22,15
2019-02-02,1610612739,1610612742,2018,98.0,111.0,209.0,102.65,117.9,107.19999999999999,107.7,52,11,41,0.212,51,23,28,0.451,6,5,18,5
2019-02-02,1610612748,1610612754,2018,88.0,95.0,183.0,103.7,103.69999999999999,110.8,108.3,50,24,26,0.48,51,32,19,0.627,11,13,18,14
2019-02-02,1610612759,1610612740,2018,113.0,108.0,221.0,114.35,111.0,115.5,113.44999999999999,53,31,22,0.585,52,23,29,0.442,21,10,15,8
2019-02-02,1610612744,1610612747,2018,115.0,101.0,216.0,123.6,113.05,111.55,113.95,51,36,15,0.706,52,27,25,0.519,18,18,16,11
2019-02-02,1610612750,1610612743,2018,106.0,107.0,213.0,113.15,111.69999999999999,115.45,110.6,51,25,26,0.49,51,36,15,0.706,17,8,23,13
2019-02-02,1610612756,1610612737,2018,112.0,118.0,230.0,108.45,119.4,112.85,117.65,53,11,42,0.20800000000000002,51,16,35,0.314,7,4,8,8
2019-02-02,1610612762,1610612745,2018,98.0,125.0,223.0,111.75,104.15,115.5,114.5,53,30,23,0.5660000000000001,51,29,22,0.569,16,14,19,10
2019-02-02,1610612758,1610612755,2018,115.0,108.0,223.0,110.6,113.75,118.1,111.15,51,26,25,0.51,52,34,18,0.654,15,11,21,13
2019-02-01,1610612766,1610612763,2018,100.0,92.0,192.0,106.8,109.95,98.75,106.95,50,24,26,0.48,52,20,32,0.385,17,7,12,8
2019-02-01,1610612752,1610612738,2018,99.0,113.0,212.0,102.6,115.15,115.15,106.7,50,10,40,0.2,51,32,19,0.627,4,6,21,11
2019-02-01,1610612748,1610612760,2018,102.0,118.0,220.0,103.30000000000001,102.15,118.69999999999999,115.25,49,24,25,0.49,50,32,18,0.64,11,13,17,15
2019-02-01,1610612762,1610612737,2018,128.0,112.0,240.0,110.2,104.25,112.65,117.05000000000001,52,29,23,0.5579999999999999,50,16,34,0.32,15,14,8,8
2019-02-01,1610612743,1610612745,2018,136.0,122.0,258.0,113.75,109.45,113.95,113.6,50,35,15,0.7,50,29,21,0.58,22,13,19,10
2019-01-31,1610612765,1610612742,2018,93.0,89.0,182.0,102.55000000000001,105.65,108.65,109.1,49,21,28,0.429,50,23,27,0.46,13,8,18,5
2019-01-31,1610612753,1610612754,2018,107.0,100.0,207.0,106.6,109.55000000000001,110.6,107.9,51,20,31,0.392,50,32,18,0.64,12,8,18,14
2019-01-31,1610612761,1610612749,2018,92.0,105.0,197.0,112.95,110.94999999999999,116.7,105.80000000000001,52,37,15,0.7120000000000001,49,36,13,0.735,21,16,22,14
2019-01-31,1610612759,1610612751,2018,117.0,114.0,231.0,114.69999999999999,110.19999999999999,113.0,111.05000000000001,52,30,22,0.5770000000000001,52,28,24,0.5379999999999999,20,10,16,12
2019-01-31,1610612744,1610612755,2018,104.0,113.0,217.0,123.05,113.05,118.15,112.0,50,36,14,0.72,51,33,18,0.647,18,18,21,12
2019-01-31,1610612746,1610612747,2018,120.0,123.0,243.0,109.85,112.6,111.8,112.95,51,28,23,0.5489999999999999,51,26,25,0.51,15,13,16,10
2019-01-30,1610612738,1610612766,2018,126.0,94.0,220.0,114.6,107.1,108.4,110.15,50,31,19,0.62,49,24,25,0.49,20,11,17,7
2019-01-30,1610612748,1610612741,2018,89.0,105.0,194.0,103.9,101.85,101.69999999999999,110.1,48,24,24,0.5,51,11,40,0.21600000000000005,11,13,5,6
2019-01-30,1610612752,1610612742,2018,90.0,114.0,204.0,103.3,115.05,108.75,110.6,49,10,39,0.204,49,22,27,0.449,4,6,18,4
2019-01-30,1610612764,1610612754,2018,107.0,89.0,196.0,112.9,114.25,111.8,107.6,50,21,29,0.42,49,32,17,0.653,15,6,18,14
2019-01-30,1610612750,1610612763,2018,99.0,97.0,196.0,114.8,112.1,98.5,106.95,50,24,26,0.48,51,20,31,0.392,16,8,12,8
2019-01-30,1610612740,1610612743,2018,99.0,105.0,204.0,115.7,113.55,113.4,109.80000000000001,51,23,28,0.451,49,34,15,0.6940000000000001,15,8,22,12
2019-01-30,1610612758,1610612737,2018,135.0,113.0,248.0,108.95,113.05,113.15,116.30000000000001,50,25,25,0.5,49,16,33,0.327,14,11,8,8
2019-01-30,1610612757,1610612762,2018,132.0,105.0,237.0,114.4,109.15,110.6,103.75,51,31,20,0.608,51,29,22,0.569,21,10,15,14
2019-01-29,1610612739,1610612764,2018,116.0,113.0,229.0,102.5,117.55000000000001,113.15,114.69999999999999,51,10,41,0.196,49,21,28,0.429,5,5,15,6
2019-01-29,1610612765,1610612749,2018,105.0,115.0,220.0,102.7,105.7,116.30000000000001,105.75,48,21,27,0.43799999999999994,48,35,13,0.7290000000000001,13,8,22,13
2019-01-29,1610612753,1610612760,2018,117.0,126.0,243.0,105.25,109.7,117.75,114.7,50,20,30,0.4,49,31,18,0.633,12,8,17,14
2019-01-29,1610612751,1610612741,2018,122.0,117.0,239.0,112.65,110.7,100.65,110.05,51,27,24,0.529,50,11,39,0.22,15,12,5,6
2019-01-29,1610612745,1610612740,2018,116.0,121.0,237.0,114.5,113.19999999999999,115.5,113.85,49,29,20,0.5920000000000001,50,22,28,0.44,19,10,15,7
2019-01-29,1610612759,1610612756,2018,126.0,124.0,250.0,114.55,108.8,109.55000000000001,120.55,51,29,22,0.569,52,11,41,0.212,19,10,7,4
2019-01-29,1610612747,1610612755,2018,105.0,121.0,226.0,111.9,112.8,116.9,112.9,50,26,24,0.52,50,32,18,0.64,16,10,21,11
2019-01-28,1610612766,1610612752,2018,101.0,92.0,193.0,108.75,110.9,103.65,115.5,48,23,25,0.479,48,10,38,0.20800000000000002,16,7,4,6
2019-01-28,1610612754,1610612744,2018,100.0,132.0,232.0,112.3,105.94999999999999,121.6,113.45,48,32,16,0.667,49,35,14,0.7140000000000001,18,14,18,17
2019-01-28,1610612738,1610612751,2018,112.0,104.0,216.0,115.05,107.6,113.8,111.3,49,30,19,0.612,50,27,23,0.54,19,11,15,12
2019-01-28,1610612763,1610612743,2018,92.0,95.0,187.0,98.65,106.55,114.0,110.85,50,20,30,0.4,48,33,15,0.688,12,8,22,11
2019-01-28,1610612746,1610612737,2018,118.0,123.0,241.0,110.3,112.35,111.9,115.15,50,28,22,0.56,48,15,33,0.313,15,13,8,7
2019-01-27,1610612741,1610612739,2018,101.0,104.0,205.0,100.05,110.25,101.65,117.25,49,11,38,0.22399999999999998,50,9,41,0.18,5,6,5,4
2019-01-27,1610612746,1610612758,2018,122.0,108.0,230.0,110.8,112.5,109.55000000000001,112.6,49,27,22,0.551,49,25,24,0.51,14,13,14,11
2019-01-27,1610612760,1610612749,2018,118.0,112.0,230.0,117.35,114.3,116.4,104.95,48,30,18,0.625,47,35,12,0.745,16,14,22,13
2019-01-27,1610612745,1610612753,2018,103.0,98.0,201.0,115.0,113.75,104.35,109.05000000000001,48,28,20,0.583,49,20,29,0.408,18,10,12,8
2019-01-27,1610612742,1610612761,2018,120.0,123.0,243.0,108.45,109.8,111.1,109.69999999999999,48,22,26,0.45799999999999996,51,36,15,0.706,18,4,21,15
2019-01-27,1610612750,1610612762,2018,111.0,125.0,236.0,115.3,111.05,109.2,103.69999999999999,49,24,25,0.49,50,28,22,0.56,16,8,15,13
2019-01-27,1610612759,1610612764,2018,132.0,119.0,251.0,112.6,107.75,112.25,113.55,50,28,22,0.56,48,21,27,0.43799999999999994,18,10,15,6
2019-01-27,1610612752,1610612748,2018,97.0,106.0,203.0,104.15,115.7,103.6,101.85,47,10,37,0.213,47,23,24,0.489,4,6,11,12
2019-01-27,1610612747,1610612756,2018,116.0,102.0,218.0,111.05,113.05,110.0,119.9,49,25,24,0.51,51,11,40,0.21600000000000005,15,10,7,4
2019-01-26,1610612740,1610612759,2018,114.0,126.0,240.0,116.4,112.85,112.75,106.55000000000001,49,22,27,0.449,49,27,22,0.551,15,7,18,9
2019-01-26,1610612763,1610612754,2018,106.0,103.0,209.0,98.2,106.65,112.75,105.15,49,19,30,0.38799999999999996,47,32,15,0.6809999999999999,11,8,18,14
2019-01-26,1610612738,1610612744,2018,111.0,115.0,226.0,115.45,107.0,122.35,114.15,48,30,18,0.625,48,34,14,0.708,19,11,18,16
2019-01-26,1610612743,1610612755,2018,126.0,110.0,236.0,114.0,111.25,117.80000000000001,111.85,47,32,15,0.6809999999999999,49,32,17,0.653,21,11,21,11
2019-01-26,1610612757,1610612737,2018,120.0,111.0,231.0,114.44999999999999,109.5,112.05,114.5,50,30,20,0.6,47,15,32,0.319,20,10,8,7
2019-01-25,1610612753,1610612764,2018,91.0,95.0,186.0,104.6,108.75,112.55000000000001,114.8,48,20,28,0.41700000000000004,47,20,27,0.426,12,8,15,5
2019-01-25,1610612751,1610612752,2018,109.0,99.0,208.0,115.55,112.69999999999999,105.5,116.45,49,26,23,0.531,46,10,36,0.217,14,12,4,6
2019-01-25,1610612739,1610612748,2018,94.0,100.0,194.0,102.75,117.3,102.8,102.7,49,9,40,0.184,46,22,24,0.478,5,4,11,11
2019-01-25,1610612741,1610612746,2018,101.0,106.0,207.0,98.85,111.6,111.65,113.4,48,11,37,0.22899999999999998,48,26,22,0.542,5,6,14,12
2019-01-25,1610612745,1610612761,2018,121.0,119.0,240.0,114.35,112.85,111.25,110.05,47,27,20,0.574,50,36,14,0.72,17,10,21,15
2019-01-25,1610612763,1610612758,2018,96.0,99.0,195.0,98.25,106.7,110.0,112.25,48,19,29,0.396,48,24,24,0.5,11,8,14,10
2019-01-25,1610612742,1610612765,2018,106.0,101.0,207.0,108.2,108.55,102.05000000000001,106.65,47,21,26,0.447,47,21,26,0.447,17,4,13,8
2019-01-25,1610612749,1610612766,2018,108.0,99.0,207.0,116.4,104.6,110.4,112.2,46,34,12,0.7390000000000001,47,23,24,0.489,21,13,16,7
2019-01-25,1610612743,1610612756,2018,132.0,95.0,227.0,112.15,110.8,111.65,118.8,46,31,15,0.674,50,11,39,0.22,20,11,7,4
2019-01-25,1610612762,1610612750,2018,106.0,102.0,208.0,109.75,103.4,115.1,111.95,49,27,22,0.551,48,24,24,0.5,14,13,16,8
2019-01-24,1610612764,1610612744,2018,118.0,126.0,244.0,113.05000000000001,114.0,121.3,113.0,46,20,26,0.435,47,33,14,0.7020000000000001,15,5,18,15
2019-01-24,1610612760,1610612740,2018,122.0,116.0,238.0,117.35,114.15,115.8,112.35,47,29,18,0.617,48,22,26,0.45799999999999996,15,14,15,7
2019-01-24,1610612756,1610612757,2018,106.0,120.0,226.0,111.7,117.75,113.65,109.75,49,11,38,0.22399999999999998,49,29,20,0.5920000000000001,7,4,20,9
2019-01-24,1610612747,1610612750,2018,105.0,120.0,225.0,111.4,112.25,114.05,112.05,48,25,23,0.521,47,23,24,0.489,15,10,16,7
2019-01-23,1610612754,1610612761,2018,110.0,106.0,216.0,112.9,104.7,111.6,109.19999999999999,46,31,15,0.674,49,36,13,0.735,17,14,21,15
2019-01-23,1610612738,1610612739,2018,123.0,103.0,226.0,114.65,107.85,103.1,117.45,47,29,18,0.617,48,9,39,0.188,18,11,5,4
2019-01-23,1610612751,1610612753,2018,114.0,110.0,224.0,116.1,113.1,102.9,108.1,48,25,23,0.521,47,20,27,0.426,13,12,12,8
2019-01-23,1610612748,1610612746,2018,99.0,111.0,210.0,102.35,102.4,110.4,113.25,45,22,23,0.489,47,25,22,0.532,11,11,14,11
2019-01-23,1610612752,1610612745,2018,110.0,114.0,224.0,106.8,117.45,113.19999999999999,112.5,45,10,35,0.222,46,26,20,0.565,4,6,17,9
2019-01-23,1610612755,1610612759,2018,122.0,120.0,242.0,117.9,112.2,112.4,106.5,48,31,17,0.6459999999999999,48,27,21,0.563,20,11,18,9
2019-01-23,1610612741,1610612737,2018,101.0,121.0,222.0,99.5,111.15,112.35,116.65,47,11,36,0.23399999999999999,46,14,32,0.304,5,6,8,6
2019-01-23,1610612763,1610612766,2018,107.0,118.0,225.0,97.5,104.95,109.65,112.8,47,19,28,0.40399999999999997,46,22,24,0.478,11,8,16,6
2019-01-23,1610612740,1610612765,2018,94.0,98.0,192.0,117.4,113.9,101.45,106.85,47,22,25,0.46799999999999997,46,20,26,0.435,15,7,13,7
2019-01-23,1610612762,1610612743,2018,114.0,108.0,222.0,109.35,103.35,112.94999999999999,111.0,48,26,22,0.542,45,31,14,0.6890000000000001,13,13,20,11
2019-01-22,1610612761,1610612758,2018,120.0,105.0,225.0,110.55,109.15,109.6,111.6,48,35,13,0.7290000000000001,47,24,23,0.511,20,15,14,10
2019-01-22,1610612760,1610612757,2018,123.0,114.0,237.0,117.4,113.9,113.05,109.15,46,28,18,0.609,48,29,19,0.604,14,14,20,9
2019-01-22,1610612742,1610612746,2018,106.0,98.0,204.0,108.25,108.85,111.94999999999999,114.25,46,20,26,0.435,46,25,21,0.5429999999999999,16,4,14,11
2019-01-22,1610612756,1610612750,2018,91.0,118.0,209.0,112.1,116.3,114.65,114.55,48,11,37,0.22899999999999998,46,22,24,0.478,7,4,16,6
2019-01-21,1610612752,1610612760,2018,109.0,127.0,236.0,107.05,116.55000000000001,117.65,114.1,44,10,34,0.22699999999999998,45,27,18,0.6,4,6,14,13
2019-01-21,1610612739,1610612741,2018,88.0,104.0,192.0,104.2,118.7,99.2,111.4,47,9,38,0.191,46,10,36,0.217,5,4,5,5
2019-01-21,1610612764,1610612765,2018,101.0,87.0,188.0,114.25,116.15,103.55000000000001,107.95,45,19,26,0.42200000000000004,45,20,25,0.444,14,5,13,7
2019-01-21,1610612749,1610612742,2018,116.0,106.0,222.0,115.35,104.55000000000001,109.0,109.30000000000001,45,33,12,0.733,45,20,25,0.444,20,13,16,4
2019-01-21,1610612737,1610612753,2018,103.0,122.0,225.0,112.75,116.94999999999999,102.05,107.44999999999999,45,14,31,0.311,46,19,27,0.413,8,6,12,7
2019-01-21,1610612751,1610612758,2018,123.0,94.0,217.0,115.25,113.65,111.35,110.95,47,24,23,0.511,46,24,22,0.522,12,12,14,10
2019-01-21,1610612763,1610612740,2018,85.0,105.0,190.0,97.65,105.25,117.9,115.8,46,19,27,0.413,46,21,25,0.457,11,8,15,6
2019-01-21,1610612738,1610612748,2018,107.0,99.0,206.0,114.45,108.45,102.65,102.44999999999999,46,28,18,0.609,44,22,22,0.5,17,11,11,11
2019-01-21,1610612755,1610612745,2018,121.0,93.0,214.0,117.65,112.65,115.35,111.7,47,30,17,0.638,45,26,19,0.578,19,11,17,9
2019-01-21,1610612762,1610612757,2018,104.0,109.0,213.0,109.55,103.05,113.5,110.5,47,26,21,0.5529999999999999,47,28,19,0.596,13,13,20,8
2019-01-21,1610612747,1610612744,2018,111.0,130.0,241.0,111.25,111.0,121.25,112.7,47,25,22,0.532,46,32,14,0.696,15,10,18,14
2019-01-20,1610612754,1610612766,2018,120.0,95.0,215.0,112.35,105.0,110.85,112.15,45,30,15,0.667,45,22,23,0.489,16,14,16,6
2019-01-20,1610612750,1610612756,2018,116.0,114.0,230.0,114.0,113.4,110.69999999999999,116.05,45,21,24,0.467,47,11,36,0.23399999999999999,15,6,7,4
2019-01-20,1610612759,1610612746,2018,95.0,103.0,198.0,113.9,105.69999999999999,112.3,115.19999999999999,47,27,20,0.574,45,24,21,0.5329999999999999,18,9,14,10
2019-01-19,1610612755,1610612760,2018,115.0,117.0,232.0,117.05000000000001,111.55000000000001,116.69999999999999,113.8,46,30,16,0.652,44,26,18,0.591,19,11,14,12
2019-01-19,1610612766,1610612756,2018,135.0,115.0,250.0,109.75,111.75,109.25,114.69999999999999,44,21,23,0.47700000000000004,46,11,35,0.239,15,6,7,4
2019-01-19,1610612765,1610612758,2018,101.0,103.0,204.0,104.05000000000001,108.65,112.30000000000001,111.15,44,20,24,0.455,45,23,22,0.511,13,7,14,9
2019-01-19,1610612754,1610612742,2018,111.0,99.0,210.0,112.15,104.9,109.94999999999999,110.05000000000001,44,29,15,0.659,44,20,24,0.455,15,14,16,4
2019-01-19,1610612753,1610612749,2018,108.0,118.0,226.0,101.5,106.1,114.3,104.80000000000001,45,19,26,0.42200000000000004,44,32,12,0.727,12,7,20,12
2019-01-19,1610612737,1610612738,2018,105.0,113.0,218.0,113.7,117.44999999999999,114.7,108.65,44,14,30,0.318,45,27,18,0.6,8,6,17,10
2019-01-19,1610612761,1610612763,2018,119.0,90.0,209.0,110.25,109.75,97.8,104.8,47,34,13,0.723,45,19,26,0.42200000000000004,19,15,11,8
2019-01-19,1610612741,1610612748,2018,103.0,117.0,220.0,99.4,110.95,102.85,102.19999999999999,45,10,35,0.222,43,21,22,0.488,5,5,11,10
2019-01-19,1610612745,1610612747,2018,138.0,134.0,272.0,115.25,110.9,110.1,110.4,44,25,19,0.568,46,25,21,0.5429999999999999,16,9,15,10
2019-01-19,1610612743,1610612739,2018,124.0,102.0,226.0,112.19999999999999,110.80000000000001,104.05000000000001,118.0,44,30,14,0.682,46,9,37,0.196,19,11,5,4
2019-01-18,1610612738,1610612763,2018,122.0,116.0,238.0,115.05,108.25,96.94999999999999,103.95,44,26,18,0.591,44,19,25,0.4320000000000001,16,10,11,8
2019-01-18,1610612765,1610612748,2018,98.0,93.0,191.0,103.30000000000001,109.5,103.95,102.19999999999999,43,19,24,0.442,42,21,21,0.5,12,7,11,10
2019-01-18,1610612753,1610612751,2018,115.0,117.0,232.0,100.25,105.85,115.0,113.1,44,19,25,0.4320000000000001,46,23,23,0.5,12,7,12,11
2019-01-18,1610612750,1610612759,2018,113.0,116.0,229.0,113.8,113.5,113.35,107.0,44,21,23,0.47700000000000004,46,26,20,0.565,15,6,18,8
2019-01-18,1610612762,1610612739,2018,115.0,99.0,214.0,109.35,102.3,103.7,116.8,46,25,21,0.5429999999999999,45,9,36,0.2,12,13,5,4
2019-01-18,1610612746,1610612744,2018,94.0,112.0,206.0,113.85,115.65,122.05,113.55,44,24,20,0.545,45,31,14,0.6890000000000001,14,10,18,13
2019-01-18,1610612757,1610612740,2018,128.0,112.0,240.0,111.6,110.9,117.3,115.05,46,27,19,0.5870000000000001,45,21,24,0.467,19,8,15,6
2019-01-17,1610612764,1610612752,2018,101.0,100.0,201.0,114.30000000000001,115.55,107.35,117.15,44,18,26,0.409,43,10,33,0.233,13,5,4,6
2019-01-17,1610612766,1610612758,2018,114.0,95.0,209.0,109.5,112.94999999999999,113.35,111.3,43,20,23,0.465,44,23,21,0.523,14,6,14,9
2019-01-17,1610612754,1610612755,2018,96.0,120.0,216.0,112.15,103.4,116.9,112.30000000000001,43,29,14,0.674,45,29,16,0.644,15,14,19,10
2019-01-17,1610612761,1610612756,2018,111.0,109.0,220.0,109.85,109.6,108.6,115.15,46,33,13,0.7170000000000001,45,11,34,0.244,18,15,7,4
2019-01-17,1610612743,1610612741,2018,135.0,105.0,240.0,110.69999999999999,110.5,98.7,109.05000000000001,43,29,14,0.674,44,10,34,0.22699999999999998,18,11,5,5
2019-01-17,1610612760,1610612747,2018,128.0,138.0,266.0,115.3,111.05,108.75,108.4,43,26,17,0.605,45,24,21,0.5329999999999999,14,12,15,9
2019-01-16,1610612765,1610612753,2018,120.0,115.0,235.0,102.85,108.85,99.45,104.1,42,18,24,0.429,43,19,24,0.442,11,7,12,7
2019-01-16,1610612738,1610612761,2018,117.0,108.0,225.0,114.85,107.85,110.6,108.7,43,25,18,0.581,45,33,12,0.733,15,10,18,15
2019-01-16,1610612745,1610612751,2018,142.0,145.0,287.0,113.25,108.5,112.15,111.1,43,25,18,0.581,45,22,23,0.489,16,9,12,10
2019-01-16,1610612763,1610612749,2018,101.0,111.0,212.0,96.69999999999999,102.7,113.94999999999999,104.7,43,19,24,0.442,43,31,12,0.721,11,8,20,11
2019-01-16,1610612742,1610612759,2018,101.0,105.0,206.0,110.44999999999999,109.9,112.55,108.35,43,20,23,0.465,45,25,20,0.556,16,4,18,7
2019-01-16,1610612757,1610612739,2018,129.0,112.0,241.0,110.1,109.9,102.7,115.75,45,26,19,0.578,44,9,35,0.205,18,8,5,4
2019-01-16,1610612744,1610612740,2018,147.0,140.0,287.0,120.5,111.94999999999999,116.1,113.1,44,30,14,0.682,44,21,23,0.47700000000000004,17,13,15,6
2019-01-16,1610612746,1610612762,2018,109.0,129.0,238.0,114.75,115.75,107.9,101.95,43,24,19,0.5579999999999999,45,24,21,0.5329999999999999,14,10,12,12
2019-01-15,1610612754,1610612756,2018,131.0,97.0,228.0,110.6,104.1,108.69999999999999,114.35,42,28,14,0.667,44,11,33,0.25,14,14,7,4
2019-01-15,1610612755,1610612750,2018,149.0,107.0,256.0,115.6,111.85,113.85,111.85,44,28,16,0.636,43,21,22,0.488,18,10,15,6
2019-01-15,1610612737,1610612760,2018,142.0,126.0,268.0,111.4,116.85,114.69999999999999,109.85,43,13,30,0.302,42,26,16,0.619,7,6,14,12
2019-01-15,1610612749,1610612748,2018,124.0,86.0,210.0,113.5,105.0,105.4,102.25,42,30,12,0.7140000000000001,41,21,20,0.512,19,11,11,10
2019-01-15,1610612743,1610612744,2018,111.0,142.0,253.0,111.0,107.65,118.5,111.94999999999999,42,29,13,0.69,43,29,14,0.674,18,11,17,12
2019-01-15,1610612747,1610612741,2018,107.0,100.0,207.0,109.44999999999999,109.05,98.2,108.5,44,23,21,0.523,43,10,33,0.233,14,9,5,5
2019-01-14,1610612751,1610612738,2018,109.0,102.0,211.0,112.3,111.7,115.95,107.75,44,21,23,0.47700000000000004,42,25,17,0.595,11,10,15,10
2019-01-14,1610612745,1610612763,2018,112.0,94.0,206.0,113.95,109.35,97.35,102.25,42,24,18,0.5710000000000001,42,19,23,0.452,15,9,11,8
2019-01-14,1610612759,1610612766,2018,93.0,108.0,201.0,113.45,107.25,109.3,114.35,44,25,19,0.568,42,19,23,0.452,18,7,14,5
2019-01-14,1610612762,1610612765,2018,100.0,94.0,194.0,108.8,101.80000000000001,103.5,109.25,44,23,21,0.523,41,18,23,0.439,11,12,11,7
2019-01-14,1610612758,1610612757,2018,115.0,107.0,222.0,113.25,112.55,109.6,110.4,43,22,21,0.512,44,26,18,0.591,13,9,18,8
2019-01-14,1610612746,1610612740,2018,117.0,121.0,238.0,113.85,115.85,116.0,112.69999999999999,42,24,18,0.5710000000000001,43,20,23,0.465,14,10,15,5
2019-01-13,1610612752,1610612755,2018,105.0,108.0,213.0,107.8,117.65,115.3,112.25,42,10,32,0.23800000000000002,43,27,16,0.628,4,6,18,9
2019-01-13,1610612764,1610612761,2018,138.0,140.0,278.0,114.15,115.1,108.85,107.1,43,18,25,0.419,44,32,12,0.727,13,5,18,14
2019-01-13,1610612737,1610612749,2018,114.0,133.0,247.0,111.1,116.4,113.55000000000001,106.1,42,13,29,0.31,41,29,12,0.7070000000000001,7,6,19,10
2019-01-13,1610612753,1610612745,2018,116.0,109.0,225.0,99.55000000000001,104.85,115.05,110.30000000000001,42,18,24,0.429,41,24,17,0.585,11,7,15,9
2019-01-13,1610612742,1610612744,2018,114.0,119.0,233.0,110.44999999999999,109.45,118.95,112.8,42,20,22,0.47600000000000003,42,28,14,0.667,16,4,17,11
2019-01-13,1610612743,1610612757,2018,116.0,113.0,229.0,110.8,106.35,108.95,111.75,41,28,13,0.6829999999999999,43,26,17,0.605,17,11,18,8
2019-01-13,1610612747,1610612739,2018,95.0,101.0,196.0,110.69999999999999,108.8,102.6,115.85,43,23,20,0.535,43,8,35,0.18600000000000005,14,9,5,3
2019-01-12,1610612746,1610612765,2018,104.0,109.0,213.0,113.55,116.44999999999999,103.15,109.85,41,24,17,0.585,40,17,23,0.425,14,10,11,6
2019-01-12,1610612748,1610612763,2018,112.0,108.0,220.0,104.9,101.85,96.69999999999999,101.8,40,20,20,0.5,41,19,22,0.46299999999999997,10,10,11,8
2019-01-12,1610612753,1610612738,2018,105.0,103.0,208.0,98.85,104.35,116.0,108.15,41,17,24,0.415,41,25,16,0.61,10,7,15,10
2019-01-12,1610612750,1610612740,2018,110.0,106.0,216.0,114.75,111.0,115.75,112.5,42,20,22,0.47600000000000003,42,20,22,0.47600000000000003,14,6,15,5
2019-01-12,1610612760,1610612759,2018,122.0,112.0,234.0,113.5,109.5,113.25,106.5,41,25,16,0.61,43,25,18,0.581,13,12,18,7
2019-01-12,1610612756,1610612743,2018,102.0,93.0,195.0,109.55,115.85,111.45,106.4,43,10,33,0.233,40,28,12,0.7,6,4,17,11
2019-01-12,1610612758,1610612766,2018,104.0,97.0,201.0,114.3,114.19999999999999,110.6,115.35,42,21,21,0.5,41,19,22,0.46299999999999997,12,9,14,5
2019-01-12,1610612762,1610612741,2018,110.0,102.0,212.0,110.25,101.95,98.35,109.05000000000001,43,22,21,0.512,42,10,32,0.23800000000000002,10,12,5,5
2019-01-11,1610612755,1610612737,2018,121.0,123.0,244.0,115.1,110.65,110.35,116.80000000000001,42,27,15,0.643,41,12,29,0.293,18,9,7,5
2019-01-11,1610612764,1610612749,2018,113.0,106.0,219.0,114.7,115.5,113.6,105.95,42,17,25,0.405,40,29,11,0.725,12,5,19,10
2019-01-11,1610612752,1610612754,2018,106.0,121.0,227.0,106.94999999999999,117.35,110.05000000000001,104.35,41,10,31,0.244,41,27,14,0.659,4,6,14,13
2019-01-11,1610612761,1610612751,2018,122.0,105.0,227.0,109.3,108.25,112.7,111.55000000000001,43,31,12,0.721,43,21,22,0.488,17,14,11,10
2019-01-11,1610612745,1610612739,2018,141.0,113.0,254.0,113.55,109.85,101.7,115.2,40,23,17,0.575,42,8,34,0.19,14,9,5,3
2019-01-11,1610612750,1610612742,2018,115.0,119.0,234.0,114.55,109.85,108.94999999999999,108.65,41,20,21,0.488,41,19,22,0.46299999999999997,14,6,16,3
2019-01-11,1610612762,1610612747,2018,113.0,95.0,208.0,109.0,103.25,111.94999999999999,109.8,42,21,21,0.5,42,23,19,0.5479999999999999,9,12,14,9
2019-01-11,1610612757,1610612766,2018,127.0,96.0,223.0,109.0,113.05000000000001,111.0,114.44999999999999,42,25,17,0.595,40,19,21,0.475,17,8,14,5
2019-01-11,1610612744,1610612741,2018,146.0,109.0,255.0,117.45,112.85,97.30000000000001,107.1,41,27,14,0.659,41,10,31,0.244,16,11,5,5
2019-01-10,1610612748,1610612738,2018,115.0,99.0,214.0,104.44999999999999,101.95,116.75,107.2,39,19,20,0.48700000000000004,40,25,15,0.625,9,10,15,10
2019-01-10,1610612743,1610612746,2018,121.0,100.0,221.0,112.30000000000001,106.05,115.19999999999999,116.44999999999999,39,27,12,0.6920000000000001,40,24,16,0.6,16,11,14,10
2019-01-10,1610612759,1610612760,2018,154.0,147.0,301.0,111.05,104.0,111.75,107.5,42,24,18,0.5710000000000001,40,25,15,0.625,17,7,13,12
2019-01-10,1610612758,1610612765,2018,112.0,102.0,214.0,115.75,115.6,102.65,110.0,41,20,21,0.488,39,17,22,0.436,11,9,11,6
2019-01-09,1610612738,1610612754,2018,135.0,108.0,243.0,116.4,106.8,109.45,102.80000000000001,39,24,15,0.615,40,27,13,0.675,14,10,14,13
2019-01-09,1610612764,1610612755,2018,123.0,106.0,229.0,114.80000000000001,116.1,116.15,110.75,41,16,25,0.39,41,27,14,0.659,11,5,18,9
2019-01-09,1610612751,1610612737,2018,116.0,100.0,216.0,111.75,111.5,110.69999999999999,116.7,42,20,22,0.47600000000000003,40,12,28,0.3,10,10,7,5
2019-01-09,1610612745,1610612749,2018,109.0,116.0,225.0,114.15,109.30000000000001,113.85,106.2,39,23,16,0.59,39,28,11,0.718,14,9,19,9
2019-01-09,1610612763,1610612759,2018,96.0,86.0,182.0,97.6,103.6,113.2,105.94999999999999,40,18,22,0.45,41,24,17,0.585,10,8,17,7
2019-01-09,1610612740,1610612739,2018,140.0,124.0,264.0,115.0,111.5,99.65,113.2,41,19,22,0.46299999999999997,41,8,33,0.195,14,5,5,3
2019-01-09,1610612742,1610612756,2018,104.0,94.0,198.0,109.4,109.15,110.2,116.55,40,18,22,0.45,42,10,32,0.23800000000000002,15,3,6,4
2019-01-09,1610612762,1610612753,2018,106.0,93.0,199.0,109.19999999999999,104.55000000000001,99.8,104.80000000000001,41,20,21,0.488,40,17,23,0.425,8,12,10,7
2019-01-09,1610612757,1610612741,2018,124.0,112.0,236.0,108.45,112.7,97.35,106.7,41,24,17,0.585,40,10,30,0.25,16,8,5,5
2019-01-09,1610612747,1610612765,2018,113.0,100.0,213.0,112.0,109.94999999999999,103.85,110.65,41,22,19,0.537,38,17,21,0.447,13,9,11,6
2019-01-08,1610612739,1610612754,2018,115.0,123.0,238.0,99.15,113.5,108.75,102.25,40,8,32,0.2,39,26,13,0.667,5,3,14,12
2019-01-08,1610612755,1610612764,2018,132.0,115.0,247.0,115.15,111.05000000000001,115.6,115.35,40,26,14,0.65,40,16,24,0.4,17,9,11,5
2019-01-08,1610612748,1610612743,2018,99.0,103.0,202.0,105.15,102.55000000000001,112.80000000000001,106.69999999999999,38,19,19,0.5,38,26,12,0.684,9,10,16,10
2019-01-08,1610612761,1610612737,2018,104.0,101.0,205.0,110.35,108.94999999999999,111.1,117.7,42,30,12,0.7140000000000001,39,12,27,0.308,16,14,7,5
2019-01-08,1610612760,1610612750,2018,117.0,119.0,236.0,111.35,106.75,113.85,109.65,39,25,14,0.6409999999999999,40,19,21,0.475,13,12,14,5
2019-01-08,1610612756,1610612758,2018,115.0,111.0,226.0,109.35,116.75,116.15,115.35,41,9,32,0.22,40,20,20,0.5,5,4,11,9
2019-01-08,1610612744,1610612752,2018,122.0,95.0,217.0,117.2,113.9,107.19999999999999,117.65,40,26,14,0.65,40,10,30,0.25,15,11,4,6
2019-01-08,1610612746,1610612766,2018,128.0,109.0,237.0,114.55,115.94999999999999,110.0,113.69999999999999,39,23,16,0.59,39,19,20,0.48700000000000004,13,10,14,5
2019-01-07,1610612765,1610612759,2018,107.0,119.0,226.0,103.85,109.1,112.8,105.6,37,17,20,0.45899999999999996,40,23,17,0.575,11,6,17,6
2019-01-07,1610612738,1610612751,2018,116.0,95.0,211.0,117.0,106.8,112.19999999999999,110.3,38,23,15,0.605,41,20,21,0.488,13,10,10,10
2019-01-07,1610612745,1610612743,2018,125.0,113.0,238.0,113.3,110.05000000000001,112.4,105.35,38,22,16,0.579,37,26,11,0.703,13,9,16,10
2019-01-07,1610612749,1610612762,2018,114.0,102.0,216.0,113.95,106.75,110.05,104.4,38,27,11,0.711,40,20,20,0.5,18,9,8,12
2019-01-07,1610612740,1610612763,2018,114.0,95.0,209.0,114.65,112.95,99.4,104.15,40,18,22,0.45,39,18,21,0.462,13,5,10,8
2019-01-07,1610612742,1610612747,2018,97.0,107.0,204.0,110.5,109.44999999999999,110.9,110.94999999999999,39,18,21,0.462,40,21,19,0.525,15,3,13,8
2019-01-07,1610612757,1610612752,2018,111.0,101.0,212.0,108.30000000000001,111.95,106.69999999999999,117.94999999999999,40,23,17,0.575,39,10,29,0.256,15,8,4,6
2019-01-07,1610612758,1610612753,2018,111.0,95.0,206.0,116.15,116.1,100.55,105.05000000000001,39,19,20,0.48700000000000004,39,17,22,0.436,10,9,10,7
2019-01-06,1610612741,1610612751,2018,100.0,117.0,217.0,97.15,106.0,112.1,110.5,39,10,29,0.256,40,19,21,0.475,5,5,10,9
2019-01-06,1610612750,1610612747,2018,108.0,86.0,194.0,113.5,110.5,112.05000000000001,110.8,39,18,21,0.462,39,21,18,0.5379999999999999,13,5,13,8
2019-01-06,1610612746,1610612753,2018,106.0,96.0,202.0,114.85,116.5,101.15,104.95,38,22,16,0.579,38,17,21,0.447,12,10,10,7
2019-01-06,1610612737,1610612748,2018,106.0,82.0,188.0,111.75,119.95,106.2,102.05000000000001,38,11,27,0.289,37,19,18,0.514,6,5,9,10
2019-01-06,1610612760,1610612764,2018,98.0,116.0,214.0,112.85,106.1,115.30000000000001,115.80000000000001,38,25,13,0.6579999999999999,39,15,24,0.385,13,12,11,4
2019-01-06,1610612761,1610612754,2018,121.0,105.0,226.0,110.55,109.05,109.55000000000001,100.6,41,29,12,0.7070000000000001,38,26,12,0.684,15,14,14,12
2019-01-06,1610612756,1610612766,2018,113.0,119.0,232.0,108.95,116.9,109.69999999999999,113.19999999999999,40,9,31,0.225,38,18,20,0.474,5,4,14,4
2019-01-05,1610612743,1610612766,2018,123.0,110.0,233.0,111.19999999999999,105.30000000000001,110.8,113.69999999999999,36,25,11,0.6940000000000001,37,18,19,0.486,15,10,14,4
2019-01-05,1610612765,1610612762,2018,105.0,110.0,215.0,104.35,109.0,109.6,103.7,36,17,19,0.47200000000000003,39,19,20,0.48700000000000004,11,6,8,11
2019-01-05,1610612755,1610612742,2018,106.0,100.0,206.0,115.9,112.05000000000001,110.80000000000001,110.75,39,25,14,0.6409999999999999,38,18,20,0.474,16,9,15,3
2019-01-05,1610612739,1610612740,2018,98.0,133.0,231.0,99.0,112.15,113.69999999999999,114.25,39,8,31,0.205,39,17,22,0.436,5,3,13,4
2019-01-05,1610612749,1610612761,2018,116.0,123.0,239.0,114.9,107.05000000000001,109.69999999999999,108.0,37,27,10,0.73,40,28,12,0.7,18,9,15,13
2019-01-05,1610612759,1610612763,2018,108.0,88.0,196.0,114.05,107.19999999999999,100.35,104.35,39,22,17,0.564,38,18,20,0.474,16,6,10,8
2019-01-05,1610612757,1610612745,2018,110.0,101.0,211.0,108.4,112.55000000000001,113.65,110.4,39,22,17,0.564,37,22,15,0.595,14,8,13,9
2019-01-05,1610612758,1610612744,2018,123.0,127.0,250.0,116.05,116.4,115.45,112.95,38,19,19,0.5,39,25,14,0.6409999999999999,10,9,15,10
2019-01-04,1610612739,1610612762,2018,91.0,117.0,208.0,99.2,111.4,110.4,104.75,38,8,30,0.21100000000000002,38,18,20,0.474,5,3,8,10
2019-01-04,1610612738,1610612742,2018,114.0,93.0,207.0,116.75,108.0,111.30000000000001,110.75,37,22,15,0.595,37,18,19,0.486,12,10,15,3
2019-01-04,1610612748,1610612764,2018,115.0,109.0,224.0,105.05000000000001,101.80000000000001,114.75,116.2,36,18,18,0.5,38,15,23,0.395,8,10,11,4
2019-01-04,1610612741,1610612754,2018,116.0,119.0,235.0,97.55,105.85,109.05000000000001,101.15,38,10,28,0.263,37,25,12,0.6759999999999999,5,5,14,11
2019-01-04,1610612763,1610612751,2018,100.0,109.0,209.0,100.25,104.05,112.3,111.5,37,18,19,0.486,39,18,21,0.462,10,8,10,8
2019-01-04,1610612750,1610612753,2018,120.0,103.0,223.0,111.85,110.35,100.35,104.55000000000001,38,17,21,0.447,37,17,20,0.45899999999999996,12,5,10,7
2019-01-04,1610612749,1610612737,2018,144.0,112.0,256.0,113.4,107.25,110.85,118.15,36,26,10,0.722,37,11,26,0.297,17,9,6,5
2019-01-04,1610612756,1610612746,2018,111.0,121.0,232.0,107.65,115.8,114.0,115.95,39,9,30,0.231,37,21,16,0.568,5,4,12,9
2019-01-04,1610612747,1610612752,2018,112.0,119.0,231.0,111.65,109.65,106.15,118.1,38,21,17,0.5529999999999999,38,9,29,0.237,13,8,4,5
2019-01-04,1610612757,1610612760,2018,109.0,111.0,220.0,108.7,112.6,113.0,106.25,38,22,16,0.579,37,24,13,0.649,14,8,13,11
2019-01-03,1610612759,1610612761,2018,125.0,107.0,232.0,114.35,107.75,110.44999999999999,107.44999999999999,38,21,17,0.5529999999999999,39,28,11,0.718,15,6,15,13
2019-01-03,1610612758,1610612743,2018,113.0,117.0,230.0,116.0,117.19999999999999,110.5,104.7,37,19,18,0.514,35,24,11,0.6859999999999999,10,9,15,9
2019-01-03,1610612744,1610612745,2018,134.0,135.0,269.0,115.0,111.05000000000001,112.45,109.5,38,25,13,0.6579999999999999,36,21,15,0.583,15,10,13,8
2019-01-02,1610612766,1610612742,2018,84.0,122.0,206.0,112.15,113.55,111.6,111.94999999999999,36,18,18,0.5,36,17,19,0.47200000000000003,14,4,15,2
2019-01-02,1610612739,1610612748,2018,92.0,117.0,209.0,100.45,110.95,103.75,102.15,37,8,29,0.21600000000000005,35,17,18,0.486,5,3,8,9
2019-01-02,1610612764,1610612737,2018,114.0,98.0,212.0,114.5,117.25,111.69999999999999,118.1,37,14,23,0.37799999999999995,36,11,25,0.306,10,4,6,5
2019-01-02,1610612751,1610612740,2018,126.0,121.0,247.0,112.25,112.0,113.1,113.65,38,17,21,0.447,38,17,21,0.447,9,8,13,4
2019-01-02,1610612738,1610612750,2018,115.0,102.0,217.0,115.3,107.8,111.85,109.35,36,21,15,0.583,37,17,20,0.45899999999999996,11,10,12,5
2019-01-02,1610612741,1610612753,2018,84.0,112.0,196.0,97.5,106.35,100.19999999999999,106.2,37,10,27,0.27,36,16,20,0.444,5,5,10,6
2019-01-02,1610612763,1610612765,2018,94.0,101.0,195.0,100.44999999999999,103.4,104.6,109.5,36,18,18,0.5,35,16,19,0.457,10,8,11,5
2019-01-02,1610612756,1610612755,2018,127.0,132.0,259.0,106.5,114.65,115.4,111.65,38,9,29,0.237,38,24,14,0.632,5,4,16,8
2019-01-02,1610612747,1610612760,2018,100.0,107.0,207.0,111.85,109.7,113.15,105.4,37,21,16,0.568,36,23,13,0.639,13,8,13,10
2019-01-01,1610612761,1610612762,2018,122.0,116.0,238.0,109.55,106.94999999999999,108.75,103.15,38,27,11,0.711,37,18,19,0.486,14,13,8,10
2019-01-01,1610612749,1610612765,2018,121.0,98.0,219.0,114.5,107.35,105.9,108.9,35,25,10,0.7140000000000001,34,16,18,0.47100000000000003,16,9,11,5
2019-01-01,1610612743,1610612752,2018,115.0,108.0,223.0,110.45,105.35,105.9,117.25,34,23,11,0.6759999999999999,37,9,28,0.243,14,9,4,5
2019-01-01,1610612758,1610612757,2018,108.0,113.0,221.0,116.44999999999999,117.19999999999999,108.95,112.9,36,19,17,0.528,37,21,16,0.568,10,9,14,7
2019-01-01,1610612746,1610612755,2018,113.0,119.0,232.0,114.15,115.55000000000001,114.75,111.55000000000001,36,21,15,0.583,37,23,14,0.622,12,9,16,7
2018-12-31,1610612754,1610612737,2018,116.0,108.0,224.0,109.30000000000001,100.44999999999999,110.75,117.15,36,24,12,0.667,35,11,24,0.314,13,11,6,5
2018-12-31,1610612766,1610612753,2018,125.0,100.0,225.0,111.3,113.25,100.94999999999999,104.4,35,17,18,0.486,35,16,19,0.457,13,4,10,6
2018-12-31,1610612745,1610612763,2018,113.0,101.0,214.0,113.1,110.65,100.6,102.9,35,20,15,0.5710000000000001,35,18,17,0.514,12,8,10,8
2018-12-31,1610612759,1610612738,2018,120.0,111.0,231.0,113.6,109.0,115.35,107.65,37,20,17,0.541,35,21,14,0.6,14,6,11,10
2018-12-31,1610612740,1610612750,2018,123.0,114.0,237.0,113.95,114.25,111.75,108.3,37,16,21,0.4320000000000001,36,17,19,0.47200000000000003,12,4,12,5
2018-12-31,1610612760,1610612742,2018,122.0,102.0,224.0,112.95,105.35,110.9,110.75,35,22,13,0.629,35,17,18,0.486,12,10,15,2
2018-12-31,1610612756,1610612744,2018,109.0,132.0,241.0,106.05000000000001,113.55,113.85,111.2,37,9,28,0.243,37,24,13,0.649,5,4,15,9
2018-12-30,1610612753,1610612765,2018,109.0,107.0,216.0,102.05,104.9,105.69999999999999,108.25,34,15,19,0.441,33,16,17,0.485,9,6,11,5
2018-12-30,1610612748,1610612750,2018,104.0,113.0,217.0,103.4,102.15,111.6,109.15,34,17,17,0.5,35,16,19,0.457,8,9,12,4
2018-12-30,1610612761,1610612741,2018,95.0,89.0,184.0,110.3,108.8,97.85,107.15,37,26,11,0.703,36,10,26,0.278,13,13,5,5
2018-12-30,1610612742,1610612760,2018,105.0,103.0,208.0,111.25,111.05000000000001,113.95,104.85,34,16,18,0.47100000000000003,34,22,12,0.647,14,2,12,10
2018-12-30,1610612757,1610612755,2018,129.0,95.0,224.0,107.5,113.35,116.2,110.80000000000001,36,20,16,0.556,36,23,13,0.639,13,7,16,7
2018-12-30,1610612747,1610612758,2018,121.0,114.0,235.0,110.30000000000001,108.15,116.35,117.75,36,20,16,0.556,35,19,16,0.5429999999999999,12,8,10,9
2018-12-29,1610612749,1610612751,2018,129.0,115.0,244.0,113.25,106.5,111.5,111.35,34,24,10,0.706,37,17,20,0.45899999999999996,15,9,9,8
2018-12-29,1610612740,1610612745,2018,104.0,108.0,212.0,115.0,114.6,113.15,110.4,36,16,20,0.444,34,19,15,0.5589999999999999,12,4,12,7
2018-12-29,1610612764,1610612766,2018,130.0,126.0,256.0,113.19999999999999,116.7,110.15,112.0,36,13,23,0.361,34,17,17,0.5,9,4,13,4
2018-12-29,1610612737,1610612739,2018,111.0,108.0,219.0,110.65,117.94999999999999,101.1,111.0,34,10,24,0.294,36,8,28,0.222,5,5,5,3
2018-12-29,1610612763,1610612738,2018,103.0,112.0,215.0,101.05000000000001,102.5,114.44999999999999,107.5,34,18,16,0.529,34,20,14,0.588,10,8,11,9
2018-12-29,1610612762,1610612752,2018,129.0,97.0,226.0,108.45,104.05,106.9,116.25,36,17,19,0.47200000000000003,36,9,27,0.25,7,10,4,5
2018-12-29,1610612756,1610612743,2018,118.0,122.0,240.0,105.95,112.25,109.25,104.65,36,9,27,0.25,33,22,11,0.667,5,4,14,8
2018-12-29,1610612757,1610612744,2018,105.0,115.0,220.0,107.25,112.3,112.4,111.30000000000001,35,20,15,0.5710000000000001,36,23,13,0.639,13,7,15,8
2018-12-29,1610612746,1610612759,2018,111.0,122.0,233.0,114.65,115.25,113.8,110.45,35,21,14,0.6,36,19,17,0.528,12,9,14,5
2018-12-28,1610612766,1610612751,2018,100.0,87.0,187.0,110.65,113.0,112.75,111.85,33,16,17,0.485,36,17,19,0.47200000000000003,12,4,9,8
2018-12-28,1610612754,1610612765,2018,125.0,88.0,213.0,107.9,100.5,106.25,107.45,35,23,12,0.657,32,16,16,0.5,12,11,11,5
2018-12-28,1610612753,1610612761,2018,116.0,87.0,203.0,102.75,106.4,112.15,108.4,33,14,19,0.424,36,26,10,0.722,8,6,13,13
2018-12-28,1610612764,1610612741,2018,92.0,101.0,193.0,114.55,116.4,98.0,108.7,35,13,22,0.371,35,9,26,0.257,9,4,5,4
2018-12-28,1610612748,1610612739,2018,118.0,94.0,212.0,103.19999999999999,103.65,101.5,110.75,33,16,17,0.485,35,8,27,0.22899999999999998,7,9,5,3
2018-12-28,1610612750,1610612737,2018,120.0,123.0,243.0,111.2,107.8,109.15,118.85,34,16,18,0.47100000000000003,33,9,24,0.273,12,4,5,4
2018-12-28,1610612740,1610612742,2018,114.0,112.0,226.0,115.75,115.19999999999999,110.8,110.25,35,15,20,0.429,33,16,17,0.485,11,4,14,2
2018-12-28,1610612743,1610612759,2018,102.0,99.0,201.0,109.65,105.3,114.4,111.15,32,21,11,0.6559999999999999,35,19,16,0.5429999999999999,13,8,14,5
2018-12-28,1610612756,1610612760,2018,102.0,118.0,220.0,106.30000000000001,112.15,113.7,105.6,35,9,26,0.257,33,21,12,0.636,5,4,12,9
2018-12-28,1610612747,1610612746,2018,107.0,118.0,225.0,111.25,108.1,114.65,116.15,35,20,15,0.5710000000000001,34,20,14,0.588,12,8,12,8
2018-12-27,1610612745,1610612738,2018,127.0,113.0,240.0,113.4,110.35,114.55,107.3,33,18,15,0.545,33,20,13,0.606,11,7,11,9
2018-12-27,1610612749,1610612752,2018,112.0,96.0,208.0,113.8,106.9,107.94999999999999,117.19999999999999,33,23,10,0.6970000000000001,35,9,26,0.257,14,9,4,5
2018-12-27,1610612758,1610612747,2018,117.0,116.0,233.0,115.69999999999999,116.9,111.1,107.1,34,18,16,0.529,34,20,14,0.588,9,9,12,8
2018-12-27,1610612762,1610612755,2018,97.0,114.0,211.0,109.45,103.44999999999999,115.80000000000001,111.55000000000001,35,17,18,0.486,35,22,13,0.629,7,10,16,6
2018-12-27,1610612744,1610612757,2018,109.0,110.0,219.0,111.7,111.95,107.69999999999999,112.3,35,23,12,0.657,34,19,15,0.5589999999999999,15,8,13,6
2018-12-26,1610612765,1610612764,2018,106.0,95.0,201.0,106.85,108.05000000000001,115.0,117.35,31,15,16,0.484,34,13,21,0.382,10,5,9,4
2018-12-26,1610612753,1610612756,2018,120.0,122.0,242.0,102.3,105.6,106.0,111.85,32,14,18,0.43799999999999994,34,8,26,0.235,8,6,5,3
2018-12-26,1610612737,1610612754,2018,121.0,129.0,250.0,108.45,118.0,106.6,100.2,32,9,23,0.281,34,22,12,0.647,5,4,12,10
2018-12-26,1610612751,1610612766,2018,134.0,132.0,266.0,110.6,110.30000000000001,109.55,111.9,35,16,19,0.457,32,16,16,0.5,8,8,12,4
2018-12-26,1610612748,1610612761,2018,104.0,106.0,210.0,103.5,104.15,111.5,107.75,32,16,16,0.5,35,25,10,0.7140000000000001,7,9,13,12
2018-12-26,1610612741,1610612750,2018,94.0,119.0,213.0,98.19999999999999,107.9,110.75,108.8,34,9,25,0.265,33,15,18,0.455,5,4,12,3
2018-12-26,1610612763,1610612739,2018,95.0,87.0,182.0,100.7,102.94999999999999,101.9,111.95,33,17,16,0.515,34,8,26,0.235,9,8,5,3
2018-12-26,1610612742,1610612740,2018,122.0,119.0,241.0,110.6,107.69999999999999,115.8,115.15,32,15,17,0.469,34,15,19,0.441,13,2,11,4
2018-12-26,1610612759,1610612743,2018,111.0,103.0,214.0,114.0,111.2,110.25,106.0,34,18,16,0.529,31,21,10,0.677,13,5,13,8
2018-12-26,1610612746,1610612758,2018,127.0,118.0,245.0,114.69999999999999,116.55,115.0,116.15,33,19,14,0.5760000000000001,33,18,15,0.545,11,8,9,9
2018-12-25,1610612752,1610612749,2018,95.0,109.0,204.0,108.94999999999999,117.55,114.65,108.55000000000001,34,9,25,0.265,32,22,10,0.688,4,5,14,8
2018-12-25,1610612745,1610612760,2018,113.0,109.0,222.0,113.1,109.19999999999999,113.75,104.95,32,17,15,0.531,32,21,11,0.6559999999999999,10,7,12,9
2018-12-25,1610612738,1610612755,2018,121.0,114.0,235.0,114.65,107.4,115.1,110.2,32,19,13,0.594,34,22,12,0.647,10,9,16,6
2018-12-25,1610612744,1610612747,2018,101.0,127.0,228.0,112.15,110.75,110.6,108.55000000000001,34,23,11,0.6759999999999999,33,19,14,0.5760000000000001,15,8,12,7
2018-12-25,1610612762,1610612757,2018,117.0,96.0,213.0,109.15,104.85,107.69999999999999,112.05,34,16,18,0.47100000000000003,33,19,14,0.5760000000000001,6,10,13,6
2018-12-23,1610612765,1610612737,2018,95.0,98.0,193.0,107.9,108.7,108.7,118.75,30,15,15,0.5,31,8,23,0.258,10,5,5,3
2018-12-23,1610612754,1610612764,2018,105.0,89.0,194.0,106.3,100.3,115.9,118.35,33,21,12,0.636,33,13,20,0.39399999999999996,11,10,9,4
2018-12-23,1610612738,1610612766,2018,119.0,103.0,222.0,114.25,106.35,109.69999999999999,112.30000000000001,31,18,13,0.581,31,16,15,0.516,9,9,12,4
2018-12-23,1610612751,1610612756,2018,111.0,103.0,214.0,111.3,111.5,106.65,112.5,34,15,19,0.441,33,8,25,0.242,7,8,5,3
2018-12-23,1610612739,1610612741,2018,92.0,112.0,204.0,102.55,111.80000000000001,96.69999999999999,108.85,33,8,25,0.242,33,8,25,0.242,5,3,5,3
2018-12-23,1610612753,1610612748,2018,91.0,115.0,206.0,103.6,105.25,103.75,104.95,31,14,17,0.452,31,15,16,0.484,8,6,7,8
2018-12-23,1610612758,1610612740,2018,122.0,117.0,239.0,113.2,115.35,114.94999999999999,114.4,32,17,15,0.531,33,15,18,0.455,8,9,11,4
2018-12-23,1610612760,1610612750,2018,112.0,114.0,226.0,113.05,103.25,110.5,109.19999999999999,31,21,10,0.677,32,14,18,0.43799999999999994,12,9,12,2
2018-12-23,1610612744,1610612746,2018,129.0,127.0,256.0,111.5,109.4,114.69999999999999,116.05,33,22,11,0.667,32,19,13,0.594,14,8,11,8
2018-12-23,1610612757,1610612742,2018,121.0,118.0,239.0,107.44999999999999,111.4,109.80000000000001,107.5,32,18,14,0.563,31,15,16,0.484,12,6,13,2
2018-12-23,1610612747,1610612763,2018,99.0,107.0,206.0,111.0,108.5,100.35,102.35,32,19,13,0.594,32,16,16,0.5,12,7,9,7
2018-12-22,1610612746,1610612743,2018,132.0,111.0,243.0,114.1,115.95,109.05,103.85,31,18,13,0.581,30,21,9,0.7,10,8,13,8
2018-12-22,1610612764,1610612756,2018,149.0,146.0,295.0,114.3,116.5,105.05000000000001,111.0,32,12,20,0.375,32,8,24,0.25,8,4,5,3
2018-12-22,1610612755,1610612761,2018,126.0,101.0,227.0,114.75,110.85,112.55,105.6,33,21,12,0.636,34,25,9,0.735,15,6,13,12
2018-12-22,1610612748,1610612749,2018,94.0,87.0,181.0,104.15,106.1,117.0,109.4,30,14,16,0.467,31,22,9,0.71,6,8,14,8
2018-12-22,1610612745,1610612759,2018,108.0,101.0,209.0,113.45,109.3,113.75,111.6,31,16,15,0.516,33,18,15,0.545,9,7,13,5
2018-12-22,1610612744,1610612742,2018,120.0,116.0,236.0,111.05000000000001,110.30000000000001,109.65,107.19999999999999,32,21,11,0.6559999999999999,30,15,15,0.5,13,8,13,2
2018-12-22,1610612762,1610612760,2018,106.0,107.0,213.0,108.85,105.0,112.5,103.5,33,16,17,0.485,30,20,10,0.667,6,10,12,8
2018-12-21,1610612766,1610612765,2018,98.0,86.0,184.0,111.15,113.45,109.55,109.8,30,15,15,0.5,29,15,14,0.517,11,4,10,5
2018-12-21,1610612761,1610612739,2018,126.0,110.0,236.0,112.65,105.7,101.94999999999999,110.45,33,24,9,0.727,32,8,24,0.25,12,12,5,3
2018-12-21,1610612751,1610612754,2018,106.0,114.0,220.0,111.1,111.4,106.1,100.1,33,15,18,0.455,32,20,12,0.625,7,8,11,9
2018-12-21,1610612752,1610612737,2018,107.0,114.0,221.0,108.65,117.19999999999999,108.3,118.75,33,9,24,0.273,30,7,23,0.233,4,5,5,2
2018-12-21,1610612738,1610612749,2018,107.0,120.0,227.0,114.75,106.0,116.15,109.95,30,18,12,0.6,30,21,9,0.7,9,9,14,7
2018-12-21,1610612741,1610612753,2018,90.0,80.0,170.0,97.15,109.75,105.44999999999999,106.25,32,7,25,0.21899999999999997,30,14,16,0.467,4,3,8,6
2018-12-21,1610612759,1610612750,2018,124.0,98.0,222.0,112.75,111.30000000000001,109.65,108.55,32,17,15,0.531,31,14,17,0.452,12,5,12,2
2018-12-21,1610612757,1610612762,2018,90.0,120.0,210.0,108.85,110.55,107.55,106.55000000000001,31,18,13,0.581,32,15,17,0.469,12,6,6,9
2018-12-21,1610612758,1610612763,2018,102.0,99.0,201.0,114.15,115.9,101.2,102.9,31,16,15,0.516,31,16,15,0.516,7,9,9,7
2018-12-21,1610612747,1610612740,2018,112.0,104.0,216.0,111.1,108.80000000000001,116.05,114.3,31,18,13,0.581,32,15,17,0.469,11,7,11,4
2018-12-20,1610612748,1610612745,2018,101.0,99.0,200.0,103.85,105.55,112.95,109.05,29,13,16,0.44799999999999995,30,16,14,0.5329999999999999,5,8,9,7
2018-12-20,1610612746,1610612742,2018,125.0,121.0,246.0,114.65,115.1,109.0,106.6,30,17,13,0.5670000000000001,29,15,14,0.517,9,8,13,2
2018-12-19,1610612766,1610612739,2018,110.0,99.0,209.0,111.5,114.1,102.0,110.05000000000001,29,14,15,0.483,31,8,23,0.258,10,4,5,3
2018-12-19,1610612753,1610612759,2018,90.0,129.0,219.0,105.75,104.95,111.25,112.0,29,14,15,0.483,31,16,15,0.516,8,6,12,4
2018-12-19,1610612755,1610612752,2018,131.0,109.0,240.0,113.85,110.75,109.4,117.1,32,20,12,0.625,32,9,23,0.281,14,6,4,5
2018-12-19,1610612738,1610612756,2018,103.0,111.0,214.0,115.0,105.7,104.55000000000001,111.75,29,18,11,0.621,31,7,24,0.226,9,9,5,2
2018-12-19,1610612761,1610612754,2018,99.0,96.0,195.0,114.15,106.5,106.65,100.4,32,23,9,0.7190000000000001,31,20,11,0.645,11,12,11,9
2018-12-19,1610612741,1610612751,2018,93.0,96.0,189.0,96.9,109.75,111.5,110.85,31,7,24,0.226,32,14,18,0.43799999999999994,4,3,7,7
2018-12-19,1610612745,1610612764,2018,136.0,118.0,254.0,110.4,108.35,114.19999999999999,115.2,29,15,14,0.517,31,12,19,0.387,8,7,8,4
2018-12-19,1610612749,1610612740,2018,123.0,115.0,238.0,115.65,110.0,116.1,114.25,29,20,9,0.69,31,15,16,0.484,13,7,11,4
2018-12-19,1610612750,1610612765,2018,123.0,129.0,252.0,108.85,107.1,108.35,109.05,30,14,16,0.467,28,14,14,0.5,12,2,10,4
2018-12-19,1610612762,1610612744,2018,108.0,103.0,211.0,106.35,106.0,111.7,110.95,31,14,17,0.452,31,21,10,0.677,5,9,13,8
2018-12-19,1610612757,1610612763,2018,99.0,92.0,191.0,109.44999999999999,110.0,101.65,103.8,30,17,13,0.5670000000000001,30,16,14,0.5329999999999999,11,6,9,7
2018-12-19,1610612758,1610612760,2018,113.0,132.0,245.0,113.75,115.0,110.65,102.15,30,16,14,0.5329999999999999,29,19,10,0.655,7,9,12,7
2018-12-18,1610612754,1610612739,2018,91.0,92.0,183.0,106.8,100.80000000000001,102.1,111.80000000000001,30,20,10,0.667,30,7,23,0.233,11,9,5,2
2018-12-18,1610612737,1610612764,2018,118.0,110.0,228.0,108.55,119.15,114.1,115.15,29,6,23,0.207,30,12,18,0.4,4,2,8,4
2018-12-18,1610612751,1610612747,2018,115.0,110.0,225.0,111.69999999999999,111.69999999999999,110.65,107.35,31,13,18,0.419,30,18,12,0.6,6,7,11,7
2018-12-18,1610612743,1610612742,2018,126.0,118.0,244.0,108.5,103.30000000000001,108.45,106.1,29,20,9,0.69,28,15,13,0.536,12,8,13,2
2018-12-17,1610612765,1610612749,2018,104.0,107.0,211.0,108.8,108.8,115.94999999999999,110.65,27,14,13,0.519,28,19,9,0.679,10,4,13,6
2018-12-17,1610612752,1610612756,2018,110.0,128.0,238.0,109.65,115.5,103.1,112.19999999999999,31,9,22,0.29,30,6,24,0.2,4,5,5,1
2018-12-17,1610612745,1610612762,2018,102.0,97.0,199.0,110.95,110.15,106.4,105.19999999999999,28,14,14,0.5,30,14,16,0.467,7,7,5,9
2018-12-17,1610612750,1610612758,2018,132.0,105.0,237.0,108.25,107.5,113.94999999999999,115.6,29,13,16,0.44799999999999995,29,16,13,0.552,11,2,7,9
2018-12-17,1610612760,1610612741,2018,121.0,96.0,217.0,110.7,103.15,97.0,109.05000000000001,28,18,10,0.643,30,7,23,0.233,11,7,4,3
2018-12-17,1610612759,1610612755,2018,123.0,96.0,219.0,109.9,111.65,113.9,110.69999999999999,30,15,15,0.5,31,20,11,0.645,11,4,14,6
2018-12-17,1610612744,1610612763,2018,110.0,93.0,203.0,112.05,111.35,102.0,103.4,30,20,10,0.667,29,16,13,0.552,12,8,9,7
2018-12-17,1610612746,1610612757,2018,127.0,131.0,258.0,114.05,114.15,108.75,109.95,29,17,12,0.586,29,16,13,0.552,9,8,11,5
2018-12-16,1610612751,1610612737,2018,144.0,127.0,271.0,109.85,111.35,107.3,117.6,30,12,18,0.4,28,6,22,0.214,5,7,4,2
2018-12-16,1610612739,1610612755,2018,105.0,128.0,233.0,102.5,109.85,113.1,111.9,29,7,22,0.24100000000000002,30,19,11,0.633,5,2,14,5
2018-12-16,1610612754,1610612752,2018,110.0,99.0,209.0,106.0,100.75,109.85,116.4,29,19,10,0.655,30,9,21,0.3,10,9,4,5
2018-12-16,1610612764,1610612747,2018,128.0,110.0,238.0,113.1,114.4,110.85,106.45,29,11,18,0.379,29,18,11,0.621,7,4,11,7
2018-12-16,1610612742,1610612758,2018,113.0,120.0,233.0,108.35,104.9,115.25,115.69999999999999,27,15,12,0.556,28,15,13,0.536,13,2,7,8
2018-12-16,1610612740,1610612748,2018,96.0,102.0,198.0,117.25,114.1,104.75,106.5,30,15,15,0.5,28,12,16,0.429,11,4,5,7
2018-12-16,1610612743,1610612761,2018,95.0,86.0,181.0,108.9,103.4,115.65,107.9,28,19,9,0.679,31,23,8,0.742,11,8,11,12
2018-12-15,1610612753,1610612762,2018,96.0,89.0,185.0,106.05,105.5,107.3,106.05,28,13,15,0.46399999999999997,29,14,15,0.483,7,6,5,9
2018-12-15,1610612766,1610612747,2018,100.0,128.0,228.0,112.44999999999999,113.80000000000001,110.44999999999999,107.65,28,14,14,0.5,28,17,11,0.607,10,4,11,6
2018-12-15,1610612765,1610612738,2018,113.0,104.0,217.0,108.3,109.25,115.6,105.5,26,13,13,0.5,28,18,10,0.643,9,4,9,9
2018-12-15,1610612763,1610612745,2018,97.0,105.0,202.0,102.75,103.45,109.7,110.2,28,16,12,0.5710000000000001,27,13,14,0.48100000000000004,9,7,7,6
2018-12-15,1610612759,1610612741,2018,93.0,98.0,191.0,110.75,112.6,97.9,110.15,29,15,14,0.517,29,6,23,0.207,11,4,4,2
2018-12-15,1610612760,1610612746,2018,110.0,104.0,214.0,111.6,103.45,115.2,114.6,27,17,10,0.63,28,17,11,0.607,10,7,9,8
2018-12-15,1610612756,1610612750,2018,107.0,99.0,206.0,101.85,112.44999999999999,108.25,107.95,29,5,24,0.172,28,13,15,0.46399999999999997,4,1,11,2
2018-12-14,1610612738,1610612737,2018,129.0,108.0,237.0,113.65,104.75,107.6,117.95,27,17,10,0.63,27,6,21,0.222,8,9,4,2
2018-12-14,1610612766,1610612752,2018,124.0,126.0,250.0,111.9,112.6,109.15,116.6,27,14,13,0.519,29,8,21,0.276,10,4,4,4
2018-12-14,1610612751,1610612764,2018,125.0,118.0,243.0,109.69999999999999,110.3,112.19999999999999,114.1,29,11,18,0.379,28,11,17,0.39299999999999996,4,7,7,4
2018-12-14,1610612739,1610612749,2018,102.0,114.0,216.0,101.7,108.9,116.5,110.3,28,7,21,0.25,27,18,9,0.667,5,2,13,5
2018-12-14,1610612755,1610612754,2018,101.0,113.0,214.0,114.69999999999999,112.85,105.7,100.75,29,19,10,0.655,28,18,10,0.643,14,5,10,8
2018-12-14,1610612763,1610612748,2018,97.0,100.0,197.0,102.35,102.8,105.65,107.8,27,16,11,0.593,27,11,16,0.40700000000000003,9,7,5,6
2018-12-14,1610612743,1610612760,2018,109.0,98.0,207.0,109.25,104.05000000000001,113.4,103.55000000000001,27,18,9,0.667,26,17,9,0.654,10,8,10,7
2018-12-14,1610612757,1610612761,2018,128.0,122.0,250.0,107.85,109.55000000000001,115.25,106.75,28,15,13,0.536,30,23,7,0.767,10,5,11,12
2018-12-14,1610612758,1610612744,2018,125.0,130.0,255.0,114.80000000000001,114.8,113.0,111.3,27,15,12,0.556,29,19,10,0.655,7,8,12,7
2018-12-13,1610612745,1610612747,2018,126.0,111.0,237.0,107.85,109.65,110.19999999999999,106.85,26,12,14,0.462,27,17,10,0.63,6,6,11,6
2018-12-13,1610612759,1610612746,2018,125.0,87.0,212.0,109.95,113.0,116.1,114.15,28,14,14,0.5,27,17,10,0.63,10,4,9,8
2018-12-13,1610612753,1610612741,2018,97.0,91.0,188.0,105.94999999999999,106.95,98.2,109.55000000000001,27,12,15,0.444,28,6,22,0.214,6,6,4,2
2018-12-13,1610612756,1610612742,2018,99.0,89.0,188.0,102.0,113.0,109.1,105.5,28,4,24,0.14300000000000002,26,15,11,0.5770000000000001,3,1,13,2
2018-12-12,1610612766,1610612765,2018,108.0,107.0,215.0,112.8,111.95,108.85,109.65,26,13,13,0.5,25,13,12,0.52,9,4,9,4
2018-12-12,1610612739,1610612752,2018,113.0,106.0,219.0,100.6,109.1,109.45,116.3,27,6,21,0.222,28,8,20,0.28600000000000003,4,2,4,4
2018-12-12,1610612754,1610612749,2018,113.0,97.0,210.0,105.15,100.95,117.3,110.25,27,17,10,0.63,26,18,8,0.6920000000000001,9,8,13,5
2018-12-12,1610612755,1610612751,2018,124.0,127.0,251.0,113.94999999999999,111.45,108.15,109.85,28,19,9,0.679,28,10,18,0.35700000000000004,14,5,4,6
2018-12-12,1610612764,1610612738,2018,125.0,130.0,255.0,111.5,114.3,112.5,104.25,27,11,16,0.40700000000000003,26,16,10,0.615,7,4,8,8
2018-12-12,1610612763,1610612757,2018,92.0,83.0,175.0,103.1,103.4,108.9,109.2,26,15,11,0.5770000000000001,27,15,12,0.556,8,7,10,5
2018-12-12,1610612740,1610612760,2018,118.0,114.0,232.0,116.69999999999999,113.30000000000001,113.25,103.0,29,14,15,0.483,25,17,8,0.68,10,4,10,7
2018-12-12,1610612742,1610612737,2018,114.0,107.0,221.0,109.35,105.15,106.85,117.9,25,14,11,0.56,26,6,20,0.231,12,2,4,2
2018-12-12,1610612762,1610612748,2018,111.0,84.0,195.0,107.9,108.05,107.1,108.5,28,13,15,0.46399999999999997,26,11,15,0.423,4,9,5,6
2018-12-12,1610612758,1610612750,2018,141.0,130.0,271.0,112.6,112.9,107.0,106.5,26,14,12,0.5379999999999999,27,13,14,0.48100000000000004,6,8,11,2
2018-12-12,1610612744,1610612761,2018,93.0,113.0,206.0,114.15,110.6,115.80000000000001,107.65,28,19,9,0.679,29,22,7,0.759,12,7,11,11
2018-12-11,1610612745,1610612757,2018,111.0,104.0,215.0,107.9,111.0,108.85,108.30000000000001,25,11,14,0.44,26,15,11,0.5770000000000001,5,6,10,5
2018-12-11,1610612759,1610612756,2018,111.0,86.0,197.0,110.05000000000001,114.1,103.2,113.30000000000001,27,13,14,0.48100000000000004,27,4,23,0.14800000000000002,9,4,3,1
2018-12-11,1610612746,1610612761,2018,99.0,123.0,222.0,116.55000000000001,112.6,115.7,108.05,26,17,9,0.654,28,21,7,0.75,9,8,11,10
2018-12-10,1610612754,1610612764,2018,109.0,101.0,210.0,104.35,101.05000000000001,111.2,114.19999999999999,26,16,10,0.615,26,11,15,0.423,8,8,7,4
2018-12-10,1610612755,1610612765,2018,116.0,102.0,218.0,114.25,112.0,110.2,109.35,27,18,9,0.667,24,13,11,0.542,13,5,9,4
2018-12-10,1610612738,1610612740,2018,113.0,100.0,213.0,112.1,103.6,116.44999999999999,113.1,25,15,10,0.6,28,14,14,0.5,7,8,10,4
2018-12-10,1610612741,1610612758,2018,89.0,108.0,197.0,99.0,109.5,112.55,113.4,27,6,21,0.222,25,13,12,0.52,4,2,6,7
2018-12-10,1610612749,1610612739,2018,108.0,92.0,200.0,119.1,111.1,101.15,109.19999999999999,25,17,8,0.68,26,6,20,0.231,12,5,4,2
2018-12-10,1610612760,1610612762,2018,122.0,113.0,235.0,113.0,102.85,105.65,107.85,24,16,8,0.667,27,13,14,0.48100000000000004,9,7,4,9
2018-12-10,1610612742,1610612753,2018,101.0,76.0,177.0,109.6,107.25,106.69999999999999,107.55,24,13,11,0.542,26,12,14,0.462,11,2,6,6
2018-12-10,1610612743,1610612763,2018,105.0,99.0,204.0,110.3,104.7,103.65,103.15,26,17,9,0.654,25,15,10,0.6,9,8,8,7
2018-12-10,1610612756,1610612746,2018,119.0,123.0,242.0,102.15,112.5,116.4,111.4,26,4,22,0.154,25,16,9,0.64,3,1,9,7
2018-12-10,1610612744,1610612750,2018,116.0,108.0,224.0,114.9,111.25,108.4,107.7,27,18,9,0.667,26,13,13,0.5,11,7,11,2
2018-12-10,1610612747,1610612748,2018,108.0,105.0,213.0,110.15,107.65,107.5,108.69999999999999,26,16,10,0.615,25,11,14,0.44,10,6,5,6
2018-12-09,1610612765,1610612740,2018,108.0,116.0,224.0,110.55000000000001,109.55,116.6,114.30000000000001,23,13,10,0.565,27,13,14,0.48100000000000004,9,4,10,3
2018-12-09,1610612761,1610612749,2018,99.0,104.0,203.0,116.55000000000001,108.19999999999999,119.65,112.1,27,21,6,0.778,24,16,8,0.667,11,10,12,4
2018-12-09,1610612759,1610612762,2018,110.0,97.0,207.0,110.05000000000001,114.55,105.6,106.75,26,12,14,0.462,26,13,13,0.5,8,4,4,9
2018-12-09,1610612752,1610612766,2018,107.0,119.0,226.0,109.1,116.75,112.5,112.2,27,8,19,0.29600000000000004,25,12,13,0.48,4,4,9,3
2018-12-08,1610612742,1610612745,2018,107.0,104.0,211.0,109.45,107.69999999999999,107.6,110.35,23,12,11,0.522,24,11,13,0.45799999999999996,10,2,5,6
2018-12-08,1610612754,1610612758,2018,107.0,97.0,204.0,105.6,101.80000000000001,113.85,113.7,25,15,10,0.6,24,13,11,0.542,7,8,6,7
2018-12-08,1610612737,1610612743,2018,106.0,98.0,204.0,107.30000000000001,120.30000000000001,110.9,103.95,25,5,20,0.2,25,17,8,0.68,3,2,9,8
2018-12-08,1610612739,1610612764,2018,116.0,101.0,217.0,102.15,109.85,111.35,115.19999999999999,25,5,20,0.2,25,11,14,0.44,3,2,7,4
2018-12-08,1610612752,1610612751,2018,104.0,112.0,216.0,108.95,116.3,108.3,110.5,26,8,18,0.308,27,9,18,0.33299999999999996,4,4,4,5
2018-12-08,1610612741,1610612738,2018,77.0,133.0,210.0,100.5,108.25,110.5,104.85,26,6,20,0.231,24,14,10,0.583,4,2,7,7
2018-12-08,1610612763,1610612747,2018,88.0,111.0,199.0,105.1,102.4,111.15,108.9,24,15,9,0.625,25,15,10,0.6,8,7,10,5
2018-12-08,1610612757,1610612750,2018,113.0,105.0,218.0,109.80000000000001,109.0,108.55000000000001,107.65,25,14,11,0.56,25,13,12,0.52,9,5,11,2
2018-12-08,1610612746,1610612748,2018,98.0,121.0,219.0,116.4,110.69999999999999,106.5,109.0,24,16,8,0.667,24,10,14,0.41700000000000004,9,7,5,5
2018-12-07,1610612766,1610612743,2018,113.0,107.0,220.0,112.2,112.4,110.95,103.65,24,11,13,0.45799999999999996,24,17,7,0.708,8,3,9,8
2018-12-07,1610612765,1610612755,2018,111.0,117.0,228.0,109.45,109.15,113.80000000000001,112.6,22,13,9,0.591,26,17,9,0.654,9,4,13,4
2018-12-07,1610612753,1610612754,2018,90.0,112.0,202.0,107.15,107.3,105.94999999999999,102.65,25,12,13,0.48,24,14,10,0.583,6,6,7,7
2018-12-07,1610612751,1610612761,2018,106.0,105.0,211.0,108.55,111.2,116.65,107.8,26,8,18,0.308,26,21,5,0.8079999999999999,3,5,11,10
2018-12-07,1610612739,1610612758,2018,110.0,129.0,239.0,102.0,109.35,113.0,114.5,24,5,19,0.20800000000000002,23,12,11,0.522,3,2,6,6
2018-12-07,1610612741,1610612760,2018,114.0,112.0,226.0,101.0,110.1,112.0,102.55,25,5,20,0.2,23,16,7,0.696,3,2,9,7
2018-12-07,1610612740,1610612763,2018,103.0,107.0,210.0,117.0,115.55000000000001,104.35,102.1,26,13,13,0.5,23,14,9,0.609,10,3,8,6
2018-12-07,1610612759,1610612747,2018,133.0,120.0,253.0,108.2,114.35,111.1,108.65,25,11,14,0.44,24,15,9,0.625,7,4,10,5
2018-12-07,1610612756,1610612748,2018,98.0,115.0,213.0,101.75,112.75,106.44999999999999,110.15,25,4,21,0.16,23,9,14,0.391,3,1,5,4
2018-12-07,1610612749,1610612744,2018,95.0,105.0,200.0,121.1,112.3,115.65,112.2,23,16,7,0.696,26,17,9,0.654,12,4,11,6
2018-12-06,1610612738,1610612752,2018,128.0,100.0,228.0,108.85,104.94999999999999,108.7,115.3,23,13,10,0.565,25,8,17,0.32,6,7,4,4
2018-12-06,1610612757,1610612756,2018,108.0,86.0,194.0,110.6,110.95,102.25,113.19999999999999,24,13,11,0.542,24,4,20,0.16699999999999998,8,5,3,1
2018-12-06,1610612762,1610612745,2018,118.0,91.0,209.0,104.95,106.7,107.85,108.85,25,12,13,0.48,23,11,12,0.478,3,9,5,6
2018-12-05,1610612739,1610612744,2018,105.0,129.0,234.0,101.05,108.0,115.6,111.95,23,5,18,0.217,25,16,9,0.64,3,2,11,5
2018-12-05,1610612753,1610612743,2018,118.0,124.0,242.0,106.94999999999999,107.5,110.45,103.8,24,12,12,0.5,23,16,7,0.696,6,6,9,7
2018-12-05,1610612737,1610612764,2018,117.0,131.0,248.0,105.7,118.6,110.4,115.15,24,5,19,0.20800000000000002,24,10,14,0.41700000000000004,3,2,7,3
2018-12-05,1610612751,1610612760,2018,112.0,114.0,226.0,108.95,111.45,111.30000000000001,102.35,25,8,17,0.32,22,15,7,0.682,3,5,9,6
2018-12-05,1610612761,1610612755,2018,113.0,102.0,215.0,116.6,107.95,115.30000000000001,113.6,25,20,5,0.8,25,17,8,0.68,10,10,13,4
2018-12-05,1610612763,1610612746,2018,96.0,86.0,182.0,106.1,103.65,117.75,112.0,22,13,9,0.591,23,16,7,0.696,7,6,9,7
2018-12-05,1610612749,1610612765,2018,115.0,92.0,207.0,121.0,112.25,109.5,109.25,22,15,7,0.682,21,13,8,0.619,11,4,9,4
2018-12-05,1610612750,1610612766,2018,121.0,104.0,225.0,108.9,108.69999999999999,113.0,110.75,24,12,12,0.5,23,11,12,0.478,10,2,8,3
2018-12-05,1610612740,1610612742,2018,132.0,106.0,238.0,116.25,116.0,109.15,107.15,25,12,13,0.48,22,12,10,0.545,9,3,10,2
2018-12-05,1610612747,1610612759,2018,121.0,113.0,234.0,110.75,108.65,106.95,113.05,23,14,9,0.609,24,11,13,0.45799999999999996,9,5,7,4
2018-12-04,1610612754,1610612741,2018,96.0,90.0,186.0,106.69999999999999,102.30000000000001,101.8,112.05,23,13,10,0.565,24,5,19,0.20800000000000002,6,7,3,2
2018-12-04,1610612748,1610612753,2018,90.0,105.0,195.0,107.6,111.05000000000001,106.35,107.5,22,9,13,0.409,23,11,12,0.478,5,4,6,5
2018-12-04,1610612742,1610612757,2018,111.0,102.0,213.0,109.35,107.5,111.05,111.4,21,11,10,0.524,23,13,10,0.565,9,2,8,5
2018-12-04,1610612756,1610612758,2018,105.0,122.0,227.0,102.65,113.65,113.45,115.25,23,4,19,0.174,22,11,11,0.5,3,1,6,5
2018-12-04,1610612762,1610612759,2018,139.0,105.0,244.0,103.33888888888889,106.98888888888888,107.7,110.6,24,11,13,0.45799999999999996,23,11,12,0.478,2,9,7,4
2018-12-03,1610612765,1610612760,2018,83.0,110.0,193.0,110.85,108.9,111.45,103.25,20,13,7,0.65,21,14,7,0.667,9,4,9,5
2018-12-03,1610612737,1610612744,2018,111.0,128.0,239.0,105.7,117.4,114.1,111.4,23,5,18,0.217,24,15,9,0.625,3,2,11,4
2018-12-03,1610612751,1610612739,2018,97.0,99.0,196.0,109.8,112.5,102.25,109.7,24,8,16,0.33299999999999996,22,4,18,0.182,3,5,3,1
2018-12-03,1610612752,1610612764,2018,107.0,110.0,217.0,109.65,115.15,111.0,117.0,24,8,16,0.33299999999999996,23,9,14,0.391,4,4,7,2
2018-12-03,1610612761,1610612743,2018,103.0,106.0,209.0,117.80000000000001,107.95,110.5,103.55,24,20,4,0.833,22,15,7,0.682,10,10,9,6
2018-12-03,1610612750,1610612745,2018,103.0,91.0,194.0,109.95,110.15,109.25,109.25,23,11,12,0.478,22,11,11,0.5,9,2,5,6
2018-12-03,1610612740,1610612746,2018,126.0,129.0,255.0,115.75,115.0,116.80000000000001,112.1,24,12,12,0.5,22,15,7,0.682,9,3,9,6
2018-12-02,1610612747,1610612756,2018,120.0,96.0,216.0,110.8,109.55,103.0,113.80000000000001,22,13,9,0.591,22,4,18,0.182,8,5,3,1
2018-12-02,1610612766,1610612740,2018,109.0,119.0,228.0,113.8,110.44999999999999,115.85,116.1,22,11,11,0.5,23,11,12,0.478,8,3,9,2
2018-12-02,1610612748,1610612762,2018,102.0,100.0,202.0,108.5,111.6,102.73888888888888,107.03888888888889,21,8,13,0.381,23,11,12,0.478,4,4,2,9
2018-12-02,1610612755,1610612763,2018,103.0,95.0,198.0,115.80000000000001,113.45,105.94999999999999,102.7,24,16,8,0.667,21,13,8,0.619,12,4,7,6
2018-12-02,1610612742,1610612746,2018,114.0,110.0,224.0,110.65,108.8,117.95,112.05,20,10,10,0.5,21,15,6,0.7140000000000001,8,2,9,6
2018-12-02,1610612759,1610612757,2018,131.0,118.0,249.0,106.75,110.1,111.55,110.55,22,10,12,0.455,22,13,9,0.591,6,4,8,5
2018-12-01,1610612752,1610612749,2018,136.0,134.0,270.0,108.2,114.1,120.55000000000001,110.8,23,7,16,0.304,21,15,6,0.7140000000000001,3,4,11,4
2018-12-01,1610612765,1610612744,2018,111.0,102.0,213.0,111.95,110.4,115.2,112.0,19,12,7,0.632,23,15,8,0.652,8,4,11,4
2018-12-01,1610612764,1610612751,2018,102.0,88.0,190.0,111.55,118.45,110.5,111.69999999999999,22,8,14,0.364,23,8,15,0.348,6,2,3,5
2018-12-01,1610612739,1610612761,2018,95.0,106.0,201.0,103.05000000000001,111.05,117.95,109.4,21,4,17,0.19,23,19,4,0.826,3,1,10,9
2018-12-01,1610612745,1610612741,2018,121.0,105.0,226.0,108.2,109.5,102.0,111.75,21,10,11,0.47600000000000003,23,5,18,0.217,4,6,3,2
2018-12-01,1610612750,1610612738,2018,109.0,118.0,227.0,109.25,110.5,108.4,103.94999999999999,22,11,11,0.5,22,12,10,0.545,9,2,6,6
2018-12-01,1610612758,1610612754,2018,111.0,110.0,221.0,113.75,115.9,107.0,101.55000000000001,21,10,11,0.47600000000000003,22,13,9,0.591,5,5,6,7
2018-11-30,1610612738,1610612739,2018,128.0,95.0,223.0,107.75,104.8,103.5,110.44999999999999,21,11,10,0.524,20,4,16,0.2,5,6,3,1
2018-11-30,1610612766,1610612762,2018,111.0,119.0,230.0,115.0,109.8,103.03888888888889,107.88888888888889,21,11,10,0.524,22,10,12,0.455,8,3,2,8
2018-11-30,1610612765,1610612741,2018,107.0,88.0,195.0,111.75,111.0,103.0,112.75,18,11,7,0.611,22,5,17,0.22699999999999998,7,4,3,2
2018-11-30,1610612755,1610612764,2018,123.0,98.0,221.0,114.9,113.7,112.9,118.5,23,15,8,0.652,21,8,13,0.381,11,4,6,2
2018-11-30,1610612751,1610612763,2018,125.0,131.0,256.0,109.6,110.4,103.55,102.0,22,8,14,0.364,20,12,8,0.6,3,5,7,5
2018-11-30,1610612748,1610612740,2018,106.0,101.0,207.0,108.69999999999999,110.9,116.35,116.6,20,7,13,0.35,22,11,11,0.5,3,4,9,2
2018-11-30,1610612760,1610612737,2018,124.0,109.0,233.0,110.0,102.85,106.9,116.75,20,13,7,0.65,22,5,17,0.22699999999999998,8,5,3,2
2018-11-30,1610612759,1610612745,2018,105.0,136.0,241.0,106.15,108.69999999999999,107.0,110.0,21,10,11,0.47600000000000003,20,9,11,0.45,6,4,4,5
2018-11-30,1610612756,1610612753,2018,85.0,99.0,184.0,104.8,113.85,107.15,109.05000000000001,21,4,17,0.19,22,10,12,0.455,3,1,6,4
2018-11-30,1610612747,1610612742,2018,114.0,103.0,217.0,112.2,111.55,111.25,108.69999999999999,21,12,9,0.5710000000000001,19,10,9,0.526,7,5,8,2
2018-11-30,1610612757,1610612743,2018,112.0,113.0,225.0,112.0,110.3,109.75,102.6,21,13,8,0.619,21,14,7,0.667,8,5,9,5
2018-11-29,1610612761,1610612744,2018,131.0,128.0,259.0,117.05000000000001,108.05000000000001,114.45,111.6,22,18,4,0.818,22,15,7,0.682,9,9,11,4
2018-11-29,1610612747,1610612754,2018,104.0,96.0,200.0,112.75,112.95,106.75,101.4,20,11,9,0.55,21,13,8,0.619,6,5,6,7
2018-11-29,1610612758,1610612746,2018,121.0,133.0,254.0,112.35,115.85,116.75,111.8,20,10,10,0.5,20,14,6,0.7,5,5,9,5
2018-11-28,1610612766,1610612737,2018,108.0,94.0,202.0,115.19999999999999,110.75,108.05000000000001,117.9,20,10,10,0.5,21,5,16,0.23800000000000002,7,3,3,2
2018-11-28,1610612755,1610612752,2018,117.0,91.0,208.0,114.85,114.9,109.55000000000001,113.55000000000001,22,14,8,0.636,22,7,15,0.318,10,4,3,4
2018-11-28,1610612751,1610612762,2018,91.0,101.0,192.0,110.15,110.69999999999999,103.63888888888889,108.53888888888889,21,8,13,0.381,21,9,12,0.429,3,5,2,7
2018-11-28,1610612745,1610612742,2018,108.0,128.0,236.0,108.15,109.35,110.07222222222222,108.85555555555555,19,9,10,0.474,18,9,9,0.5,4,5,8,1
2018-11-28,1610612749,1610612741,2018,116.0,113.0,229.0,120.9,110.55,102.55,112.45,20,14,6,0.7,21,5,16,0.23800000000000002,10,4,3,2
2018-11-28,1610612750,1610612759,2018,128.0,89.0,217.0,107.9,110.6,108.85,109.4,21,10,11,0.47600000000000003,20,10,10,0.5,8,2,6,4
2018-11-28,1610612740,1610612764,2018,125.0,104.0,229.0,117.55,117.85,112.8,117.1,21,10,11,0.47600000000000003,20,8,12,0.4,8,2,6,2
2018-11-28,1610612760,1610612739,2018,100.0,83.0,183.0,111.0,105.25,104.45,110.19999999999999,19,12,7,0.632,19,4,15,0.21100000000000002,7,5,3,1
2018-11-28,1610612757,1610612753,2018,115.0,112.0,227.0,112.65,110.65,106.0,107.80000000000001,20,12,8,0.6,21,10,11,0.47600000000000003,7,5,6,4
2018-11-28,1610612746,1610612756,2018,115.0,99.0,214.0,116.44999999999999,112.0,104.4,114.05,19,13,6,0.684,20,4,16,0.2,8,5,3,1
2018-11-27,1610612765,1610612752,2018,115.0,108.0,223.0,110.85,110.7,108.5,113.30000000000001,17,10,7,0.588,21,7,14,0.33299999999999996,6,4,3,4
2018-11-27,1610612748,1610612737,2018,113.0,115.0,228.0,108.65,110.80000000000001,107.65,118.55000000000001,19,7,12,0.368,20,4,16,0.2,3,4,3,1
2018-11-27,1610612763,1610612761,2018,114.0,122.0,236.0,103.0,101.94999999999999,116.80000000000001,108.0,19,12,7,0.632,21,17,4,0.81,7,5,9,8
2018-11-27,1610612743,1610612747,2018,117.0,85.0,202.0,108.9,103.25,114.45,112.35,20,13,7,0.65,19,11,8,0.579,8,5,6,5
2018-11-27,1610612756,1610612754,2018,104.0,109.0,213.0,103.85,114.35,106.35,102.1,19,4,15,0.21100000000000002,20,12,8,0.6,3,1,6,6
2018-11-26,1610612766,1610612749,2018,110.0,107.0,217.0,115.19999999999999,110.6,121.52222222222221,110.72222222222223,19,9,10,0.474,19,14,5,0.737,6,3,10,4
2018-11-26,1610612739,1610612750,2018,95.0,102.0,197.0,105.2,111.55,108.85,113.0,18,4,14,0.222,20,9,11,0.45,3,1,8,1
2018-11-26,1610612764,1610612745,2018,135.0,131.0,266.0,111.65,116.2,107.8,108.35,19,7,12,0.368,18,9,9,0.5,5,2,4,5
2018-11-26,1610612741,1610612759,2018,107.0,108.0,215.0,102.8,112.55000000000001,108.85,110.1,20,5,15,0.25,19,9,10,0.474,3,2,6,3
2018-11-26,1610612740,1610612738,2018,107.0,124.0,231.0,118.15,118.35,106.6,104.2,20,10,10,0.5,20,10,10,0.5,8,2,5,5
2018-11-26,1610612762,1610612754,2018,88.0,121.0,209.0,104.8125,107.9,104.75,102.9,20,9,11,0.45,19,11,8,0.579,2,7,6,5
2018-11-26,1610612744,1610612753,2018,116.0,110.0,226.0,115.85,112.19999999999999,106.19999999999999,108.0,21,14,7,0.667,20,10,10,0.5,10,4,6,4
2018-11-25,1610612747,1610612753,2018,104.0,108.0,212.0,115.4,112.6,105.96666666666667,108.11666666666667,18,11,7,0.611,19,9,10,0.474,6,5,6,3
2018-11-25,1610612765,1610612756,2018,118.0,107.0,225.0,110.35,110.85,102.65,114.25,16,9,7,0.563,18,4,14,0.222,5,4,3,1
2018-11-25,1610612737,1610612766,2018,124.0,123.0,247.0,107.94999999999999,118.75,115.19999999999999,110.3,19,3,16,0.158,18,9,9,0.5,2,1,6,3
2018-11-25,1610612751,1610612755,2018,125.0,127.0,252.0,109.47777777777779,110.05,112.85,113.9,20,8,12,0.4,21,13,8,0.619,3,5,10,3
2018-11-25,1610612761,1610612748,2018,125.0,115.0,240.0,116.35,107.44999999999999,108.55,110.65,20,16,4,0.8,18,7,11,0.389,8,8,3,4
2018-11-25,1610612763,1610612752,2018,98.0,103.0,201.0,103.55,102.0,109.0,114.6,18,12,6,0.667,20,6,14,0.3,7,5,3,3
2018-11-25,1610612758,1610612762,2018,112.0,133.0,245.0,112.06111111111112,114.73333333333333,104.7625,107.85,19,10,9,0.526,19,8,11,0.42100000000000004,5,5,2,6
2018-11-25,1610612757,1610612746,2018,100.0,104.0,204.0,113.55,111.19999999999999,116.4,111.35,19,12,7,0.632,18,12,6,0.667,7,5,8,4
2018-11-24,1610612739,1610612745,2018,117.0,108.0,225.0,104.45,111.69999999999999,108.45,107.65,17,3,14,0.17600000000000002,17,9,8,0.529,2,1,4,5
2018-11-24,1610612764,1610612740,2018,124.0,114.0,238.0,111.5,116.2,119.0,117.75,18,6,12,0.33299999999999996,19,10,9,0.526,4,2,8,2
2018-11-24,1610612750,1610612741,2018,111.0,96.0,207.0,109.85,114.35,102.1,112.80000000000001,19,8,11,0.42100000000000004,19,5,14,0.263,7,1,3,2
2018-11-24,1610612760,1610612743,2018,98.0,105.0,203.0,112.05000000000001,105.75,108.8,103.8,18,12,6,0.667,19,12,7,0.632,7,5,8,4
2018-11-24,1610612742,1610612738,2018,113.0,104.0,217.0,110.32222222222222,109.80555555555556,106.55000000000001,103.6,17,8,9,0.47100000000000003,19,10,9,0.526,7,1,5,5
2018-11-24,1610612749,1610612759,2018,135.0,129.0,264.0,120.97222222222223,109.92222222222222,107.4,107.4,18,13,5,0.722,18,9,9,0.5,9,4,6,3
2018-11-24,1610612744,1610612758,2018,117.0,116.0,233.0,116.15,111.55,112.71111111111111,116.33333333333334,20,13,7,0.65,18,10,8,0.556,9,4,5,5
2018-11-23,1610612751,1610612750,2018,102.0,112.0,214.0,110.075,110.175,109.3,115.65,19,8,11,0.42100000000000004,18,7,11,0.389,3,5,7,0
2018-11-23,1610612746,1610612763,2018,112.0,107.0,219.0,117.2,111.05,102.5,101.5,17,11,6,0.647,17,12,5,0.706,7,4,7,5
2018-11-23,1610612765,1610612745,2018,116.0,111.0,227.0,109.94444444444444,110.80555555555556,108.3,106.5,15,8,7,0.5329999999999999,16,9,7,0.563,4,4,4,5
2018-11-23,1610612737,1610612738,2018,96.0,114.0,210.0,108.94999999999999,118.15,105.9,104.45,18,3,15,0.16699999999999998,18,9,9,0.5,2,1,5,4
2018-11-23,1610612752,1610612740,2018,114.0,109.0,223.0,108.19999999999999,114.65,119.95,119.05,19,5,14,0.263,18,10,8,0.556,2,3,8,2
2018-11-23,1610612755,1610612739,2018,112.0,121.0,233.0,113.6,113.25,103.51666666666667,111.71666666666667,20,13,7,0.65,16,2,14,0.125,10,3,2,0
2018-11-23,1610612761,1610612764,2018,125.0,107.0,232.0,116.0,106.65,111.65,114.85,19,15,4,0.789,17,6,11,0.353,7,8,4,2
2018-11-23,1610612754,1610612759,2018,100.0,111.0,211.0,104.98888888888888,102.18888888888888,108.19999999999999,108.9,18,11,7,0.611,17,8,9,0.47100000000000003,6,5,6,2
2018-11-23,1610612741,1610612748,2018,96.0,103.0,199.0,103.1,113.55000000000001,108.4,111.05000000000001,18,5,13,0.278,17,6,11,0.353,3,2,3,3
2018-11-23,1610612760,1610612766,2018,109.0,104.0,213.0,112.25,105.25,115.6,110.6,17,11,6,0.647,17,9,8,0.529,6,5,6,3
2018-11-23,1610612749,1610612756,2018,114.0,116.0,230.0,121.17222222222222,109.17222222222222,102.7,114.0,17,13,4,0.765,17,3,14,0.17600000000000002,9,4,3,0
2018-11-23,1610612743,1610612753,2018,112.0,87.0,199.0,109.15,104.0,106.9875,107.7625,18,11,7,0.611,18,9,9,0.5,7,4,6,3
2018-11-23,1610612744,1610612757,2018,125.0,97.0,222.0,115.3,111.69999999999999,114.44999999999999,109.6,19,12,7,0.632,18,12,6,0.667,8,4,7,5
2018-11-23,1610612747,1610612762,2018,90.0,83.0,173.0,115.25,113.6,105.6125,107.8,17,10,7,0.588,18,8,10,0.444,5,5,2,6
2018-11-21,1610612766,1610612754,2018,127.0,109.0,236.0,115.35,110.8,105.08888888888889,100.93888888888888,16,8,8,0.5,17,11,6,0.647,5,3,6,5
2018-11-21,1610612755,1610612740,2018,121.0,120.0,241.0,113.15,113.0,118.95,118.3,19,12,7,0.632,17,10,7,0.588,9,3,8,2
2018-11-21,1610612737,1610612761,2018,108.0,124.0,232.0,109.18888888888888,117.82222222222222,116.5,107.2,17,3,14,0.17600000000000002,18,14,4,0.778,2,1,7,7
2018-11-21,1610612738,1610612752,2018,109.0,117.0,226.0,105.72777777777779,103.64444444444445,107.6,114.55,17,9,8,0.529,18,4,14,0.222,5,4,2,2
2018-11-21,1610612739,1610612747,2018,105.0,109.0,214.0,103.91666666666666,111.36666666666667,115.57777777777778,113.92222222222222,15,2,13,0.133,16,9,7,0.563,2,0,5,4
2018-11-21,1610612741,1610612756,2018,124.0,116.0,240.0,101.55,112.65,101.97777777777779,113.67222222222222,17,4,13,0.235,16,3,13,0.188,2,2,3,0
2018-11-21,1610612745,1610612765,2018,126.0,124.0,250.0,107.46666666666667,105.82222222222222,108.59444444444443,109.05555555555556,15,8,7,0.5329999999999999,14,8,6,0.5710000000000001,3,5,4,4
2018-11-21,1610612749,1610612757,2018,143.0,100.0,243.0,121.17222222222222,110.22222222222223,114.65,108.55,16,12,4,0.75,17,12,5,0.706,8,4,7,5
2018-11-21,1610612750,1610612743,2018,101.0,103.0,204.0,109.6,116.75,109.65,104.5,17,7,10,0.41200000000000003,17,10,7,0.588,7,0,7,3
2018-11-21,1610612742,1610612751,2018,119.0,113.0,232.0,110.07222222222222,110.15555555555557,110.025,110.825,16,7,9,0.43799999999999994,18,8,10,0.444,6,1,3,5
2018-11-21,1610612759,1610612763,2018,103.0,104.0,207.0,108.9,108.35,103.05,102.9,16,8,8,0.5,16,11,5,0.688,6,2,7,4
2018-11-21,1610612762,1610612758,2018,110.0,119.0,229.0,105.55,107.12142857142857,112.51111111111112,116.73333333333333,17,8,9,0.47100000000000003,17,9,8,0.529,2,6,5,4
2018-11-21,1610612744,1610612760,2018,95.0,123.0,218.0,115.8,111.5,111.45555555555555,105.77222222222221,18,12,6,0.667,16,10,6,0.625,8,4,6,4
2018-11-20,1610612753,1610612761,2018,91.0,93.0,184.0,106.8375,109.1125,116.35,107.9,17,9,8,0.529,17,13,4,0.765,6,3,7,6
2018-11-20,1610612764,1610612746,2018,125.0,118.0,243.0,111.45,115.15,117.11666666666667,110.43888888888888,16,5,11,0.313,16,11,5,0.688,3,2,7,4
2018-11-20,1610612748,1610612751,2018,92.0,104.0,196.0,109.75,111.5,109.825,111.375,16,6,10,0.375,17,7,10,0.41200000000000003,3,3,3,4
2018-11-20,1610612752,1610612757,2018,114.0,118.0,232.0,107.19999999999999,113.65,114.28888888888889,108.26111111111112,17,4,13,0.235,16,11,5,0.688,2,2,7,4
2018-11-19,1610612766,1610612738,2018,117.0,112.0,229.0,114.69999999999999,110.05,105.22777777777779,103.44444444444444,15,7,8,0.467,16,9,7,0.563,4,3,5,4
2018-11-19,1610612765,1610612739,2018,113.0,102.0,215.0,108.275,109.5625,103.9375,111.325,13,7,6,0.5379999999999999,14,2,12,0.14300000000000002,3,4,2,0
2018-11-19,1610612754,1610612762,2018,121.0,94.0,215.0,104.075,101.1125,107.0,106.92142857142858,16,10,6,0.625,16,8,8,0.5,5,5,2,6
2018-11-19,1610612755,1610612756,2018,119.0,114.0,233.0,113.2,113.0,101.2,113.575,18,11,7,0.611,15,3,12,0.2,8,3,3,0
2018-11-19,1610612737,1610612746,2018,119.0,127.0,246.0,108.8,117.225,116.45,110.05,16,3,13,0.188,15,10,5,0.667,2,1,7,3
2018-11-19,1610612763,1610612742,2018,98.0,88.0,186.0,104.15,104.0,111.1,110.975,15,10,5,0.667,15,7,8,0.467,6,4,6,1
2018-11-19,1610612749,1610612743,2018,104.0,98.0,202.0,121.77222222222221,109.42222222222222,110.95,104.65,15,11,4,0.733,16,10,6,0.625,7,4,7,3
2018-11-19,1610612740,1610612759,2018,140.0,126.0,266.0,118.01666666666667,117.86111111111111,108.11111111111111,106.87777777777778,16,9,7,0.563,15,8,7,0.5329999999999999,7,2,6,2
2018-11-19,1610612758,1610612760,2018,117.0,113.0,230.0,111.8375,116.5875,111.0875,105.05,16,8,8,0.5,15,10,5,0.667,4,4,6,4
2018-11-18,1610612750,1610612763,2018,87.0,100.0,187.0,110.3,117.4,104.12222222222222,104.96666666666667,16,7,9,0.43799999999999994,14,9,5,0.643,7,0,6,3
2018-11-18,1610612748,1610612747,2018,97.0,113.0,210.0,111.9,112.25,115.7375,114.825,15,6,9,0.4,15,8,7,0.5329999999999999,3,3,5,3
2018-11-18,1610612753,1610612752,2018,131.0,117.0,248.0,105.4875,108.3125,106.69999999999999,112.2,16,8,8,0.5,16,4,12,0.25,5,3,2,2
2018-11-18,1610612764,1610612757,2018,109.0,119.0,228.0,111.7,114.84444444444443,113.775,108.2125,15,5,10,0.33299999999999996,15,10,5,0.667,3,2,7,3
2018-11-18,1610612759,1610612744,2018,104.0,92.0,196.0,108.11111111111111,107.27777777777777,116.99444444444444,111.98888888888888,14,7,7,0.5,17,12,5,0.706,5,2,8,4
2018-11-17,1610612751,1610612746,2018,119.0,127.0,246.0,109.37857142857143,110.46428571428572,115.59285714285716,109.55,16,7,9,0.43799999999999994,14,9,5,0.643,3,4,7,2
2018-11-17,1610612766,1610612755,2018,119.0,122.0,241.0,114.60555555555555,109.24444444444444,113.1,112.75,14,7,7,0.5,17,10,7,0.588,4,3,8,2
2018-11-17,1610612754,1610612737,2018,97.0,89.0,186.0,104.4857142857143,101.69285714285715,110.0,118.325,15,9,6,0.6,15,3,12,0.2,4,5,2,1
2018-11-17,1610612753,1610612747,2018,130.0,117.0,247.0,103.0375,107.4625,115.65714285714284,113.62857142857143,15,7,8,0.467,14,8,6,0.5710000000000001,4,3,5,3
2018-11-17,1610612740,1610612743,2018,125.0,115.0,240.0,117.7875,118.0,110.55555555555556,103.54444444444445,15,8,7,0.5329999999999999,15,10,5,0.667,6,2,7,3
2018-11-17,1610612738,1610612762,2018,86.0,98.0,184.0,106.45,103.625,108.7,107.27142857142857,15,9,6,0.6,15,7,8,0.467,5,4,2,5
2018-11-17,1610612741,1610612761,2018,83.0,122.0,205.0,102.6,111.0,115.98333333333333,109.33333333333334,16,4,12,0.25,16,12,4,0.75,2,2,7,5
2018-11-17,1610612745,1610612758,2018,132.0,112.0,244.0,106.05,105.725,110.9375,116.0875,14,7,7,0.5,15,8,7,0.5329999999999999,2,5,4,4
2018-11-17,1610612742,1610612744,2018,112.0,109.0,221.0,111.30555555555556,110.98611111111111,117.425,112.1,14,6,8,0.429,16,12,4,0.75,5,1,8,4
2018-11-17,1610612756,1610612760,2018,100.0,110.0,210.0,101.3,113.375,110.82857142857142,105.33571428571429,14,3,11,0.214,14,9,5,0.643,3,0,6,3
2018-11-16,1610612738,1610612761,2018,123.0,116.0,239.0,105.37857142857143,102.57142857142857,115.9,108.625,14,8,6,0.5710000000000001,15,12,3,0.8,4,4,7,5
2018-11-16,1610612754,1610612748,2018,99.0,91.0,190.0,104.86666666666667,102.3,112.97222222222223,113.03888888888889,14,8,6,0.5710000000000001,14,6,8,0.429,3,5,3,3
2018-11-16,1610612755,1610612762,2018,113.0,107.0,220.0,113.32222222222222,112.90555555555557,109.5,107.22142857142856,16,9,7,0.563,14,7,7,0.5,7,2,2,5
2018-11-16,1610612764,1610612751,2018,104.0,115.0,219.0,112.325,114.7125,109.27857142857144,110.61428571428571,14,5,9,0.35700000000000004,15,6,9,0.4,3,2,3,3
2018-11-16,1610612763,1610612758,2018,112.0,104.0,216.0,103.94444444444444,104.94444444444444,111.8875,116.8875,13,8,5,0.615,14,8,6,0.5710000000000001,5,3,4,4
2018-11-16,1610612750,1610612757,2018,112.0,96.0,208.0,110.33333333333334,118.35,114.75714285714285,107.93571428571428,15,6,9,0.4,14,10,4,0.7140000000000001,6,0,7,3
2018-11-16,1610612740,1610612752,2018,129.0,124.0,253.0,117.20714285714286,117.53571428571428,106.69999999999999,111.8,14,7,7,0.5,15,4,11,0.267,5,2,2,2
2018-11-16,1610612749,1610612741,2018,123.0,104.0,227.0,121.83333333333334,109.5,102.41111111111111,110.52222222222221,14,10,4,0.7140000000000001,15,4,11,0.267,6,4,2,2
2018-11-15,1610612745,1610612744,2018,107.0,86.0,193.0,106.0142857142857,107.45714285714286,119.62142857142857,112.6,13,6,7,0.462,15,12,3,0.8,1,5,8,4
2018-11-15,1610612743,1610612737,2018,138.0,93.0,231.0,109.22222222222223,104.16666666666666,110.05,117.075,14,9,5,0.643,14,3,11,0.214,6,3,2,1
2018-11-15,1610612746,1610612759,2018,116.0,111.0,227.0,115.69841269841271,109.38888888888889,108.0625,106.9375,13,8,5,0.615,13,7,6,0.5379999999999999,6,2,5,2
2018-11-14,1610612753,1610612755,2018,111.0,106.0,217.0,102.5875,106.4625,113.5,113.16666666666667,14,6,8,0.429,15,9,6,0.6,3,3,7,2
2018-11-14,1610612764,1610612739,2018,119.0,95.0,214.0,112.05714285714285,115.97142857142856,104.46428571428572,110.84285714285716,13,4,9,0.308,13,2,11,0.154,2,2,2,0
2018-11-14,1610612738,1610612741,2018,111.0,82.0,193.0,104.95,104.0,103.55,110.675,13,7,6,0.5379999999999999,14,4,10,0.28600000000000003,3,4,2,2
2018-11-14,1610612751,1610612748,2018,107.0,120.0,227.0,109.68333333333334,109.98333333333333,112.5,113.525,14,6,8,0.429,13,5,8,0.385,3,3,3,2
2018-11-14,1610612761,1610612765,2018,104.0,106.0,210.0,116.8,108.525,108.45833333333334,109.78472222222223,14,12,2,0.857,12,6,6,0.5,7,5,3,3
2018-11-14,1610612749,1610612763,2018,113.0,116.0,229.0,122.53472222222223,108.84722222222223,102.90972222222223,104.52777777777777,13,10,3,0.769,12,7,5,0.583,6,4,5,2
2018-11-14,1610612750,1610612740,2018,107.0,100.0,207.0,110.6875,119.2875,117.30714285714285,117.9857142857143,14,5,9,0.35700000000000004,13,7,6,0.5379999999999999,5,0,5,2
2018-11-14,1610612760,1610612752,2018,128.0,103.0,231.0,108.97857142857143,105.03571428571428,106.95555555555555,111.02777777777777,13,8,5,0.615,14,4,10,0.28600000000000003,5,3,2,2
2018-11-14,1610612742,1610612762,2018,118.0,68.0,186.0,111.1875,113.5625,111.83333333333334,106.57142857142857,13,5,8,0.385,13,7,6,0.5379999999999999,4,1,2,5
2018-11-14,1610612756,1610612759,2018,116.0,96.0,212.0,100.55555555555556,114.125,109.07142857142857,106.5,13,2,11,0.154,12,7,5,0.583,2,0,5,2
2018-11-14,1610612747,1610612757,2018,126.0,117.0,243.0,115.75714285714285,113.92857142857143,114.31666666666666,106.4,13,7,6,0.5379999999999999,13,10,3,0.769,4,3,7,3
2018-11-13,1610612739,1610612766,2018,113.0,89.0,202.0,104.04761904761905,112.03174603174602,115.88888888888889,109.22222222222223,12,1,11,0.083,13,7,6,0.5379999999999999,1,0,4,3
2018-11-13,1610612743,1610612745,2018,99.0,109.0,208.0,109.99305555555556,103.94444444444444,105.82539682539684,107.57936507936508,13,9,4,0.6920000000000001,12,5,7,0.41700000000000004,6,3,1,4
2018-11-13,1610612744,1610612737,2018,110.0,103.0,213.0,119.57142857142857,113.3,110.4,117.575,14,11,3,0.7859999999999999,13,3,10,0.231,7,4,2,1
2018-11-12,1610612764,1610612753,2018,117.0,109.0,226.0,111.86666666666667,116.48333333333333,102.32857142857142,105.65,12,3,9,0.25,13,6,7,0.462,1,2,3,3
2018-11-12,1610612748,1610612755,2018,114.0,124.0,238.0,111.3,111.775,112.59722222222223,113.30555555555556,12,5,7,0.41700000000000004,14,8,6,0.5710000000000001,3,2,7,1
2018-11-12,1610612761,1610612740,2018,110.0,126.0,236.0,117.30555555555556,107.45833333333334,116.80714285714285,118.88571428571429,13,12,1,0.9229999999999999,12,6,6,0.5,7,5,5,1
2018-11-12,1610612741,1610612742,2018,98.0,103.0,201.0,105.05,111.325,111.4375,114.61607142857143,13,4,9,0.308,12,4,8,0.33299999999999996,2,2,4,0
2018-11-12,1610612763,1610612762,2018,88.0,96.0,184.0,104.1875,105.0,113.0,107.63392857142857,11,7,4,0.636,12,6,6,0.5,5,2,2,4
2018-11-12,1610612750,1610612751,2018,120.0,113.0,233.0,110.21428571428572,119.56428571428572,108.58333333333334,109.88333333333333,13,4,9,0.308,13,6,7,0.462,4,0,3,3
2018-11-12,1610612760,1610612756,2018,118.0,101.0,219.0,108.65079365079364,105.28571428571428,100.48412698412699,114.07142857142857,12,7,5,0.583,12,2,10,0.16699999999999998,4,3,2,0
2018-11-12,1610612758,1610612759,2018,104.0,99.0,203.0,111.95,117.7,110.16666666666666,106.91666666666666,13,7,6,0.5379999999999999,11,7,4,0.636,3,4,5,2
2018-11-12,1610612746,1610612744,2018,121.0,116.0,237.0,115.51785714285714,108.875,120.0,112.8,12,7,5,0.583,13,11,2,0.846,5,2,7,4
2018-11-11,1610612765,1610612766,2018,103.0,113.0,216.0,108.76190476190476,109.65079365079364,115.99305555555556,109.81944444444444,11,6,5,0.545,12,6,6,0.5,3,3,4,2
2018-11-11,1610612745,1610612754,2018,115.0,103.0,218.0,105.11111111111111,108.47222222222223,104.91666666666666,102.0,11,4,7,0.364,13,8,5,0.615,0,4,3,5
2018-11-11,1610612752,1610612753,2018,89.0,115.0,204.0,107.88888888888889,110.72222222222223,101.48333333333333,106.9,13,4,9,0.308,12,5,7,0.41700000000000004,2,2,3,2
2018-11-11,1610612743,1610612749,2018,114.0,121.0,235.0,109.9126984126984,102.80158730158729,122.4375,108.8125,12,9,3,0.75,12,9,3,0.75,6,3,6,3
2018-11-11,1610612757,1610612738,2018,100.0,94.0,194.0,115.11666666666667,105.85,105.1,104.2,12,9,3,0.75,12,7,5,0.583,6,3,3,4
2018-11-11,1610612747,1610612737,2018,107.0,106.0,213.0,115.95714285714286,114.27857142857144,110.55555555555556,118.23611111111111,12,6,6,0.5,12,3,9,0.25,3,3,2,1
2018-11-10,1610612761,1610612752,2018,128.0,112.0,240.0,116.8125,107.0,107.64583333333334,109.75694444444444,12,11,1,0.917,12,4,8,0.33299999999999996,6,5,2,2
2018-11-10,1610612746,1610612749,2018,128.0,126.0,254.0,114.78571428571429,107.5,121.95535714285714,107.76785714285714,11,6,5,0.545,11,9,2,0.818,4,2,6,3
2018-11-10,1610612740,1610612756,2018,119.0,99.0,218.0,116.86666666666667,120.35,100.55555555555556,113.91666666666666,11,5,6,0.455,11,2,9,0.182,4,1,2,0
2018-11-10,1610612748,1610612764,2018,110.0,116.0,226.0,111.36111111111111,111.31944444444444,111.5,116.86111111111111,11,5,6,0.455,11,2,9,0.182,3,2,1,1
2018-11-10,1610612741,1610612739,2018,99.0,98.0,197.0,105.52777777777777,111.93055555555556,104.5,113.05555555555554,12,3,9,0.25,11,1,10,0.091,1,2,1,0
2018-11-10,1610612763,1610612755,2018,112.0,106.0,218.0,104.11607142857143,104.89285714285714,112.72222222222223,113.62698412698413,10,6,4,0.6,13,8,5,0.615,4,2,7,1
2018-11-10,1610612759,1610612745,2018,96.0,89.0,185.0,110.72222222222223,107.75,106.125,108.8125,10,6,4,0.6,10,4,6,0.4,4,2,0,4
2018-11-10,1610612744,1610612751,2018,116.0,100.0,216.0,120.3,112.5,109.08333333333334,109.48333333333333,12,10,2,0.833,12,6,6,0.5,6,4,3,3
2018-11-10,1610612742,1610612760,2018,111.0,96.0,207.0,111.78571428571428,115.92857142857143,109.47222222222223,104.75,11,3,8,0.273,11,7,4,0.636,3,0,4,3
2018-11-10,1610612758,1610612747,2018,86.0,101.0,187.0,113.53333333333333,118.61666666666667,117.18333333333334,116.35,12,7,5,0.583,11,5,6,0.455,3,4,3,2
2018-11-09,1610612753,1610612764,2018,117.0,108.0,225.0,100.52777777777777,106.86111111111111,111.54166666666666,116.89583333333334,11,4,7,0.364,10,2,8,0.2,2,2,1,1
2018-11-09,1610612755,1610612766,2018,133.0,132.0,265.0,111.75,112.25892857142857,114.76984126984127,108.44444444444444,12,7,5,0.583,11,6,5,0.545,6,1,4,2
2018-11-09,1610612737,1610612765,2018,109.0,124.0,233.0,110.76984126984127,117.68253968253968,107.86607142857143,109.61607142857143,11,3,8,0.273,10,5,5,0.5,2,1,3,2
2018-11-09,1610612748,1610612754,2018,102.0,110.0,212.0,111.9375,111.125,104.91666666666666,101.9,10,5,5,0.5,12,7,5,0.583,3,2,3,4
2018-11-09,1610612743,1610612751,2018,110.0,112.0,222.0,110.13888888888889,102.02777777777777,108.72222222222223,109.36111111111111,11,9,2,0.818,11,5,6,0.455,6,3,3,2
2018-11-09,1610612762,1610612738,2018,123.0,115.0,238.0,111.83333333333334,107.0625,104.55555555555556,103.27777777777777,11,5,6,0.455,11,7,4,0.636,1,4,3,4
2018-11-09,1610612758,1610612750,2018,121.0,110.0,231.0,112.25,119.0,110.41428571428571,119.0142857142857,11,6,5,0.545,12,4,8,0.33299999999999996,2,4,4,0
2018-11-08,1610612760,1610612745,2018,98.0,80.0,178.0,110.3125,106.375,108.07142857142857,109.10714285714286,10,6,4,0.6,9,4,5,0.444,3,3,0,4
2018-11-08,1610612756,1610612738,2018,109.0,116.0,225.0,100.0625,113.60416666666666,103.8125,103.0,10,2,8,0.2,10,6,4,0.6,2,0,3,3
2018-11-08,1610612757,1610612746,2018,116.0,105.0,221.0,114.91666666666666,106.75,115.47619047619048,107.08333333333334,11,8,3,0.727,10,6,4,0.6,5,3,4,2
2018-11-08,1610612744,1610612749,2018,111.0,134.0,245.0,120.25,111.5,120.64583333333334,107.79166666666666,11,10,1,0.909,10,8,2,0.8,6,4,6,2
2018-11-07,1610612739,1610612760,2018,86.0,95.0,181.0,105.66666666666666,114.16666666666666,111.5625,108.125,10,1,9,0.1,9,5,4,0.556,1,0,3,2
2018-11-07,1610612753,1610612765,2018,96.0,103.0,199.0,100.64583333333334,107.125,108.21428571428572,110.5,10,4,6,0.4,9,4,5,0.444,2,2,3,1
2018-11-07,1610612737,1610612752,2018,107.0,112.0,219.0,111.22222222222223,117.94444444444446,107.33333333333334,110.01587301587301,10,3,7,0.3,11,3,8,0.273,2,1,2,1
2018-11-07,1610612748,1610612759,2018,95.0,88.0,183.0,113.17857142857143,112.44642857142857,113.35555555555555,109.23333333333333,9,4,5,0.444,9,6,3,0.667,2,2,4,2
2018-11-07,1610612754,1610612755,2018,94.0,100.0,194.0,105.95,101.85,112.41666666666666,114.1875,11,7,4,0.636,11,6,5,0.545,3,4,6,0
2018-11-07,1610612763,1610612743,2018,89.0,87.0,176.0,105.9375,106.33333333333334,111.39583333333334,102.89583333333334,9,5,4,0.556,10,9,1,0.9,3,2,6,3
2018-11-07,1610612740,1610612741,2018,107.0,98.0,205.0,118.15,122.5,105.84920634920636,112.4126984126984,10,4,6,0.4,11,3,8,0.273,3,1,1,2
2018-11-07,1610612762,1610612742,2018,117.0,102.0,219.0,110.8,107.5625,112.20238095238095,115.75,10,4,6,0.4,10,3,7,0.3,0,4,3,0
2018-11-07,1610612758,1610612761,2018,105.0,114.0,219.0,109.87553191489363,114.84893617021277,116.84821428571428,107.375,10,6,4,0.6,11,10,1,0.909,2,4,6,4
2018-11-07,1610612747,1610612750,2018,114.0,110.0,224.0,116.83333333333334,117.05,110.32539682539684,119.38095238095238,10,4,6,0.4,11,4,7,0.364,2,2,4,0
2018-11-06,1610612766,1610612737,2018,113.0,102.0,215.0,115.02678571428572,108.6875,111.66666666666666,118.39583333333334,10,5,5,0.5,9,3,6,0.33299999999999996,3,2,2,1
2018-11-06,1610612742,1610612764,2018,119.0,100.0,219.0,112.0,117.16666666666666,112.16666666666666,116.79761904761905,9,2,7,0.222,9,2,7,0.222,2,0,1,1
2018-11-06,1610612756,1610612751,2018,82.0,104.0,186.0,101.35714285714286,114.05952380952381,108.77083333333334,110.95833333333334,9,2,7,0.222,10,4,6,0.4,2,0,3,1
2018-11-06,1610612757,1610612749,2018,118.0,103.0,221.0,114.97222222222223,107.08333333333334,121.9125,107.125,10,7,3,0.7,9,8,1,0.889,4,3,6,2
2018-11-05,1610612765,1610612748,2018,115.0,120.0,235.0,107.61904761904762,109.73809523809524,112.57142857142858,112.5,8,4,4,0.5,8,3,5,0.375,3,1,2,1
2018-11-05,1610612754,1610612745,2018,94.0,98.0,192.0,106.23958333333334,103.61875,109.16666666666666,109.83333333333334,10,7,3,0.7,8,3,5,0.375,3,4,0,3
2018-11-05,1610612753,1610612739,2018,102.0,100.0,202.0,100.36904761904762,107.67857142857143,106.1,115.3,9,3,6,0.33299999999999996,9,1,8,0.111,1,2,1,0
2018-11-05,1610612752,1610612741,2018,115.0,116.0,231.0,106.875,109.57142857142857,104.77777777777777,112.38888888888889,10,3,7,0.3,10,2,8,0.2,2,1,1,1
2018-11-05,1610612760,1610612740,2018,122.0,116.0,238.0,110.92857142857143,107.64285714285714,118.03333333333333,122.45555555555555,8,4,4,0.5,9,4,5,0.444,2,2,3,1
2018-11-05,1610612743,1610612738,2018,115.0,107.0,222.0,111.2125,102.3125,103.5,102.21428571428572,9,8,1,0.889,9,6,3,0.667,5,3,3,3
2018-11-05,1610612762,1610612761,2018,111.0,124.0,235.0,110.55882352941177,102.43504901960785,116.0625,107.375,9,4,5,0.444,10,9,1,0.9,0,4,6,3
2018-11-05,1610612744,1610612763,2018,117.0,101.0,218.0,120.33333333333334,111.94444444444444,105.67857142857143,105.51190476190476,10,9,1,0.9,8,5,3,0.625,5,4,3,2
2018-11-05,1610612746,1610612750,2018,120.0,109.0,229.0,115.16666666666667,106.66666666666667,110.27678571428572,119.46428571428572,9,5,4,0.556,10,4,6,0.4,3,2,4,0
2018-11-04,1610612749,1610612758,2018,144.0,109.0,253.0,120.6,106.78571428571428,109.72553191489362,112.74893617021277,8,7,1,0.875,9,6,3,0.667,5,2,2,4
2018-11-04,1610612751,1610612755,2018,122.0,97.0,219.0,107.8375,112.375,113.65,114.0875,9,3,6,0.33299999999999996,10,6,4,0.6,2,1,6,0
2018-11-04,1610612764,1610612752,2018,108.0,95.0,203.0,112.8,118.91428571428571,107.875,109.83333333333334,8,1,7,0.125,9,3,6,0.33299999999999996,0,1,2,1
2018-11-04,1610612759,1610612753,2018,110.0,117.0,227.0,113.175,108.525,98.9857142857143,107.32857142857142,8,6,2,0.75,8,2,6,0.25,4,2,1,1
2018-11-04,1610612756,1610612763,2018,102.0,100.0,202.0,101.41666666666666,115.0,105.41666666666666,105.66666666666667,8,1,7,0.125,7,5,2,0.7140000000000001,1,0,3,2
2018-11-04,1610612757,1610612750,2018,111.0,81.0,192.0,115.47916666666666,108.875,112.21428571428572,120.21428571428572,9,6,3,0.667,9,4,5,0.444,3,3,4,0
2018-11-04,1610612747,1610612761,2018,107.0,121.0,228.0,117.30555555555556,116.94444444444444,115.2625,107.775,9,4,5,0.444,9,8,1,0.889,2,2,6,2
2018-11-03,1610612755,1610612765,2018,109.0,99.0,208.0,114.11428571428571,114.68571428571428,108.41666666666667,109.83333333333333,9,5,4,0.556,7,4,3,0.5710000000000001,5,0,3,1
2018-11-03,1610612766,1610612739,2018,126.0,94.0,220.0,114.42857142857143,109.57142857142857,107.34482758620689,111.98275862068965,9,4,5,0.444,8,1,7,0.125,2,2,1,0
2018-11-03,1610612754,1610612738,2018,102.0,101.0,203.0,106.29255319148936,103.63936170212766,103.58333333333334,102.25,9,6,3,0.667,8,6,2,0.75,2,4,3,3
2018-11-03,1610612737,1610612748,2018,123.0,118.0,241.0,110.7,118.1625,111.92857142857143,111.9047619047619,8,2,6,0.25,7,3,4,0.429,1,1,2,1
2018-11-03,1610612741,1610612745,2018,88.0,96.0,184.0,106.0625,113.27083333333334,110.9,111.45,9,2,7,0.222,7,2,5,0.28600000000000003,1,1,0,2
2018-11-03,1610612759,1610612740,2018,109.0,95.0,204.0,113.0142857142857,109.18571428571428,119.2,123.2125,7,5,2,0.7140000000000001,8,4,4,0.5,3,2,3,1
2018-11-03,1610612743,1610612762,2018,103.0,88.0,191.0,110.49728260869566,104.91032608695653,112.63025210084034,102.7296918767507,8,7,1,0.875,8,4,4,0.5,4,3,0,4
2018-11-03,1610612757,1610612747,2018,110.0,114.0,224.0,116.20238095238095,108.82142857142857,117.72222222222223,117.44444444444444,8,6,2,0.75,8,3,5,0.375,3,3,2,1
2018-11-02,1610612753,1610612746,2018,95.0,120.0,215.0,99.2,106.4,114.63333333333333,108.18333333333334,7,2,5,0.28600000000000003,8,4,4,0.5,1,1,3,1
2018-11-02,1610612751,1610612745,2018,111.0,119.0,230.0,105.78125,109.77083333333334,107.16363636363636,109.15,8,3,5,0.375,6,1,5,0.16699999999999998,2,1,0,1
2018-11-02,1610612764,1610612760,2018,111.0,134.0,245.0,109.41,111.53428571428572,108.75510204081633,106.71428571428572,7,1,6,0.14300000000000002,7,3,4,0.429,0,1,2,1
2018-11-02,1610612741,1610612754,2018,105.0,107.0,212.0,106.5,113.61904761904762,106.20921985815602,103.60047281323878,8,2,6,0.25,8,5,3,0.625,1,1,2,3
2018-11-02,1610612742,1610612752,2018,106.0,118.0,224.0,113.01666666666667,117.35,106.975,110.4,8,2,6,0.25,8,2,6,0.25,2,0,2,0
2018-11-02,1610612762,1610612763,2018,100.0,110.0,210.0,112.67142857142858,102.60714285714286,104.05,106.08333333333334,7,4,3,0.5710000000000001,6,4,2,0.667,0,4,3,1
2018-11-02,1610612756,1610612761,2018,98.0,107.0,205.0,101.9,115.61666666666667,114.43042452830188,105.35613207547169,7,1,6,0.14300000000000002,8,7,1,0.875,1,0,6,1
2018-11-02,1610612744,1610612750,2018,116.0,99.0,215.0,120.5,112.625,113.29761904761905,120.79761904761905,9,8,1,0.889,8,4,4,0.5,4,4,4,0
2018-11-01,1610612766,1610612760,2018,107.0,111.0,218.0,115.21428571428572,109.33333333333334,108.69940476190476,106.69494047619048,8,4,4,0.5,6,2,4,0.33299999999999996,2,2,2,0
2018-11-01,1610612739,1610612743,2018,91.0,110.0,201.0,108.48768472906404,112.33990147783251,110.47049689440993,105.88354037267081,7,1,6,0.14300000000000002,7,6,1,0.857,1,0,4,2
2018-11-01,1610612755,1610612746,2018,122.0,113.0,235.0,113.65,114.31666666666666,112.2572463768116,106.39855072463769,8,4,4,0.5,7,4,3,0.5710000000000001,4,0,3,1
2018-11-01,1610612737,1610612758,2018,115.0,146.0,261.0,107.45744680851064,114.67952127659575,108.2033096926714,112.98226950354609,7,2,5,0.28600000000000003,8,5,3,0.625,1,1,2,3
2018-11-01,1610612738,1610612749,2018,117.0,113.0,230.0,102.38333333333333,101.15,114.75490196078431,105.78571428571428,7,5,2,0.7140000000000001,7,7,0,1.0,2,3,5,2
2018-11-01,1610612757,1610612740,2018,132.0,119.0,251.0,115.33333333333333,108.33333333333334,118.9857142857143,122.54285714285714,7,5,2,0.7140000000000001,7,4,3,0.5710000000000001,2,3,3,1
2018-10-31,1610612751,1610612765,2018,120.0,119.0,239.0,105.63962765957447,109.6622340425532,107.53333333333333,108.86666666666667,7,2,5,0.28600000000000003,6,4,2,0.667,1,1,3,1
2018-10-31,1610612752,1610612754,2018,101.0,107.0,208.0,107.38571428571429,110.47142857142856,106.10505319148936,103.80186170212767,7,2,5,0.28600000000000003,7,4,3,0.5710000000000001,2,0,2,2
2018-10-31,1610612741,1610612743,2018,107.0,108.0,215.0,106.91666666666666,114.0,110.60144927536231,105.84782608695653,7,2,5,0.28600000000000003,6,5,1,0.833,1,1,4,1
2018-10-31,1610612750,1610612762,2018,128.0,125.0,253.0,112.0,120.16666666666667,112.35,100.91666666666666,7,3,4,0.429,6,4,2,0.667,3,0,0,4
2018-10-31,1610612744,1610612740,2018,131.0,121.0,252.0,119.64285714285714,111.92857142857143,118.53333333333333,121.73333333333333,8,7,1,0.875,6,4,2,0.667,3,4,3,1
2018-10-31,1610612747,1610612742,2018,114.0,113.0,227.0,117.875,117.8125,112.5,117.4,7,2,5,0.28600000000000003,7,2,5,0.28600000000000003,1,1,2,0
2018-10-31,1610612756,1610612759,2018,90.0,120.0,210.0,101.75531914893617,115.19326241134752,103.84428571428572,104.47571428571428,6,1,5,0.16699999999999998,6,4,2,0.667,1,0,3,1
2018-10-30,1610612766,1610612748,2018,125.0,113.0,238.0,114.5142857142857,108.8,111.52857142857144,110.87142857142857,7,3,4,0.429,6,3,3,0.5,1,2,2,1
2018-10-30,1610612739,1610612737,2018,136.0,114.0,250.0,106.26149425287356,112.48275862068965,107.17173252279636,113.61702127659575,6,0,6,0.0,6,2,4,0.33299999999999996,0,0,1,1
2018-10-30,1610612753,1610612758,2018,99.0,107.0,206.0,99.1,106.4,108.73803191489361,114.27393617021276,6,2,4,0.33299999999999996,7,4,3,0.5710000000000001,1,1,2,2
2018-10-30,1610612738,1610612765,2018,108.0,105.0,213.0,103.63505747126436,100.88793103448276,104.48226950354609,107.54964539007092,6,4,2,0.667,5,4,1,0.8,1,3,3,1
2018-10-30,1610612761,1610612755,2018,129.0,112.0,241.0,113.72506738544473,104.76684636118598,112.11538461538461,108.2051282051282,7,6,1,0.857,7,4,3,0.5710000000000001,5,1,4,0
2018-10-30,1610612745,1610612757,2018,85.0,104.0,189.0,109.16363636363636,110.3,116.01666666666667,110.28333333333333,5,1,4,0.2,6,4,2,0.667,0,1,2,2
2018-10-30,1610612763,1610612764,2018,107.0,95.0,202.0,104.8,107.3,110.66,112.40333333333334,5,3,2,0.6,6,1,5,0.16699999999999998,2,1,0,1
2018-10-30,1610612760,1610612746,2018,128.0,110.0,238.0,107.35416666666667,106.55208333333334,112.24444444444444,106.19444444444446,5,1,4,0.2,6,4,2,0.667,1,0,3,1
2018-10-29,1610612754,1610612757,2018,93.0,103.0,196.0,106.25815217391305,103.80163043478261,113.00666666666666,108.58333333333334,6,4,2,0.667,5,3,2,0.6,2,2,2,1
2018-10-29,1610612755,1610612737,2018,113.0,92.0,205.0,112.36538461538461,109.78846153846155,108.6241134751773,114.11702127659575,6,3,3,0.5,5,2,3,0.4,3,0,1,1
2018-10-29,1610612748,1610612758,2018,113.0,123.0,236.0,111.68333333333334,109.71666666666667,108.28267477203647,114.93465045592706,5,3,2,0.6,6,3,3,0.5,2,1,2,1
2018-10-29,1610612752,1610612751,2018,115.0,96.0,211.0,106.76666666666667,111.48333333333333,106.27355623100303,109.35866261398176,6,1,5,0.16699999999999998,6,2,4,0.33299999999999996,1,0,1,1
2018-10-29,1610612741,1610612744,2018,124.0,149.0,273.0,105.8,110.43333333333334,116.94285714285715,110.92857142857143,6,2,4,0.33299999999999996,7,6,1,0.857,1,1,3,3
2018-10-29,1610612749,1610612761,2018,124.0,109.0,233.0,114.67156862745098,105.33333333333334,113.73214285714286,104.60302197802199,6,6,0,1.0,6,6,0,1.0,4,2,5,1
2018-10-29,1610612750,1610612747,2018,124.0,120.0,244.0,110.58333333333334,119.78333333333333,113.46195652173913,116.38858695652175,6,2,4,0.33299999999999996,6,2,4,0.33299999999999996,2,0,1,1
2018-10-29,1610612759,1610612742,2018,113.0,108.0,221.0,103.29666666666667,104.27333333333334,109.64166666666667,113.80833333333334,5,3,2,0.6,6,2,4,0.33299999999999996,2,1,2,0
2018-10-29,1610612743,1610612740,2018,116.0,111.0,227.0,110.55,105.78333333333333,118.9,122.1,5,4,1,0.8,5,4,1,0.8,3,1,3,1
2018-10-28,1610612751,1610612744,2018,114.0,120.0,234.0,106.19099378881987,109.23447204968943,115.125,109.0625,5,2,3,0.4,6,5,1,0.833,1,1,3,2
2018-10-28,1610612742,1610612762,2018,104.0,113.0,217.0,103.32291666666666,105.98958333333334,113.1,100.95,5,2,3,0.4,5,3,2,0.6,2,0,0,3
2018-10-28,1610612760,1610612756,2018,117.0,110.0,227.0,106.57083333333333,106.35208333333333,100.75531914893617,115.17659574468085,4,0,4,0.0,5,1,4,0.2,0,0,1,0
2018-10-28,1610612746,1610612764,2018,136.0,104.0,240.0,110.21111111111111,106.11111111111111,111.50999999999999,110.72,5,3,2,0.6,5,1,4,0.2,2,1,0,1
2018-10-27,1610612765,1610612738,2018,89.0,109.0,198.0,106.24893617021277,107.58297872340427,102.95172413793102,102.23793103448276,4,4,0,1.0,5,3,2,0.6,3,1,1,2
2018-10-27,1610612740,1610612762,2018,111.0,132.0,243.0,114.88,116.5,104.76981132075471,100.45754716981132,4,4,0,1.0,4,2,2,0.5,3,1,0,2
2018-10-27,1610612737,1610612741,2018,85.0,97.0,182.0,108.84057971014492,114.23913043478261,106.19999999999999,113.4,4,2,2,0.5,5,1,4,0.2,1,1,1,0
2018-10-27,1610612739,1610612754,2018,107.0,119.0,226.0,106.0448275862069,112.18275862068967,105.26708074534162,103.63198757763976,5,0,5,0.0,5,3,2,0.6,0,0,2,1
2018-10-27,1610612755,1610612766,2018,105.0,103.0,208.0,110.01632801161102,106.24129172714078,115.3,109.3,5,2,3,0.4,6,3,3,0.5,2,0,1,2
2018-10-27,1610612748,1610612757,2018,120.0,111.0,231.0,111.2,109.3,112.95748299319727,108.43027210884354,4,2,2,0.5,4,3,1,0.75,1,1,2,1
2018-10-27,1610612763,1610612756,2018,117.0,96.0,213.0,97.78958333333333,104.15625,103.8936170212766,113.46808510638297,4,2,2,0.5,4,1,3,0.25,1,1,1,0
2018-10-27,1610612749,1610612753,2018,113.0,91.0,204.0,115.65490196078431,106.5,100.15,107.44791666666666,5,5,0,1.0,5,2,3,0.4,3,2,1,1
2018-10-27,1610612759,1610612747,2018,110.0,106.0,216.0,102.83000000000001,104.19,113.50833333333333,116.42361111111111,4,2,2,0.5,5,2,3,0.4,1,1,1,1
2018-10-26,1610612766,1610612741,2018,135.0,106.0,241.0,111.95744680851064,109.81914893617022,106.33125,109.1625,5,2,3,0.4,4,1,3,0.25,0,2,1,0
2018-10-26,1610612752,1610612744,2018,100.0,128.0,228.0,107.4,109.69999999999999,114.98831168831168,109.13766233766233,5,1,4,0.2,5,4,1,0.8,1,0,3,1
2018-10-26,1610612761,1610612742,2018,116.0,107.0,223.0,113.875,104.23397435897436,103.25997340425532,105.89827127659575,5,5,0,1.0,4,2,2,0.5,4,1,2,0
2018-10-26,1610612745,1610612746,2018,113.0,133.0,246.0,110.91363636363636,103.95357142857142,109.93636363636364,106.06818181818181,4,1,3,0.25,4,2,2,0.5,0,1,2,0
2018-10-26,1610612750,1610612749,2018,95.0,125.0,220.0,112.70833333333334,115.77083333333334,115.47,106.63,5,2,3,0.4,4,4,0,1.0,2,0,3,1
2018-10-26,1610612740,1610612751,2018,117.0,115.0,232.0,114.8530612244898,116.47551020408164,105.45289855072464,108.66304347826087,3,3,0,1.0,4,2,2,0.5,2,1,1,1
2018-10-26,1610612758,1610612764,2018,116.0,112.0,228.0,108.11801242236024,114.87267080745342,107.41999999999999,106.94,5,2,3,0.4,4,1,3,0.25,1,1,0,1
2018-10-25,1610612765,1610612739,2018,110.0,103.0,213.0,104.23226950354609,104.38297872340425,106.0859649122807,112.17368421052632,3,3,0,1.0,4,0,4,0.0,2,1,0,0
2018-10-25,1610612753,1610612757,2018,114.0,128.0,242.0,102.69791666666666,107.0625,112.72916666666666,108.33333333333334,4,2,2,0.5,3,2,1,0.667,1,1,2,0
2018-10-25,1610612760,1610612738,2018,95.0,101.0,196.0,107.05083333333334,104.42208333333333,103.38808777429466,100.50156739811914,3,0,3,0.0,4,2,2,0.5,0,0,1,1
2018-10-25,1610612747,1610612743,2018,121.0,114.0,235.0,113.20476190476191,116.82539682539684,110.13333333333333,104.33333333333333,4,1,3,0.25,4,4,0,1.0,0,1,3,1
2018-10-24,1610612737,1610612742,2018,111.0,104.0,215.0,108.77777777777777,114.28888888888889,103.22690217391305,105.85733695652175,3,1,2,0.33299999999999996,3,2,1,0.667,0,1,2,0
2018-10-24,1610612739,1610612751,2018,86.0,102.0,188.0,108.41138864109425,108.83809099018734,105.7195652173913,110.96304347826086,3,0,3,0.0,3,1,2,0.33299999999999996,0,0,1,0
2018-10-24,1610612748,1610612752,2018,110.0,87.0,197.0,106.93,108.24,105.06595744680851,108.59787234042554,3,1,2,0.33299999999999996,4,1,3,0.25,0,1,1,0
2018-10-24,1610612761,1610612750,2018,112.0,105.0,217.0,114.475,103.9173076923077,113.625,116.9875,4,4,0,1.0,4,2,2,0.5,3,1,2,0
2018-10-24,1610612741,1610612766,2018,112.0,110.0,222.0,103.01041666666666,110.01041666666666,112.35744680851064,109.81914893617022,3,0,3,0.0,4,2,2,0.5,0,0,0,2
2018-10-24,1610612745,1610612762,2018,89.0,100.0,189.0,111.12727272727273,104.0,104.82115384615385,100.59615384615384,3,1,2,0.33299999999999996,3,1,2,0.33299999999999996,0,1,0,1
2018-10-24,1610612759,1610612754,2018,96.0,116.0,212.0,103.47,100.97,104.19565217391305,104.32246376811594,3,2,1,0.667,4,2,2,0.5,1,1,2,0
2018-10-24,1610612749,1610612755,2018,123.0,108.0,231.0,106.96000000000001,106.55000000000001,110.02349241583426,106.09988901220865,3,3,0,1.0,4,2,2,0.5,2,1,2,0
2018-10-24,1610612756,1610612747,2018,113.0,131.0,244.0,103.7904717853839,113.27844588344126,112.96915584415584,116.82792207792208,3,1,2,0.33299999999999996,3,0,3,0.0,1,0,0,0
2018-10-24,1610612758,1610612763,2018,97.0,92.0,189.0,108.15714285714284,115.03015873015873,100.0321365248227,105.37965425531914,4,1,3,0.25,3,2,1,0.667,0,1,1,1
2018-10-24,1610612744,1610612764,2018,144.0,122.0,266.0,112.7621212121212,108.12575757575758,107.2569387755102,106.57510204081632,4,3,1,0.75,3,1,2,0.33299999999999996,2,1,0,1
2018-10-23,1610612765,1610612755,2018,133.0,132.0,265.0,103.9468085106383,104.07446808510639,109.79094339622642,105.85283018867923,2,2,0,1.0,3,2,1,0.667,1,1,2,0
2018-10-23,1610612740,1610612746,2018,116.0,109.0,225.0,114.83541666666667,116.5125,109.92790697674418,105.98837209302326,2,2,0,1.0,3,2,1,0.667,1,1,2,0
2018-10-23,1610612743,1610612758,2018,126.0,112.0,238.0,109.9659090909091,104.25454545454545,108.46666666666667,114.82777777777778,3,3,0,1.0,3,1,2,0.33299999999999996,2,1,0,1
2018-10-22,1610612738,1610612753,2018,90.0,93.0,183.0,103.52057416267942,100.55661881977672,102.79898049645391,107.25288120567376,3,2,1,0.667,3,1,2,0.33299999999999996,1,1,1,0
2018-10-22,1610612761,1610612766,2018,127.0,106.0,233.0,111.40384615384616,104.6826923076923,108.41578014184398,107.62123226950355,3,3,0,1.0,3,2,1,0.667,2,1,0,2
2018-10-22,1610612749,1610612752,2018,124.0,113.0,237.0,106.79448979591837,106.46673469387756,104.95217391304348,108.45217391304348,2,2,0,1.0,3,1,2,0.33299999999999996,1,1,1,0
2018-10-22,1610612750,1610612754,2018,101.0,91.0,192.0,113.73404255319149,117.16170212765957,105.19565217391305,104.7891304347826,3,1,2,0.33299999999999996,3,2,1,0.667,1,0,2,0
2018-10-22,1610612742,1610612741,2018,115.0,109.0,224.0,103.12650323774284,105.81012950971322,102.9366134751773,109.97983156028369,2,1,1,0.5,2,0,2,0.0,1,0,0,0
2018-10-22,1610612762,1610612763,2018,84.0,92.0,176.0,105.02727629513345,100.65227629513345,100.09827898550725,105.63451086956522,2,1,1,0.5,2,1,1,0.5,0,1,1,0
2018-10-22,1610612757,1610612764,2018,124.0,125.0,249.0,112.3125,107.05,107.05583333333334,106.40333333333334,2,2,0,1.0,2,0,2,0.0,2,0,0,0
2018-10-22,1610612744,1610612756,2018,123.0,103.0,226.0,111.74545454545455,108.60909090909091,103.80434782608695,113.17391304347827,3,2,1,0.667,2,1,1,0.5,1,1,1,0
2018-10-22,1610612747,1610612759,2018,142.0,143.0,285.0,110.81439393939394,114.9469696969697,103.04408163265308,100.57591836734693,2,0,2,0.0,2,1,1,0.5,0,0,1,0
2018-10-21,1610612739,1610612737,2018,111.0,133.0,244.0,108.39458560193587,108.62885662431941,106.71111111111111,115.1888888888889,2,0,2,0.0,2,0,2,0.0,0,0,0,0
2018-10-21,1610612760,1610612758,2018,120.0,131.0,251.0,106.93409863945578,104.14392006802721,107.0,115.14444444444445,2,0,2,0.0,2,0,2,0.0,0,0,0,0
2018-10-21,1610612743,1610612744,2018,100.0,98.0,198.0,110.09302325581396,104.33488372093024,111.88148148148147,108.68703703703704,2,2,0,1.0,2,2,0,1.0,1,1,1,1
2018-10-21,1610612746,1610612745,2018,115.0,112.0,227.0,108.75035595633602,108.31490270526815,111.10252525252525,103.88703703703703,2,1,1,0.5,2,1,1,0.5,1,0,0,1
2018-10-20,1610612754,1610612751,2018,132.0,112.0,244.0,104.92222222222222,104.68888888888888,106.70652173913044,109.8586956521739,2,1,1,0.5,2,1,1,0.5,1,0,1,0
2018-10-20,1610612764,1610612761,2018,113.0,117.0,230.0,107.01318027210885,106.2874149659864,111.3327677224736,104.62028657616892,1,0,1,0.0,2,2,0,1.0,0,0,2,0
2018-10-20,1610612752,1610612738,2018,101.0,103.0,204.0,104.49592391304347,108.35009057971014,103.50828460038986,100.56335282651072,2,1,1,0.5,2,1,1,0.5,1,0,1,0
2018-10-20,1610612755,1610612753,2018,116.0,115.0,231.0,109.74576923076924,105.74615384615385,102.6653079710145,107.16893115942028,2,1,1,0.5,2,1,1,0.5,1,0,1,0
2018-10-20,1610612748,1610612766,2018,112.0,113.0,225.0,106.86530612244897,108.1469387755102,108.35106382978724,107.57446808510639,2,1,1,0.5,2,1,1,0.5,0,1,0,1
2018-10-20,1610612741,1610612765,2018,116.0,118.0,234.0,102.80851063829788,109.87234042553192,103.77613320999075,103.9632284921369,1,0,1,0.0,1,1,0,1.0,0,0,1,0
2018-10-20,1610612742,1610612750,2018,140.0,136.0,276.0,102.75,105.46739130434783,109.34404255319149,108.62170212765957,1,0,1,0.0,2,1,1,0.5,0,0,1,0
2018-10-20,1610612743,1610612756,2018,119.0,91.0,210.0,110.0,104.50238095238095,103.95217391304348,113.10917874396137,1,1,0,1.0,1,1,0,1.0,0,1,1,0
2018-10-20,1610612757,1610612759,2018,121.0,108.0,229.0,106.56760204081633,103.81122448979592,102.965,100.38416666666666,1,1,0,1.0,1,1,0,1.0,1,0,1,0
2018-10-20,1610612747,1610612745,2018,115.0,124.0,239.0,110.49772727272727,114.21363636363637,110.96363636363637,103.76981132075471,1,0,1,0.0,1,0,1,0.0,0,0,0,0
2018-10-19,1610612753,1610612766,2018,88.0,120.0,208.0,102.82377428307123,107.02243293246994,108.20744680851064,107.78654024051804,1,1,0,1.0,1,0,1,0.0,1,0,0,0
2018-10-19,1610612751,1610612752,2018,107.0,105.0,212.0,106.69806763285024,109.89565217391305,104.46597222222222,108.38680555555555,1,0,1,0.0,1,1,0,1.0,0,0,1,0
2018-10-19,1610612761,1610612738,2018,113.0,101.0,214.0,111.33333333333334,104.63725490196079,103.51439920556106,100.45713339953657,1,1,0,1.0,1,1,0,1.0,1,0,1,0
2018-10-19,1610612763,1610612737,2018,131.0,117.0,248.0,99.7895467160037,105.48889916743755,103.54861111111111,108.84097222222223,1,0,1,0.0,1,0,1,0.0,0,0,0,0
2018-10-19,1610612750,1610612739,2018,131.0,123.0,254.0,109.13173913043478,108.45565217391305,108.25862068965517,108.43195812807882,1,0,1,0.0,1,0,1,0.0,0,0,0,0
2018-10-19,1610612740,1610612758,2018,149.0,129.0,278.0,114.46595744680852,116.33829787234043,98.96326530612245,106.42811791383221,1,1,0,1.0,1,0,1,0.0,0,1,0,0
2018-10-19,1610612749,1610612754,2018,118.0,101.0,219.0,106.68458333333334,106.505,105.19145299145299,103.07158119658119,1,1,0,1.0,1,1,0,1.0,0,1,1,0
2018-10-19,1610612762,1610612744,2018,123.0,124.0,247.0,104.83573717948718,100.37740384615384,111.77735849056603,108.55094339622642,1,1,0,1.0,1,1,0,1.0,0,1,1,0
2018-10-19,1610612746,1610612760,2018,108.0,92.0,200.0,108.76332364341084,108.4779554263566,107.07815892314372,104.11311333043855,1,0,1,0.0,1,0,1,0.0,0,0,0,0
2018-10-18,1610612755,1610612741,2018,127.0,108.0,235.0,109.59098039215687,105.70392156862745,102.74236817761332,109.7099907493062,1,0,1,0.0,0,0,0,0.0,0,0,0,0
2018-10-18,1610612764,1610612748,2018,112.0,113.0,225.0,106.97916666666667,106.20833333333334,103.72609043617447,104.21948779511806,0,0,0,0.0,1,0,1,0.0,0,0,0,0
2018-10-18,1610612757,1610612747,2018,128.0,119.0,247.0,106.35416666666666,103.64583333333334,110.3906976744186,114.04186046511629,0,0,0,0.0,0,0,0,0.0,0,0,0,0
2018-10-17,1610612766,1610612749,2018,112.0,113.0,225.0,108.18478260869566,107.72826086956522,106.61458333333334,106.46683673469389,0,0,0,0.0,0,0,0,0.0,0,0,0,0
2018-10-17,1610612765,1610612751,2018,103.0,100.0,203.0,103.80434782608697,103.98913043478261,106.77777777777777,109.9888888888889,0,0,0,0.0,0,0,0,0.0,0,0,0,0
2018-10-17,1610612754,1610612763,2018,111.0,83.0,194.0,105.14423076923077,103.29632867132867,99.95862884160756,105.45508274231679,0,0,0,0.0,0,0,0,0.0,0,0,0,0
2018-10-17,1610612753,1610612748,2018,104.0,101.0,205.0,102.81521739130434,107.07608695652173,103.73530612244897,104.2269387755102,0,0,0,0.0,0,0,0,0.0,0,0,0,0
2018-10-17,1610612752,1610612737,2018,126.0,107.0,233.0,104.26052009456265,108.38037825059101,103.49408983451536,108.66122931442081,0,0,0,0.0,0,0,0,0.0,0,0,0,0
2018-10-17,1610612761,1610612739,2018,116.0,104.0,220.0,111.30392156862746,104.62490196078431,108.29043887147336,108.36426332288401,0,0,0,0.0,0,0,0,0.0,0,0,0,0
2018-10-17,1610612745,1610612740,2018,112.0,131.0,243.0,110.97222222222223,103.53092243186583,111.37916499397832,111.32697711762344,0,0,0,0.0,0,0,0,0.0,0,0,0,0
2018-10-17,1610612759,1610612750,2018,112.0,108.0,220.0,102.90051020408163,100.28784013605443,109.12377994676132,108.43034605146407,0,0,0,0.0,0,0,0,0.0,0,0,0,0
2018-10-17,1610612758,1610612762,2018,117.0,123.0,240.0,98.77690166975881,106.24049165120593,104.66360294117646,100.2469362745098,0,0,0,0.0,0,0,0,0.0,0,0,0,0
2018-10-17,1610612746,1610612743,2018,98.0,107.0,205.0,108.88322612568035,108.48837209302326,109.83673469387756,108.0391156462585,0,0,0,0.0,0,0,0,0.0,0,0,0,0
2018-10-17,1610612756,1610612742,2018,121.0,100.0,221.0,103.75555555555556,113.25555555555556,102.75990338164252,105.31352657004831,0,0,0,0.0,0,0,0,0.0,0,0,0,0
2018-10-16,1610612738,1610612755,2018,105.0,87.0,192.0,103.51768867924528,100.56772237196765,109.80812324929971,105.73249299719888,0,0,0,0.0,0,0,0,0.0,0,0,0,0
2018-10-16,1610612744,1610612760,2018,108.0,100.0,208.0,112.83498560921011,106.56619763351455,107.14152617568766,104.08096716947648,0,0,0,0.0,0,0,0,0.0,0,0,0,0
2018-10-12,1610612753,1610612759,2018,81.0,100.0,181.0,103.06183574879228,107.14323671497584,102.90316977854971,100.51346070343031,0,0,0,0.0,0,0,0,0.0,0,0,0,0
2018-10-12,1610612742,1610612766,2018,118.0,123.0,241.0,102.61111111111111,105.1,108.00144927536232,107.61642512077294,0,0,0,0.0,0,0,0,0.0,0,0,0,0
2018-10-12,1610612739,1610612765,2018,110.0,129.0,239.0,108.28181818181818,108.18277511961722,103.50386473429953,103.93961352657004,0,0,0,0.0,0,0,0,0.0,0,0,0,0
2018-10-12,1610612752,1610612751,2018,107.0,113.0,220.0,104.25265700483092,108.3084541062802,106.71338383838383,110.0409090909091,0,0,0,0.0,0,0,0,0.0,0,0,0,0
2018-10-12,1610612748,1610612737,2018,119.0,113.0,232.0,103.595,104.13,103.3719806763285,108.54975845410628,0,0,0,0.0,0,0,0,0.0,0,0,0,0
2018-10-12,1610612741,1610612743,2018,93.0,98.0,191.0,102.8586956521739,109.81521739130434,109.94791666666666,108.22321428571428,0,0,0,0.0,0,0,0,0.0,0,0,0,0
2018-10-12,1610612763,1610612745,2018,103.0,121.0,224.0,99.94082125603865,105.2596618357488,110.85683760683762,103.52457264957266,0,0,0,0.0,0,0,0,0.0,0,0,0,0
2018-10-12,1610612749,1610612750,2018,143.0,121.0,264.0,106.23404255319149,106.29396439426834,108.98007246376812,108.08106884057972,0,0,0,0.0,0,0,0,0.0,0,0,0,0
2018-10-12,1610612757,1610612758,2018,118.0,115.0,233.0,106.23803191489361,103.51595744680851,98.59280303030303,106.11931818181819,0,0,0,0.0,0,0,0,0.0,0,0,0,0
2018-10-12,1610612744,1610612747,2018,105.0,119.0,224.0,112.90322055953155,106.44404684450228,110.27857142857144,114.13571428571429,0,0,0,0.0,0,0,0,0.0,0,0,0,0
2018-10-11,1610612740,1610612761,2018,119.0,134.0,253.0,111.31972928630026,111.0908531583265,111.06,104.5,0,0,0,0.0,0,0,0,0.0,0,0,0,0
2018-10-11,1610612758,1610612762,2018,93.0,132.0,225.0,98.67684108527132,105.81831395348837,104.39458333333334,100.35125,0,0,0,0.0,0,0,0,0.0,0,0,0,0
2018-10-10,1610612765,1610612764,2018,97.0,102.0,199.0,103.6,103.94444444444444,107.01418439716312,106.31648936170212,0,0,0,0.0,0,0,0,0.0,0,0,0,0
2018-10-10,1610612753,1610612763,2018,102.0,86.0,188.0,103.08102766798419,107.37252964426878,100.0834980237154,105.32658102766798,0,0,0,0.0,0,0,0,0.0,0,0,0,0
2018-10-10,1610612761,1610612751,2018,118.0,91.0,209.0,111.00897959183673,104.61979591836734,106.90180878552971,109.96744186046513,0,0,0,0.0,0,0,0,0.0,0,0,0,0
2018-10-10,1610612737,1610612759,2018,130.0,127.0,257.0,103.09041501976284,108.34041501976284,102.61246672582077,100.21628216503993,0,0,0,0.0,0,0,0,0.0,0,0,0,0
2018-10-10,1610612748,1610612740,2018,140.0,128.0,268.0,103.22531914893617,103.86936170212766,111.13921404682274,110.80602006688963,0,0,0,0.0,0,0,0,0.0,0,0,0,0
2018-10-10,1610612741,1610612754,2018,104.0,89.0,193.0,102.85797101449276,110.02512077294686,105.28676470588235,103.29010695187166,0,0,0,0.0,0,0,0,0.0,0,0,0,0
2018-10-10,1610612757,1610612756,2018,116.0,83.0,199.0,106.13858695652175,103.72826086956522,104.00101010101011,113.2219696969697,0,0,0,0.0,0,0,0,0.0,0,0,0,0
2018-10-10,1610612747,1610612744,2018,123.0,113.0,236.0,107.64857142857143,109.77571428571429,112.90086206896552,106.30271883289126,0,0,0,0.0,0,0,0,0.0,0,0,0,0
2018-10-09,1610612760,1610612749,2018,119.0,115.0,234.0,107.03034420289856,103.95788043478261,106.14029255319149,106.18129432624113,0,0,0,0.0,0,0,0,0.0,0,0,0,0
2018-10-09,1610612746,1610612743,2018,109.0,103.0,212.0,108.88877654196158,108.54271991911021,110.01063829787233,108.24493414387031,0,0,0,0.0,0,0,0,0.0,0,0,0,0
2018-10-08,1610612755,1610612742,2018,112.0,115.0,227.0,109.79714285714286,105.61857142857143,102.4510101010101,105.04141414141415,0,0,0,0.0,0,0,0,0.0,0,0,0,0
2018-10-08,1610612766,1610612741,2018,110.0,104.0,214.0,108.0,107.65555555555555,102.83333333333334,110.04444444444445,0,0,0,0.0,0,0,0,0.0,0,0,0,0
2018-10-08,1610612739,1610612754,2018,102.0,111.0,213.0,108.34431818181818,108.15551948051947,105.215,103.30363636363637,0,0,0,0.0,0,0,0,0.0,0,0,0,0
2018-10-08,1610612765,1610612751,2018,108.0,110.0,218.0,103.57550505050506,103.85858585858585,106.87301587301587,110.00952380952381,0,0,0,0.0,0,0,0,0.0,0,0,0,0
2018-10-08,1610612748,1610612753,2018,90.0,89.0,179.0,103.38304347826087,104.02130434782609,103.23030303030303,107.57373737373737,0,0,0,0.0,0,0,0,0.0,0,0,0,0
2018-10-08,1610612752,1610612764,2018,98.0,110.0,208.0,104.34444444444443,108.26666666666667,106.96376811594203,106.41847826086956,0,0,0,0.0,0,0,0,0.0,0,0,0,0
2018-10-08,1610612744,1610612756,2018,109.0,117.0,226.0,112.93640350877193,106.19382591093117,103.8625322997416,113.26821705426357,0,0,0,0.0,0,0,0,0.0,0,0,0,0
2018-10-07,1610612760,1610612737,2018,113.0,94.0,207.0,106.97826086956522,104.05296022201665,103.1739898989899,108.29065656565656,0,0,0,0.0,0,0,0,0.0,0,0,0,0
2018-10-07,1610612759,1610612745,2018,93.0,108.0,201.0,102.74320652173913,100.1159420289855,110.86437908496731,103.61601307189542,0,0,0,0.0,0,0,0,0.0,0,0,0,0
2018-10-07,1610612750,1610612749,2018,107.0,125.0,232.0,109.025,107.88541666666666,105.93617021276594,106.19148936170212,0,0,0,0.0,0,0,0,0.0,0,0,0,0
2018-10-07,1610612757,1610612762,2018,112.0,123.0,235.0,106.07916666666667,103.50555555555556,104.20642006802721,100.26594387755102,0,0,0,0.0,0,0,0,0.0,0,0,0,0
2018-10-06,1610612739,1610612738,2018,113.0,102.0,215.0,108.30909090909091,108.20909090909092,103.51442307692308,100.45741758241758,0,0,0,0.0,0,0,0,0.0,0,0,0,0
2018-10-06,1610612763,1610612754,2018,109.0,104.0,213.0,99.99823232323232,105.31136363636364,105.21173469387756,103.24628942486086,0,0,0,0.0,0,0,0,0.0,0,0,0,0
2018-10-06,1610612747,1610612746,2018,87.0,103.0,190.0,107.84183673469389,109.81122448979592,108.95134575569358,108.80434782608695,0,0,0,0.0,0,0,0,0.0,0,0,0,0
2018-10-05,1610612742,1610612755,2018,114.0,120.0,234.0,102.3409090909091,104.85227272727273,109.67958333333334,105.55458333333334,0,0,0,0.0,0,0,0,0.0,0,0,0,0
2018-10-05,1610612764,1610612748,2018,121.0,114.0,235.0,106.83256244218316,106.32539315448659,103.25998225377107,103.8555900621118,0,0,0,0.0,0,0,0,0.0,0,0,0,0
2018-10-05,1610612752,1610612740,2018,106.0,100.0,206.0,104.34949494949495,108.33661616161616,111.2261295822677,110.8433503836317,0,0,0,0.0,0,0,0,0.0,0,0,0,0
2018-10-05,1610612763,1610612737,2018,120.0,110.0,230.0,99.7840909090909,105.22727272727272,103.07954545454545,108.1590909090909,0,0,0,0.0,0,0,0,0.0,0,0,0,0
2018-10-05,1610612750,1610612760,2018,101.0,113.0,214.0,109.14015151515152,107.81723484848484,106.9,104.09716312056737,0,0,0,0.0,0,0,0,0.0,0,0,0,0
2018-10-05,1610612759,1610612765,2018,117.0,93.0,210.0,102.62419056429232,100.1709065679926,103.67045454545455,103.72727272727272,0,0,0,0.0,0,0,0,0.0,0,0,0,0
2018-10-05,1610612756,1610612757,2018,93.0,115.0,208.0,103.97515856236787,113.25079281183932,105.97943262411347,103.62789598108748,0,0,0,0.0,0,0,0,0.0,0,0,0,0
2018-10-05,1610612744,1610612758,2018,122.0,94.0,216.0,112.85714285714286,106.28640109890111,98.708312716477,105.64943097476497,0,0,0,0.0,0,0,0,0.0,0,0,0,0
2018-10-04,1610612745,1610612754,2018,100.0,110.0,210.0,110.9864964853866,103.5662227155013,105.14583333333334,103.28030303030303,0,0,0,0.0,0,0,0,0.0,0,0,0,0
2018-10-04,1610612747,1610612758,2018,128.0,123.0,251.0,107.61607142857143,109.63988095238095,98.42593528816987,105.40798786653184,0,0,0,0.0,0,0,0,0.0,0,0,0,0
2018-10-03,1610612751,1610612752,2018,102.0,107.0,209.0,106.92099567099567,110.0254329004329,104.29545454545455,108.43181818181819,0,0,0,0.0,0,0,0,0.0,0,0,0,0
2018-10-03,1610612749,1610612741,2018,116.0,82.0,198.0,105.83256244218316,106.4350138760407,103.05757575757576,109.99646464646466,0,0,0,0.0,0,0,0,0.0,0,0,0,0
2018-10-03,1610612760,1610612765,2018,91.0,97.0,188.0,107.08478260869565,104.16376811594202,103.7233086680761,103.892177589852,0,0,0,0.0,0,0,0,0.0,0,0,0,0
2018-10-03,1610612746,1610612750,2018,128.0,101.0,229.0,108.74603174603175,108.88333333333333,109.20309477756285,107.61266924564796,0,0,0,0.0,0,0,0,0.0,0,0,0,0
2018-10-02,1610612766,1610612748,2018,122.0,113.0,235.0,107.86212121212122,107.59419191919193,103.14221014492753,103.6725543478261,0,0,0,0.0,0,0,0,0.0,0,0,0,0
2018-10-02,1610612738,1610612739,2018,95.0,102.0,197.0,103.60874125874126,100.43566433566434,108.36060606060606,108.33333333333334,0,0,0,0.0,0,0,0,0.0,0,0,0,0
2018-10-02,1610612745,1610612763,2018,131.0,115.0,246.0,110.81523378582202,103.46644042232278,99.59619450317125,104.96009513742072,0,0,0,0.0,0,0,0,0.0,0,0,0,0
2018-10-02,1610612762,1610612761,2018,105.0,90.0,195.0,104.19821971341727,100.34107685627443,111.20408163265306,104.63265306122449,0,0,0,0.0,0,0,0,0.0,0,0,0,0
2018-10-02,1610612747,1610612743,2018,111.0,113.0,224.0,107.5615501519757,109.5676291793313,109.96739130434783,108.24585921325051,0,0,0,0.0,0,0,0,0.0,0,0,0,0
2018-10-01,1610612755,1610612753,2018,120.0,114.0,234.0,109.58652210884354,105.44621598639456,103.10227272727273,107.44318181818181,0,0,0,0.0,0,0,0,0.0,0,0,0,0
2018-10-01,1610612764,1610612752,2018,121.0,124.0,245.0,106.69565217391305,106.11956521739131,104.04122621564483,108.31051797040169,0,0,0,0.0,0,0,0,0.0,0,0,0,0
2018-10-01,1610612737,1610612740,2018,116.0,102.0,218.0,102.94767441860465,108.23070824524314,111.29652173913044,110.78217391304348,0,0,0,0.0,0,0,0,0.0,0,0,0,0
2018-10-01,1610612756,1610612758,2018,102.0,106.0,208.0,103.98837209302326,113.33720930232559,98.31989664082687,105.44470284237727,0,0,0,0.0,0,0,0,0.0,0,0,0,0
2018-09-30,1610612759,1610612748,2018,104.0,100.0,204.0,102.6413043478261,100.15217391304347,103.1577243293247,103.6732192414431,0,0,0,0.0,0,0,0,0.0,0,0,0,0
2018-09-30,1610612738,1610612766,2018,115.0,112.0,227.0,103.52136752136752,100.32051282051282,107.79545454545455,107.51136363636364,0,0,0,0.0,0,0,0,0.0,0,0,0,0
2018-09-30,1610612741,1610612740,2018,128.0,116.0,244.0,102.7840909090909,109.9090909090909,111.22692990239574,110.59605146406389,0,0,0,0.0,0,0,0,0.0,0,0,0,0
2018-09-30,1610612747,1610612743,2018,107.0,124.0,231.0,107.54813664596273,109.37267080745342,109.8,108.29126984126984,0,0,0,0.0,0,0,0,0.0,0,0,0,0
2018-09-29,1610612761,1610612757,2018,122.0,104.0,226.0,111.10926870748298,104.62202380952381,105.99492753623188,103.4403381642512,0,0,0,0.0,0,0,0,0.0,0,0,0,0
2018-09-29,1610612744,1610612750,2018,110.0,114.0,224.0,112.8840909090909,106.20052447552447,109.12747035573122,107.59486166007905,0,0,0,0.0,0,0,0,0.0,0,0,0,0
2018-09-28,1610612766,1610612738,2018,104.0,97.0,201.0,107.86046511627907,107.63319238900635,103.56699346405229,100.29411764705881,0,0,0,0.0,0,0,0,0.0,0,0,0,0
